date,confirmed_patients,suspected_patients,all_hospital_beds,icu_covid_confirmed,icu_covid_suspected,icu_available_beds,total_covid_patients
2020-03-29,1,6,0,1,1,8,7
2020-03-29,0,0,0,0,0,0,0
2020-03-29,7,20,0,2,5,12,27
2020-03-29,6,13,0,5,3,7,19
2020-03-29,33,123,0,19,20,65,156
2020-03-29,2,12,0,2,4,2,14
2020-03-29,0,0,0,0,0,2,0
2020-03-29,46,27,0,16,10,28,73
2020-03-29,0,0,0,0,0,0,0
2020-03-29,1,5,0,0,0,0,6
2020-03-29,0,6,0,0,3,3,6
2020-03-29,0,0,0,0,0,0,0
2020-03-29,121,211,0,77,39,205,332
2020-03-29,489,1132,0,191,182,345,1621
2020-03-29,0,0,0,0,0,0,0
2020-03-29,0,0,0,0,0,0,0
2020-03-29,1,7,0,0,0,3,8
2020-03-29,7,12,0,3,4,948,19
2020-03-29,0,2,0,0,0,0,2
2020-03-29,20,48,0,9,8,25,68
2020-03-29,44,78,0,13,20,46,122
2020-03-29,141,72,0,65,15,70,213
2020-03-29,1,11,0,0,0,1,12
2020-03-29,0,0,0,0,0,0,0
2020-03-29,1,2,0,0,0,3,3
2020-03-29,18,14,0,4,1,10,32
2020-03-29,0,0,0,0,0,2,0
2020-03-29,36,91,0,20,16,119,127
2020-03-29,74,167,0,31,40,131,241
2020-03-29,34,35,0,5,2,7,69
2020-03-29,2,5,0,1,0,2,7
2020-03-29,0,1,0,0,0,2,1
2020-03-29,1,0,0,0,0,2,1
2020-03-29,36,27,0,12,18,50,63
2020-03-29,1,10,0,0,0,18,11
2020-03-29,2,16,0,1,2,10,18
2020-03-29,5,100,0,1,2,2,105
2020-03-29,8,116,0,3,14,22,124
2020-03-29,7,27,0,4,1,28,34
2020-03-29,0,0,0,0,0,0,0
2020-03-29,7,13,0,2,6,11,20
2020-03-29,1,1,0,1,0,1,2
2020-03-29,15,21,0,9,3,47,36
2020-03-29,0,26,0,0,0,5,26
2020-03-29,16,57,0,8,8,39,73
2020-03-29,23,0,0,1,0,3,0
2020-03-29,0,0,0,0,0,0,0
2020-03-29,0,1,0,0,1,0,1
2020-03-29,23,62,0,8,15,62,85
2020-03-29,2,3,0,1,1,0,5
2020-03-29,24,85,0,5,19,14,109
2020-03-29,0,0,0,0,0,0,0
2020-03-29,50,73,0,24,10,61,123
2020-03-29,0,0,0,0,0,0,0
2020-03-29,0,1,0,0,1,2,1
2020-03-30,0,4,0,0,0,0,4
2020-03-30,0,31,0,0,0,0,31
2020-03-30,146,446,0,72,23,228,592
2020-03-30,2,2,0,1,2,0,4
2020-03-30,67,179,0,27,33,66,246
2020-03-30,1,4,0,0,0,13,5
2020-03-30,98,251,0,42,58,131,349
2020-03-30,4,12,0,2,1,5,16
2020-03-30,5,11,0,3,4,957,16
2020-03-30,0,0,0,0,0,0,0
2020-03-30,19,19,0,5,1,29,38
2020-03-30,19,109,0,3,3,4,128
2020-03-30,10,9,0,4,2,16,19
2020-03-30,26,17,0,2,5,3,43
2020-03-30,0,0,0,0,0,0,0
2020-03-30,1,9,0,0,2,11,10
2020-03-30,0,0,0,0,0,3,0
2020-03-30,0,1,0,0,0,2,1
2020-03-30,5,21,0,4,6,7,26
2020-03-30,11,16,0,4,0,17,27
2020-03-30,153,93,0,74,23,103,246
2020-03-30,18,123,0,6,8,51,141
2020-03-30,0,1,0,0,1,5,1
2020-03-30,0,2,0,0,0,4,2
2020-03-30,59,89,0,27,18,146,148
2020-03-30,2,12,0,1,2,0,14
2020-03-30,58,92,0,18,7,90,150
2020-03-30,60,133,0,22,33,77,193
2020-03-30,17,51,0,9,5,29,68
2020-03-30,601,1277,0,245,244,456,1878
2020-03-30,3,8,0,1,0,9,11
2020-03-30,0,1,0,0,1,3,1
2020-03-30,3,17,0,2,4,10,20
2020-03-30,2,11,0,0,1,8,13
2020-03-30,25,82,0,5,28,15,107
2020-03-30,28,30,0,8,4,53,58
2020-03-30,19,25,0,11,7,48,44
2020-03-30,7,22,0,3,4,29,29
2020-03-30,0,1,0,0,0,0,1
2020-03-30,0,3,0,0,1,5,3
2020-03-30,1,8,0,0,0,10,9
2020-03-30,0,1,0,0,0,4,1
2020-03-30,1,5,0,1,3,4,6
2020-03-30,1,2,0,0,0,3,3
2020-03-30,15,16,0,6,0,47,31
2020-03-30,0,9,0,0,6,9,9
2020-03-30,10,88,0,3,14,24,98
2020-03-30,25,54,0,11,6,90,79
2020-03-30,0,2,0,0,0,5,2
2020-03-30,0,0,0,0,0,0,0
2020-03-30,1,1,0,1,0,1,2
2020-03-30,45,86,0,21,23,58,131
2020-03-30,0,0,0,0,0,0,0
2020-03-30,56,40,0,18,11,47,96
2020-03-30,0,2,0,0,0,2,2
2020-03-31,1,3,0,1,2,4,4
2020-03-31,15,15,0,6,5,42,30
2020-03-31,53,110,0,20,31,66,163
2020-03-31,8,18,0,3,3,21,26
2020-03-31,14,63,0,6,6,46,77
2020-03-31,19,29,0,14,7,48,48
2020-03-31,158,408,0,75,39,208,566
2020-03-31,20,31,0,9,1,34,51
2020-03-31,30,274,0,4,19,23,304
2020-03-31,0,0,0,0,0,0,0
2020-03-31,0,0,0,0,0,0,0
2020-03-31,36,40,0,2,1,6,76
2020-03-31,27,54,0,11,10,68,81
2020-03-31,0,1,0,0,0,7,1
2020-03-31,18,27,0,6,0,28,45
2020-03-31,10,9,0,0,6,12,19
2020-03-31,0,0,0,0,0,4,0
2020-03-31,0,1,0,0,0,4,1
2020-03-31,0,1,0,0,1,5,1
2020-03-31,12,100,0,3,4,4,112
2020-03-31,44,54,0,14,5,28,98
2020-03-31,0,0,0,0,0,4,0
2020-03-31,67,69,0,30,14,77,136
2020-03-31,713,1239,0,315,239,445,1952
2020-03-31,60,23,0,18,5,37,83
2020-03-31,6,14,0,4,5,9,20
2020-03-31,3,11,0,0,2,10,14
2020-03-31,4,20,0,2,3,2,24
2020-03-31,9,14,0,4,2,15,23
2020-03-31,155,98,0,73,17,92,253
2020-03-31,0,0,0,0,0,0,0
2020-03-31,7,15,0,3,6,955,22
2020-03-31,1,5,0,1,0,4,6
2020-03-31,0,0,0,0,0,0,0
2020-03-31,0,7,0,0,0,0,7
2020-03-31,1,5,0,1,1,12,6
2020-03-31,56,94,0,27,17,77,150
2020-03-31,82,231,0,33,48,63,313
2020-03-31,0,37,0,0,0,4,37
2020-03-31,21,90,0,5,24,12,111
2020-03-31,80,155,0,28,59,75,235
2020-03-31,0,4,0,0,0,3,4
2020-03-31,1,0,0,1,0,1,1
2020-03-31,0,83,0,0,0,6,0
2020-03-31,0,1,0,0,0,2,1
2020-03-31,1,10,0,1,2,7,11
2020-03-31,1,11,0,0,4,8,12
2020-03-31,3,2,0,2,2,1,5
2020-03-31,105,233,0,45,44,131,338
2020-03-31,11,15,0,4,2,17,26
2020-03-31,0,2,0,0,0,4,2
2020-03-31,1,3,0,1,0,5,4
2020-03-31,0,19,0,0,0,0,19
2020-03-31,2,21,0,2,4,6,23
2020-03-31,0,4,0,0,2,3,4
2020-04-01,0,1,0,0,1,4,1
2020-04-01,25,28,0,6,2,7,53
2020-04-01,4,15,0,3,4,7,19
2020-04-01,1,3,0,1,0,4,4
2020-04-01,0,7,0,0,0,0,7
2020-04-01,2,2,0,0,1,9,4
2020-04-01,0,5,0,0,2,3,5
2020-04-01,2,0,0,2,0,0,2
2020-04-01,0,1,0,0,1,5,1
2020-04-01,95,196,0,39,52,34,291
2020-04-01,25,39,0,10,6,31,64
2020-04-01,0,3,0,0,0,2,3
2020-04-01,2,6,0,1,2,1,8
2020-04-01,7,89,0,0,0,6,96
2020-04-01,0,0,0,0,0,0,0
2020-04-01,0,1,0,0,0,5,1
2020-04-01,0,0,0,0,0,0,0
2020-04-01,0,2,0,0,0,2,2
2020-04-01,1,4,0,0,1,13,5
2020-04-01,0,5,0,0,0,3,5
2020-04-01,1,9,0,0,3,7,10
2020-04-01,4,12,0,3,4,9,16
2020-04-01,739,1332,0,335,220,492,2071
2020-04-01,0,0,0,0,0,0,0
2020-04-01,168,340,0,71,32,215,508
2020-04-01,117,221,0,50,48,118,338
2020-04-01,31,42,0,12,12,61,73
2020-04-01,0,1,0,0,0,0,1
2020-04-01,85,182,0,29,47,76,267
2020-04-01,14,8,0,1,3,9,22
2020-04-01,57,35,0,19,9,36,92
2020-04-01,15,45,0,7,9,32,60
2020-04-01,67,66,0,30,8,64,133
2020-04-01,0,0,0,0,0,2,0
2020-04-01,0,0,0,0,0,0,0
2020-04-01,9,19,0,4,2,14,28
2020-04-01,3,15,0,0,3,9,18
2020-04-01,5,33,0,2,4,9,38
2020-04-01,8,10,0,5,6,968,18
2020-04-01,3,3,0,1,1,2,6
2020-04-01,23,23,0,15,6,51,46
2020-04-01,22,96,0,5,23,27,118
2020-04-01,5,18,0,1,2,22,23
2020-04-01,0,0,0,0,0,0,0
2020-04-01,52,76,0,27,15,106,128
2020-04-01,2,12,0,2,2,3,14
2020-04-01,13,16,0,4,4,15,29
2020-04-01,2,24,0,2,4,6,26
2020-04-01,160,85,0,77,15,91,245
2020-04-01,36,54,0,0,4,3,90
2020-04-01,14,18,0,5,2,31,32
2020-04-01,53,138,0,20,33,74,191
2020-04-01,0,0,0,0,0,2,0
2020-04-01,25,35,0,16,11,21,60
2020-04-01,0,2,0,0,0,8,2
2020-04-01,19,101,0,5,13,53,120
2020-04-02,32,15,0,9,0,11,47
2020-04-02,15,8,0,7,1,27,23
2020-04-02,17,74,0,6,13,33,91
2020-04-02,7,16,0,3,1,16,23
2020-04-02,136,181,0,45,49,104,317
2020-04-02,26,44,0,18,10,47,70
2020-04-02,0,1,0,0,0,0,1
2020-04-02,0,1,0,0,1,4,1
2020-04-02,0,0,0,0,0,0,0
2020-04-02,0,7,0,0,0,0,7
2020-04-02,1,4,0,1,1,12,5
2020-04-02,818,1270,0,346,193,488,2088
2020-04-02,1,8,0,0,2,8,9
2020-04-02,163,101,0,69,19,95,264
2020-04-02,62,40,0,26,4,26,102
2020-04-02,0,3,0,0,2,4,3
2020-04-02,0,0,0,0,0,0,0
2020-04-02,71,92,0,24,19,80,163
2020-04-02,18,2,0,0,0,2,20
2020-04-02,0,3,0,0,0,2,3
2020-04-02,1,7,0,1,3,6,8
2020-04-02,0,0,0,0,0,2,0
2020-04-02,75,60,0,32,11,58,135
2020-04-02,15,12,0,0,6,10,27
2020-04-02,0,1,0,0,0,5,1
2020-04-02,4,26,0,4,5,3,30
2020-04-02,0,0,0,0,0,0,0
2020-04-02,57,76,0,29,17,112,133
2020-04-02,5,5,0,4,4,966,10
2020-04-02,0,1,0,0,0,2,1
2020-04-02,32,38,0,13,10,73,70
2020-04-02,0,1,0,0,0,0,1
2020-04-02,3,2,0,2,3,0,5
2020-04-02,14,14,0,4,2,12,28
2020-04-02,27,111,0,7,24,15,138
2020-04-02,4,26,0,2,2,12,30
2020-04-02,4,16,0,3,5,6,20
2020-04-02,8,18,0,1,0,10,26
2020-04-02,4,4,0,3,0,7,8
2020-04-02,8,102,0,0,1,3,110
2020-04-02,0,3,0,0,0,2,3
2020-04-02,2,25,0,2,6,4,27
2020-04-02,144,343,0,69,35,206,487
2020-04-02,129,225,0,67,47,96,354
2020-04-02,2,0,0,2,0,0,2
2020-04-02,2,4,0,1,0,10,6
2020-04-02,126,185,0,50,45,37,311
2020-04-02,4,5,0,0,1,3,9
2020-04-02,2,6,0,1,1,7,8
2020-04-02,0,0,0,0,0,0,0
2020-04-02,27,77,0,12,23,36,104
2020-04-02,30,43,0,11,7,22,73
2020-04-02,0,1,0,0,1,5,1
2020-04-02,38,58,0,2,1,6,96
2020-04-02,0,1,0,0,0,8,1
2020-04-02,42,42,0,20,7,17,84
2020-04-03,6,15,0,5,2,3,21
2020-04-03,0,0,0,0,0,0,0
2020-04-03,0,3,0,1,0,3,3
2020-04-03,0,0,0,0,0,1,0
2020-04-03,0,5,0,0,1,6,5
2020-04-03,164,83,0,71,17,97,247
2020-04-03,31,39,0,15,10,75,70
2020-04-03,0,5,0,0,1,7,5
2020-04-03,1,7,0,0,0,10,8
2020-04-03,65,39,0,26,4,38,104
2020-04-03,28,45,0,12,8,22,73
2020-04-03,131,182,0,66,36,151,313
2020-04-03,22,116,0,6,28,56,138
2020-04-03,15,81,0,7,16,35,96
2020-04-03,0,2,0,0,0,0,2
2020-04-03,1,9,0,0,1,9,10
2020-04-03,118,204,0,44,53,57,322
2020-04-03,2,12,0,2,2,5,14
2020-04-03,0,0,0,0,0,8,0
2020-04-03,962,1239,0,422,209,473,2201
2020-04-03,3,19,0,2,6,9,22
2020-04-03,8,102,0,1,2,1,110
2020-04-03,35,73,0,12,16,47,108
2020-04-03,0,0,0,0,0,0,0
2020-04-03,16,21,0,7,5,23,37
2020-04-03,77,76,0,28,17,76,153
2020-04-03,4,8,0,3,0,2,12
2020-04-03,64,74,0,32,13,117,138
2020-04-03,21,23,0,10,1,7,44
2020-04-03,0,3,0,0,0,0,3
2020-04-03,9,7,0,7,0,5,16
2020-04-03,0,2,0,0,0,2,2
2020-04-03,4,5,0,1,1,4,9
2020-04-03,0,0,0,0,0,0,0
2020-04-03,105,182,0,44,59,127,287
2020-04-03,1,0,0,1,0,5,1
2020-04-03,41,38,0,18,8,22,79
2020-04-03,80,71,0,39,8,74,151
2020-04-03,6,24,0,2,3,15,30
2020-04-03,15,9,0,0,4,14,24
2020-04-03,16,18,0,3,1,17,34
2020-04-03,0,0,0,0,0,0,0
2020-04-03,0,0,0,0,0,1,0
2020-04-03,27,29,0,18,4,50,56
2020-04-03,2,9,0,1,3,14,11
2020-04-03,0,1,0,0,0,5,1
2020-04-03,4,5,0,3,2,967,9
2020-04-03,2,7,0,3,6,4,9
2020-04-03,0,2,0,0,1,2,2
2020-04-03,0,0,0,0,0,0,0
2020-04-03,171,308,0,84,28,216,479
2020-04-03,0,3,0,0,1,4,3
2020-04-03,2,4,0,2,1,5,6
2020-04-03,18,2,0,0,0,2,20
2020-04-03,6,16,0,3,5,17,22
2020-04-03,2,0,0,2,0,0,2
2020-04-04,0,2,0,0,0,0,2
2020-04-04,4,6,0,3,3,954,10
2020-04-04,1,8,0,0,1,6,9
2020-04-04,2,16,0,2,2,7,18
2020-04-04,4,5,0,3,3,4,9
2020-04-04,0,1,0,0,0,8,1
2020-04-04,126,186,0,39,56,125,312
2020-04-04,0,4,0,0,0,8,4
2020-04-04,0,1,0,0,0,5,1
2020-04-04,0,0,0,0,0,0,0
2020-04-04,60,95,0,35,18,120,155
2020-04-04,2,3,0,2,0,0,5
2020-04-04,2,6,0,2,2,5,8
2020-04-04,0,2,0,0,1,5,2
2020-04-04,16,25,0,4,2,18,41
2020-04-04,159,79,0,72,19,91,238
2020-04-04,5,16,0,3,5,12,21
2020-04-04,0,0,0,0,0,2,0
2020-04-04,30,47,0,12,7,87,77
2020-04-04,21,127,0,7,25,10,148
2020-04-04,7,16,0,2,6,15,23
2020-04-04,20,2,0,0,0,2,22
2020-04-04,16,19,0,7,2,23,35
2020-04-04,0,3,0,0,1,7,3
2020-04-04,0,1,0,0,1,2,1
2020-04-04,0,0,0,0,0,0,0
2020-04-04,43,30,0,16,7,24,73
2020-04-04,4,6,0,3,0,7,10
2020-04-04,0,0,0,0,0,0,0
2020-04-04,3,14,0,1,4,7,17
2020-04-04,0,2,0,0,0,1,2
2020-04-04,69,76,0,25,18,82,145
2020-04-04,66,19,0,25,6,40,85
2020-04-04,28,34,0,18,2,53,62
2020-04-04,0,0,0,0,0,0,0
2020-04-04,1,9,0,1,0,0,10
2020-04-04,0,0,0,0,0,0,0
2020-04-04,30,45,0,12,9,26,75
2020-04-04,1,0,0,1,0,5,1
2020-04-04,9,10,0,5,2,5,19
2020-04-04,8,106,0,1,1,2,114
2020-04-04,5,14,0,1,1,6,19
2020-04-04,177,218,0,86,19,222,395
2020-04-04,15,9,0,0,3,12,24
2020-04-04,8,20,0,5,1,6,28
2020-04-04,138,254,0,51,66,67,392
2020-04-04,143,213,0,70,45,153,356
2020-04-04,0,0,0,0,0,0,0
2020-04-04,0,4,0,0,1,4,4
2020-04-04,23,14,0,10,1,12,37
2020-04-04,1,4,0,0,0,7,5
2020-04-04,14,93,0,7,20,36,107
2020-04-04,2,10,0,4,0,13,12
2020-04-04,33,54,0,14,11,29,87
2020-04-04,80,65,0,37,7,79,145
2020-04-04,1007,1190,0,449,181,537,2197
2020-04-05,20,2,0,0,0,2,22
2020-04-05,0,0,0,0,0,4,0
2020-04-05,6,21,0,2,6,16,27
2020-04-05,69,15,0,24,6,36,84
2020-04-05,15,17,0,6,24,3,32
2020-04-05,0,0,0,0,0,0,0
2020-04-05,4,20,0,8,2,3,24
2020-04-05,0,3,0,0,2,4,3
2020-04-05,129,207,0,47,60,130,336
2020-04-05,72,87,0,39,13,113,159
2020-04-05,79,68,0,37,11,74,147
2020-04-05,0,0,0,0,0,6,0
2020-04-05,3,1,0,2,0,0,4
2020-04-05,0,2,0,0,0,0,2
2020-04-05,2,4,0,2,1,3,6
2020-04-05,2,11,0,2,9,28,13
2020-04-05,9,106,0,1,0,3,115
2020-04-05,3,6,0,3,3,4,9
2020-04-05,179,220,0,89,31,247,399
2020-04-05,29,35,0,15,10,74,64
2020-04-05,0,0,0,0,0,0,0
2020-04-05,144,221,0,70,46,156,365
2020-04-05,1094,1082,0,473,166,554,2176
2020-04-05,5,15,0,3,5,13,20
2020-04-05,0,1,0,0,0,8,1
2020-04-05,2,16,0,1,6,10,18
2020-04-05,5,12,0,4,4,10,17
2020-04-05,16,6,0,0,3,7,22
2020-04-05,0,0,0,0,0,0,0
2020-04-05,1,8,0,0,1,11,9
2020-04-05,9,9,0,8,1,3,18
2020-04-05,0,0,0,0,0,0,0
2020-04-05,0,2,0,0,2,3,2
2020-04-05,0,0,0,0,0,0,0
2020-04-05,16,15,0,4,0,23,31
2020-04-05,0,1,0,0,0,1,1
2020-04-05,146,240,0,59,54,70,386
2020-04-05,16,81,0,8,15,39,97
2020-04-05,8,11,0,4,0,13,19
2020-04-05,0,0,0,0,0,0,0
2020-04-05,15,10,0,1,3,8,25
2020-04-05,0,4,0,0,2,3,4
2020-04-05,46,24,0,17,4,19,70
2020-04-05,30,25,0,14,5,30,55
2020-04-05,23,13,0,10,1,10,36
2020-04-05,0,0,0,0,0,2,0
2020-04-05,21,128,0,7,28,12,149
2020-04-05,23,27,0,12,4,40,50
2020-04-05,0,1,0,0,0,5,1
2020-04-05,64,78,0,23,26,82,142
2020-04-05,166,69,0,68,18,90,235
2020-04-05,2,3,0,0,0,8,5
2020-04-05,3,0,0,2,0,0,3
2020-04-05,31,26,0,18,2,59,57
2020-04-05,1,0,0,1,0,5,1
2020-04-05,1,14,0,1,1,10,15
2020-04-06,9,114,0,1,0,3,123
2020-04-06,31,32,0,14,3,20,63
2020-04-06,79,70,0,43,19,92,149
2020-04-06,1,19,0,1,3,7,20
2020-04-06,4,0,0,3,4,-3,4
2020-04-06,0,0,0,0,0,6,0
2020-04-06,0,0,0,0,0,0,0
2020-04-06,68,20,0,25,5,36,88
2020-04-06,18,81,0,11,20,45,99
2020-04-06,0,0,0,0,0,0,0
2020-04-06,3,3,0,2,0,0,6
2020-04-06,34,26,0,19,5,54,60
2020-04-06,15,21,0,6,6,28,36
2020-04-06,129,193,0,46,65,152,322
2020-04-06,2,3,0,2,2,42,5
2020-04-06,12,24,0,8,3,16,36
2020-04-06,0,3,0,0,0,0,3
2020-04-06,0,0,0,0,0,0,0
2020-04-06,4,2,0,0,2,4,6
2020-04-06,28,28,0,12,4,37,56
2020-04-06,1166,1070,0,486,175,587,2236
2020-04-06,22,106,0,9,20,32,128
2020-04-06,0,0,0,0,0,6,0
2020-04-06,3,3,0,2,0,3,6
2020-04-06,0,0,0,0,0,0,0
2020-04-06,5,9,0,4,2,5,14
2020-04-06,6,3,0,2,2,28,9
2020-04-06,6,18,0,2,4,20,24
2020-04-06,9,14,0,7,2,3,23
2020-04-06,16,15,0,5,1,18,31
2020-04-06,0,0,0,0,0,2,0
2020-04-06,0,8,0,0,2,1,8
2020-04-06,0,7,0,0,0,15,7
2020-04-06,77,78,0,26,19,75,155
2020-04-06,1,15,0,1,5,9,16
2020-04-06,80,71,0,34,9,71,151
2020-04-06,0,0,0,0,0,5,0
2020-04-06,0,2,0,0,2,10,2
2020-04-06,0,0,0,0,0,0,0
2020-04-06,20,2,0,0,0,2,22
2020-04-06,30,28,0,15,11,78,58
2020-04-06,148,185,0,60,43,102,333
2020-04-06,3,12,0,0,3,2,15
2020-04-06,181,49,0,79,10,100,230
2020-04-06,20,12,0,10,1,24,32
2020-04-06,0,2,0,0,1,8,2
2020-04-06,0,0,0,0,0,0,0
2020-04-06,0,0,0,0,0,4,0
2020-04-06,16,1,0,0,0,10,17
2020-04-06,24,36,0,12,5,39,60
2020-04-06,187,224,0,83,25,270,411
2020-04-06,0,3,0,0,0,0,3
2020-04-06,8,8,0,4,4,13,16
2020-04-06,0,0,0,0,0,0,0
2020-04-06,145,171,0,73,33,134,316
2020-04-06,1,5,0,1,2,4,6
2020-04-07,2,5,0,2,4,30,7
2020-04-07,74,91,0,28,18,72,165
2020-04-07,187,47,0,77,7,105,234
2020-04-07,20,2,0,0,0,2,22
2020-04-07,9,14,0,7,2,3,23
2020-04-07,22,68,0,9,20,31,90
2020-04-07,0,1,0,0,0,8,1
2020-04-07,0,3,0,0,1,7,3
2020-04-07,9,121,0,1,0,3,130
2020-04-07,0,0,0,0,0,0,0
2020-04-07,0,0,0,0,0,6,0
2020-04-07,0,1,0,0,0,0,1
2020-04-07,0,0,0,0,0,0,0
2020-04-07,3,3,0,0,3,3,6
2020-04-07,0,5,0,0,3,7,5
2020-04-07,28,91,0,14,13,50,119
2020-04-07,8,23,0,5,6,10,31
2020-04-07,129,207,0,57,57,129,336
2020-04-07,0,0,0,0,0,0,0
2020-04-07,63,13,0,26,2,35,76
2020-04-07,6,28,0,2,6,21,34
2020-04-07,6,5,0,4,4,12,11
2020-04-07,1,4,0,1,2,3,5
2020-04-07,41,8,0,23,1,48,49
2020-04-07,16,2,0,0,3,10,18
2020-04-07,203,124,0,87,29,189,327
2020-04-07,143,144,0,71,29,136,287
2020-04-07,0,3,0,0,0,0,3
2020-04-07,0,0,0,0,0,0,0
2020-04-07,0,1,0,0,0,2,1
2020-04-07,19,18,0,9,3,20,37
2020-04-07,76,84,0,43,25,90,160
2020-04-07,5,8,0,2,3,6,13
2020-04-07,18,25,0,5,4,21,43
2020-04-07,0,1,0,0,0,0,1
2020-04-07,0,2,0,0,0,9,2
2020-04-07,0,0,0,0,0,1,0
2020-04-07,20,82,0,11,13,50,102
2020-04-07,146,178,0,54,49,126,324
2020-04-07,0,3,0,0,1,2,3
2020-04-07,2,3,0,2,1,4,5
2020-04-07,3,3,0,2,0,0,6
2020-04-07,0,1,0,0,1,5,1
2020-04-07,4,4,0,4,3,4,8
2020-04-07,1,14,0,1,5,6,15
2020-04-07,2,7,0,0,0,7,9
2020-04-07,88,116,0,36,9,57,204
2020-04-07,3,4,0,2,0,3,7
2020-04-07,31,38,0,17,9,82,69
2020-04-07,0,1,0,0,0,0,1
2020-04-07,31,33,0,14,4,20,64
2020-04-07,14,24,0,7,6,31,38
2020-04-07,0,0,0,0,0,3,0
2020-04-07,1251,1350,0,517,162,603,2601
2020-04-07,2,25,0,1,5,6,27
2020-04-07,28,40,0,13,9,32,68
2020-04-08,2,0,0,1,0,1,2
2020-04-08,225,103,0,92,24,183,328
2020-04-08,4,9,0,3,4,8,13
2020-04-08,0,2,0,0,0,8,2
2020-04-08,1,1,0,0,2,5,2
2020-04-08,1331,1077,0,532,211,582,2408
2020-04-08,156,34,0,70,6,104,190
2020-04-08,16,7,0,8,3,3,23
2020-04-08,2,7,0,1,2,6,9
2020-04-08,0,0,0,0,0,0,0
2020-04-08,6,22,0,2,5,18,28
2020-04-08,5,3,0,4,2,17,8
2020-04-08,32,19,0,11,8,18,51
2020-04-08,0,0,0,0,0,6,0
2020-04-08,0,0,0,0,0,0,0
2020-04-08,76,81,0,28,12,73,157
2020-04-08,0,0,0,0,0,0,0
2020-04-08,2,7,0,2,2,6,9
2020-04-08,0,6,0,0,1,7,6
2020-04-08,18,24,0,5,0,24,42
2020-04-08,30,35,0,11,5,58,65
2020-04-08,35,50,0,18,13,78,85
2020-04-08,0,2,0,0,0,4,2
2020-04-08,42,18,0,19,1,51,60
2020-04-08,66,20,0,25,2,32,86
2020-04-08,2,13,0,2,11,22,15
2020-04-08,0,0,0,0,0,1,0
2020-04-08,2,8,0,1,1,1,10
2020-04-08,22,63,0,10,8,64,85
2020-04-08,18,73,0,9,14,31,91
2020-04-08,84,69,0,45,18,111,153
2020-04-08,18,15,0,10,2,19,33
2020-04-08,4,5,0,2,2,10,9
2020-04-08,9,128,0,1,1,2,137
2020-04-08,0,0,0,0,0,0,0
2020-04-08,2,24,0,1,3,5,26
2020-04-08,0,0,0,0,0,1,0
2020-04-08,0,7,0,0,1,5,7
2020-04-08,153,181,0,49,34,201,334
2020-04-08,0,1,0,0,0,0,1
2020-04-08,132,301,0,51,53,144,433
2020-04-08,1,15,0,1,7,4,16
2020-04-08,16,3,0,0,1,10,19
2020-04-08,149,145,0,56,41,154,294
2020-04-08,0,0,0,0,1,1,0
2020-04-08,2,3,0,0,0,6,5
2020-04-08,31,57,0,16,3,32,88
2020-04-08,19,8,0,0,0,2,27
2020-04-08,0,2,0,0,1,4,2
2020-04-08,0,1,0,0,0,0,1
2020-04-08,0,0,0,0,0,7,0
2020-04-08,15,19,0,8,2,27,34
2020-04-08,7,16,0,2,5,22,23
2020-04-08,90,116,0,36,17,55,206
2020-04-08,0,3,0,0,1,5,3
2020-04-08,0,0,0,0,0,0,0
2020-04-09,17,26,0,5,0,22,43
2020-04-09,2,4,0,2,1,4,6
2020-04-09,2,6,0,0,2,6,8
2020-04-09,14,9,0,8,0,33,23
2020-04-09,1368,758,0,541,156,569,2126
2020-04-09,0,0,0,0,0,0,0
2020-04-09,0,0,0,0,0,0,0
2020-04-09,0,0,0,0,1,5,0
2020-04-09,27,35,0,16,9,25,62
2020-04-09,2,4,0,1,2,11,6
2020-04-09,37,64,0,18,12,73,101
2020-04-09,0,0,0,0,0,5,0
2020-04-09,5,21,0,2,4,24,26
2020-04-09,0,0,0,0,0,0,0
2020-04-09,2,10,0,2,8,21,12
2020-04-09,0,7,0,0,0,10,7
2020-04-09,0,1,0,0,0,0,1
2020-04-09,1,14,0,1,4,5,15
2020-04-09,18,15,0,0,0,2,33
2020-04-09,5,7,0,2,1,5,12
2020-04-09,0,0,0,0,0,8,0
2020-04-09,25,41,0,10,9,59,66
2020-04-09,58,14,0,18,2,39,72
2020-04-09,146,117,0,45,29,206,263
2020-04-09,227,124,0,98,18,163,351
2020-04-09,4,14,0,2,5,7,18
2020-04-09,201,159,0,59,34,133,360
2020-04-09,29,18,0,12,7,16,47
2020-04-09,0,3,0,0,2,5,3
2020-04-09,2,1,0,1,0,1,3
2020-04-09,0,0,0,0,0,0,0
2020-04-09,0,0,0,0,0,0,0
2020-04-09,28,30,0,11,7,45,58
2020-04-09,14,10,0,7,3,1,24
2020-04-09,1,7,0,0,2,5,8
2020-04-09,18,69,0,8,13,29,87
2020-04-09,158,65,0,70,17,87,223
2020-04-09,136,269,0,56,41,143,405
2020-04-09,3,18,0,2,4,6,21
2020-04-09,0,2,0,0,0,5,2
2020-04-09,5,7,0,2,1,21,12
2020-04-09,0,0,0,0,1,2,0
2020-04-09,10,11,0,5,4,19,21
2020-04-09,6,6,0,3,0,2,12
2020-04-09,74,60,0,31,11,63,134
2020-04-09,0,2,0,0,0,0,2
2020-04-09,17,3,0,0,1,10,20
2020-04-09,18,12,0,9,1,16,30
2020-04-09,0,0,0,0,0,3,0
2020-04-09,0,1,0,0,1,5,1
2020-04-09,40,18,0,20,2,45,58
2020-04-09,88,64,0,33,13,45,152
2020-04-09,9,135,0,1,0,3,144
2020-04-09,80,76,0,44,18,107,156
2020-04-09,0,0,0,0,0,11,0
2020-04-09,0,2,0,0,0,5,2
2020-04-10,18,9,0,9,3,31,27
2020-04-10,0,0,0,0,0,0,0
2020-04-10,0,0,0,0,0,0,0
2020-04-10,0,0,0,0,0,0,0
2020-04-10,0,0,0,0,0,6,0
2020-04-10,14,12,0,8,3,1,26
2020-04-10,26,17,0,14,5,20,43
2020-04-10,1299,754,0,514,142,663,2053
2020-04-10,0,3,0,0,0,4,3
2020-04-10,4,18,0,1,6,32,22
2020-04-10,2,3,0,2,3,24,5
2020-04-10,0,1,0,0,1,5,1
2020-04-10,0,1,0,0,0,2,1
2020-04-10,139,129,0,69,25,187,268
2020-04-10,2,10,0,0,3,0,12
2020-04-10,4,11,0,3,5,4,15
2020-04-10,151,44,0,67,5,99,195
2020-04-10,3,2,0,1,1,7,5
2020-04-10,27,41,0,11,9,57,68
2020-04-10,42,30,0,17,6,75,72
2020-04-10,18,21,0,5,1,25,39
2020-04-10,0,0,0,0,0,0,0
2020-04-10,0,0,0,0,0,11,0
2020-04-10,17,1,0,0,1,10,18
2020-04-10,6,26,0,1,1,17,32
2020-04-10,3,3,0,2,1,6,6
2020-04-10,56,12,0,18,3,41,68
2020-04-10,33,38,0,15,5,45,71
2020-04-10,2,8,0,1,0,7,10
2020-04-10,0,7,0,0,4,7,7
2020-04-10,11,10,0,6,1,16,21
2020-04-10,93,71,0,45,26,128,164
2020-04-10,0,3,0,0,0,2,3
2020-04-10,206,141,0,57,34,140,347
2020-04-10,0,0,0,0,0,4,0
2020-04-10,8,0,0,3,0,1,8
2020-04-10,0,1,0,0,0,8,1
2020-04-10,2,1,0,1,0,1,3
2020-04-10,9,135,0,1,0,3,144
2020-04-10,156,295,0,66,58,134,451
2020-04-10,19,76,0,8,13,30,95
2020-04-10,0,2,0,0,1,4,2
2020-04-10,5,7,0,2,1,12,12
2020-04-10,0,0,0,0,0,4,0
2020-04-10,0,0,0,0,1,0,0
2020-04-10,0,2,0,0,0,0,2
2020-04-10,1,15,0,1,5,5,16
2020-04-10,27,17,0,11,3,44,44
2020-04-10,0,0,0,0,0,0,0
2020-04-10,0,5,0,0,1,6,5
2020-04-10,16,11,0,9,3,9,27
2020-04-10,85,46,0,32,12,125,131
2020-04-10,0,0,0,0,0,0,0
2020-04-10,70,45,0,30,13,69,115
2020-04-10,42,13,0,19,1,43,55
2020-04-10,230,124,0,96,14,153,354
2020-04-11,0,2,0,0,1,3,2
2020-04-11,0,3,0,0,0,2,3
2020-04-11,0,0,0,0,0,0,0
2020-04-11,20,19,0,7,4,13,39
2020-04-11,0,0,0,0,0,7,0
2020-04-11,0,0,0,0,0,0,0
2020-04-11,3,19,0,1,4,30,22
2020-04-11,0,0,0,0,0,4,0
2020-04-11,0,0,0,0,0,4,0
2020-04-11,5,3,0,2,0,12,8
2020-04-11,87,91,0,46,19,121,178
2020-04-11,153,213,0,57,42,117,366
2020-04-11,0,1,0,0,1,11,1
2020-04-11,0,0,0,0,0,0,0
2020-04-11,67,46,0,29,10,80,113
2020-04-11,0,0,0,0,0,0,0
2020-04-11,3,3,0,2,1,5,6
2020-04-11,0,0,0,0,0,6,0
2020-04-11,23,19,0,8,4,44,42
2020-04-11,10,0,0,4,0,1,10
2020-04-11,12,3,0,4,2,19,15
2020-04-11,146,61,0,66,8,106,207
2020-04-11,54,15,0,18,2,42,69
2020-04-11,14,11,0,7,3,1,25
2020-04-11,0,2,0,0,1,5,2
2020-04-11,3,4,0,1,0,7,7
2020-04-11,0,0,0,0,0,0,0
2020-04-11,2,4,0,1,1,5,6
2020-04-11,2,27,0,1,3,14,29
2020-04-11,0,0,0,0,0,5,0
2020-04-11,2,2,0,2,0,9,4
2020-04-11,28,63,0,11,8,52,91
2020-04-11,2,2,0,0,0,2,4
2020-04-11,2,5,0,0,3,3,7
2020-04-11,13,16,0,9,4,32,29
2020-04-11,1362,905,0,555,135,595,2267
2020-04-11,10,140,0,1,0,3,150
2020-04-11,2,10,0,2,5,23,12
2020-04-11,232,127,0,57,26,149,359
2020-04-11,0,0,0,0,0,0,0
2020-04-11,32,52,0,17,4,41,84
2020-04-11,0,5,0,0,2,5,5
2020-04-11,18,17,0,5,2,24,35
2020-04-11,0,4,0,0,0,0,4
2020-04-11,0,2,0,0,0,3,2
2020-04-11,40,16,0,21,4,53,56
2020-04-11,82,51,0,28,13,132,133
2020-04-11,239,118,0,98,23,140,357
2020-04-11,0,0,0,0,0,0,0
2020-04-11,0,1,0,0,1,9,1
2020-04-11,23,14,0,14,5,28,37
2020-04-11,17,2,0,0,1,9,19
2020-04-11,144,109,0,44,20,219,253
2020-04-11,39,38,0,15,15,75,77
2020-04-11,22,58,0,9,11,33,80
2020-04-11,4,14,0,3,6,6,18
2020-04-12,138,108,0,63,33,190,246
2020-04-12,2,24,0,1,1,13,26
2020-04-12,245,142,0,69,26,146,387
2020-04-12,0,0,0,0,0,0,0
2020-04-12,0,3,0,0,0,6,3
2020-04-12,2,0,0,2,0,15,2
2020-04-12,4,15,0,3,6,4,19
2020-04-12,3,11,0,1,3,25,14
2020-04-12,19,15,0,6,3,6,34
2020-04-12,1,0,0,1,0,6,1
2020-04-12,0,2,0,0,0,6,2
2020-04-12,4,4,0,2,0,3,8
2020-04-12,0,0,0,0,0,0,0
2020-04-12,0,0,0,0,0,0,0
2020-04-12,0,0,0,0,0,6,0
2020-04-12,8,0,0,3,0,3,8
2020-04-12,0,4,0,0,0,0,4
2020-04-12,0,0,0,0,0,6,0
2020-04-12,0,0,0,0,0,2,0
2020-04-12,10,140,0,1,0,4,150
2020-04-12,0,0,0,0,0,6,0
2020-04-12,19,1,0,0,0,11,20
2020-04-12,0,0,0,0,0,0,0
2020-04-12,91,101,0,42,21,52,192
2020-04-12,31,28,0,18,3,41,59
2020-04-12,0,5,0,0,0,5,5
2020-04-12,244,108,0,99,19,170,352
2020-04-12,69,46,0,28,9,68,115
2020-04-12,23,46,0,11,4,54,69
2020-04-12,0,0,0,0,0,6,0
2020-04-12,25,21,0,10,6,23,46
2020-04-12,0,0,0,0,0,0,0
2020-04-12,3,1,0,2,2,4,4
2020-04-12,15,4,0,6,1,22,19
2020-04-12,0,3,0,0,2,2,3
2020-04-12,1433,715,0,559,144,564,2148
2020-04-12,21,65,0,8,8,36,86
2020-04-12,19,19,0,8,3,7,38
2020-04-12,157,172,0,63,36,108,329
2020-04-12,145,51,0,66,8,102,196
2020-04-12,92,44,0,30,7,71,136
2020-04-12,2,8,0,2,4,24,10
2020-04-12,4,3,0,2,0,15,7
2020-04-12,42,7,0,21,1,53,49
2020-04-12,46,32,0,16,3,64,78
2020-04-12,19,13,0,4,4,26,32
2020-04-12,46,31,0,16,2,23,77
2020-04-12,0,0,0,0,0,5,0
2020-04-12,0,0,0,0,0,3,0
2020-04-12,0,2,0,0,2,9,2
2020-04-12,2,4,0,0,2,3,6
2020-04-12,18,13,0,8,1,2,31
2020-04-12,13,19,0,7,10,30,32
2020-04-12,0,0,0,0,0,0,0
2020-04-12,0,0,0,0,0,0,0
2020-04-12,0,3,0,0,0,2,3
2020-04-13,247,122,0,66,30,132,369
2020-04-13,243,107,0,101,24,171,350
2020-04-13,151,66,0,65,11,87,217
2020-04-13,22,57,0,12,8,60,79
2020-04-13,0,0,0,0,0,6,0
2020-04-13,19,1,0,0,1,12,20
2020-04-13,3,14,0,1,3,31,17
2020-04-13,14,3,0,6,0,18,17
2020-04-13,10,150,0,1,2,3,160
2020-04-13,42,7,0,21,2,59,49
2020-04-13,0,1,0,0,1,10,1
2020-04-13,44,44,0,16,5,69,88
2020-04-13,0,1,0,0,1,0,1
2020-04-13,22,19,0,4,2,21,41
2020-04-13,39,32,0,18,1,49,71
2020-04-13,0,0,0,0,0,3,0
2020-04-13,85,81,0,40,21,58,166
2020-04-13,18,9,0,5,3,10,27
2020-04-13,73,36,0,28,7,65,109
2020-04-13,0,2,0,0,1,3,2
2020-04-13,13,13,0,7,5,27,26
2020-04-13,149,81,0,54,17,205,230
2020-04-13,2,5,0,2,2,20,7
2020-04-13,0,4,0,0,1,8,4
2020-04-13,1,1,0,0,0,2,2
2020-04-13,0,0,0,0,0,6,0
2020-04-13,1501,793,0,570,150,632,2294
2020-04-13,0,0,0,0,0,0,0
2020-04-13,21,56,0,9,9,35,77
2020-04-13,0,4,0,0,0,0,4
2020-04-13,0,2,0,0,2,3,2
2020-04-13,2,8,0,0,1,10,10
2020-04-13,89,48,0,30,9,61,137
2020-04-13,0,3,0,0,0,0,3
2020-04-13,19,8,0,7,1,6,27
2020-04-13,57,19,0,18,4,26,76
2020-04-13,1,8,0,1,7,3,9
2020-04-13,2,2,0,2,2,5,4
2020-04-13,2,20,0,2,1,12,22
2020-04-13,167,155,0,60,24,135,322
2020-04-13,1,2,0,0,0,8,3
2020-04-13,0,0,0,0,0,0,0
2020-04-13,7,1,0,3,0,6,8
2020-04-13,0,1,0,0,1,3,1
2020-04-13,26,16,0,12,8,14,42
2020-04-13,0,0,0,0,0,0,0
2020-04-13,0,0,0,0,0,6,0
2020-04-13,4,0,0,2,0,14,4
2020-04-13,3,0,0,2,0,6,3
2020-04-13,0,1,0,0,0,9,1
2020-04-13,4,8,0,3,2,1,12
2020-04-13,0,4,0,0,1,5,4
2020-04-13,21,22,0,9,5,45,43
2020-04-13,0,1,0,0,0,0,1
2020-04-13,0,1,0,0,0,2,1
2020-04-13,0,0,0,0,0,0,0
2020-04-14,70,46,0,24,8,59,116
2020-04-14,24,45,0,12,8,42,69
2020-04-14,1,4,0,1,2,9,5
2020-04-14,10,156,0,0,1,5,166
2020-04-14,19,14,0,6,3,3,33
2020-04-14,1,1,0,0,1,7,2
2020-04-14,0,1,0,0,0,0,1
2020-04-14,37,51,0,15,9,61,88
2020-04-14,0,0,0,0,0,1,0
2020-04-14,0,4,0,0,2,7,4
2020-04-14,0,6,0,0,0,0,6
2020-04-14,3,0,0,2,0,12,3
2020-04-14,4,4,0,3,0,3,8
2020-04-14,0,3,0,0,0,0,3
2020-04-14,22,10,0,12,1,12,32
2020-04-14,0,0,0,0,0,2,0
2020-04-14,2,23,0,2,3,9,25
2020-04-14,35,23,0,17,3,45,58
2020-04-14,0,0,0,0,0,0,0
2020-04-14,3,4,0,2,1,7,7
2020-04-14,144,47,0,66,5,104,191
2020-04-14,0,0,0,0,0,4,0
2020-04-14,0,5,0,0,4,4,5
2020-04-14,0,1,0,0,0,12,1
2020-04-14,3,15,0,2,6,18,18
2020-04-14,8,0,0,2,0,2,8
2020-04-14,3,9,0,1,3,23,12
2020-04-14,17,15,0,5,4,9,32
2020-04-14,0,0,0,0,0,0,0
2020-04-14,24,35,0,9,7,43,59
2020-04-14,1,1,0,0,0,2,2
2020-04-14,0,0,0,0,0,6,0
2020-04-14,166,149,0,59,43,117,315
2020-04-14,2,7,0,0,0,10,9
2020-04-14,0,4,0,0,2,4,4
2020-04-14,18,25,0,9,7,50,43
2020-04-14,0,0,0,0,0,6,0
2020-04-14,15,5,0,6,0,18,20
2020-04-14,1,6,0,1,6,4,7
2020-04-14,0,1,0,0,0,2,1
2020-04-14,55,12,0,19,4,25,67
2020-04-14,0,3,0,0,0,3,3
2020-04-14,18,13,0,3,0,25,31
2020-04-14,0,0,0,0,0,0,0
2020-04-14,235,117,0,64,36,141,352
2020-04-14,147,111,0,57,31,259,258
2020-04-14,1587,613,0,588,115,614,2200
2020-04-14,42,8,0,19,1,64,50
2020-04-14,12,25,0,6,4,27,37
2020-04-14,243,109,0,101,22,162,352
2020-04-14,92,106,0,34,21,61,198
2020-04-14,0,0,0,0,0,8,0
2020-04-14,20,3,0,0,0,12,23
2020-04-14,0,1,0,0,0,0,1
2020-04-14,87,53,0,28,5,69,140
2020-04-14,0,0,0,0,0,4,0
2020-04-15,0,0,0,0,0,8,0
2020-04-15,1624,632,0,600,139,566,2256
2020-04-15,8,0,0,2,0,3,8
2020-04-15,236,112,0,98,23,148,348
2020-04-15,53,18,0,14,4,27,71
2020-04-15,0,0,0,0,0,7,0
2020-04-15,38,41,0,16,8,76,79
2020-04-15,0,4,0,0,0,0,4
2020-04-15,0,0,0,0,0,0,0
2020-04-15,21,21,0,10,3,27,42
2020-04-15,0,0,0,0,0,0,0
2020-04-15,149,109,0,65,39,61,258
2020-04-15,25,33,0,12,2,44,58
2020-04-15,0,0,0,0,0,8,0
2020-04-15,207,155,0,70,29,112,362
2020-04-15,4,10,0,2,4,11,14
2020-04-15,2,0,0,0,2,3,2
2020-04-15,13,11,0,2,4,12,24
2020-04-15,9,14,0,6,4,30,23
2020-04-15,19,17,0,7,4,33,36
2020-04-15,0,5,0,0,1,12,5
2020-04-15,1,1,0,1,0,13,2
2020-04-15,0,0,0,0,0,10,0
2020-04-15,3,3,0,0,2,1,6
2020-04-15,2,5,0,0,0,11,7
2020-04-15,0,0,0,0,0,0,0
2020-04-15,0,0,0,0,1,4,0
2020-04-15,0,0,0,0,0,0,0
2020-04-15,66,60,0,20,14,55,126
2020-04-15,40,12,0,16,1,47,52
2020-04-15,4,2,0,3,2,5,6
2020-04-15,15,163,0,0,0,6,178
2020-04-15,87,84,0,25,7,76,171
2020-04-15,20,11,0,4,1,22,31
2020-04-15,81,99,0,34,11,70,180
2020-04-15,3,13,0,1,7,25,16
2020-04-15,1,5,0,0,2,6,6
2020-04-15,0,0,0,0,0,2,0
2020-04-15,2,6,0,2,4,28,8
2020-04-15,0,2,0,0,2,8,2
2020-04-15,1,0,0,0,0,4,1
2020-04-15,1,6,0,0,1,6,7
2020-04-15,0,6,0,0,0,0,6
2020-04-15,21,13,0,7,4,2,34
2020-04-15,0,0,0,0,0,6,0
2020-04-15,25,57,0,8,16,37,82
2020-04-15,18,3,0,7,0,22,21
2020-04-15,144,42,0,65,6,92,186
2020-04-15,0,0,0,0,0,0,0
2020-04-15,3,4,0,2,1,2,7
2020-04-15,0,0,0,0,0,5,0
2020-04-15,0,0,0,0,0,2,0
2020-04-15,2,1,0,2,0,14,3
2020-04-15,0,0,0,0,0,3,0
2020-04-15,156,103,0,73,27,235,259
2020-04-15,37,7,0,17,2,61,44
2020-04-16,64,54,0,25,13,43,118
2020-04-16,0,2,0,0,1,4,2
2020-04-16,0,1,0,0,0,5,1
2020-04-16,54,18,0,13,3,26,72
2020-04-16,20,22,0,4,0,23,42
2020-04-16,4,3,0,3,1,7,7
2020-04-16,3,10,0,1,3,28,13
2020-04-16,0,3,0,0,0,2,3
2020-04-16,0,0,0,0,0,2,0
2020-04-16,0,0,0,0,0,2,0
2020-04-16,1,5,0,4,2,-1,6
2020-04-16,3,3,0,2,2,2,6
2020-04-16,21,7,0,9,1,3,28
2020-04-16,1,0,0,0,0,1,1
2020-04-16,0,1,0,0,1,5,1
2020-04-16,0,1,0,0,0,0,1
2020-04-16,9,15,0,6,4,28,24
2020-04-16,24,52,0,7,10,38,76
2020-04-16,1,10,0,0,3,8,11
2020-04-16,0,0,0,0,0,0,0
2020-04-16,134,48,0,69,8,89,182
2020-04-16,5,7,0,2,1,15,12
2020-04-16,0,0,0,0,0,5,0
2020-04-16,0,0,0,0,0,2,0
2020-04-16,0,0,0,0,0,0,0
2020-04-16,1,1,0,0,0,7,2
2020-04-16,0,0,0,0,0,8,0
2020-04-16,152,117,0,55,25,258,269
2020-04-16,1,0,0,1,0,14,1
2020-04-16,216,150,0,72,34,123,366
2020-04-16,0,3,0,0,1,5,3
2020-04-16,22,5,0,8,1,17,27
2020-04-16,1,0,0,0,0,2,1
2020-04-16,84,35,0,31,9,64,119
2020-04-16,18,19,0,6,3,25,37
2020-04-16,0,2,0,0,2,6,2
2020-04-16,33,33,0,12,4,48,66
2020-04-16,0,7,0,0,0,6,7
2020-04-16,12,18,0,1,1,15,30
2020-04-16,1679,620,0,594,108,608,2299
2020-04-16,37,59,0,14,13,61,96
2020-04-16,0,0,0,0,0,0,0
2020-04-16,0,1,0,0,1,10,1
2020-04-16,164,124,0,60,25,83,288
2020-04-16,0,5,0,0,0,0,5
2020-04-16,0,0,0,0,0,0,0
2020-04-16,8,0,0,2,0,5,8
2020-04-16,3,11,0,3,0,32,14
2020-04-16,2,1,0,1,0,15,3
2020-04-16,37,4,0,16,0,62,41
2020-04-16,41,19,0,17,0,57,60
2020-04-16,0,2,0,0,0,0,2
2020-04-16,73,82,0,31,9,66,155
2020-04-16,0,5,0,0,0,14,5
2020-04-16,231,111,0,94,19,151,342
2020-04-16,21,16,0,11,2,28,37
2020-04-17,4,2,0,2,0,15,6
2020-04-17,165,123,0,62,29,82,288
2020-04-17,7,0,0,2,0,0,7
2020-04-17,1,9,0,0,6,7,10
2020-04-17,0,5,0,0,0,0,5
2020-04-17,215,144,0,69,23,119,359
2020-04-17,85,91,0,35,18,55,176
2020-04-17,0,1,0,0,0,0,1
2020-04-17,2,6,0,1,3,33,8
2020-04-17,0,4,0,0,1,3,4
2020-04-17,15,17,0,7,2,22,32
2020-04-17,36,16,0,18,1,59,52
2020-04-17,4,0,0,1,0,14,4
2020-04-17,0,0,0,0,0,0,0
2020-04-17,0,3,0,0,0,4,3
2020-04-17,140,60,0,71,11,86,200
2020-04-17,0,1,0,0,0,0,1
2020-04-17,0,6,0,0,1,3,6
2020-04-17,0,0,0,0,0,0,0
2020-04-17,0,0,0,0,0,2,0
2020-04-17,0,5,0,0,0,7,5
2020-04-17,63,46,0,24,18,38,109
2020-04-17,2,4,0,1,3,0,6
2020-04-17,232,111,0,92,21,157,343
2020-04-17,0,1,0,0,0,13,1
2020-04-17,0,4,0,2,1,1,4
2020-04-17,0,0,0,0,0,0,0
2020-04-17,1,0,0,0,0,2,1
2020-04-17,1,0,0,1,0,13,1
2020-04-17,0,1,0,0,1,5,1
2020-04-17,31,29,0,12,2,52,60
2020-04-17,0,0,0,0,0,7,0
2020-04-17,0,3,0,0,1,5,3
2020-04-17,19,15,0,10,2,3,34
2020-04-17,36,6,0,16,0,63,42
2020-04-17,3,11,0,3,2,32,14
2020-04-17,79,36,0,28,8,66,115
2020-04-17,23,23,0,10,3,26,46
2020-04-17,1720,634,0,594,105,593,2354
2020-04-17,22,25,0,3,1,22,47
2020-04-17,51,16,0,16,1,22,67
2020-04-17,0,0,0,0,0,5,0
2020-04-17,160,124,0,58,15,274,284
2020-04-17,0,0,0,0,0,3,0
2020-04-17,0,0,0,0,0,2,0
2020-04-17,23,5,0,7,1,6,28
2020-04-17,12,17,0,1,2,16,29
2020-04-17,2,3,0,1,2,6,5
2020-04-17,10,11,0,5,1,36,21
2020-04-17,0,6,0,0,1,12,6
2020-04-17,0,2,0,0,2,9,2
2020-04-17,34,46,0,13,11,59,80
2020-04-17,0,4,0,0,2,3,4
2020-04-17,0,5,0,0,4,4,5
2020-04-17,23,33,0,8,11,37,56
2020-04-17,0,1,0,0,0,0,1
2020-04-18,35,44,0,13,8,79,79
2020-04-18,0,3,0,0,2,5,3
2020-04-18,0,4,0,0,0,5,4
2020-04-18,9,11,0,6,1,34,20
2020-04-18,8,0,0,2,0,1,8
2020-04-18,0,0,0,0,0,4,0
2020-04-18,23,27,0,11,4,38,50
2020-04-18,3,1,0,1,0,13,4
2020-04-18,4,0,0,1,0,14,4
2020-04-18,0,0,0,0,0,0,0
2020-04-18,0,0,0,0,0,0,0
2020-04-18,0,0,0,0,0,13,0
2020-04-18,0,0,0,0,0,1,0
2020-04-18,11,17,0,1,2,6,28
2020-04-18,32,35,0,13,2,51,67
2020-04-18,0,0,0,0,0,2,0
2020-04-18,0,8,0,0,2,11,8
2020-04-18,0,0,0,0,0,0,0
2020-04-18,0,7,0,0,0,7,7
2020-04-18,21,12,0,9,4,2,33
2020-04-18,0,2,0,0,1,6,2
2020-04-18,0,0,0,0,0,2,0
2020-04-18,25,28,0,9,5,35,53
2020-04-18,223,118,0,71,19,133,341
2020-04-18,0,0,0,0,0,0,0
2020-04-18,1,1,0,1,0,4,2
2020-04-18,33,14,0,18,2,56,47
2020-04-18,31,9,0,15,4,60,40
2020-04-18,0,0,0,0,0,6,0
2020-04-18,0,1,0,0,0,0,1
2020-04-18,0,1,0,0,1,4,1
2020-04-18,1,1,0,1,0,13,2
2020-04-18,157,120,0,64,23,263,277
2020-04-18,4,5,0,1,4,4,9
2020-04-18,14,23,0,5,1,31,37
2020-04-18,0,1,0,0,0,0,1
2020-04-18,82,73,0,36,16,62,155
2020-04-18,2,4,0,1,1,32,6
2020-04-18,0,0,0,0,0,11,0
2020-04-18,0,0,0,0,0,3,0
2020-04-18,0,3,0,0,0,4,3
2020-04-18,1,4,0,0,2,11,5
2020-04-18,0,0,0,0,0,6,0
2020-04-18,27,0,0,9,0,11,27
2020-04-18,2,2,0,1,1,12,4
2020-04-18,0,1,0,0,0,0,1
2020-04-18,49,12,0,16,0,37,61
2020-04-18,161,108,0,61,22,107,269
2020-04-18,3,12,0,3,2,23,15
2020-04-18,0,0,0,0,0,9,0
2020-04-18,137,52,0,67,13,84,189
2020-04-18,1709,578,0,586,110,579,2287
2020-04-18,26,21,0,2,0,38,47
2020-04-18,65,46,0,22,17,58,111
2020-04-18,223,97,0,90,18,164,320
2020-04-18,74,29,0,27,7,75,103
2020-04-19,0,0,0,0,0,0,0
2020-04-19,23,16,0,12,2,32,39
2020-04-19,0,3,0,0,0,14,3
2020-04-19,0,0,0,0,0,3,0
2020-04-19,0,0,0,0,0,0,0
2020-04-19,0,0,0,0,0,2,0
2020-04-19,1,0,0,1,0,11,1
2020-04-19,29,7,0,16,1,60,36
2020-04-19,143,32,0,67,5,105,175
2020-04-19,34,40,0,14,7,69,74
2020-04-19,2,7,0,2,1,27,9
2020-04-19,73,34,0,27,10,76,107
2020-04-19,26,26,0,9,4,33,52
2020-04-19,53,6,0,18,0,22,59
2020-04-19,11,10,0,6,3,40,21
2020-04-19,0,11,0,0,3,11,11
2020-04-19,0,7,0,0,0,7,7
2020-04-19,236,113,0,76,22,145,349
2020-04-19,13,16,0,5,3,41,29
2020-04-19,2,8,0,0,2,27,10
2020-04-19,1739,549,0,595,115,577,2288
2020-04-19,0,0,0,0,0,0,0
2020-04-19,0,3,0,0,0,7,3
2020-04-19,1,0,0,0,0,6,1
2020-04-19,0,1,0,0,0,0,1
2020-04-19,226,94,0,92,26,154,320
2020-04-19,1,0,0,1,0,5,1
2020-04-19,162,130,0,73,24,248,292
2020-04-19,32,35,0,14,2,59,67
2020-04-19,0,0,0,0,0,3,0
2020-04-19,0,2,0,0,2,5,2
2020-04-19,65,39,0,22,11,59,104
2020-04-19,11,12,0,1,5,6,23
2020-04-19,25,6,0,2,0,26,31
2020-04-19,0,0,0,0,0,0,0
2020-04-19,158,97,0,62,17,107,255
2020-04-19,3,7,0,1,3,10,10
2020-04-19,84,63,0,37,5,61,147
2020-04-19,8,0,0,3,0,0,8
2020-04-19,1,4,0,1,4,4,5
2020-04-19,0,0,0,0,0,5,0
2020-04-19,0,1,0,0,1,4,1
2020-04-19,0,0,0,0,0,11,0
2020-04-19,0,0,0,0,0,9,0
2020-04-19,0,0,0,0,0,0,0
2020-04-19,0,2,0,0,1,4,2
2020-04-19,0,0,0,0,0,2,0
2020-04-19,0,2,0,0,0,5,2
2020-04-19,27,0,0,9,0,13,27
2020-04-19,0,0,0,0,0,0,0
2020-04-19,25,8,0,11,2,1,33
2020-04-19,1,3,0,0,1,11,4
2020-04-19,6,0,0,0,0,21,6
2020-04-19,0,0,0,0,0,2,0
2020-04-19,2,3,0,1,0,13,5
2020-04-19,34,20,0,18,2,49,54
2020-04-20,1,0,0,1,0,16,1
2020-04-20,25,9,0,11,2,1,34
2020-04-20,0,0,0,0,0,0,0
2020-04-20,34,11,0,13,1,51,45
2020-04-20,24,7,0,2,1,23,31
2020-04-20,6,4,0,2,1,11,10
2020-04-20,0,1,0,0,1,7,1
2020-04-20,0,1,0,0,1,6,1
2020-04-20,0,6,0,0,0,4,6
2020-04-20,0,0,0,0,0,0,0
2020-04-20,1,0,0,1,0,4,1
2020-04-20,240,145,0,72,29,133,385
2020-04-20,69,32,0,33,8,62,101
2020-04-20,0,1,0,0,0,0,1
2020-04-20,10,11,0,6,3,36,21
2020-04-20,0,2,0,0,1,0,2
2020-04-20,85,52,0,38,4,59,137
2020-04-20,1,5,0,1,2,7,6
2020-04-20,0,0,0,0,0,0,0
2020-04-20,5,1,0,0,0,14,6
2020-04-20,0,6,0,0,0,7,6
2020-04-20,0,2,0,0,1,1,2
2020-04-20,27,0,0,9,0,15,27
2020-04-20,79,27,0,27,7,73,106
2020-04-20,0,0,0,0,0,0,0
2020-04-20,8,0,0,3,0,3,8
2020-04-20,0,1,0,0,1,5,1
2020-04-20,3,1,0,1,0,11,4
2020-04-20,152,200,0,60,28,150,352
2020-04-20,29,18,0,8,2,27,47
2020-04-20,0,0,0,0,0,0,0
2020-04-20,0,0,0,0,0,4,0
2020-04-20,30,23,0,16,4,18,53
2020-04-20,0,1,0,0,0,11,1
2020-04-20,238,76,0,95,13,149,314
2020-04-20,0,0,0,0,0,7,0
2020-04-20,37,28,0,13,8,75,65
2020-04-20,1,2,0,0,1,9,3
2020-04-20,56,16,0,18,4,19,72
2020-04-20,30,9,0,20,2,61,39
2020-04-20,8,7,0,2,1,15,15
2020-04-20,172,102,0,73,21,184,274
2020-04-20,2,12,0,0,6,29,14
2020-04-20,2,3,0,2,0,28,5
2020-04-20,35,30,0,15,1,55,65
2020-04-20,0,4,0,0,0,13,4
2020-04-20,0,1,0,0,0,0,1
2020-04-20,0,0,0,0,0,3,0
2020-04-20,1,2,0,1,0,8,3
2020-04-20,1,0,0,0,0,5,1
2020-04-20,1791,602,0,625,93,607,2393
2020-04-20,149,42,0,68,8,115,191
2020-04-20,13,18,0,5,6,34,31
2020-04-20,0,0,0,0,0,2,0
2020-04-20,0,0,0,0,0,2,0
2020-04-20,0,0,0,0,0,6,0
2020-04-21,153,204,2714,51,36,142,357
2020-04-21,3,2,351,1,0,16,5
2020-04-21,31,12,1171,13,1,57,43
2020-04-21,0,1,0,0,0,3,1
2020-04-21,1,1,387,1,0,9,2
2020-04-21,0,0,0,0,0,0,0
2020-04-21,0,3,0,0,2,4,3
2020-04-21,27,0,276,9,0,15,27
2020-04-21,76,45,738,25,9,79,121
2020-04-21,0,0,0,0,0,0,0
2020-04-21,4,18,0,2,2,11,22
2020-04-21,0,0,17,0,0,2,0
2020-04-21,28,28,976,9,10,25,56
2020-04-21,1,0,25,0,0,2,1
2020-04-21,0,0,0,0,0,2,0
2020-04-21,26,8,415,13,5,82,34
2020-04-21,0,0,445,0,0,16,0
2020-04-21,1,0,279,1,0,16,1
2020-04-21,0,5,0,0,0,15,5
2020-04-21,0,0,90,0,0,3,0
2020-04-21,23,12,161,12,0,1,35
2020-04-21,11,20,1400,4,7,72,31
2020-04-21,0,1,20,0,0,0,1
2020-04-21,1,4,58,1,2,7,5
2020-04-21,0,0,0,0,0,3,0
2020-04-21,2,17,575,0,6,28,19
2020-04-21,5,2,0,1,0,15,7
2020-04-21,1,0,50,1,0,3,1
2020-04-21,0,1,0,0,0,0,1
2020-04-21,1,0,80,1,0,4,1
2020-04-21,144,34,2582,70,16,120,178
2020-04-21,0,1,0,0,0,0,1
2020-04-21,0,2,58,0,0,6,2
2020-04-21,0,5,308,0,0,6,5
2020-04-21,0,3,155,0,0,12,3
2020-04-21,1,5,303,1,3,25,6
2020-04-21,179,129,4213,77,27,277,308
2020-04-21,35,35,764,15,3,46,70
2020-04-21,33,44,1037,13,11,71,77
2020-04-21,0,0,54,0,0,0,0
2020-04-21,0,1,151,0,0,9,1
2020-04-21,0,0,50,0,0,12,0
2020-04-21,5,4,242,2,1,11,9
2020-04-21,0,1,36,0,1,5,1
2020-04-21,85,59,591,41,9,66,144
2020-04-21,0,0,9,0,0,0,0
2020-04-21,6,17,204,2,0,38,23
2020-04-21,27,24,544,16,5,30,51
2020-04-21,221,84,3776,98,21,161,305
2020-04-21,1854,617,13663,613,111,941,2471
2020-04-21,8,0,223,3,0,6,8
2020-04-21,250,120,2726,81,32,112,370
2020-04-21,0,1,424,0,1,19,1
2020-04-21,53,14,395,19,2,33,67
2020-04-21,54,39,50,21,8,72,93
2020-04-21,7,4,875,2,1,68,11
2020-04-22,0,0,25,0,0,1,0
2020-04-22,0,0,54,0,0,0,0
2020-04-22,0,0,30,0,0,0,0
2020-04-22,1,0,80,1,0,4,1
2020-04-22,84,61,1141,38,17,46,145
2020-04-22,0,0,0,0,0,0,0
2020-04-22,32,25,1167,14,1,58,57
2020-04-22,26,8,161,12,0,1,34
2020-04-22,10,18,204,2,2,32,28
2020-04-22,36,43,748,14,4,52,79
2020-04-22,0,0,0,0,0,0,0
2020-04-22,1,7,303,1,3,25,8
2020-04-22,137,39,2741,68,9,157,176
2020-04-22,9,0,192,3,0,3,9
2020-04-22,0,0,445,0,0,13,0
2020-04-22,0,1,65,0,1,4,1
2020-04-22,3,3,0,0,0,4,6
2020-04-22,1,0,57,1,0,8,1
2020-04-22,29,28,632,14,4,25,57
2020-04-22,0,3,58,0,1,4,3
2020-04-22,0,1,0,0,0,3,1
2020-04-22,0,0,424,0,1,17,0
2020-04-22,0,2,0,0,1,3,2
2020-04-22,27,0,226,9,0,25,27
2020-04-22,50,17,395,15,2,32,67
2020-04-22,0,0,0,0,0,4,0
2020-04-22,172,111,4786,73,21,293,283
2020-04-22,1,0,279,1,0,14,1
2020-04-22,3,16,596,0,7,27,19
2020-04-22,0,0,12,0,0,0,0
2020-04-22,0,0,151,0,0,7,0
2020-04-22,0,5,165,0,1,13,5
2020-04-22,0,0,17,0,0,2,0
2020-04-22,0,1,25,0,0,0,1
2020-04-22,1858,590,17405,602,125,1215,2448
2020-04-22,149,201,3830,54,32,167,350
2020-04-22,47,23,50,18,5,79,70
2020-04-22,32,52,1031,13,14,75,84
2020-04-22,13,20,1421,5,6,58,33
2020-04-22,229,127,3668,84,25,176,356
2020-04-22,5,10,242,2,5,12,15
2020-04-22,0,3,568,0,0,22,3
2020-04-22,1,2,387,1,0,11,3
2020-04-22,5,20,0,1,1,10,25
2020-04-22,241,77,5467,104,21,365,318
2020-04-22,25,9,427,13,3,88,34
2020-04-22,4,0,0,1,0,14,4
2020-04-22,0,8,310,0,1,8,8
2020-04-22,27,30,1049,8,9,33,57
2020-04-22,0,1,151,0,0,2,1
2020-04-22,6,3,875,2,1,95,9
2020-04-22,0,0,9,0,0,0,0
2020-04-22,75,17,738,28,3,74,92
2020-04-22,3,4,351,1,1,10,7
2020-04-22,1,0,50,1,0,4,1
2020-04-22,0,0,50,0,0,12,0
2020-04-23,39,39,748,16,4,52,78
2020-04-23,9,0,192,3,0,4,9
2020-04-23,0,1,0,0,0,2,1
2020-04-23,48,40,737,17,7,80,88
2020-04-23,0,1,65,0,1,4,1
2020-04-23,0,0,17,0,0,2,0
2020-04-23,53,19,517,16,1,35,72
2020-04-23,1,0,645,1,0,16,1
2020-04-23,0,6,0,0,3,3,6
2020-04-23,0,0,25,0,0,0,0
2020-04-23,6,6,875,4,1,122,12
2020-04-23,0,0,25,0,0,1,0
2020-04-23,0,7,310,0,1,4,7
2020-04-23,1,3,116,0,1,6,4
2020-04-23,0,0,106,0,0,4,0
2020-04-23,1,4,526,1,1,30,5
2020-04-23,1,0,80,1,0,4,1
2020-04-23,0,1,58,0,0,4,1
2020-04-23,0,2,445,0,2,9,2
2020-04-23,1,1,387,1,0,2,2
2020-04-23,0,8,173,0,1,15,8
2020-04-23,24,16,717,13,4,90,40
2020-04-23,0,3,568,0,1,16,3
2020-04-23,0,0,9,0,0,0,0
2020-04-23,253,65,5501,105,12,389,318
2020-04-23,30,11,1429,16,1,63,41
2020-04-23,3,14,242,2,4,12,17
2020-04-23,0,0,54,0,0,0,0
2020-04-23,170,143,5251,75,25,293,313
2020-04-23,0,0,424,0,1,14,0
2020-04-23,0,1,151,0,1,7,1
2020-04-23,3,17,615,0,5,48,20
2020-04-23,31,51,1031,13,13,81,82
2020-04-23,0,1,50,0,1,11,1
2020-04-23,31,34,1047,15,6,25,65
2020-04-23,0,0,0,0,0,0,0
2020-04-23,0,1,30,0,0,0,1
2020-04-23,137,28,2741,67,5,137,165
2020-04-23,30,1,882,11,0,16,31
2020-04-23,3,3,351,1,0,9,6
2020-04-23,146,94,4516,54,19,175,240
2020-04-23,0,0,151,0,0,2,0
2020-04-23,1863,595,21107,600,118,1263,2458
2020-04-23,23,4,240,9,0,1,27
2020-04-23,11,15,204,5,4,31,26
2020-04-23,0,2,206,0,0,7,2
2020-04-23,1,0,50,1,0,5,1
2020-04-23,0,0,0,0,0,0,0
2020-04-23,75,29,1173,31,6,70,104
2020-04-23,4,0,130,1,0,14,4
2020-04-23,0,0,12,0,0,0,0
2020-04-23,4,21,0,1,1,11,25
2020-04-23,222,118,3526,83,24,232,340
2020-04-23,81,90,1129,37,24,95,171
2020-04-23,14,17,1421,6,2,62,31
2020-04-23,25,24,1305,10,5,47,49
2020-04-24,1,8,526,1,5,24,9
2020-04-24,1,4,307,0,1,8,5
2020-04-24,175,138,5374,68,24,391,313
2020-04-24,0,4,0,0,0,6,4
2020-04-24,0,2,445,0,2,10,2
2020-04-24,30,17,1715,16,1,59,47
2020-04-24,129,34,2741,60,5,134,163
2020-04-24,49,16,517,16,4,40,65
2020-04-24,152,101,4516,57,16,250,253
2020-04-24,0,0,12,0,0,0,0
2020-04-24,0,5,206,0,1,6,5
2020-04-24,33,0,882,11,0,19,33
2020-04-24,4,18,0,0,2,43,22
2020-04-24,4,1,351,2,0,12,5
2020-04-24,79,63,1127,39,10,110,142
2020-04-24,1,0,80,1,0,5,1
2020-04-24,0,0,0,0,0,0,0
2020-04-24,0,0,65,0,0,5,0
2020-04-24,0,1,151,0,0,9,1
2020-04-24,1860,546,20782,600,87,1378,2406
2020-04-24,12,15,1421,6,2,58,27
2020-04-24,1,0,387,1,0,7,1
2020-04-24,0,0,54,0,0,0,0
2020-04-24,223,120,3524,82,26,222,343
2020-04-24,0,1,0,0,0,6,1
2020-04-24,0,7,173,0,3,12,7
2020-04-24,1,3,89,1,0,5,4
2020-04-24,0,0,25,0,0,2,0
2020-04-24,41,37,748,19,1,47,78
2020-04-24,21,11,717,12,5,80,32
2020-04-24,4,0,130,1,0,17,4
2020-04-24,5,8,875,4,1,112,13
2020-04-24,0,0,9,0,0,0,0
2020-04-24,0,0,0,0,0,0,0
2020-04-24,1,4,116,0,2,6,5
2020-04-24,9,0,192,2,0,4,9
2020-04-24,1,0,645,1,0,16,1
2020-04-24,0,0,17,0,0,2,0
2020-04-24,24,10,248,8,1,6,34
2020-04-24,0,1,58,0,1,4,1
2020-04-24,0,0,151,0,0,4,0
2020-04-24,0,0,25,0,0,0,0
2020-04-24,0,2,50,0,1,11,2
2020-04-24,257,78,5606,107,13,408,335
2020-04-24,0,1,106,0,1,4,1
2020-04-24,0,0,30,0,0,0,0
2020-04-24,3,20,616,0,3,45,23
2020-04-24,53,37,737,17,11,121,90
2020-04-24,29,54,1031,12,11,87,83
2020-04-24,29,20,1047,12,4,26,49
2020-04-24,0,4,424,0,3,18,4
2020-04-24,0,4,568,0,0,11,4
2020-04-24,10,16,204,4,3,32,26
2020-04-24,75,19,1173,30,5,108,94
2020-04-24,2,11,242,2,2,12,13
2020-04-24,24,63,1283,6,3,40,87
2020-04-25,0,3,206,0,1,9,3
2020-04-25,4,30,340,0,3,106,34
2020-04-25,218,138,3550,81,30,235,356
2020-04-25,1,0,645,1,0,11,1
2020-04-25,0,0,30,0,0,0,0
2020-04-25,0,0,54,0,0,0,0
2020-04-25,125,47,3331,62,15,203,172
2020-04-25,0,1,65,0,0,5,1
2020-04-25,0,0,0,0,0,0,0
2020-04-25,26,0,882,7,0,22,26
2020-04-25,47,27,790,15,11,43,74
2020-04-25,27,71,1286,6,9,51,98
2020-04-25,6,0,199,2,0,5,6
2020-04-25,3,9,789,0,0,64,12
2020-04-25,4,4,354,2,3,4,8
2020-04-25,0,0,151,0,0,10,0
2020-04-25,268,96,5561,110,19,395,364
2020-04-25,1,7,155,0,2,11,8
2020-04-25,0,2,568,0,1,20,2
2020-04-25,1,4,526,1,1,28,5
2020-04-25,5,9,875,3,0,111,14
2020-04-25,1,3,110,0,2,2,4
2020-04-25,177,133,5370,74,21,394,310
2020-04-25,23,12,717,16,4,79,35
2020-04-25,0,0,0,0,0,0,0
2020-04-25,0,0,25,0,0,0,0
2020-04-25,2,13,358,2,3,16,15
2020-04-25,1,1,80,1,1,4,2
2020-04-25,25,53,1464,10,6,154,78
2020-04-25,0,0,17,0,0,2,0
2020-04-25,0,3,308,0,0,4,3
2020-04-25,29,18,1715,22,3,56,47
2020-04-25,10,16,592,3,4,61,26
2020-04-25,41,45,2014,19,2,86,86
2020-04-25,1,1,387,1,1,1,2
2020-04-25,0,3,89,0,0,6,3
2020-04-25,0,1,106,0,1,4,1
2020-04-25,53,46,1261,20,14,184,99
2020-04-25,5,0,130,1,0,18,5
2020-04-25,0,0,25,0,0,0,0
2020-04-25,0,1,0,0,1,5,1
2020-04-25,73,18,1412,29,3,132,91
2020-04-25,147,101,4496,53,14,277,248
2020-04-25,0,0,151,0,0,4,0
2020-04-25,0,0,9,0,0,0,0
2020-04-25,0,4,0,0,0,0,4
2020-04-25,83,53,1748,39,6,197,136
2020-04-25,0,3,424,0,0,14,3
2020-04-25,0,1,50,0,0,11,1
2020-04-25,27,20,1146,12,5,20,47
2020-04-25,21,23,1573,5,1,90,44
2020-04-25,0,2,58,0,0,3,2
2020-04-25,0,2,445,0,2,6,2
2020-04-25,24,8,249,8,1,5,32
2020-04-25,0,0,12,0,0,0,0
2020-04-25,1845,572,20233,579,99,1359,2417
2020-04-26,180,109,5370,73,23,378,289
2020-04-26,0,0,0,0,0,6,0
2020-04-26,24,13,717,12,4,85,37
2020-04-26,0,2,445,0,1,10,2
2020-04-26,0,1,58,0,0,5,1
2020-04-26,27,42,1464,9,9,150,69
2020-04-26,1,9,789,0,1,63,10
2020-04-26,4,1,354,2,0,5,5
2020-04-26,0,0,17,0,0,2,0
2020-04-26,0,0,0,0,0,0,0
2020-04-26,5,5,875,3,2,113,10
2020-04-26,79,21,1412,31,3,126,100
2020-04-26,1,2,110,0,2,5,3
2020-04-26,0,0,424,0,0,18,0
2020-04-26,0,0,25,0,0,0,0
2020-04-26,0,0,25,0,0,0,0
2020-04-26,37,44,2014,18,9,79,81
2020-04-26,53,10,790,18,2,43,63
2020-04-26,1,3,526,1,2,21,4
2020-04-26,0,4,206,0,2,6,4
2020-04-26,0,0,305,0,0,4,0
2020-04-26,146,83,4496,50,20,201,229
2020-04-26,0,2,0,0,1,5,2
2020-04-26,0,0,12,0,0,0,0
2020-04-26,1,1,130,1,1,23,2
2020-04-26,1,0,645,1,0,10,1
2020-04-26,24,19,1146,9,4,23,43
2020-04-26,8,14,592,3,1,62,22
2020-04-26,0,0,65,0,0,5,0
2020-04-26,0,0,0,0,0,0,0
2020-04-26,29,15,1706,23,0,50,44
2020-04-26,28,19,1571,7,4,97,47
2020-04-26,26,0,882,8,0,21,26
2020-04-26,0,0,151,0,0,12,0
2020-04-26,84,43,1748,42,5,191,127
2020-04-26,0,0,30,0,0,0,0
2020-04-26,48,40,1255,16,6,171,88
2020-04-26,3,7,358,2,3,19,10
2020-04-26,0,0,9,0,0,0,0
2020-04-26,273,90,5552,114,21,427,363
2020-04-26,1,8,155,0,3,7,9
2020-04-26,0,0,50,0,0,11,0
2020-04-26,1887,575,20162,588,122,1262,2462
2020-04-26,1,1,80,1,1,4,2
2020-04-26,4,21,340,1,5,101,25
2020-04-26,1,0,387,1,0,8,1
2020-04-26,0,0,89,0,0,6,0
2020-04-26,0,1,568,0,0,20,1
2020-04-26,0,0,106,0,0,3,0
2020-04-26,0,0,54,0,0,0,0
2020-04-26,27,73,1282,6,3,55,100
2020-04-26,0,0,151,0,0,4,0
2020-04-26,9,0,199,2,0,6,9
2020-04-26,118,64,3331,60,17,194,182
2020-04-26,26,12,252,8,2,5,38
2020-04-26,215,152,3625,75,35,230,367
2020-04-27,0,0,17,0,0,2,0
2020-04-27,9,2,199,2,0,5,11
2020-04-27,0,3,445,0,3,13,3
2020-04-27,27,7,247,11,1,4,34
2020-04-27,24,23,1146,10,6,25,47
2020-04-27,0,1,58,0,1,5,1
2020-04-27,0,0,50,0,0,6,0
2020-04-27,220,118,3649,73,25,208,338
2020-04-27,3,6,526,2,2,37,9
2020-04-27,0,1,50,0,0,12,1
2020-04-27,277,59,5544,115,15,377,336
2020-04-27,1,7,155,0,2,7,8
2020-04-27,39,52,2013,17,3,89,91
2020-04-27,8,16,592,4,3,60,24
2020-04-27,52,28,790,16,4,62,80
2020-04-27,0,0,0,0,0,0,0
2020-04-27,1,1,103,0,1,2,2
2020-04-27,0,0,25,0,0,0,0
2020-04-27,0,0,12,0,0,0,0
2020-04-27,30,36,1573,8,8,90,66
2020-04-27,28,75,1282,6,10,36,103
2020-04-27,1,0,387,1,0,8,1
2020-04-27,2,6,358,1,0,26,8
2020-04-27,154,83,4556,49,18,183,237
2020-04-27,1,1,80,1,1,4,2
2020-04-27,31,19,1702,23,2,53,50
2020-04-27,189,113,5370,76,23,370,302
2020-04-27,0,0,9,0,0,0,0
2020-04-27,0,0,0,0,0,5,0
2020-04-27,26,13,717,12,3,82,39
2020-04-27,81,47,1748,39,8,183,128
2020-04-27,82,19,1412,29,3,149,101
2020-04-27,0,5,0,0,2,5,5
2020-04-27,0,3,305,0,0,4,3
2020-04-27,0,1,151,0,1,7,1
2020-04-27,2,11,789,0,2,63,13
2020-04-27,2,1,354,1,0,3,3
2020-04-27,0,1,30,0,0,0,1
2020-04-27,115,49,3331,56,10,206,164
2020-04-27,0,0,424,0,0,22,0
2020-04-27,0,0,0,0,0,0,0
2020-04-27,0,0,568,0,0,10,0
2020-04-27,0,1,130,0,0,15,1
2020-04-27,0,0,25,0,0,0,0
2020-04-27,4,2,875,2,1,120,6
2020-04-27,0,0,106,0,0,3,0
2020-04-27,46,42,1238,16,13,164,88
2020-04-27,1940,609,20205,592,117,1226,2549
2020-04-27,1,3,206,0,0,7,4
2020-04-27,24,44,1485,10,11,158,68
2020-04-27,0,1,65,0,1,3,1
2020-04-27,29,0,898,7,0,27,29
2020-04-27,0,1,151,0,1,2,1
2020-04-27,5,17,340,1,3,111,22
2020-04-27,0,0,54,0,0,0,0
2020-04-27,1,1,645,1,0,12,2
2020-04-28,39,44,2007,14,7,87,83
2020-04-28,31,30,1573,7,2,92,61
2020-04-28,0,0,0,0,0,0,0
2020-04-28,0,6,305,0,1,5,6
2020-04-28,3,11,789,0,4,52,14
2020-04-28,0,0,25,0,0,0,0
2020-04-28,12,16,592,5,0,61,28
2020-04-28,0,1,30,0,0,0,1
2020-04-28,0,2,65,0,1,4,2
2020-04-28,5,21,340,1,2,103,26
2020-04-28,116,34,3331,51,5,197,150
2020-04-28,0,0,54,0,0,0,0
2020-04-28,0,0,151,0,0,1,0
2020-04-28,27,16,717,12,4,81,43
2020-04-28,0,0,130,0,1,10,0
2020-04-28,0,5,0,0,1,3,5
2020-04-28,1,7,358,1,1,19,8
2020-04-28,2,1,645,2,0,6,3
2020-04-28,215,112,3716,78,20,170,327
2020-04-28,29,4,260,12,1,4,33
2020-04-28,2,0,354,1,0,15,2
2020-04-28,24,16,1146,10,6,25,40
2020-04-28,31,71,1295,11,11,26,102
2020-04-28,0,0,25,0,0,2,0
2020-04-28,1,0,387,0,0,5,1
2020-04-28,203,84,5370,75,25,369,287
2020-04-28,0,0,151,0,0,8,0
2020-04-28,156,123,4556,51,31,179,279
2020-04-28,1,0,80,1,0,5,1
2020-04-28,76,64,1748,37,13,148,140
2020-04-28,1962,581,20337,597,130,1209,2543
2020-04-28,2,7,875,2,2,116,9
2020-04-28,0,0,0,0,0,0,0
2020-04-28,81,23,1412,27,9,132,104
2020-04-28,43,33,1256,16,9,129,76
2020-04-28,0,0,17,0,0,2,0
2020-04-28,32,2,898,6,0,26,34
2020-04-28,3,3,526,3,1,33,6
2020-04-28,1,7,159,0,2,8,8
2020-04-28,0,1,50,0,0,12,1
2020-04-28,1,2,102,1,1,4,3
2020-04-28,27,43,1485,11,12,137,70
2020-04-28,0,0,9,0,0,0,0
2020-04-28,0,1,424,0,0,19,1
2020-04-28,0,2,58,0,1,3,2
2020-04-28,276,105,5605,112,18,361,381
2020-04-28,0,2,445,0,1,8,2
2020-04-28,0,0,106,0,0,5,0
2020-04-28,0,1,568,0,0,19,1
2020-04-28,2,6,206,1,1,4,8
2020-04-28,32,13,1702,22,3,53,45
2020-04-28,0,0,0,0,0,4,0
2020-04-28,9,2,199,2,0,8,11
2020-04-28,0,0,56,0,0,6,0
2020-04-28,0,1,12,0,0,0,1
2020-04-28,50,13,790,17,0,49,63
2020-04-29,0,0,25,0,0,1,0
2020-04-29,0,0,106,0,0,5,0
2020-04-29,30,0,920,5,0,30,30
2020-04-29,0,0,25,0,0,0,0
2020-04-29,2,7,206,1,1,5,9
2020-04-29,3,2,526,3,0,34,5
2020-04-29,0,3,0,0,1,2,3
2020-04-29,156,124,4556,56,23,162,280
2020-04-29,10,18,592,5,5,56,28
2020-04-29,0,4,156,0,2,6,4
2020-04-29,0,1,568,0,0,22,1
2020-04-29,0,6,358,0,1,22,6
2020-04-29,1,5,305,0,3,7,6
2020-04-29,35,26,1573,4,5,97,61
2020-04-29,42,36,1314,17,5,137,78
2020-04-29,0,0,54,0,0,0,0
2020-04-29,0,0,56,0,0,6,0
2020-04-29,9,2,199,2,0,8,11
2020-04-29,29,5,258,13,0,4,34
2020-04-29,31,26,1354,10,7,50,57
2020-04-29,0,0,17,0,0,1,0
2020-04-29,1959,591,20960,602,97,1167,2550
2020-04-29,212,124,3728,78,32,201,336
2020-04-29,211,91,5397,76,16,373,302
2020-04-29,21,20,1146,9,7,30,41
2020-04-29,0,0,130,0,1,10,0
2020-04-29,0,2,58,0,1,1,2
2020-04-29,0,0,24,0,0,0,0
2020-04-29,28,14,717,12,2,85,42
2020-04-29,1,2,102,1,1,4,3
2020-04-29,0,0,445,0,0,10,0
2020-04-29,4,3,875,3,0,106,7
2020-04-29,76,63,1746,33,13,168,139
2020-04-29,0,1,30,0,0,0,1
2020-04-29,2,0,645,2,0,5,2
2020-04-29,0,0,50,0,0,12,0
2020-04-29,0,0,151,0,0,0,0
2020-04-29,5,14,789,2,2,51,19
2020-04-29,5,28,340,1,3,80,33
2020-04-29,0,0,0,0,0,4,0
2020-04-29,110,34,3331,46,2,198,144
2020-04-29,38,48,2007,16,8,91,86
2020-04-29,0,0,151,0,0,6,0
2020-04-29,0,0,39,0,0,0,0
2020-04-29,0,0,0,0,0,0,0
2020-04-29,0,0,0,0,0,0,0
2020-04-29,24,50,1485,9,14,131,74
2020-04-29,1,0,387,0,0,6,1
2020-04-29,2,0,354,1,0,8,2
2020-04-29,80,24,1862,26,6,107,104
2020-04-29,282,73,5619,119,17,363,355
2020-04-29,36,13,1702,23,3,59,49
2020-04-29,51,19,790,16,1,52,70
2020-04-29,0,2,424,0,1,20,2
2020-04-29,0,3,65,0,1,2,3
2020-04-29,1,0,80,1,0,5,1
2020-04-30,6,6,875,3,3,106,12
2020-04-30,0,0,39,0,0,0,0
2020-04-30,24,43,1485,9,6,141,67
2020-04-30,0,4,0,0,2,2,4
2020-04-30,0,2,58,0,0,2,2
2020-04-30,1894,470,18236,591,93,1235,2364
2020-04-30,74,52,1746,34,12,165,126
2020-04-30,1,0,387,0,0,7,1
2020-04-30,0,0,50,0,0,12,0
2020-04-30,0,0,130,0,0,12,0
2020-04-30,0,0,151,0,0,0,0
2020-04-30,0,0,25,0,0,0,0
2020-04-30,0,0,0,0,0,0,0
2020-04-30,2,0,645,2,0,10,2
2020-04-30,0,0,445,0,0,14,0
2020-04-30,0,1,104,0,1,4,1
2020-04-30,29,3,261,13,0,4,32
2020-04-30,0,6,156,0,1,10,6
2020-04-30,0,0,0,0,0,0,0
2020-04-30,4,28,340,1,4,82,32
2020-04-30,0,0,0,0,0,4,0
2020-04-30,3,2,206,1,0,5,5
2020-04-30,0,2,65,0,0,4,2
2020-04-30,1,0,80,1,0,5,1
2020-04-30,3,3,526,3,1,30,6
2020-04-30,0,0,41,0,0,0,0
2020-04-30,0,0,424,0,0,20,0
2020-04-30,85,11,1887,32,1,100,96
2020-04-30,104,37,3331,45,3,191,141
2020-04-30,0,7,305,0,2,8,7
2020-04-30,28,2,920,5,2,29,30
2020-04-30,5,7,789,2,3,50,12
2020-04-30,3,0,354,2,0,16,3
2020-04-30,0,0,106,0,0,4,0
2020-04-30,17,24,1146,8,4,30,41
2020-04-30,1,0,25,0,0,2,1
2020-04-30,35,27,1573,3,5,100,62
2020-04-30,214,68,4725,74,13,457,282
2020-04-30,158,100,3738,58,17,184,258
2020-04-30,0,0,56,0,0,6,0
2020-04-30,0,0,151,0,0,5,0
2020-04-30,10,0,199,2,0,3,10
2020-04-30,37,35,1332,17,5,129,72
2020-04-30,41,37,1997,15,4,83,78
2020-04-30,33,18,1381,10,4,51,51
2020-04-30,214,138,3310,85,30,184,352
2020-04-30,0,0,54,0,0,0,0
2020-04-30,26,9,717,13,3,85,35
2020-04-30,0,3,568,0,0,21,3
2020-04-30,11,12,592,5,3,57,23
2020-04-30,0,0,17,0,0,1,0
2020-04-30,29,25,1385,20,0,49,54
2020-04-30,0,3,358,0,0,19,3
2020-04-30,283,81,4933,122,19,357,364
2020-04-30,0,2,30,0,0,0,2
2020-04-30,53,10,790,16,1,48,63
2020-05-01,0,5,305,0,0,7,5
2020-05-01,1884,511,18549,606,98,1185,2395
2020-05-01,4,15,789,1,4,52,19
2020-05-01,0,0,41,0,0,0,0
2020-05-01,0,1,50,0,0,12,1
2020-05-01,0,0,445,0,0,8,0
2020-05-01,0,0,151,0,0,0,0
2020-05-01,0,0,25,0,0,0,0
2020-05-01,35,19,1573,2,3,86,54
2020-05-01,0,0,106,0,0,3,0
2020-05-01,0,1,424,0,1,20,1
2020-05-01,0,0,54,0,0,0,0
2020-05-01,21,37,1485,8,7,143,58
2020-05-01,5,15,340,2,2,80,20
2020-05-01,1,0,645,1,0,15,1
2020-05-01,1,0,80,1,0,5,1
2020-05-01,36,3,263,14,1,2,39
2020-05-01,290,60,4932,123,11,365,350
2020-05-01,0,0,151,0,0,6,0
2020-05-01,0,2,30,0,0,0,2
2020-05-01,1,0,25,0,0,1,1
2020-05-01,0,0,130,0,0,14,0
2020-05-01,0,0,0,0,0,-2,0
2020-05-01,0,5,358,0,0,23,5
2020-05-01,75,60,1746,32,13,165,135
2020-05-01,35,29,1347,14,4,122,64
2020-05-01,0,1,105,0,1,6,1
2020-05-01,28,2,920,5,2,23,30
2020-05-01,0,2,58,0,1,2,2
2020-05-01,0,0,0,0,0,3,0
2020-05-01,35,13,1717,19,0,47,48
2020-05-01,0,2,65,0,0,4,2
2020-05-01,210,152,3302,83,39,217,362
2020-05-01,157,106,3738,55,15,138,263
2020-05-01,0,0,0,0,0,0,0
2020-05-01,3,4,526,1,2,21,7
2020-05-01,11,0,199,2,0,1,11
2020-05-01,0,0,39,0,0,0,0
2020-05-01,4,1,206,1,0,3,5
2020-05-01,218,101,4725,62,23,374,319
2020-05-01,3,1,354,2,0,13,4
2020-05-01,97,43,3331,38,6,197,140
2020-05-01,48,12,790,15,3,49,60
2020-05-01,0,2,387,0,0,6,2
2020-05-01,28,10,717,13,2,77,38
2020-05-01,29,12,1375,10,4,51,41
2020-05-01,0,0,17,0,0,1,0
2020-05-01,0,0,568,0,0,19,0
2020-05-01,0,0,0,0,0,0,0
2020-05-01,0,0,56,0,0,4,0
2020-05-01,10,11,592,6,3,58,21
2020-05-01,17,16,1146,9,5,21,33
2020-05-01,7,1,875,3,1,105,8
2020-05-01,86,14,1887,32,0,101,100
2020-05-01,44,28,2004,18,3,77,72
2020-05-01,0,2,156,0,1,11,2
2020-05-02,81,27,1915,29,7,101,108
2020-05-02,0,0,151,0,0,7,0
2020-05-02,3,0,354,1,0,11,3
2020-05-02,0,2,156,0,1,10,2
2020-05-02,36,7,1723,19,1,41,43
2020-05-02,48,13,790,16,1,51,61
2020-05-02,1,0,80,1,0,5,1
2020-05-02,45,36,2008,17,2,87,81
2020-05-02,0,1,387,0,0,3,1
2020-05-02,0,0,0,0,0,0,0
2020-05-02,0,0,17,0,0,1,0
2020-05-02,14,15,592,7,6,54,29
2020-05-02,0,5,305,0,0,8,5
2020-05-02,5,23,340,2,4,82,28
2020-05-02,23,35,1299,16,10,119,58
2020-05-02,289,68,5513,123,18,370,357
2020-05-02,0,0,645,0,0,13,0
2020-05-02,0,0,0,0,0,3,0
2020-05-02,28,2,920,5,2,24,30
2020-05-02,0,0,445,0,0,12,0
2020-05-02,0,0,25,0,0,0,0
2020-05-02,0,0,54,0,0,0,0
2020-05-02,3,14,789,2,1,49,17
2020-05-02,1,0,25,0,0,2,1
2020-05-02,8,3,829,3,2,103,11
2020-05-02,0,0,65,0,0,6,0
2020-05-02,3,10,526,1,4,21,13
2020-05-02,0,0,41,0,0,0,0
2020-05-02,73,59,1746,31,7,163,132
2020-05-02,0,0,151,0,0,2,0
2020-05-02,0,1,50,0,1,11,1
2020-05-02,4,4,206,2,0,3,8
2020-05-02,1819,561,21176,599,105,1185,2380
2020-05-02,25,11,717,13,4,80,36
2020-05-02,0,0,30,0,0,0,0
2020-05-02,0,0,424,0,0,19,0
2020-05-02,26,26,1416,10,7,55,52
2020-05-02,36,30,1573,1,7,87,66
2020-05-02,0,11,358,0,0,24,11
2020-05-02,144,116,4419,55,22,126,260
2020-05-02,211,126,3829,78,31,197,337
2020-05-02,20,45,1485,9,8,139,65
2020-05-02,0,0,39,0,0,0,0
2020-05-02,0,0,42,0,0,2,0
2020-05-02,0,0,0,0,0,4,0
2020-05-02,0,0,568,0,0,20,0
2020-05-02,0,0,0,0,0,0,0
2020-05-02,0,0,130,0,0,11,0
2020-05-02,215,107,5374,64,34,376,322
2020-05-02,17,16,1146,9,6,22,33
2020-05-02,95,36,3331,40,6,195,131
2020-05-02,36,3,261,14,1,2,39
2020-05-02,0,2,118,0,1,6,2
2020-05-02,9,1,199,2,0,3,10
2020-05-02,0,0,58,0,0,2,0
2020-05-02,0,0,106,0,0,5,0
2020-05-03,0,0,387,0,0,4,0
2020-05-03,9,1,199,2,0,2,10
2020-05-03,73,62,1746,33,15,164,135
2020-05-03,0,0,645,0,0,12,0
2020-05-03,0,0,65,0,0,6,0
2020-05-03,7,12,340,2,4,84,19
2020-05-03,6,3,206,4,0,3,9
2020-05-03,154,100,4419,59,16,135,254
2020-05-03,4,5,526,1,3,22,9
2020-05-03,28,6,717,14,1,88,34
2020-05-03,0,1,118,0,0,8,1
2020-05-03,0,1,42,0,0,2,1
2020-05-03,0,0,17,0,0,1,0
2020-05-03,276,76,5545,125,20,369,352
2020-05-03,3,0,354,1,0,15,3
2020-05-03,0,6,358,0,0,24,6
2020-05-03,0,0,568,0,0,19,0
2020-05-03,0,0,106,0,0,5,0
2020-05-03,17,18,1146,9,6,22,35
2020-05-03,0,0,30,0,0,0,0
2020-05-03,47,14,790,16,2,50,61
2020-05-03,0,2,29,0,0,0,2
2020-05-03,33,15,1573,1,7,77,48
2020-05-03,0,0,54,0,0,0,0
2020-05-03,0,2,154,0,1,10,2
2020-05-03,1,2,305,0,0,8,3
2020-05-03,26,31,1293,16,12,117,57
2020-05-03,0,0,151,0,0,7,0
2020-05-03,217,132,3809,78,34,179,349
2020-05-03,218,90,5374,66,25,376,308
2020-05-03,20,44,1485,8,7,147,64
2020-05-03,2,14,789,1,4,51,16
2020-05-03,93,39,3331,40,7,199,132
2020-05-03,1779,520,21621,599,95,1178,2299
2020-05-03,0,1,445,0,1,7,1
2020-05-03,0,0,0,0,0,7,0
2020-05-03,45,43,2008,18,4,86,88
2020-05-03,7,1,829,3,1,92,8
2020-05-03,83,18,1915,30,4,107,101
2020-05-03,0,0,0,0,0,0,0
2020-05-03,0,1,50,0,1,11,1
2020-05-03,30,12,1710,16,2,86,42
2020-05-03,39,5,251,13,1,3,44
2020-05-03,0,0,25,0,0,0,0
2020-05-03,0,0,25,0,0,2,0
2020-05-03,0,2,424,0,0,22,2
2020-05-03,0,0,0,0,0,2,0
2020-05-03,29,34,1386,8,8,58,63
2020-05-03,14,11,592,8,1,58,25
2020-05-03,1,0,80,1,0,5,1
2020-05-03,0,3,58,0,1,2,3
2020-05-03,0,0,130,1,1,9,0
2020-05-03,0,0,151,0,0,2,0
2020-05-03,23,5,920,6,1,26,28
2020-05-03,0,0,41,0,0,0,0
2020-05-03,0,0,0,0,0,0,0
2020-05-04,156,103,4564,58,11,146,259
2020-05-04,0,0,130,1,1,9,0
2020-05-04,0,0,88,0,0,6,0
2020-05-04,0,0,30,0,0,0,0
2020-05-04,0,0,106,0,0,6,0
2020-05-04,3,13,789,1,2,57,16
2020-05-04,0,1,50,0,0,11,1
2020-05-04,1,2,344,0,1,8,3
2020-05-04,0,0,387,0,1,5,0
2020-05-04,216,107,3898,75,29,202,323
2020-05-04,0,0,667,0,0,12,0
2020-05-04,9,1,199,2,0,4,10
2020-05-04,0,0,0,0,0,3,0
2020-05-04,1,0,568,0,0,22,1
2020-05-04,0,0,54,0,0,0,0
2020-05-04,0,0,25,0,0,0,0
2020-05-04,0,1,448,0,0,12,1
2020-05-04,1,7,350,0,3,21,8
2020-05-04,84,10,1887,26,0,118,94
2020-05-04,0,0,0,0,0,0,0
2020-05-04,15,22,592,8,0,57,37
2020-05-04,300,54,5588,124,11,373,354
2020-05-04,34,11,995,2,3,90,45
2020-05-04,6,6,206,4,1,6,12
2020-05-04,26,17,1383,9,5,55,43
2020-05-04,45,14,790,13,0,54,59
2020-05-04,0,2,29,0,0,0,2
2020-05-04,47,9,252,16,0,1,56
2020-05-04,0,4,58,0,0,4,4
2020-05-04,0,0,0,0,0,0,0
2020-05-04,3,8,526,2,2,24,11
2020-05-04,0,0,41,0,0,0,0
2020-05-04,90,33,3331,37,5,210,123
2020-05-04,21,1,920,6,0,24,22
2020-05-04,5,0,829,3,0,102,5
2020-05-04,0,1,445,0,1,9,1
2020-05-04,27,23,1284,16,5,131,50
2020-05-04,0,1,42,0,0,4,1
2020-05-04,11,6,340,1,0,88,17
2020-05-04,47,39,2001,19,6,89,86
2020-05-04,1828,543,22298,581,95,1166,2371
2020-05-04,3,0,354,0,0,15,3
2020-05-04,36,12,1728,21,2,74,48
2020-05-04,19,32,1485,7,6,142,51
2020-05-04,0,0,25,0,0,2,0
2020-05-04,0,0,0,0,0,5,0
2020-05-04,0,0,17,0,0,1,0
2020-05-04,73,62,1769,31,15,163,135
2020-05-04,0,0,180,0,0,5,0
2020-05-04,0,3,185,0,0,9,3
2020-05-04,29,10,717,15,3,97,39
2020-05-04,0,1,122,0,0,3,1
2020-05-04,0,0,65,0,0,6,0
2020-05-04,19,14,1287,8,6,23,33
2020-05-04,0,0,151,0,0,1,0
2020-05-04,214,80,5607,71,17,349,294
2020-05-05,0,0,151,0,0,1,0
2020-05-05,0,0,186,0,0,12,0
2020-05-05,4,1,829,3,0,107,5
2020-05-05,1,13,390,0,3,20,14
2020-05-05,23,1,920,5,0,18,24
2020-05-05,0,2,110,0,1,-2,2
2020-05-05,3,2,526,2,1,27,5
2020-05-05,0,2,387,0,2,4,2
2020-05-05,0,0,65,0,0,6,0
2020-05-05,29,11,1369,3,1,87,40
2020-05-05,208,125,3898,84,30,185,333
2020-05-05,79,34,3273,36,3,220,113
2020-05-05,0,0,568,0,0,19,0
2020-05-05,0,0,42,0,0,4,0
2020-05-05,0,1,445,0,1,10,1
2020-05-05,0,0,54,0,0,0,0
2020-05-05,31,4,717,13,2,99,35
2020-05-05,13,16,707,5,1,50,29
2020-05-05,0,0,51,0,0,0,0
2020-05-05,0,4,185,0,0,9,4
2020-05-05,25,25,2323,13,6,119,50
2020-05-05,0,0,50,0,0,12,0
2020-05-05,0,2,45,0,0,0,2
2020-05-05,79,24,2619,27,6,101,103
2020-05-05,0,0,158,0,0,5,0
2020-05-05,18,29,1366,9,8,25,47
2020-05-05,0,0,448,0,0,14,0
2020-05-05,21,48,1628,8,10,119,69
2020-05-05,0,0,25,0,0,0,0
2020-05-05,0,0,106,0,0,6,0
2020-05-05,0,0,41,0,0,0,0
2020-05-05,44,14,1096,13,5,35,58
2020-05-05,11,13,753,2,0,80,24
2020-05-05,57,1,255,16,0,1,58
2020-05-05,2,1,397,0,1,12,3
2020-05-05,294,69,6128,122,11,345,363
2020-05-05,76,71,2446,28,14,143,147
2020-05-05,0,0,25,0,0,2,0
2020-05-05,0,13,344,0,2,10,13
2020-05-05,0,1,30,0,0,0,1
2020-05-05,0,0,51,0,0,5,0
2020-05-05,0,0,14,0,0,0,0
2020-05-05,1826,544,22079,571,110,1164,2370
2020-05-05,0,0,129,0,0,3,0
2020-05-05,210,69,5585,70,15,372,279
2020-05-05,32,10,1737,20,0,80,42
2020-05-05,0,0,0,0,0,0,0
2020-05-05,5,5,242,4,0,4,10
2020-05-05,0,0,667,0,0,9,0
2020-05-05,49,50,2049,17,10,88,99
2020-05-05,12,0,199,2,0,0,12
2020-05-05,3,13,871,0,3,60,16
2020-05-05,24,24,1360,9,9,56,48
2020-05-05,0,0,88,0,0,6,0
2020-05-05,155,105,4564,58,20,139,260
2020-05-05,0,0,17,0,0,2,0
2020-05-06,0,1,186,0,0,11,1
2020-05-06,0,0,25,0,0,1,0
2020-05-06,0,0,667,0,0,12,0
2020-05-06,4,2,829,3,0,106,6
2020-05-06,0,0,65,0,0,5,0
2020-05-06,1,1,387,1,0,6,2
2020-05-06,2,2,526,2,2,31,4
2020-05-06,0,0,54,0,0,0,0
2020-05-06,0,0,41,0,0,0,0
2020-05-06,308,71,6195,120,14,339,379
2020-05-06,0,0,151,0,0,1,0
2020-05-06,0,0,51,0,0,1,0
2020-05-06,34,7,1747,18,0,80,41
2020-05-06,216,63,5585,71,14,372,279
2020-05-06,0,4,175,0,0,8,4
2020-05-06,73,38,3275,36,4,210,111
2020-05-06,0,0,0,0,0,0,0
2020-05-06,43,18,1096,12,2,52,61
2020-05-06,76,12,2619,26,4,113,88
2020-05-06,0,0,180,0,0,4,0
2020-05-06,0,0,568,0,0,15,0
2020-05-06,0,3,110,0,1,4,3
2020-05-06,0,1,25,0,0,0,1
2020-05-06,0,0,106,0,0,4,0
2020-05-06,4,13,871,1,2,56,17
2020-05-06,0,0,88,0,0,6,0
2020-05-06,0,0,126,0,1,2,0
2020-05-06,16,51,1628,7,13,122,67
2020-05-06,0,2,45,0,0,0,2
2020-05-06,9,21,753,3,3,84,30
2020-05-06,167,69,4564,51,14,157,236
2020-05-06,0,0,448,0,0,17,0
2020-05-06,3,14,390,2,1,21,17
2020-05-06,0,0,445,0,0,7,0
2020-05-06,27,40,2319,12,7,115,67
2020-05-06,62,1,252,19,0,7,63
2020-05-06,1,0,17,0,0,2,1
2020-05-06,1790,502,23573,558,99,1206,2292
2020-05-06,27,11,1369,2,1,88,38
2020-05-06,0,0,50,0,0,12,0
2020-05-06,0,0,42,0,0,4,0
2020-05-06,30,6,717,13,1,81,36
2020-05-06,6,3,242,4,2,4,9
2020-05-06,0,0,51,0,0,6,0
2020-05-06,0,0,14,0,0,0,0
2020-05-06,12,18,707,6,2,61,30
2020-05-06,78,58,2407,34,9,171,136
2020-05-06,13,0,199,2,0,2,13
2020-05-06,0,1,30,0,0,0,1
2020-05-06,28,23,1352,11,8,45,51
2020-05-06,25,3,920,5,0,18,28
2020-05-06,17,29,1366,8,9,31,46
2020-05-06,2,1,397,0,1,7,3
2020-05-06,1,6,344,0,2,6,7
2020-05-06,197,99,3938,81,28,183,296
2020-05-06,47,47,2054,17,5,92,94
2020-05-07,19,32,2318,12,7,91,51
2020-05-07,0,0,106,0,0,5,0
2020-05-07,3,10,390,2,0,14,13
2020-05-07,0,0,51,0,0,1,0
2020-05-07,11,0,920,5,0,28,11
2020-05-07,0,1,51,0,0,1,1
2020-05-07,1,0,568,0,0,14,1
2020-05-07,0,1,30,0,0,0,1
2020-05-07,2,4,526,2,1,26,6
2020-05-07,0,0,42,0,0,4,0
2020-05-07,58,1,334,18,1,7,59
2020-05-07,0,2,172,0,0,10,2
2020-05-07,0,0,54,0,0,0,0
2020-05-07,1771,552,23461,548,90,1220,2323
2020-05-07,1,0,88,0,0,6,1
2020-05-07,13,25,1366,6,6,31,38
2020-05-07,222,77,5585,78,16,351,299
2020-05-07,1,1,448,0,0,19,2
2020-05-07,3,1,397,0,0,9,4
2020-05-07,75,61,2446,34,9,131,136
2020-05-07,1,1,387,1,0,3,2
2020-05-07,20,45,1628,7,12,97,65
2020-05-07,8,23,753,2,3,38,31
2020-05-07,5,3,242,4,0,4,8
2020-05-07,0,0,0,0,0,0,0
2020-05-07,33,25,1353,13,7,56,58
2020-05-07,0,0,110,0,0,3,0
2020-05-07,0,0,445,0,0,7,0
2020-05-07,0,0,17,0,0,2,0
2020-05-07,72,21,2619,30,1,78,93
2020-05-07,10,15,707,7,3,39,25
2020-05-07,25,14,1369,1,4,75,39
2020-05-07,33,3,1734,19,1,79,36
2020-05-07,312,75,6204,123,16,338,387
2020-05-07,49,39,2051,15,3,92,88
2020-05-07,0,0,180,0,0,3,0
2020-05-07,27,12,717,11,3,82,39
2020-05-07,0,0,112,0,0,4,0
2020-05-07,0,0,50,0,0,12,0
2020-05-07,37,14,1096,11,2,43,51
2020-05-07,0,0,151,0,0,1,0
2020-05-07,4,1,829,3,0,106,5
2020-05-07,194,76,3902,79,20,177,270
2020-05-07,0,0,25,0,0,0,0
2020-05-07,153,73,4564,51,12,165,226
2020-05-07,1,5,352,0,0,6,6
2020-05-07,0,0,25,0,0,0,0
2020-05-07,0,0,14,0,0,0,0
2020-05-07,14,0,199,3,0,0,14
2020-05-07,0,0,186,0,0,11,0
2020-05-07,0,0,41,0,0,0,0
2020-05-07,0,3,65,0,2,3,3
2020-05-07,0,0,667,0,0,17,0
2020-05-07,70,37,3275,32,3,180,107
2020-05-07,0,0,45,0,0,0,0
2020-05-07,2,11,871,1,2,52,13
2020-05-08,3,4,390,2,0,11,7
2020-05-08,10,23,707,7,0,48,33
2020-05-08,80,56,2446,38,8,126,136
2020-05-08,17,34,2332,11,5,82,51
2020-05-08,33,23,1096,11,3,43,56
2020-05-08,15,32,1366,6,8,27,47
2020-05-08,0,0,667,0,0,15,0
2020-05-08,189,88,3902,77,27,158,277
2020-05-08,14,1,199,3,1,0,15
2020-05-08,0,0,25,0,0,1,0
2020-05-08,1,0,42,0,0,4,1
2020-05-08,1,0,530,0,0,26,1
2020-05-08,71,32,2619,28,7,92,103
2020-05-08,0,0,0,0,0,0,0
2020-05-08,33,21,1300,13,6,52,54
2020-05-08,32,4,717,11,2,86,36
2020-05-08,66,4,342,19,0,9,70
2020-05-08,0,0,54,0,0,0,0
2020-05-08,0,0,45,0,0,0,0
2020-05-08,0,0,445,0,0,6,0
2020-05-08,0,0,17,0,0,2,0
2020-05-08,21,61,1628,7,14,99,82
2020-05-08,334,73,6156,129,15,328,407
2020-05-08,4,0,397,0,0,14,4
2020-05-08,0,0,51,0,0,2,0
2020-05-08,0,0,106,0,0,2,0
2020-05-08,32,7,1726,22,1,81,39
2020-05-08,1,0,387,1,0,2,1
2020-05-08,21,15,1369,3,2,81,36
2020-05-08,1766,510,23900,535,82,1181,2276
2020-05-08,0,0,180,0,0,4,0
2020-05-08,0,4,171,0,0,7,4
2020-05-08,0,1,30,0,0,0,1
2020-05-08,1,3,526,1,2,21,4
2020-05-08,1,1,448,0,0,23,2
2020-05-08,26,0,920,7,0,20,26
2020-05-08,0,0,41,0,0,0,0
2020-05-08,0,3,65,0,2,0,3
2020-05-08,0,0,14,0,0,0,0
2020-05-08,0,1,110,0,0,2,1
2020-05-08,0,1,51,0,1,2,1
2020-05-08,0,0,50,0,0,11,0
2020-05-08,0,0,120,0,0,7,0
2020-05-08,0,1,25,0,0,0,1
2020-05-08,1,5,352,0,0,6,6
2020-05-08,7,2,829,3,0,115,9
2020-05-08,0,0,151,0,0,2,0
2020-05-08,0,0,186,0,0,4,0
2020-05-08,7,1,242,5,0,2,8
2020-05-08,1,1,88,0,1,5,2
2020-05-08,142,78,4821,52,11,166,220
2020-05-08,2,15,871,1,4,51,17
2020-05-08,69,26,3306,29,5,180,95
2020-05-08,50,31,2049,15,4,89,81
2020-05-08,222,77,6836,77,22,338,299
2020-05-08,9,17,753,2,1,32,26
2020-05-09,3,3,526,3,1,27,6
2020-05-09,0,2,50,0,1,9,2
2020-05-09,3,0,397,0,0,19,3
2020-05-09,66,4,349,19,0,9,70
2020-05-09,18,11,1369,3,3,82,29
2020-05-09,0,0,51,0,0,0,0
2020-05-09,4,9,390,2,2,6,13
2020-05-09,1,0,530,0,0,30,1
2020-05-09,190,120,3874,73,30,159,310
2020-05-09,0,0,0,0,0,0,0
2020-05-09,32,26,1096,12,4,40,58
2020-05-09,0,0,151,0,0,3,0
2020-05-09,0,0,108,0,0,4,0
2020-05-09,0,1,45,0,0,0,1
2020-05-09,0,4,171,0,0,11,4
2020-05-09,68,29,2619,28,4,97,97
2020-05-09,0,0,180,0,0,4,0
2020-05-09,36,15,1728,25,2,78,51
2020-05-09,9,1,829,3,0,113,10
2020-05-09,0,0,25,0,0,3,0
2020-05-09,0,1,25,0,0,0,1
2020-05-09,1690,531,23877,493,82,1213,2221
2020-05-09,0,0,14,0,0,0,0
2020-05-09,8,29,753,2,1,40,37
2020-05-09,81,58,2446,40,11,122,139
2020-05-09,33,24,1321,13,4,50,57
2020-05-09,0,0,186,1,1,1,0
2020-05-09,0,0,445,0,0,7,0
2020-05-09,1,5,352,0,0,6,6
2020-05-09,0,0,667,0,0,17,0
2020-05-09,1,2,448,0,2,24,3
2020-05-09,11,24,707,7,2,46,35
2020-05-09,0,1,30,0,0,0,1
2020-05-09,66,36,3306,28,5,183,102
2020-05-09,0,0,54,0,0,0,0
2020-05-09,28,2,920,9,0,27,30
2020-05-09,55,43,2049,16,5,88,98
2020-05-09,145,86,4821,55,13,171,231
2020-05-09,20,48,1628,8,12,104,68
2020-05-09,0,0,88,0,0,6,0
2020-05-09,0,0,42,0,0,3,0
2020-05-09,0,0,65,0,0,4,0
2020-05-09,18,35,2327,12,5,88,53
2020-05-09,16,28,1366,4,7,24,44
2020-05-09,0,0,51,0,0,2,0
2020-05-09,28,4,717,11,1,80,32
2020-05-09,0,0,106,0,0,2,0
2020-05-09,0,0,41,0,0,0,0
2020-05-09,12,6,199,4,0,0,18
2020-05-09,3,12,871,2,3,50,15
2020-05-09,1,1,387,1,0,8,2
2020-05-09,5,6,242,4,2,2,11
2020-05-09,338,58,6172,134,9,329,396
2020-05-09,0,0,17,0,0,2,0
2020-05-09,0,0,110,0,0,3,0
2020-05-09,228,72,6836,85,19,321,300
2020-05-10,0,0,0,0,0,0,0
2020-05-10,0,0,186,1,1,1,0
2020-05-10,1731,539,23858,498,90,1253,2270
2020-05-10,2,4,352,0,0,3,6
2020-05-10,12,5,199,4,0,3,17
2020-05-10,0,0,17,0,0,2,0
2020-05-10,8,19,753,2,2,34,27
2020-05-10,0,1,25,0,0,0,1
2020-05-10,0,0,88,0,0,6,0
2020-05-10,63,1,336,17,0,9,64
2020-05-10,0,0,30,0,0,0,0
2020-05-10,28,24,1308,12,5,49,52
2020-05-10,0,0,50,0,0,9,0
2020-05-10,0,0,65,0,0,4,0
2020-05-10,334,56,6056,134,8,357,390
2020-05-10,2,0,387,2,0,3,2
2020-05-10,0,0,51,0,0,1,0
2020-05-10,144,83,4821,53,12,188,227
2020-05-10,0,0,51,0,0,2,0
2020-05-10,0,0,180,0,0,4,0
2020-05-10,18,37,2310,11,7,105,55
2020-05-10,1,2,448,0,1,21,3
2020-05-10,0,0,41,0,0,0,0
2020-05-10,4,13,390,2,3,11,17
2020-05-10,0,1,45,0,0,0,1
2020-05-10,0,2,171,0,0,15,2
2020-05-10,3,0,397,0,0,16,3
2020-05-10,199,117,3856,73,29,177,316
2020-05-10,0,1,110,0,0,0,1
2020-05-10,66,25,2619,25,9,102,91
2020-05-10,0,0,54,0,0,0,0
2020-05-10,27,2,920,8,0,26,29
2020-05-10,0,0,151,0,0,2,0
2020-05-10,18,43,1628,7,9,110,61
2020-05-10,0,0,106,0,0,3,0
2020-05-10,17,10,1369,1,3,80,27
2020-05-10,9,0,829,3,0,108,9
2020-05-10,0,0,14,0,0,0,0
2020-05-10,1,1,530,0,0,30,2
2020-05-10,14,22,707,8,1,48,36
2020-05-10,6,0,242,4,0,4,6
2020-05-10,0,0,25,0,0,1,0
2020-05-10,15,28,1366,2,8,19,43
2020-05-10,0,0,667,1,0,8,0
2020-05-10,66,45,3306,28,4,179,111
2020-05-10,3,2,526,2,0,24,5
2020-05-10,0,1,107,0,0,5,1
2020-05-10,0,0,445,0,0,6,0
2020-05-10,26,4,717,11,1,81,30
2020-05-10,53,45,2056,22,9,89,98
2020-05-10,230,78,6836,81,21,353,308
2020-05-10,0,0,42,0,0,3,0
2020-05-10,29,23,1096,12,5,43,52
2020-05-10,5,7,871,2,2,50,12
2020-05-10,37,14,1728,27,2,96,51
2020-05-10,77,46,2446,40,4,125,123
2020-05-11,3,2,526,2,1,22,5
2020-05-11,21,14,1374,2,6,74,35
2020-05-11,0,1,50,0,1,8,1
2020-05-11,9,0,829,5,0,109,9
2020-05-11,13,4,199,4,0,4,17
2020-05-11,0,0,88,0,0,6,0
2020-05-11,0,0,54,0,0,0,0
2020-05-11,0,0,51,0,0,0,0
2020-05-11,0,0,51,0,0,2,0
2020-05-11,0,1,445,0,1,9,1
2020-05-11,78,53,2446,36,13,125,131
2020-05-11,0,1,151,0,0,2,1
2020-05-11,3,12,390,0,2,12,15
2020-05-11,35,0,920,10,0,20,35
2020-05-11,0,0,14,0,0,0,0
2020-05-11,0,3,171,0,0,8,3
2020-05-11,1,0,397,0,0,16,1
2020-05-11,8,16,753,2,2,36,24
2020-05-11,0,0,180,0,0,5,0
2020-05-11,0,0,110,0,0,5,0
2020-05-11,232,88,6836,85,25,362,320
2020-05-11,16,38,1628,8,10,105,54
2020-05-11,0,0,106,0,0,6,0
2020-05-11,1,0,387,1,0,13,1
2020-05-11,0,1,114,0,1,7,1
2020-05-11,1,0,42,0,0,3,1
2020-05-11,0,0,30,0,0,0,0
2020-05-11,1,0,25,0,0,2,1
2020-05-11,5,9,871,2,4,50,14
2020-05-11,1763,547,23866,498,86,1242,2310
2020-05-11,2,1,448,0,0,25,3
2020-05-11,13,15,707,10,2,45,28
2020-05-11,0,0,65,0,0,5,0
2020-05-11,0,0,41,0,0,0,0
2020-05-11,2,6,352,0,0,5,8
2020-05-11,39,4,1724,27,1,77,43
2020-05-11,0,1,25,0,0,0,1
2020-05-11,22,10,717,9,3,89,32
2020-05-11,63,28,2619,23,11,107,91
2020-05-11,152,66,4821,53,12,178,218
2020-05-11,15,15,1366,2,5,34,30
2020-05-11,0,0,0,0,0,0,0
2020-05-11,339,61,6089,131,13,374,400
2020-05-11,56,37,2057,19,11,87,93
2020-05-11,16,35,2335,9,5,93,51
2020-05-11,0,0,17,0,0,2,0
2020-05-11,31,18,1096,11,6,43,49
2020-05-11,0,0,186,0,0,4,0
2020-05-11,59,41,3306,27,7,193,100
2020-05-11,0,1,45,0,0,0,1
2020-05-11,31,23,1301,12,7,48,54
2020-05-11,186,104,3935,69,34,184,290
2020-05-11,0,0,667,0,0,9,0
2020-05-11,7,2,242,4,2,7,9
2020-05-11,60,2,323,17,0,10,62
2020-05-11,1,0,528,0,0,27,1
2020-05-12,0,0,186,0,0,5,0
2020-05-12,0,0,180,0,0,4,0
2020-05-12,34,0,920,11,0,17,34
2020-05-12,334,51,6136,132,10,357,385
2020-05-12,206,100,3924,67,29,172,306
2020-05-12,0,0,151,0,0,3,0
2020-05-12,9,18,753,3,2,32,27
2020-05-12,0,0,14,0,0,0,0
2020-05-12,4,4,526,2,1,28,8
2020-05-12,0,0,42,0,0,4,0
2020-05-12,0,1,30,0,0,0,1
2020-05-12,263,85,6836,88,14,358,348
2020-05-12,148,49,4821,48,10,180,197
2020-05-12,0,1,445,0,1,11,1
2020-05-12,0,0,667,0,0,9,0
2020-05-12,1,0,387,1,0,6,1
2020-05-12,38,14,1729,28,1,72,52
2020-05-12,0,0,528,0,0,31,0
2020-05-12,3,5,352,0,0,6,8
2020-05-12,0,0,50,0,0,8,0
2020-05-12,1,0,25,0,0,2,1
2020-05-12,6,5,242,4,1,5,11
2020-05-12,0,0,51,0,0,1,0
2020-05-12,0,0,25,0,0,0,0
2020-05-12,26,25,1319,13,9,42,51
2020-05-12,0,2,199,0,0,10,2
2020-05-12,1742,506,23941,499,84,1267,2248
2020-05-12,0,0,45,0,0,0,0
2020-05-12,0,0,54,0,0,0,0
2020-05-12,1,0,397,0,0,11,1
2020-05-12,30,33,1096,14,6,35,63
2020-05-12,0,0,41,0,0,0,0
2020-05-12,14,20,1366,1,7,26,34
2020-05-12,0,0,106,0,0,6,0
2020-05-12,0,0,111,0,1,5,0
2020-05-12,2,3,448,0,1,25,5
2020-05-12,17,49,1628,7,12,121,66
2020-05-12,0,0,17,0,0,2,0
2020-05-12,6,1,829,5,0,106,7
2020-05-12,60,3,330,18,1,8,63
2020-05-12,24,5,717,9,2,83,29
2020-05-12,15,14,707,9,6,48,29
2020-05-12,0,1,110,0,1,1,1
2020-05-12,79,51,2446,34,12,116,130
2020-05-12,16,4,199,4,0,0,20
2020-05-12,0,0,65,0,1,3,0
2020-05-12,63,27,2619,23,4,100,90
2020-05-12,3,18,390,0,1,13,21
2020-05-12,19,15,1369,1,2,81,34
2020-05-12,62,48,2061,19,4,84,110
2020-05-12,14,34,2373,7,6,94,48
2020-05-12,0,0,51,0,0,1,0
2020-05-12,0,1,88,0,1,5,1
2020-05-12,6,22,871,4,4,49,28
2020-05-12,0,0,0,0,0,0,0
2020-05-12,55,29,3306,24,5,180,84
2020-05-13,1733,618,23951,504,83,1253,2351
2020-05-13,0,0,51,0,0,3,0
2020-05-13,0,0,151,0,0,5,0
2020-05-13,81,59,2446,37,12,117,140
2020-05-13,20,40,1628,8,7,108,60
2020-05-13,3,27,753,0,4,37,30
2020-05-13,57,32,2619,24,7,108,89
2020-05-13,15,35,2371,5,4,105,50
2020-05-13,1,0,487,0,0,10,1
2020-05-13,0,1,186,0,1,6,1
2020-05-13,20,11,1369,2,1,79,31
2020-05-13,4,4,352,1,1,5,8
2020-05-13,16,18,707,8,3,41,34
2020-05-13,58,33,3306,22,5,194,91
2020-05-13,7,2,829,5,0,106,9
2020-05-13,0,0,51,0,0,1,0
2020-05-13,0,0,110,0,1,2,0
2020-05-13,0,0,445,0,0,12,0
2020-05-13,3,7,526,2,1,24,10
2020-05-13,0,0,14,0,0,0,0
2020-05-13,69,60,2051,18,5,78,129
2020-05-13,8,3,242,4,0,10,11
2020-05-13,16,4,199,4,0,0,20
2020-05-13,0,0,112,0,1,7,0
2020-05-13,40,0,920,10,0,22,40
2020-05-13,0,0,54,0,0,0,0
2020-05-13,61,4,317,19,0,8,65
2020-05-13,0,2,199,0,0,11,2
2020-05-13,0,0,50,0,0,11,0
2020-05-13,1,0,25,1,0,1,1
2020-05-13,0,0,0,0,0,0,0
2020-05-13,11,16,1366,1,4,32,27
2020-05-13,3,16,390,0,1,16,19
2020-05-13,0,0,45,0,0,0,0
2020-05-13,1,0,397,0,0,15,1
2020-05-13,0,0,41,0,0,0,0
2020-05-13,329,51,6144,136,10,346,380
2020-05-13,0,0,180,0,0,2,0
2020-05-13,0,0,25,0,0,0,0
2020-05-13,0,1,65,0,0,5,1
2020-05-13,2,3,448,0,2,19,5
2020-05-13,34,35,1096,17,2,38,69
2020-05-13,5,20,871,3,1,53,25
2020-05-13,188,77,4002,66,22,180,265
2020-05-13,0,0,667,0,0,5,0
2020-05-13,257,85,7007,105,22,393,342
2020-05-13,0,1,30,0,0,0,1
2020-05-13,0,0,528,0,0,26,0
2020-05-13,0,0,106,0,0,5,0
2020-05-13,0,0,42,0,0,4,0
2020-05-13,0,0,17,0,0,2,0
2020-05-13,26,3,717,9,2,67,29
2020-05-13,25,29,1312,13,10,37,54
2020-05-13,34,6,1718,26,2,73,40
2020-05-13,133,90,4821,49,10,153,223
2020-05-13,0,1,88,0,1,5,1
2020-05-14,259,68,7007,102,14,385,327
2020-05-14,5,23,871,3,3,51,28
2020-05-14,184,91,4015,68,26,180,275
2020-05-14,0,0,17,0,0,2,0
2020-05-14,1648,559,23919,480,101,1230,2207
2020-05-14,329,70,6151,140,15,354,399
2020-05-14,0,0,528,0,0,29,0
2020-05-14,0,0,51,0,0,0,0
2020-05-14,32,12,1096,12,0,45,44
2020-05-14,0,0,45,0,0,0,0
2020-05-14,132,97,4821,47,15,182,229
2020-05-14,2,1,448,0,0,19,3
2020-05-14,0,0,667,0,0,8,0
2020-05-14,0,0,41,0,0,0,0
2020-05-14,1,0,397,0,0,13,1
2020-05-14,0,0,54,0,0,0,0
2020-05-14,28,30,1340,16,11,48,58
2020-05-14,64,52,2134,17,6,82,116
2020-05-14,56,38,2619,20,10,111,94
2020-05-14,0,0,180,0,0,3,0
2020-05-14,2,3,526,1,0,21,5
2020-05-14,19,19,1369,2,1,85,38
2020-05-14,3,9,390,0,2,12,12
2020-05-14,12,40,2393,5,11,91,52
2020-05-14,0,0,88,0,0,6,0
2020-05-14,37,0,920,10,0,21,37
2020-05-14,0,0,14,0,0,0,0
2020-05-14,0,0,110,0,1,7,0
2020-05-14,0,0,25,0,0,0,0
2020-05-14,0,0,151,0,0,5,0
2020-05-14,51,40,3306,21,4,172,91
2020-05-14,0,1,30,0,0,0,1
2020-05-14,39,5,1721,23,0,58,44
2020-05-14,6,1,829,5,0,104,7
2020-05-14,8,1,242,5,0,5,9
2020-05-14,5,7,352,1,1,3,12
2020-05-14,0,0,50,0,0,10,0
2020-05-14,15,25,707,8,2,47,40
2020-05-14,0,0,51,0,0,5,0
2020-05-14,0,0,110,0,0,2,0
2020-05-14,0,0,0,0,0,0,0
2020-05-14,82,56,2446,37,13,118,138
2020-05-14,2,21,753,0,3,29,23
2020-05-14,0,0,42,0,0,4,0
2020-05-14,1,0,487,0,0,10,1
2020-05-14,26,4,717,10,2,64,30
2020-05-14,62,9,327,20,0,6,71
2020-05-14,1,0,25,1,0,1,1
2020-05-14,0,1,106,0,0,5,1
2020-05-14,0,3,199,0,0,11,3
2020-05-14,16,2,199,4,0,2,18
2020-05-14,10,26,1366,1,12,27,36
2020-05-14,20,47,1628,8,4,121,67
2020-05-14,0,1,65,0,0,4,1
2020-05-14,0,0,445,0,0,10,0
2020-05-14,0,0,186,0,0,3,0
2020-05-15,5,34,871,3,1,51,39
2020-05-15,2,2,448,1,0,14,4
2020-05-15,0,0,17,0,0,2,0
2020-05-15,0,1,50,0,1,10,1
2020-05-15,0,0,151,0,0,3,0
2020-05-15,0,0,25,0,0,0,0
2020-05-15,184,72,4015,71,21,182,256
2020-05-15,0,0,14,0,0,0,0
2020-05-15,1648,553,23901,481,90,1229,2201
2020-05-15,1,4,526,1,2,22,5
2020-05-15,48,27,3318,23,2,164,75
2020-05-15,6,1,829,5,0,109,7
2020-05-15,1,0,25,1,0,1,1
2020-05-15,38,1,920,9,0,15,39
2020-05-15,3,26,753,0,5,32,29
2020-05-15,19,37,1628,9,7,114,56
2020-05-15,0,0,110,0,0,2,0
2020-05-15,6,2,242,4,0,7,8
2020-05-15,56,33,2619,19,4,85,89
2020-05-15,0,0,0,0,0,0,0
2020-05-15,1,0,387,1,0,6,1
2020-05-15,0,0,41,0,0,0,0
2020-05-15,76,72,2446,38,19,117,148
2020-05-15,14,26,707,8,1,50,40
2020-05-15,20,2,199,3,0,4,22
2020-05-15,0,0,445,0,0,12,0
2020-05-15,0,1,106,0,1,4,1
2020-05-15,19,19,1369,3,2,80,38
2020-05-15,2,8,390,0,1,11,10
2020-05-15,40,12,1721,18,0,82,52
2020-05-15,0,0,51,0,0,2,0
2020-05-15,326,66,6126,139,12,332,392
2020-05-15,0,0,667,0,0,7,0
2020-05-15,0,0,88,0,0,6,0
2020-05-15,125,69,4821,51,14,168,194
2020-05-15,0,0,42,0,0,4,0
2020-05-15,0,0,45,0,0,0,0
2020-05-15,3,6,352,1,0,6,9
2020-05-15,250,60,7007,110,14,339,310
2020-05-15,0,0,199,0,0,10,0
2020-05-15,59,32,2128,16,2,81,91
2020-05-15,0,0,119,0,1,7,0
2020-05-15,0,0,54,0,0,0,0
2020-05-15,0,0,51,0,0,0,0
2020-05-15,1,0,528,0,0,29,1
2020-05-15,11,34,1366,3,13,28,45
2020-05-15,0,0,186,0,0,3,0
2020-05-15,27,20,1340,14,5,54,47
2020-05-15,0,0,65,0,0,5,0
2020-05-15,30,24,1096,10,6,40,54
2020-05-15,1,0,397,0,0,13,1
2020-05-15,11,44,2410,5,8,100,55
2020-05-15,67,4,262,20,0,0,71
2020-05-15,26,6,717,12,2,64,32
2020-05-15,0,0,30,0,0,0,0
2020-05-15,0,0,180,0,0,4,0
2020-05-16,14,26,707,9,1,46,40
2020-05-16,0,0,45,0,0,0,0
2020-05-16,19,20,1369,1,2,82,39
2020-05-16,2,1,448,1,0,20,3
2020-05-16,3,25,753,0,7,38,28
2020-05-16,36,15,1713,18,1,77,51
2020-05-16,0,0,106,0,0,4,0
2020-05-16,81,64,2446,40,10,114,145
2020-05-16,1,10,390,0,0,15,11
2020-05-16,1,3,199,1,0,8,4
2020-05-16,183,83,3957,68,17,194,266
2020-05-16,0,0,445,0,0,11,0
2020-05-16,20,2,199,2,1,2,22
2020-05-16,0,0,110,0,0,2,0
2020-05-16,0,0,180,0,0,5,0
2020-05-16,1570,516,23918,483,80,1207,2086
2020-05-16,27,23,1333,13,8,47,50
2020-05-16,8,1,811,4,0,104,9
2020-05-16,51,39,3318,22,6,177,90
2020-05-16,11,19,1366,2,10,21,30
2020-05-16,12,34,2370,5,7,100,46
2020-05-16,0,1,65,0,1,3,1
2020-05-16,27,7,717,12,3,63,34
2020-05-16,0,0,42,0,0,4,0
2020-05-16,31,23,1096,9,5,43,54
2020-05-16,1,5,526,1,1,25,6
2020-05-16,0,0,25,0,0,0,0
2020-05-16,0,0,51,0,0,2,0
2020-05-16,1,0,25,1,0,2,1
2020-05-16,0,0,30,0,0,0,0
2020-05-16,0,0,151,0,0,6,0
2020-05-16,60,1,260,18,0,8,61
2020-05-16,0,0,88,0,0,6,0
2020-05-16,3,4,352,1,0,5,7
2020-05-16,0,0,41,0,0,0,0
2020-05-16,1,3,387,1,0,6,4
2020-05-16,1,0,397,0,0,15,1
2020-05-16,40,1,920,10,0,14,41
2020-05-16,0,0,113,0,2,7,0
2020-05-16,6,1,242,5,0,4,7
2020-05-16,0,0,528,0,0,28,0
2020-05-16,0,1,186,0,0,2,1
2020-05-16,319,51,6144,138,15,326,370
2020-05-16,0,0,50,0,0,10,0
2020-05-16,0,0,51,0,0,2,0
2020-05-16,251,74,7007,103,18,345,325
2020-05-16,0,0,0,0,0,0,0
2020-05-16,0,0,17,0,0,2,0
2020-05-16,16,34,1628,9,8,105,50
2020-05-16,0,0,667,0,0,7,0
2020-05-16,58,39,2139,16,4,85,97
2020-05-16,122,79,4821,54,13,145,201
2020-05-16,44,30,2619,20,4,106,74
2020-05-16,0,0,54,0,0,0,0
2020-05-16,0,0,14,0,0,0,0
2020-05-16,5,31,871,2,0,54,36
2020-05-17,0,1,65,0,1,3,1
2020-05-17,1,0,25,1,0,1,1
2020-05-17,6,3,242,5,0,4,9
2020-05-17,0,0,54,0,0,0,0
2020-05-17,20,21,1369,1,2,85,41
2020-05-17,0,0,151,0,0,3,0
2020-05-17,0,0,106,0,0,3,0
2020-05-17,0,0,17,0,0,2,0
2020-05-17,40,1,881,10,0,14,41
2020-05-17,31,13,1314,11,2,45,44
2020-05-17,0,0,88,0,0,6,0
2020-05-17,40,31,2619,18,5,101,71
2020-05-17,68,3,268,18,0,5,71
2020-05-17,0,0,50,0,0,11,0
2020-05-17,0,1,30,0,0,0,1
2020-05-17,0,0,110,0,0,1,0
2020-05-17,74,72,2446,38,15,125,146
2020-05-17,267,88,7007,117,18,341,355
2020-05-17,0,0,186,1,1,1,0
2020-05-17,1,0,445,0,0,10,1
2020-05-17,44,38,3318,19,6,192,82
2020-05-17,21,4,199,4,1,5,25
2020-05-17,0,0,45,0,0,0,0
2020-05-17,1,0,397,0,0,15,1
2020-05-17,0,0,0,0,0,0,0
2020-05-17,0,0,42,0,0,4,0
2020-05-17,17,30,707,9,1,46,47
2020-05-17,0,0,528,0,0,53,0
2020-05-17,0,0,25,0,0,0,0
2020-05-17,2,25,753,0,7,38,27
2020-05-17,1,4,526,1,1,21,5
2020-05-17,16,39,1628,9,9,110,55
2020-05-17,0,0,51,0,0,3,0
2020-05-17,60,46,2133,18,10,94,106
2020-05-17,1,2,387,1,0,6,3
2020-05-17,5,26,871,3,0,55,31
2020-05-17,25,6,717,12,4,62,31
2020-05-17,8,2,811,4,0,102,10
2020-05-17,0,0,14,0,0,0,0
2020-05-17,15,41,2350,6,8,107,56
2020-05-17,321,59,6131,140,10,364,380
2020-05-17,1549,558,23854,478,97,1233,2107
2020-05-17,4,1,352,1,0,6,5
2020-05-17,36,12,1743,17,1,71,48
2020-05-17,1,11,390,0,0,15,12
2020-05-17,32,23,1096,9,6,40,55
2020-05-17,1,0,180,1,0,4,1
2020-05-17,0,0,667,1,0,6,0
2020-05-17,129,81,4821,52,15,184,210
2020-05-17,0,0,51,0,0,1,0
2020-05-17,1,3,199,1,1,11,4
2020-05-17,0,0,117,0,1,7,0
2020-05-17,10,18,1366,1,9,21,28
2020-05-17,1,0,41,0,0,0,1
2020-05-17,2,0,448,1,0,22,2
2020-05-17,186,91,3945,68,18,187,277
2020-05-18,4,8,390,0,3,17,12
2020-05-18,8,1,811,4,0,106,9
2020-05-18,0,0,50,0,0,11,0
2020-05-18,13,58,2367,4,14,113,71
2020-05-18,0,0,0,0,0,0,0
2020-05-18,4,1,352,1,0,3,5
2020-05-18,0,0,17,0,0,2,0
2020-05-18,0,2,110,0,0,3,2
2020-05-18,1,0,387,1,1,10,1
2020-05-18,9,23,1366,1,8,31,32
2020-05-18,0,0,14,0,0,0,0
2020-05-18,41,19,1096,10,5,41,60
2020-05-18,1,0,25,1,0,1,1
2020-05-18,73,1,187,17,0,11,74
2020-05-18,1,3,199,1,1,13,4
2020-05-18,18,20,1369,1,1,77,38
2020-05-18,36,12,1704,18,0,72,48
2020-05-18,2,0,397,0,0,15,2
2020-05-18,0,1,41,0,0,0,1
2020-05-18,16,27,707,9,2,42,43
2020-05-18,0,1,51,0,1,4,1
2020-05-18,1,2,526,1,1,22,3
2020-05-18,33,16,1307,15,3,39,49
2020-05-18,0,0,42,0,0,4,0
2020-05-18,19,51,1628,9,10,122,70
2020-05-18,0,1,25,0,0,0,1
2020-05-18,25,2,717,11,3,70,27
2020-05-18,140,81,4821,52,14,197,221
2020-05-18,195,86,3994,68,18,210,281
2020-05-18,0,0,45,0,0,0,0
2020-05-18,0,1,88,0,1,5,1
2020-05-18,35,1,920,9,1,29,36
2020-05-18,46,33,2619,22,9,115,79
2020-05-18,87,51,2968,42,10,120,138
2020-05-18,3,20,871,2,2,53,23
2020-05-18,61,44,2135,15,4,99,105
2020-05-18,0,0,151,0,0,1,0
2020-05-18,0,0,107,0,0,8,0
2020-05-18,0,0,51,0,0,2,0
2020-05-18,0,1,106,0,0,3,1
2020-05-18,263,78,7007,111,12,387,341
2020-05-18,0,0,54,0,0,0,0
2020-05-18,21,4,199,5,1,2,25
2020-05-18,329,49,6040,139,10,341,378
2020-05-18,1531,520,23910,483,87,1221,2051
2020-05-18,46,33,3318,17,5,201,79
2020-05-18,1,0,180,1,0,4,1
2020-05-18,6,0,242,5,0,7,6
2020-05-18,1,0,445,0,0,13,1
2020-05-18,0,0,65,0,0,4,0
2020-05-18,0,2,30,0,0,0,2
2020-05-18,0,0,667,0,0,5,0
2020-05-18,2,1,448,1,0,22,3
2020-05-18,1,34,753,0,4,40,35
2020-05-18,0,0,186,0,0,3,0
2020-05-18,0,2,528,0,0,4,2
2020-05-19,18,29,707,9,3,42,47
2020-05-19,4,3,352,1,0,6,7
2020-05-19,0,1,88,0,1,5,1
2020-05-19,48,26,2619,18,2,114,74
2020-05-19,37,5,920,9,2,22,42
2020-05-19,42,11,1735,20,1,72,53
2020-05-19,33,27,1336,12,7,41,60
2020-05-19,7,26,1366,2,10,27,33
2020-05-19,0,0,667,0,0,4,0
2020-05-19,189,103,3999,69,31,191,292
2020-05-19,4,24,871,2,2,54,28
2020-05-19,0,1,110,0,1,1,1
2020-05-19,0,2,199,0,2,10,2
2020-05-19,0,0,50,0,0,11,0
2020-05-19,74,4,200,19,0,10,78
2020-05-19,0,3,30,0,0,0,3
2020-05-19,0,0,17,0,0,2,0
2020-05-19,1,0,445,0,0,10,1
2020-05-19,1517,619,23675,466,94,1216,2136
2020-05-19,269,97,7007,116,19,352,366
2020-05-19,4,20,390,0,2,14,24
2020-05-19,0,1,528,0,0,23,1
2020-05-19,64,43,2138,17,7,88,107
2020-05-19,14,74,1628,9,8,117,88
2020-05-19,1,0,397,0,0,13,1
2020-05-19,0,0,54,0,0,0,0
2020-05-19,0,0,151,0,0,1,0
2020-05-19,0,1,25,0,0,0,1
2020-05-19,0,0,65,0,0,3,0
2020-05-19,3,45,753,0,6,38,48
2020-05-19,0,0,106,0,0,6,0
2020-05-19,17,31,1369,3,2,87,48
2020-05-19,1,0,387,1,1,14,1
2020-05-19,1,0,180,1,0,6,1
2020-05-19,0,0,113,0,0,9,0
2020-05-19,134,76,4821,55,20,206,210
2020-05-19,83,108,2968,40,16,122,191
2020-05-19,41,30,1096,10,5,26,71
2020-05-19,0,0,45,0,0,0,0
2020-05-19,0,0,51,0,0,3,0
2020-05-19,23,5,717,11,2,61,28
2020-05-19,0,0,51,0,0,1,0
2020-05-19,1,0,25,1,0,1,1
2020-05-19,319,68,6142,142,13,311,387
2020-05-19,7,1,242,4,0,2,8
2020-05-19,0,0,42,0,0,4,0
2020-05-19,0,0,14,0,0,0,0
2020-05-19,11,0,811,4,0,102,11
2020-05-19,23,1,199,5,1,0,24
2020-05-19,43,57,3318,16,6,195,100
2020-05-19,0,0,186,0,0,4,0
2020-05-19,1,0,448,1,0,23,1
2020-05-19,11,90,2392,4,12,115,101
2020-05-19,2,1,526,1,1,20,3
2020-05-19,0,0,0,0,0,0,0
2020-05-19,0,1,41,0,0,0,1
2020-05-20,40,56,3318,16,5,170,96
2020-05-20,18,37,707,9,2,44,55
2020-05-20,1,0,25,1,0,0,1
2020-05-20,8,1,242,4,0,1,9
2020-05-20,47,32,2619,20,7,113,79
2020-05-20,56,41,2140,14,4,97,97
2020-05-20,0,2,30,0,0,0,2
2020-05-20,18,30,1369,3,5,80,48
2020-05-20,0,0,186,0,0,7,0
2020-05-20,81,134,2968,39,24,112,215
2020-05-20,0,0,45,0,0,0,0
2020-05-20,0,0,106,0,0,7,0
2020-05-20,0,0,151,0,0,4,0
2020-05-20,22,4,199,5,0,5,26
2020-05-20,0,0,65,0,0,4,0
2020-05-20,23,4,717,11,1,60,27
2020-05-20,0,0,51,0,0,0,0
2020-05-20,0,0,54,0,0,0,0
2020-05-20,42,3,920,9,3,21,45
2020-05-20,1,0,387,1,1,6,1
2020-05-20,0,0,0,0,0,0,0
2020-05-20,48,8,1735,21,2,66,56
2020-05-20,4,25,390,0,0,20,29
2020-05-20,0,1,41,0,0,0,1
2020-05-20,0,0,17,0,0,2,0
2020-05-20,335,69,6207,140,10,322,404
2020-05-20,2,34,871,2,2,52,36
2020-05-20,11,92,2378,3,14,106,103
2020-05-20,4,8,352,1,1,4,12
2020-05-20,4,1,448,2,0,20,5
2020-05-20,1506,561,23670,452,87,1253,2067
2020-05-20,0,0,42,0,0,2,0
2020-05-20,0,0,88,0,0,6,0
2020-05-20,0,0,667,0,0,6,0
2020-05-20,1,0,180,1,0,7,1
2020-05-20,183,107,4010,67,28,144,290
2020-05-20,9,73,1628,6,9,128,82
2020-05-20,0,2,110,0,0,3,2
2020-05-20,4,52,753,0,5,45,56
2020-05-20,127,89,4821,51,14,213,216
2020-05-20,80,3,214,22,0,8,83
2020-05-20,0,0,116,0,0,9,0
2020-05-20,2,6,526,1,2,21,8
2020-05-20,0,0,14,0,0,0,0
2020-05-20,1,0,445,0,0,11,1
2020-05-20,10,0,811,4,0,103,10
2020-05-20,0,0,51,0,0,2,0
2020-05-20,9,29,1366,3,6,27,38
2020-05-20,0,2,199,0,2,7,2
2020-05-20,0,0,50,0,0,10,0
2020-05-20,0,1,25,0,0,0,1
2020-05-20,36,26,1339,12,9,39,62
2020-05-20,37,37,1096,11,6,25,74
2020-05-20,0,4,528,0,0,21,4
2020-05-20,3,0,397,0,0,16,3
2020-05-20,275,113,7007,120,10,382,388
2020-05-21,30,19,1329,12,3,44,49
2020-05-21,37,33,1096,10,4,26,70
2020-05-21,4,12,352,1,2,5,16
2020-05-21,4,31,871,3,5,49,35
2020-05-21,262,102,6993,119,11,401,364
2020-05-21,0,2,199,1,1,6,2
2020-05-21,0,0,54,0,0,0,0
2020-05-21,131,93,4821,47,16,225,224
2020-05-21,7,59,753,2,7,35,66
2020-05-21,21,4,199,5,1,2,25
2020-05-21,0,0,151,0,0,2,0
2020-05-21,0,0,528,0,0,18,0
2020-05-21,194,91,4020,64,18,129,285
2020-05-21,77,162,2968,39,23,114,239
2020-05-21,0,0,106,0,0,8,0
2020-05-21,1,0,25,1,0,0,1
2020-05-21,75,3,210,22,0,10,78
2020-05-21,0,0,88,0,0,6,0
2020-05-21,1491,614,23620,461,95,1199,2105
2020-05-21,0,3,186,0,1,5,3
2020-05-21,39,1,920,8,1,9,40
2020-05-21,22,30,1369,3,5,82,52
2020-05-21,0,0,65,0,0,4,0
2020-05-21,0,1,50,0,1,9,1
2020-05-21,0,0,17,0,0,2,0
2020-05-21,0,0,51,0,0,1,0
2020-05-21,1,0,387,1,1,0,1
2020-05-21,0,0,0,0,0,0,0
2020-05-21,61,57,2144,16,4,99,118
2020-05-21,0,0,42,0,0,2,0
2020-05-21,8,1,811,4,0,103,9
2020-05-21,0,0,51,0,0,1,0
2020-05-21,0,0,667,0,0,5,0
2020-05-21,6,0,242,4,0,3,6
2020-05-21,8,1,448,2,1,17,9
2020-05-21,0,1,25,0,0,0,1
2020-05-21,24,6,717,9,1,58,30
2020-05-21,4,29,390,0,0,18,33
2020-05-21,8,23,1366,5,8,28,31
2020-05-21,44,10,1728,20,0,73,54
2020-05-21,1,0,445,0,0,8,1
2020-05-21,0,0,14,0,0,0,0
2020-05-21,0,0,30,0,0,0,0
2020-05-21,0,0,45,0,0,0,0
2020-05-21,4,1,397,1,0,14,5
2020-05-21,0,0,112,0,0,6,0
2020-05-21,2,5,473,1,2,20,7
2020-05-21,8,75,1628,6,11,118,83
2020-05-21,7,100,2409,4,14,108,107
2020-05-21,0,0,110,0,0,3,0
2020-05-21,0,1,41,0,0,0,1
2020-05-21,325,53,6180,139,6,313,378
2020-05-21,39,60,3318,16,8,167,99
2020-05-21,18,35,707,7,6,45,53
2020-05-21,1,0,180,1,0,7,1
2020-05-21,43,37,2619,16,11,103,80
2020-05-22,4,1,397,1,0,11,5
2020-05-22,2,1,469,1,1,21,3
2020-05-22,5,16,871,3,2,47,21
2020-05-22,20,4,717,7,2,60,24
2020-05-22,0,0,51,0,0,4,0
2020-05-22,29,35,1345,12,5,42,64
2020-05-22,18,16,707,6,1,45,34
2020-05-22,3,3,390,1,1,15,6
2020-05-22,269,89,6993,127,18,397,358
2020-05-22,195,115,4029,64,16,130,310
2020-05-22,0,1,25,0,0,0,1
2020-05-22,0,1,667,0,0,13,1
2020-05-22,11,30,1628,5,6,113,41
2020-05-22,23,11,1374,3,2,81,34
2020-05-22,6,1,242,4,0,4,7
2020-05-22,331,50,6221,145,10,333,381
2020-05-22,1,0,180,1,0,6,1
2020-05-22,9,26,1366,5,6,23,35
2020-05-22,0,0,45,0,0,0,0
2020-05-22,7,1,448,2,0,17,8
2020-05-22,36,19,3318,18,2,170,55
2020-05-22,0,2,65,0,1,5,2
2020-05-22,45,8,1761,20,0,64,53
2020-05-22,0,0,186,0,0,7,0
2020-05-22,0,0,42,0,0,3,0
2020-05-22,0,0,54,0,0,0,0
2020-05-22,0,0,17,0,0,2,0
2020-05-22,40,12,1096,14,0,40,52
2020-05-22,4,13,352,1,1,3,17
2020-05-22,0,0,0,0,0,0,0
2020-05-22,1,0,528,0,0,21,1
2020-05-22,0,4,199,1,2,8,4
2020-05-22,43,29,2619,18,11,84,72
2020-05-22,38,1,881,9,1,31,39
2020-05-22,0,0,14,0,0,0,0
2020-05-22,1,7,387,1,0,0,8
2020-05-22,23,5,199,7,1,4,28
2020-05-22,0,0,106,0,0,7,0
2020-05-22,125,101,4821,44,11,218,226
2020-05-22,1490,565,23628,470,102,1187,2055
2020-05-22,0,0,30,0,0,0,0
2020-05-22,9,1,811,3,1,104,10
2020-05-22,0,0,88,0,0,6,0
2020-05-22,75,2,210,23,0,9,77
2020-05-22,1,0,25,0,0,1,1
2020-05-22,0,2,110,0,0,3,2
2020-05-22,0,1,51,0,0,1,1
2020-05-22,0,0,151,0,0,2,0
2020-05-22,0,0,119,0,0,8,0
2020-05-22,0,0,50,0,0,9,0
2020-05-22,1,0,445,0,0,4,1
2020-05-22,0,1,41,0,0,0,1
2020-05-22,10,13,2400,2,2,106,23
2020-05-22,79,81,2968,38,17,119,160
2020-05-22,6,20,753,3,5,42,26
2020-05-22,64,30,2135,20,6,89,94
2020-05-23,2,0,462,1,0,27,2
2020-05-23,0,0,45,0,0,0,0
2020-05-23,0,0,14,0,0,0,0
2020-05-23,0,0,0,0,0,0,0
2020-05-23,45,28,2619,18,9,83,73
2020-05-23,0,1,41,0,0,0,1
2020-05-23,0,1,667,0,0,13,1
2020-05-23,0,0,120,0,1,4,0
2020-05-23,25,3,199,7,1,4,28
2020-05-23,23,15,1369,6,2,87,38
2020-05-23,66,37,2137,21,6,85,103
2020-05-23,40,1,920,9,1,13,41
2020-05-23,12,12,2388,3,0,101,24
2020-05-23,3,2,180,0,0,7,5
2020-05-23,5,17,871,3,2,49,22
2020-05-23,0,0,186,1,1,0,0
2020-05-23,0,0,106,0,0,6,0
2020-05-23,193,95,3971,59,20,142,288
2020-05-23,10,21,1366,5,8,21,31
2020-05-23,6,19,753,3,5,42,25
2020-05-23,1,1,387,1,0,2,2
2020-05-23,0,0,42,0,0,4,0
2020-05-23,0,0,25,0,0,0,0
2020-05-23,304,82,6224,138,14,323,386
2020-05-23,14,34,1628,6,6,100,48
2020-05-23,7,4,242,5,1,4,11
2020-05-23,0,0,51,0,0,0,0
2020-05-23,0,1,110,0,1,2,1
2020-05-23,1,5,199,1,5,3,6
2020-05-23,21,3,717,8,1,66,24
2020-05-23,0,2,65,0,1,5,2
2020-05-23,18,14,707,6,0,43,32
2020-05-23,134,100,4821,47,15,207,234
2020-05-23,4,13,352,1,1,3,17
2020-05-23,80,78,2968,41,19,110,158
2020-05-23,39,11,1096,16,0,42,50
2020-05-23,37,17,3318,18,1,178,54
2020-05-23,48,10,1727,22,2,78,58
2020-05-23,1,0,445,0,0,9,1
2020-05-23,4,1,397,1,0,10,5
2020-05-23,2,4,390,1,2,15,6
2020-05-23,1440,566,23605,462,104,1257,2006
2020-05-23,7,1,811,3,1,104,8
2020-05-23,75,2,210,23,0,9,77
2020-05-23,29,25,1318,11,1,39,54
2020-05-23,0,0,151,0,0,1,0
2020-05-23,0,0,50,0,0,9,0
2020-05-23,0,0,528,0,0,21,0
2020-05-23,0,0,88,0,0,6,0
2020-05-23,278,94,6993,122,13,407,372
2020-05-23,1,0,25,0,0,2,1
2020-05-23,0,0,30,0,0,0,0
2020-05-23,5,0,448,2,0,20,5
2020-05-23,0,0,54,0,0,0,0
2020-05-23,0,0,17,0,0,2,0
2020-05-23,0,0,51,0,0,2,0
2020-05-24,5,21,753,3,6,39,26
2020-05-24,0,0,88,0,0,6,0
2020-05-24,18,19,707,8,0,46,37
2020-05-24,35,19,3318,16,2,195,54
2020-05-24,47,41,2619,20,10,97,88
2020-05-24,0,0,25,0,0,0,0
2020-05-24,25,3,199,8,2,7,28
2020-05-24,7,1,811,3,1,106,8
2020-05-24,0,2,65,0,1,5,2
2020-05-24,9,17,2363,2,4,110,26
2020-05-24,4,3,352,1,0,5,7
2020-05-24,0,0,14,0,0,0,0
2020-05-24,1,0,445,0,0,13,1
2020-05-24,0,0,51,0,0,2,0
2020-05-24,15,27,1628,6,5,102,42
2020-05-24,22,15,1369,6,1,85,37
2020-05-24,2,4,390,1,2,13,6
2020-05-24,0,1,528,0,1,22,1
2020-05-24,0,1,41,0,0,0,1
2020-05-24,6,16,871,3,3,50,22
2020-05-24,42,2,920,10,1,13,44
2020-05-24,88,61,2968,44,11,119,149
2020-05-24,0,0,42,0,0,4,0
2020-05-24,7,5,242,5,0,5,12
2020-05-24,139,103,4821,48,22,196,242
2020-05-24,32,36,1331,13,5,46,68
2020-05-24,0,0,54,0,0,0,0
2020-05-24,1,0,387,1,0,2,1
2020-05-24,0,0,51,0,0,0,0
2020-05-24,2,1,461,1,0,28,3
2020-05-24,66,40,2128,19,4,91,106
2020-05-24,1443,547,23608,448,101,1227,1990
2020-05-24,0,0,45,0,0,0,0
2020-05-24,1,4,199,1,4,4,5
2020-05-24,77,4,210,23,0,9,81
2020-05-24,21,6,717,8,0,71,27
2020-05-24,0,0,106,0,0,6,0
2020-05-24,1,0,25,0,0,0,1
2020-05-24,0,0,17,0,0,2,0
2020-05-24,5,0,448,2,0,20,5
2020-05-24,11,25,1366,6,5,17,36
2020-05-24,188,80,3944,60,18,150,268
2020-05-24,0,0,30,0,0,0,0
2020-05-24,0,0,121,0,2,1,0
2020-05-24,4,1,397,1,0,14,5
2020-05-24,0,0,0,0,0,0,0
2020-05-24,53,4,1712,23,1,84,57
2020-05-24,39,13,1096,16,0,43,52
2020-05-24,0,1,50,0,0,10,1
2020-05-24,310,60,6189,139,11,321,370
2020-05-24,286,102,6993,117,14,404,388
2020-05-24,3,2,180,0,0,7,5
2020-05-24,0,4,110,0,2,0,4
2020-05-24,0,0,186,0,0,0,0
2020-05-24,0,0,151,0,0,1,0
2020-05-24,0,0,667,0,0,15,0
2020-05-25,0,0,42,0,0,4,0
2020-05-25,0,0,151,0,0,2,0
2020-05-25,91,65,2968,40,20,115,156
2020-05-25,10,0,811,3,0,106,10
2020-05-25,0,0,25,0,0,0,0
2020-05-25,33,30,1337,10,4,46,63
2020-05-25,1477,564,23620,465,94,1453,2041
2020-05-25,0,1,50,0,0,10,1
2020-05-25,13,35,1628,6,13,103,48
2020-05-25,40,2,920,13,2,22,42
2020-05-25,0,0,667,0,0,16,0
2020-05-25,0,1,110,0,0,2,1
2020-05-25,26,3,199,8,2,3,29
2020-05-25,317,68,6158,139,21,385,385
2020-05-25,69,6,210,23,0,9,75
2020-05-25,0,1,51,0,0,3,1
2020-05-25,44,13,1096,15,5,46,57
2020-05-25,2,0,448,1,0,26,2
2020-05-25,1,0,387,1,0,4,1
2020-05-25,1,3,199,1,3,11,4
2020-05-25,5,20,753,3,6,47,25
2020-05-25,1,0,186,0,0,4,1
2020-05-25,0,0,51,0,0,1,0
2020-05-25,4,3,397,1,0,15,7
2020-05-25,0,0,120,0,1,6,0
2020-05-25,19,8,717,8,0,70,27
2020-05-25,21,20,707,11,4,44,41
2020-05-25,9,17,2381,2,29,116,26
2020-05-25,51,8,1707,25,1,77,59
2020-05-25,0,0,54,0,0,0,0
2020-05-25,1,1,528,0,0,24,2
2020-05-25,5,22,871,3,6,46,27
2020-05-25,0,0,45,0,0,0,0
2020-05-25,0,0,106,0,0,3,0
2020-05-25,0,1,30,0,0,0,1
2020-05-25,0,0,88,0,0,6,0
2020-05-25,6,4,242,4,1,10,10
2020-05-25,3,4,390,1,6,9,7
2020-05-25,0,1,41,0,0,0,1
2020-05-25,1,0,25,0,0,0,1
2020-05-25,0,0,17,0,0,2,0
2020-05-25,0,0,14,0,0,0,0
2020-05-25,6,4,352,1,0,4,10
2020-05-25,300,94,6993,119,19,441,394
2020-05-25,2,0,180,1,0,5,2
2020-05-25,66,38,2128,19,1,92,104
2020-05-25,193,88,3959,63,15,159,281
2020-05-25,7,0,448,3,0,19,7
2020-05-25,12,24,1366,6,4,22,36
2020-05-25,32,20,3318,14,12,204,52
2020-05-25,18,11,1369,6,4,79,29
2020-05-25,0,0,0,0,0,0,0
2020-05-25,138,116,4821,48,23,245,254
2020-05-25,0,2,65,0,1,5,2
2020-05-25,40,41,2619,21,11,100,81
2020-05-25,1,0,445,0,0,11,1
2020-05-26,3,1,180,1,0,4,4
2020-05-26,0,1,51,0,0,2,1
2020-05-26,0,0,65,0,0,7,0
2020-05-26,0,2,199,0,2,8,2
2020-05-26,6,3,242,4,1,5,9
2020-05-26,1,0,25,0,0,2,1
2020-05-26,0,0,88,0,0,6,0
2020-05-26,0,0,17,0,0,2,0
2020-05-26,0,0,45,0,0,0,0
2020-05-26,154,125,4821,57,19,237,279
2020-05-26,1477,610,23592,464,103,1449,2087
2020-05-26,2,2,447,1,0,28,4
2020-05-26,0,0,51,0,0,3,0
2020-05-26,1,0,667,0,0,13,1
2020-05-26,69,29,2141,20,2,96,98
2020-05-26,18,14,1369,7,5,85,32
2020-05-26,0,1,41,0,0,0,1
2020-05-26,5,0,448,3,0,20,5
2020-05-26,0,3,54,0,0,0,3
2020-05-26,1,3,129,1,2,6,4
2020-05-26,14,29,1366,6,8,24,43
2020-05-26,69,8,210,22,0,10,77
2020-05-26,5,20,871,2,4,59,25
2020-05-26,0,0,47,0,0,0,0
2020-05-26,6,21,753,3,5,43,27
2020-05-26,207,102,3959,68,22,173,309
2020-05-26,45,9,1096,16,4,47,54
2020-05-26,0,0,42,0,0,4,0
2020-05-26,1,0,186,0,0,5,1
2020-05-26,301,117,6993,119,18,439,418
2020-05-26,5,5,352,1,1,3,10
2020-05-26,2,3,390,1,5,8,5
2020-05-26,13,36,1628,6,14,115,49
2020-05-26,0,1,110,0,0,0,1
2020-05-26,0,0,14,0,0,0,0
2020-05-26,1,0,445,0,0,12,1
2020-05-26,0,1,151,0,1,0,1
2020-05-26,93,76,2968,37,20,124,169
2020-05-26,34,28,1344,11,5,40,62
2020-05-26,37,4,920,8,4,19,41
2020-05-26,19,16,707,9,2,45,35
2020-05-26,0,0,50,0,0,11,0
2020-05-26,11,1,811,3,1,105,12
2020-05-26,0,1,106,0,0,2,1
2020-05-26,1,4,528,0,0,22,5
2020-05-26,325,58,6167,145,8,375,383
2020-05-26,18,5,717,8,2,84,23
2020-05-26,0,2,30,0,0,0,2
2020-05-26,40,47,2619,20,14,95,87
2020-05-26,9,9,2376,4,26,98,18
2020-05-26,0,1,25,0,0,0,1
2020-05-26,24,3,199,8,2,2,27
2020-05-26,33,20,3318,14,12,195,53
2020-05-26,59,7,1724,24,0,82,66
2020-05-26,4,1,397,1,0,14,5
2020-05-26,1,1,387,1,0,3,2
2020-05-27,1,0,25,0,0,1,1
2020-05-27,71,44,2143,19,4,93,115
2020-05-27,95,69,2968,37,10,128,164
2020-05-27,6,2,242,4,0,3,8
2020-05-27,14,23,1366,7,4,21,37
2020-05-27,0,2,30,0,0,0,2
2020-05-27,6,14,753,3,1,45,20
2020-05-27,0,1,25,0,0,0,1
2020-05-27,0,0,667,0,0,15,0
2020-05-27,0,0,14,0,0,0,0
2020-05-27,0,0,106,0,0,3,0
2020-05-27,3,0,397,1,0,15,3
2020-05-27,0,0,51,0,0,3,0
2020-05-27,3,1,180,1,1,3,4
2020-05-27,11,0,811,3,0,100,11
2020-05-27,0,0,51,0,0,4,0
2020-05-27,1,2,199,1,2,7,3
2020-05-27,28,24,3318,12,3,188,52
2020-05-27,1,0,445,0,0,12,1
2020-05-27,0,0,17,0,0,2,0
2020-05-27,307,111,6993,125,19,403,418
2020-05-27,0,0,45,0,0,0,0
2020-05-27,0,0,88,0,0,6,0
2020-05-27,6,1,448,3,0,21,7
2020-05-27,2,4,464,2,1,22,6
2020-05-27,22,5,717,9,2,94,27
2020-05-27,0,0,41,0,0,0,0
2020-05-27,0,0,42,0,0,4,0
2020-05-27,17,8,1369,6,3,89,25
2020-05-27,159,101,4821,54,19,222,260
2020-05-27,0,0,110,0,0,0,0
2020-05-27,9,22,871,3,2,51,31
2020-05-27,23,1,199,7,0,0,24
2020-05-27,1,1,387,1,0,2,2
2020-05-27,2,2,528,0,0,24,4
2020-05-27,1462,628,23626,464,90,1275,2090
2020-05-27,5,4,352,1,0,3,9
2020-05-27,33,8,1096,16,3,46,41
2020-05-27,11,30,1628,7,6,115,41
2020-05-27,8,21,2401,6,3,87,29
2020-05-27,63,5,1727,28,0,72,68
2020-05-27,329,79,6215,144,12,315,408
2020-05-27,36,5,920,10,3,13,41
2020-05-27,28,24,1349,10,10,40,52
2020-05-27,0,2,54,0,0,0,2
2020-05-27,1,3,122,1,2,6,4
2020-05-27,0,0,151,0,0,0,0
2020-05-27,1,1,390,1,0,10,2
2020-05-27,199,114,4005,66,21,131,313
2020-05-27,40,42,2619,18,9,98,82
2020-05-27,0,0,50,0,0,11,0
2020-05-27,0,3,65,0,1,5,3
2020-05-27,20,14,707,8,2,41,34
2020-05-27,0,0,47,0,0,0,0
2020-05-27,67,17,210,14,0,13,84
2020-05-27,0,0,186,0,0,3,0
2020-05-28,1,1,387,1,0,1,2
2020-05-28,0,0,186,0,0,8,0
2020-05-28,2,0,475,2,0,24,2
2020-05-28,1,0,528,0,0,25,1
2020-05-28,3,7,390,1,0,14,10
2020-05-28,13,38,1628,7,7,103,51
2020-05-28,0,1,25,0,0,0,1
2020-05-28,5,1,448,3,0,22,6
2020-05-28,49,42,2619,20,9,83,91
2020-05-28,0,1,110,0,0,0,1
2020-05-28,1415,639,23608,458,112,1275,2054
2020-05-28,39,10,1096,17,1,44,49
2020-05-28,0,0,25,0,0,0,0
2020-05-28,0,0,14,0,0,0,0
2020-05-28,0,2,30,0,0,0,2
2020-05-28,0,0,51,0,0,4,0
2020-05-28,0,0,47,0,0,0,0
2020-05-28,0,3,54,0,0,0,3
2020-05-28,0,0,42,0,0,4,0
2020-05-28,0,0,65,0,0,6,0
2020-05-28,0,0,45,0,0,0,0
2020-05-28,96,57,2968,44,13,106,153
2020-05-28,15,25,1366,5,5,16,40
2020-05-28,3,0,180,1,0,4,3
2020-05-28,1,2,128,1,1,5,3
2020-05-28,0,0,41,0,0,0,0
2020-05-28,8,30,871,2,2,46,38
2020-05-28,68,39,2131,16,2,82,107
2020-05-28,14,27,2395,8,4,95,41
2020-05-28,5,4,352,1,0,5,9
2020-05-28,0,1,51,0,0,4,1
2020-05-28,3,0,397,1,0,13,3
2020-05-28,61,7,199,19,1,10,68
2020-05-28,1,0,445,0,0,11,1
2020-05-28,0,0,40,0,0,2,0
2020-05-28,11,0,811,3,0,101,11
2020-05-28,37,2,920,10,1,8,39
2020-05-28,156,87,4821,53,17,186,243
2020-05-28,25,0,199,7,0,2,25
2020-05-28,0,0,88,0,0,6,0
2020-05-28,19,16,707,8,0,40,35
2020-05-28,313,70,6238,137,16,317,383
2020-05-28,0,0,151,0,0,2,0
2020-05-28,1,5,199,1,5,8,6
2020-05-28,5,18,753,3,3,33,23
2020-05-28,202,99,4000,62,23,134,301
2020-05-28,0,0,106,0,0,4,0
2020-05-28,26,14,3318,13,2,180,40
2020-05-28,0,0,667,0,0,9,0
2020-05-28,58,8,1744,25,0,77,66
2020-05-28,291,106,6993,119,13,403,397
2020-05-28,19,7,717,9,3,74,26
2020-05-28,1,0,50,1,0,10,1
2020-05-28,28,19,1353,10,9,54,47
2020-05-28,6,2,242,4,0,4,8
2020-05-28,15,8,1369,6,1,78,23
2020-05-29,0,0,88,0,0,6,0
2020-05-29,13,11,1370,7,2,75,24
2020-05-29,0,0,387,1,0,4,0
2020-05-29,27,1,199,7,0,2,28
2020-05-29,0,0,51,0,0,3,0
2020-05-29,0,0,186,0,0,5,0
2020-05-29,0,0,106,0,0,1,0
2020-05-29,31,16,1352,10,6,47,47
2020-05-29,37,8,1096,14,1,47,45
2020-05-29,0,0,14,0,0,0,0
2020-05-29,15,35,1628,8,3,101,50
2020-05-29,7,37,871,2,6,51,44
2020-05-29,3,5,469,3,3,13,8
2020-05-29,191,79,3994,62,14,128,270
2020-05-29,0,1,25,0,0,0,1
2020-05-29,6,7,242,4,1,5,13
2020-05-29,60,4,192,17,1,11,64
2020-05-29,54,16,1741,28,1,70,70
2020-05-29,1,5,199,1,3,8,6
2020-05-29,1402,570,23642,446,103,1258,1972
2020-05-29,0,0,42,0,0,3,0
2020-05-29,14,23,2416,8,9,84,37
2020-05-29,37,3,920,11,2,17,40
2020-05-29,102,77,2968,42,12,118,179
2020-05-29,300,58,6192,138,16,291,358
2020-05-29,0,0,47,0,0,0,0
2020-05-29,63,44,2145,17,5,86,107
2020-05-29,1,0,65,0,0,5,1
2020-05-29,0,0,25,0,0,1,0
2020-05-29,134,95,4821,50,13,164,229
2020-05-29,26,22,3318,13,1,182,48
2020-05-29,0,0,54,0,0,0,0
2020-05-29,0,2,130,0,0,8,2
2020-05-29,1,1,50,1,1,9,2
2020-05-29,0,0,667,0,0,9,0
2020-05-29,0,2,30,0,0,0,2
2020-05-29,5,8,352,0,0,7,13
2020-05-29,0,0,151,0,0,2,0
2020-05-29,17,24,1366,5,6,17,41
2020-05-29,6,0,448,2,0,18,6
2020-05-29,0,0,528,0,0,22,0
2020-05-29,0,1,110,0,0,0,1
2020-05-29,0,0,40,0,0,2,0
2020-05-29,1,0,445,0,0,11,1
2020-05-29,4,6,390,1,1,19,10
2020-05-29,10,1,811,3,0,116,11
2020-05-29,0,1,45,0,0,0,1
2020-05-29,262,62,6993,100,8,409,324
2020-05-29,3,9,397,1,0,18,12
2020-05-29,0,0,51,0,0,3,0
2020-05-29,8,15,753,4,1,35,23
2020-05-29,0,0,41,0,0,0,0
2020-05-29,20,11,707,8,2,38,31
2020-05-29,16,11,717,8,4,76,27
2020-05-29,2,0,180,1,0,3,2
2020-05-29,49,16,2619,19,6,88,65
2020-05-30,0,0,110,0,0,0,0
2020-05-30,0,1,126,0,0,8,1
2020-05-30,311,86,6197,144,17,302,397
2020-05-30,0,4,387,0,2,1,4
2020-05-30,55,21,1564,29,2,72,76
2020-05-30,5,12,352,0,1,4,17
2020-05-30,1,2,528,0,0,17,3
2020-05-30,105,41,2968,38,12,126,146
2020-05-30,0,0,47,0,0,0,0
2020-05-30,0,0,51,0,0,3,0
2020-05-30,70,48,2147,17,2,89,118
2020-05-30,44,13,1096,13,2,51,57
2020-05-30,1,0,667,1,0,10,1
2020-05-30,0,0,65,0,1,2,0
2020-05-30,130,95,4821,52,12,203,225
2020-05-30,5,56,871,2,10,46,61
2020-05-30,1357,577,23636,440,100,1288,1934
2020-05-30,14,23,2402,8,9,86,37
2020-05-30,0,1,45,0,0,0,1
2020-05-30,291,131,6993,122,26,396,422
2020-05-30,7,7,242,3,1,4,14
2020-05-30,37,2,920,12,2,19,39
2020-05-30,0,1,25,0,0,0,1
2020-05-30,14,8,1369,9,1,77,22
2020-05-30,0,0,14,0,0,0,0
2020-05-30,0,0,51,0,0,4,0
2020-05-30,0,2,30,0,0,0,2
2020-05-30,1,6,199,1,6,8,7
2020-05-30,14,32,1628,7,4,97,46
2020-05-30,3,5,390,1,0,18,8
2020-05-30,185,84,3954,61,15,133,269
2020-05-30,0,0,41,0,0,0,0
2020-05-30,29,17,3318,11,0,175,46
2020-05-30,0,0,106,0,0,8,0
2020-05-30,0,0,186,0,0,3,0
2020-05-30,0,0,42,0,0,3,0
2020-05-30,6,16,753,4,0,42,22
2020-05-30,11,0,811,3,0,95,11
2020-05-30,47,17,2619,19,6,78,64
2020-05-30,2,0,180,1,0,4,2
2020-05-30,0,0,88,0,0,6,0
2020-05-30,0,0,25,0,0,2,0
2020-05-30,0,0,54,0,0,0,0
2020-05-30,6,0,448,2,0,24,6
2020-05-30,18,11,707,7,2,39,29
2020-05-30,18,8,717,7,3,90,26
2020-05-30,73,8,217,22,0,6,81
2020-05-30,0,0,151,0,0,4,0
2020-05-30,0,0,40,0,0,2,0
2020-05-30,19,23,1366,6,8,15,42
2020-05-30,3,9,397,1,0,18,12
2020-05-30,3,2,464,3,0,13,5
2020-05-30,1,0,445,0,0,12,1
2020-05-30,26,20,1332,11,12,42,46
2020-05-30,27,1,199,9,0,0,28
2020-05-30,1,1,50,1,1,9,2
2020-05-31,283,124,6993,120,22,408,407
2020-05-31,18,27,1366,6,8,18,45
2020-05-31,50,19,2619,22,4,91,69
2020-05-31,9,9,753,2,1,39,18
2020-05-31,16,18,2393,7,2,94,34
2020-05-31,11,32,1628,6,6,94,43
2020-05-31,1,0,50,1,0,9,1
2020-05-31,0,0,151,0,0,3,0
2020-05-31,19,10,707,5,1,38,29
2020-05-31,3,1,455,3,1,20,4
2020-05-31,5,44,871,2,8,48,49
2020-05-31,0,0,65,0,1,1,0
2020-05-31,0,0,30,0,0,0,0
2020-05-31,306,92,6120,145,8,327,398
2020-05-31,59,16,1732,30,2,64,75
2020-05-31,6,5,242,3,1,5,11
2020-05-31,1,6,199,1,3,4,7
2020-05-31,0,1,25,0,0,0,1
2020-05-31,0,0,42,0,0,4,0
2020-05-31,4,6,352,0,0,8,10
2020-05-31,5,0,448,2,0,22,5
2020-05-31,25,21,1329,11,5,40,46
2020-05-31,0,0,41,0,0,0,0
2020-05-31,1389,519,23606,416,95,1316,1908
2020-05-31,3,10,397,1,0,18,13
2020-05-31,25,13,3318,9,2,196,38
2020-05-31,0,0,40,0,0,2,0
2020-05-31,68,52,2138,18,10,83,120
2020-05-31,0,0,186,0,0,3,0
2020-05-31,0,1,88,0,0,6,1
2020-05-31,0,0,106,0,0,7,0
2020-05-31,136,73,4821,53,10,205,209
2020-05-31,1,0,180,1,0,2,1
2020-05-31,0,1,51,0,1,4,1
2020-05-31,0,0,14,0,0,0,0
2020-05-31,0,0,127,0,0,3,0
2020-05-31,0,1,54,0,0,0,1
2020-05-31,99,33,2968,37,8,131,132
2020-05-31,1,0,667,1,0,11,1
2020-05-31,0,2,387,0,0,11,2
2020-05-31,9,0,811,4,0,98,9
2020-05-31,1,0,445,0,0,12,1
2020-05-31,1,0,110,0,0,0,1
2020-05-31,28,2,199,10,0,0,30
2020-05-31,16,17,1369,6,2,85,33
2020-05-31,195,99,3954,62,15,141,294
2020-05-31,0,0,47,0,0,0,0
2020-05-31,2,6,390,1,0,17,8
2020-05-31,2,2,528,1,0,23,4
2020-05-31,22,4,717,7,2,89,26
2020-05-31,35,1,920,12,1,13,36
2020-05-31,73,7,217,22,0,6,80
2020-05-31,0,1,45,0,0,0,1
2020-05-31,0,0,25,0,0,2,0
2020-05-31,46,10,1096,26,1,39,56
2020-05-31,0,0,51,0,0,0,0
2020-06-01,0,1,88,0,0,6,1
2020-06-01,1,0,667,1,0,8,1
2020-06-01,0,0,47,0,0,0,0
2020-06-01,25,4,717,7,3,80,29
2020-06-01,0,0,40,0,0,2,0
2020-06-01,0,0,106,0,0,3,0
2020-06-01,2,1,528,1,0,22,3
2020-06-01,1,5,199,1,3,8,6
2020-06-01,5,3,242,3,0,5,8
2020-06-01,26,2,199,8,0,2,28
2020-06-01,0,0,25,0,0,3,0
2020-06-01,26,14,3318,9,2,192,40
2020-06-01,40,6,1096,11,0,42,46
2020-06-01,0,0,45,0,0,0,0
2020-06-01,3,3,454,3,0,22,6
2020-06-01,0,1,131,0,0,6,1
2020-06-01,1,0,445,0,0,14,1
2020-06-01,0,0,14,0,0,0,0
2020-06-01,0,0,151,0,0,0,0
2020-06-01,20,17,707,5,4,41,37
2020-06-01,68,3,193,20,1,8,71
2020-06-01,3,1,397,2,1,18,4
2020-06-01,4,6,352,0,0,7,10
2020-06-01,13,17,1628,8,5,100,30
2020-06-01,0,0,51,0,0,4,0
2020-06-01,9,0,811,4,0,100,9
2020-06-01,1422,596,23614,425,105,1305,2018
2020-06-01,5,62,871,2,5,50,67
2020-06-01,1,1,110,0,1,2,2
2020-06-01,314,83,6121,150,16,317,397
2020-06-01,97,51,2968,37,9,134,148
2020-06-01,0,1,25,0,0,0,1
2020-06-01,24,21,1317,8,5,36,45
2020-06-01,9,8,753,2,1,38,17
2020-06-01,68,54,2142,17,6,393,122
2020-06-01,14,18,2409,8,5,103,32
2020-06-01,0,1,54,0,0,0,1
2020-06-01,0,0,186,0,0,4,0
2020-06-01,0,1,180,1,1,2,1
2020-06-01,1,0,50,1,0,9,1
2020-06-01,203,104,3969,62,14,148,307
2020-06-01,22,11,1369,7,1,79,33
2020-06-01,63,14,1722,30,3,69,77
2020-06-01,0,2,387,0,0,6,2
2020-06-01,292,113,6993,121,20,430,405
2020-06-01,45,29,2619,18,2,85,74
2020-06-01,4,0,448,1,1,17,4
2020-06-01,0,0,41,0,0,0,0
2020-06-01,0,0,42,0,0,4,0
2020-06-01,0,0,51,0,0,4,0
2020-06-01,2,3,390,0,1,22,5
2020-06-01,0,0,30,0,0,0,0
2020-06-01,34,1,920,11,1,14,35
2020-06-01,148,69,4821,62,17,186,217
2020-06-01,0,3,65,0,1,5,3
2020-06-01,23,25,1366,8,8,26,48
2020-06-02,42,17,1096,17,1,31,59
2020-06-02,4,2,448,1,0,15,6
2020-06-02,26,23,3318,10,7,177,49
2020-06-02,0,2,54,0,0,0,2
2020-06-02,1,0,180,1,0,4,1
2020-06-02,66,1,237,18,0,8,67
2020-06-02,9,18,753,2,2,38,27
2020-06-02,16,16,707,4,5,41,32
2020-06-02,1457,570,23620,439,85,1276,2027
2020-06-02,3,6,352,0,0,7,9
2020-06-02,67,15,1732,33,1,67,82
2020-06-02,211,94,3979,66,14,127,305
2020-06-02,0,0,42,0,0,4,0
2020-06-02,32,2,920,10,2,25,34
2020-06-02,0,0,106,0,0,4,0
2020-06-02,2,3,397,1,0,16,5
2020-06-02,0,0,51,0,0,2,0
2020-06-02,1,10,390,0,2,17,11
2020-06-02,3,69,871,2,5,52,72
2020-06-02,0,0,41,0,0,0,0
2020-06-02,1,0,445,0,0,15,1
2020-06-02,0,0,30,0,0,0,0
2020-06-02,0,1,25,0,0,0,1
2020-06-02,0,0,47,0,0,0,0
2020-06-02,31,1,199,8,0,6,32
2020-06-02,92,68,2968,33,5,131,160
2020-06-02,0,0,45,0,0,0,0
2020-06-02,0,0,14,0,0,0,0
2020-06-02,2,2,460,2,0,23,4
2020-06-02,17,25,2405,9,10,78,42
2020-06-02,6,4,528,2,0,19,10
2020-06-02,297,72,6143,142,16,301,369
2020-06-02,4,2,242,3,0,2,6
2020-06-02,15,41,1628,8,12,94,56
2020-06-02,1,7,199,1,5,2,8
2020-06-02,0,0,151,0,0,1,0
2020-06-02,1,1,110,0,0,0,2
2020-06-02,0,1,135,0,0,7,1
2020-06-02,1,0,50,1,0,8,1
2020-06-02,0,3,65,0,1,5,3
2020-06-02,0,0,25,0,0,2,0
2020-06-02,0,0,186,0,0,2,0
2020-06-02,0,0,40,0,0,2,0
2020-06-02,156,70,4821,63,13,189,226
2020-06-02,43,28,2647,18,8,76,71
2020-06-02,0,0,51,0,0,3,0
2020-06-02,0,1,88,0,1,5,1
2020-06-02,64,37,2126,16,2,90,101
2020-06-02,25,3,717,8,1,84,28
2020-06-02,0,2,387,0,0,6,2
2020-06-02,25,21,1343,10,9,34,46
2020-06-02,1,0,667,1,0,6,1
2020-06-02,306,92,6993,130,18,388,398
2020-06-02,25,27,1366,9,6,20,52
2020-06-02,25,11,1374,7,3,68,36
2020-06-02,12,0,811,4,0,98,12
2020-06-03,4,0,448,0,0,22,4
2020-06-03,37,34,2647,17,4,80,71
2020-06-03,11,23,753,2,2,41,34
2020-06-03,0,2,387,0,0,5,2
2020-06-03,0,0,25,0,0,2,0
2020-06-03,69,4,237,17,0,6,73
2020-06-03,21,4,717,9,1,79,25
2020-06-03,1,10,390,0,3,19,11
2020-06-03,12,0,811,4,0,96,12
2020-06-03,0,0,151,0,0,0,0
2020-06-03,0,0,14,0,0,0,0
2020-06-03,0,0,51,0,0,2,0
2020-06-03,19,33,2418,12,6,94,52
2020-06-03,43,23,1101,15,6,36,66
2020-06-03,15,52,1628,4,12,101,67
2020-06-03,27,14,1369,6,2,75,41
2020-06-03,2,1,397,1,0,12,3
2020-06-03,296,80,6993,124,10,387,376
2020-06-03,221,101,4001,71,14,137,322
2020-06-03,0,0,88,0,0,6,0
2020-06-03,2,0,445,0,0,19,2
2020-06-03,0,0,40,0,0,1,0
2020-06-03,0,0,186,0,0,3,0
2020-06-03,2,1,466,2,1,21,3
2020-06-03,0,0,106,0,0,5,0
2020-06-03,0,0,42,0,0,4,0
2020-06-03,1,0,50,1,0,8,1
2020-06-03,1,6,199,1,5,10,7
2020-06-03,0,1,25,0,0,0,1
2020-06-03,0,0,51,0,0,0,0
2020-06-03,0,1,65,0,1,6,1
2020-06-03,24,19,1337,9,4,34,43
2020-06-03,28,32,1366,10,5,21,60
2020-06-03,89,80,2968,32,6,144,169
2020-06-03,0,0,528,1,0,19,0
2020-06-03,30,27,3318,8,6,184,57
2020-06-03,0,0,131,0,0,6,0
2020-06-03,10,13,707,4,1,48,23
2020-06-03,1,0,180,1,0,3,1
2020-06-03,66,9,1759,35,1,74,75
2020-06-03,32,0,199,7,0,2,32
2020-06-03,37,2,920,8,0,6,39
2020-06-03,0,2,54,0,0,0,2
2020-06-03,157,75,4821,67,18,178,232
2020-06-03,1,5,352,0,0,7,6
2020-06-03,0,0,47,0,0,0,0
2020-06-03,1488,502,23607,435,78,1239,1990
2020-06-03,0,0,41,0,0,0,0
2020-06-03,3,76,871,2,8,50,79
2020-06-03,295,75,6214,134,24,288,370
2020-06-03,1,0,667,0,0,4,1
2020-06-03,59,38,2126,16,3,88,97
2020-06-03,3,1,242,3,0,2,4
2020-06-03,1,0,110,0,0,2,1
2020-06-03,0,0,30,0,0,0,0
2020-06-03,0,0,45,0,0,0,0
2020-06-04,13,1,811,3,0,95,14
2020-06-04,1,0,180,1,1,2,1
2020-06-04,0,0,41,0,0,0,0
2020-06-04,33,0,199,7,0,3,33
2020-06-04,0,0,106,0,0,2,0
2020-06-04,1462,586,23715,453,99,1249,2048
2020-06-04,3,4,242,3,0,4,7
2020-06-04,18,70,1628,7,10,101,88
2020-06-04,0,0,30,0,0,0,0
2020-06-04,3,0,445,1,0,14,3
2020-06-04,0,0,51,0,0,1,0
2020-06-04,2,8,390,0,3,13,10
2020-06-04,74,3,237,18,0,4,77
2020-06-04,1,5,199,1,3,7,6
2020-06-04,0,0,40,0,0,2,0
2020-06-04,0,0,51,0,0,2,0
2020-06-04,1,0,151,0,0,0,1
2020-06-04,2,2,110,0,1,1,4
2020-06-04,0,0,42,0,0,2,0
2020-06-04,0,0,186,0,0,0,0
2020-06-04,0,0,25,0,0,2,0
2020-06-04,2,3,397,1,0,16,5
2020-06-04,4,0,448,0,0,22,4
2020-06-04,2,0,667,0,0,5,2
2020-06-04,0,1,25,0,0,0,1
2020-06-04,297,82,6218,135,18,292,379
2020-06-04,0,0,50,0,0,10,0
2020-06-04,2,0,464,2,0,23,2
2020-06-04,82,92,2968,32,9,157,174
2020-06-04,35,18,1101,11,3,48,53
2020-06-04,0,3,397,0,1,0,3
2020-06-04,28,33,2423,14,7,103,61
2020-06-04,226,91,4025,73,20,122,317
2020-06-04,37,38,3318,14,7,176,75
2020-06-04,168,70,4821,66,15,169,238
2020-06-04,27,23,1333,7,5,34,50
2020-06-04,0,0,125,0,0,5,0
2020-06-04,0,2,352,0,2,2,2
2020-06-04,0,1,54,0,0,0,1
2020-06-04,4,54,871,2,7,51,58
2020-06-04,1,1,528,1,0,24,2
2020-06-04,0,0,14,0,0,0,0
2020-06-04,11,35,753,2,3,47,46
2020-06-04,66,35,2136,16,3,95,101
2020-06-04,28,10,717,9,2,65,38
2020-06-04,10,21,707,4,1,48,31
2020-06-04,0,0,47,0,0,0,0
2020-06-04,41,21,2647,15,4,87,62
2020-06-04,39,2,920,9,1,3,41
2020-06-04,0,1,65,0,0,5,1
2020-06-04,0,0,88,0,0,6,0
2020-06-04,29,16,1369,7,3,78,45
2020-06-04,62,14,1756,34,1,78,76
2020-06-04,0,0,45,0,0,0,0
2020-06-04,300,110,6993,123,18,393,410
2020-06-04,28,27,1366,12,3,18,55
2020-06-05,0,0,14,0,0,0,0
2020-06-05,0,0,47,0,0,0,0
2020-06-05,0,0,25,0,0,0,0
2020-06-05,180,63,4821,61,14,140,243
2020-06-05,2,9,390,0,0,16,11
2020-06-05,35,37,2424,14,7,95,72
2020-06-05,1,0,110,0,0,2,1
2020-06-05,3,2,528,1,2,19,5
2020-06-05,1,0,151,0,0,2,1
2020-06-05,31,0,199,7,0,1,31
2020-06-05,0,2,130,0,0,4,2
2020-06-05,0,0,25,0,0,1,0
2020-06-05,0,0,45,0,0,0,0
2020-06-05,1,0,180,1,0,2,1
2020-06-05,79,3,237,15,0,7,82
2020-06-05,42,22,2658,14,4,98,64
2020-06-05,0,0,51,0,0,2,0
2020-06-05,0,0,41,0,0,0,0
2020-06-05,0,0,50,0,0,10,0
2020-06-05,43,32,3375,18,6,206,75
2020-06-05,25,14,1369,8,1,76,39
2020-06-05,228,98,4023,75,24,129,326
2020-06-05,2,3,199,2,1,8,5
2020-06-05,11,21,753,4,3,49,32
2020-06-05,3,3,483,2,0,27,6
2020-06-05,299,69,6190,137,16,320,368
2020-06-05,0,0,186,0,0,3,0
2020-06-05,0,0,30,0,0,0,0
2020-06-05,67,30,2129,16,3,91,97
2020-06-05,0,1,352,0,0,1,1
2020-06-05,0,0,667,0,0,4,0
2020-06-05,14,1,811,3,0,92,15
2020-06-05,17,46,1628,6,6,105,63
2020-06-05,82,68,2968,30,10,154,150
2020-06-05,29,21,1357,9,3,45,50
2020-06-05,4,1,242,2,0,3,5
2020-06-05,39,2,920,7,0,8,41
2020-06-05,315,80,6973,131,11,401,395
2020-06-05,0,0,106,0,0,4,0
2020-06-05,1,2,397,1,0,0,3
2020-06-05,3,0,445,2,0,13,3
2020-06-05,3,69,871,2,8,54,72
2020-06-05,2,3,397,1,0,9,5
2020-06-05,0,0,54,0,0,0,0
2020-06-05,29,8,717,9,3,82,37
2020-06-05,0,1,65,0,0,6,1
2020-06-05,2,0,448,1,0,21,2
2020-06-05,1451,547,23507,439,109,1210,1998
2020-06-05,62,16,1756,33,1,80,78
2020-06-05,26,33,1366,13,4,14,59
2020-06-05,36,18,1101,8,2,47,54
2020-06-05,13,20,707,5,0,45,33
2020-06-05,0,0,88,0,0,6,0
2020-06-05,0,0,42,0,0,3,0
2020-06-05,0,0,51,0,0,2,0
2020-06-05,0,0,40,0,0,2,0
2020-06-06,0,0,25,0,0,0,0
2020-06-06,13,0,811,3,0,91,13
2020-06-06,5,0,242,2,0,4,5
2020-06-06,30,3,717,9,1,69,33
2020-06-06,30,34,1366,13,3,16,64
2020-06-06,1,0,448,1,0,19,1
2020-06-06,26,1,199,9,1,4,27
2020-06-06,1,4,199,1,4,8,5
2020-06-06,0,0,14,0,0,0,0
2020-06-06,0,0,186,0,0,2,0
2020-06-06,0,0,42,0,0,4,0
2020-06-06,3,4,449,2,1,23,7
2020-06-06,12,16,707,4,1,47,28
2020-06-06,0,0,40,0,0,2,0
2020-06-06,1,3,397,1,0,0,4
2020-06-06,33,28,2414,15,7,90,61
2020-06-06,0,0,54,0,0,0,0
2020-06-06,0,0,50,0,0,10,0
2020-06-06,34,1,920,9,0,17,35
2020-06-06,81,2,237,19,0,7,83
2020-06-06,309,67,6973,137,11,396,376
2020-06-06,83,72,2968,30,11,156,155
2020-06-06,0,0,151,0,0,2,0
2020-06-06,18,43,1628,5,5,107,61
2020-06-06,3,6,390,0,1,18,9
2020-06-06,0,0,51,0,0,4,0
2020-06-06,0,0,106,0,0,2,0
2020-06-06,195,59,4821,69,15,147,254
2020-06-06,0,0,47,0,0,0,0
2020-06-06,80,32,1756,33,3,89,112
2020-06-06,285,76,6170,134,12,319,361
2020-06-06,5,0,445,2,0,12,5
2020-06-06,33,28,1333,9,8,40,61
2020-06-06,0,0,667,0,0,8,0
2020-06-06,4,71,871,3,8,52,75
2020-06-06,10,24,753,4,3,44,34
2020-06-06,1,1,110,0,0,3,2
2020-06-06,41,32,3375,16,7,202,73
2020-06-06,0,0,30,0,0,0,0
2020-06-06,5,3,528,1,0,22,8
2020-06-06,0,0,25,0,0,3,0
2020-06-06,0,0,88,0,2,4,0
2020-06-06,37,21,1101,7,0,53,58
2020-06-06,0,0,45,0,0,0,0
2020-06-06,1399,582,23617,418,88,1233,1981
2020-06-06,220,89,3958,72,19,141,309
2020-06-06,0,1,65,0,0,6,1
2020-06-06,0,2,130,0,0,4,2
2020-06-06,0,0,51,0,0,1,0
2020-06-06,0,0,41,0,0,0,0
2020-06-06,70,41,2137,15,4,88,111
2020-06-06,1,0,180,1,0,2,1
2020-06-06,1,5,352,0,0,3,6
2020-06-06,1,3,397,1,0,11,4
2020-06-06,26,9,1369,8,1,69,35
2020-06-06,41,24,2658,15,4,98,65
2020-06-07,69,31,2139,16,4,97,100
2020-06-07,92,74,2968,29,11,152,166
2020-06-07,2,4,199,2,1,9,6
2020-06-07,34,14,2337,13,1,88,48
2020-06-07,83,24,1756,34,4,82,107
2020-06-07,1,4,352,0,0,4,5
2020-06-07,0,0,42,0,0,4,0
2020-06-07,1,0,180,1,0,2,1
2020-06-07,0,0,88,0,1,5,0
2020-06-07,1,2,397,1,0,2,3
2020-06-07,3,2,454,2,0,25,5
2020-06-07,0,0,25,0,0,0,0
2020-06-07,0,0,54,0,0,0,0
2020-06-07,0,0,110,0,0,4,0
2020-06-07,13,17,707,4,1,46,30
2020-06-07,5,0,445,2,0,10,5
2020-06-07,0,2,186,1,1,2,2
2020-06-07,0,0,106,0,0,1,0
2020-06-07,27,1,199,9,1,4,28
2020-06-07,1,0,448,1,0,21,1
2020-06-07,164,57,4821,72,11,158,221
2020-06-07,0,0,25,0,0,2,0
2020-06-07,39,24,1366,15,1,18,63
2020-06-07,1,3,397,1,0,11,4
2020-06-07,0,0,151,0,0,3,0
2020-06-07,0,0,65,0,0,5,0
2020-06-07,217,79,3958,63,19,134,296
2020-06-07,0,0,30,0,0,0,0
2020-06-07,1,6,390,0,0,16,7
2020-06-07,0,1,51,0,1,1,1
2020-06-07,87,1,237,18,0,7,88
2020-06-07,0,0,41,0,0,0,0
2020-06-07,10,24,753,3,3,46,34
2020-06-07,5,2,242,2,1,4,7
2020-06-07,0,0,14,0,0,0,0
2020-06-07,0,1,51,0,0,0,1
2020-06-07,0,0,40,0,0,2,0
2020-06-07,28,0,729,8,0,4,28
2020-06-07,39,32,1329,11,6,48,71
2020-06-07,322,77,6973,148,18,398,399
2020-06-07,12,1,811,3,0,91,13
2020-06-07,0,0,45,0,0,0,0
2020-06-07,0,1,127,0,0,6,1
2020-06-07,0,0,47,0,0,0,0
2020-06-07,286,73,5907,131,16,333,359
2020-06-07,5,6,528,1,1,21,11
2020-06-07,5,66,871,3,9,49,71
2020-06-07,0,1,50,0,0,12,1
2020-06-07,37,20,1101,6,0,55,57
2020-06-07,27,10,1369,9,0,73,37
2020-06-07,1453,558,23659,428,91,1247,2011
2020-06-07,33,26,2399,14,8,90,59
2020-06-07,23,44,1628,7,5,105,67
2020-06-07,20,3,717,6,1,66,23
2020-06-07,38,31,3375,15,6,216,69
2020-06-07,0,0,667,0,0,12,0
2020-06-08,22,6,717,8,2,66,28
2020-06-08,0,0,25,0,0,0,0
2020-06-08,0,0,106,0,0,5,0
2020-06-08,0,0,14,0,0,0,0
2020-06-08,0,0,30,0,0,0,0
2020-06-08,0,0,47,0,0,0,0
2020-06-08,1,5,235,1,2,11,6
2020-06-08,20,35,1628,7,6,116,55
2020-06-08,12,0,811,3,0,93,12
2020-06-08,5,74,871,3,10,47,79
2020-06-08,4,0,448,2,0,19,4
2020-06-08,5,3,242,2,1,5,8
2020-06-08,0,3,54,0,0,0,3
2020-06-08,5,4,528,1,1,20,9
2020-06-08,0,0,45,0,0,0,0
2020-06-08,2,0,390,2,0,16,2
2020-06-08,70,37,2132,15,2,97,107
2020-06-08,1,6,352,0,0,3,7
2020-06-08,44,17,3375,19,3,229,61
2020-06-08,1,0,667,0,0,9,1
2020-06-08,24,1,199,8,1,2,25
2020-06-08,0,0,51,0,0,3,0
2020-06-08,0,0,25,0,0,2,0
2020-06-08,85,2,237,18,1,6,87
2020-06-08,0,1,88,0,1,5,1
2020-06-08,1,1,397,0,0,17,2
2020-06-08,26,13,1369,10,2,78,39
2020-06-08,0,0,40,0,0,2,0
2020-06-08,197,54,4821,74,12,156,251
2020-06-08,1458,595,23736,426,95,1301,2053
2020-06-08,1,0,42,0,0,4,1
2020-06-08,13,15,707,3,2,47,28
2020-06-08,43,27,1366,18,5,18,70
2020-06-08,3,0,480,2,0,26,3
2020-06-08,0,2,120,0,1,4,2
2020-06-08,0,0,50,0,0,10,0
2020-06-08,0,0,41,0,0,0,0
2020-06-08,87,26,1756,29,5,81,113
2020-06-08,1,6,397,1,1,3,7
2020-06-08,37,24,2425,13,10,103,61
2020-06-08,220,108,3987,71,18,128,328
2020-06-08,327,64,6976,149,11,410,391
2020-06-08,0,0,51,0,0,1,0
2020-06-08,291,80,6122,143,23,332,371
2020-06-08,0,0,65,0,0,6,0
2020-06-08,0,0,110,0,0,4,0
2020-06-08,34,2,743,8,0,10,36
2020-06-08,0,1,186,0,1,8,1
2020-06-08,92,60,2968,31,12,144,152
2020-06-08,0,0,151,0,0,5,0
2020-06-08,5,0,445,2,0,17,5
2020-06-08,34,5,1101,5,0,54,39
2020-06-08,11,11,753,3,2,48,22
2020-06-08,1,0,180,1,0,2,1
2020-06-08,42,27,1327,12,10,47,69
2020-06-08,32,11,2647,13,2,106,43
2020-06-09,33,19,2413,13,7,87,52
2020-06-09,0,0,106,0,0,5,0
2020-06-09,0,0,51,0,0,0,0
2020-06-09,205,71,4821,76,18,136,276
2020-06-09,68,36,2132,15,1,92,104
2020-06-09,4,0,445,2,0,14,4
2020-06-09,30,0,199,8,0,0,30
2020-06-09,4,0,242,2,0,4,4
2020-06-09,299,74,6182,141,12,330,373
2020-06-09,36,8,743,6,1,12,44
2020-06-09,1,8,352,0,1,4,9
2020-06-09,1416,695,23627,410,97,1258,2111
2020-06-09,83,22,1742,30,4,75,105
2020-06-09,0,0,30,0,0,0,0
2020-06-09,45,31,1366,18,7,17,76
2020-06-09,1,0,667,0,0,9,1
2020-06-09,1,3,397,0,0,11,4
2020-06-09,5,70,871,3,4,49,75
2020-06-09,0,0,45,0,0,0,0
2020-06-09,315,69,6976,146,19,390,384
2020-06-09,21,40,1628,10,4,106,61
2020-06-09,42,45,1350,10,11,41,87
2020-06-09,1,0,42,0,0,4,1
2020-06-09,0,0,25,0,0,2,0
2020-06-09,1,0,47,0,0,0,1
2020-06-09,31,13,1101,6,3,47,44
2020-06-09,0,3,235,0,0,13,3
2020-06-09,0,6,397,0,0,1,6
2020-06-09,0,0,51,0,0,1,0
2020-06-09,0,0,50,0,0,9,0
2020-06-09,227,106,3987,73,18,134,333
2020-06-09,37,12,2647,13,0,100,49
2020-06-09,94,52,2968,32,9,137,146
2020-06-09,0,0,41,0,0,0,0
2020-06-09,6,0,448,2,1,16,6
2020-06-09,25,7,717,7,2,64,32
2020-06-09,0,2,54,0,0,0,2
2020-06-09,0,0,40,0,0,2,0
2020-06-09,29,13,1369,13,4,78,42
2020-06-09,0,0,14,0,0,0,0
2020-06-09,0,1,186,1,1,2,1
2020-06-09,6,5,528,1,0,20,11
2020-06-09,0,3,125,0,2,7,3
2020-06-09,0,1,65,0,1,5,1
2020-06-09,1,0,180,1,0,1,1
2020-06-09,41,18,3375,18,3,213,59
2020-06-09,10,12,753,2,2,49,22
2020-06-09,0,0,88,0,0,6,0
2020-06-09,13,0,811,3,0,92,13
2020-06-09,0,0,151,0,0,3,0
2020-06-09,0,0,25,0,0,0,0
2020-06-09,0,1,110,0,1,1,1
2020-06-09,83,2,212,18,0,2,85
2020-06-09,3,2,453,2,0,24,5
2020-06-09,17,25,707,5,2,44,42
2020-06-09,6,4,390,3,1,11,10
2020-06-10,3,2,456,2,0,23,5
2020-06-10,30,1,199,9,1,2,31
2020-06-10,0,0,45,0,0,0,0
2020-06-10,312,72,6976,143,10,392,384
2020-06-10,1,14,352,0,1,5,15
2020-06-10,36,26,2471,13,5,97,62
2020-06-10,0,0,40,0,0,2,0
2020-06-10,3,3,397,0,0,10,6
2020-06-10,26,15,1369,11,4,83,41
2020-06-10,88,46,2968,32,11,147,134
2020-06-10,16,0,811,3,0,87,16
2020-06-10,0,0,30,0,0,0,0
2020-06-10,5,1,445,2,0,10,6
2020-06-10,0,1,235,0,0,9,1
2020-06-10,0,0,25,0,0,1,0
2020-06-10,7,23,448,3,6,17,30
2020-06-10,286,76,6186,135,16,330,362
2020-06-10,26,5,717,6,0,68,31
2020-06-10,3,4,242,3,0,5,7
2020-06-10,0,2,110,0,0,1,2
2020-06-10,0,0,25,0,0,0,0
2020-06-10,6,5,528,3,0,14,11
2020-06-10,44,56,1347,10,7,56,100
2020-06-10,0,0,106,0,0,7,0
2020-06-10,1389,564,23634,403,109,1258,1953
2020-06-10,171,76,4821,75,17,132,247
2020-06-10,232,101,3987,71,15,127,333
2020-06-10,38,5,780,5,3,10,43
2020-06-10,0,0,41,0,0,0,0
2020-06-10,40,22,3375,16,5,220,62
2020-06-10,0,2,130,0,2,4,2
2020-06-10,0,1,151,0,1,3,1
2020-06-10,0,1,54,0,0,0,1
2020-06-10,0,0,88,0,0,6,0
2020-06-10,1,0,47,0,0,0,1
2020-06-10,0,0,186,0,0,3,0
2020-06-10,18,15,707,4,1,46,33
2020-06-10,45,38,1366,17,4,17,83
2020-06-10,8,3,390,3,0,10,11
2020-06-10,11,12,753,2,2,45,23
2020-06-10,0,0,51,0,0,3,0
2020-06-10,29,11,1049,7,2,50,40
2020-06-10,39,11,2647,14,0,95,50
2020-06-10,89,23,1742,32,10,77,112
2020-06-10,0,0,50,0,0,9,0
2020-06-10,20,23,1628,10,6,111,43
2020-06-10,0,0,65,0,0,4,0
2020-06-10,67,35,2144,19,4,84,102
2020-06-10,1,0,180,1,0,3,1
2020-06-10,79,0,212,16,0,2,79
2020-06-10,0,0,51,0,0,1,0
2020-06-10,0,0,14,0,0,0,0
2020-06-10,1,0,667,0,5,4,1
2020-06-10,1,5,397,0,1,0,6
2020-06-10,1,0,42,0,0,4,1
2020-06-10,5,57,871,3,4,47,62
2020-06-11,7,4,528,3,1,5,11
2020-06-11,17,0,811,5,0,85,17
2020-06-11,0,0,110,0,0,2,0
2020-06-11,8,2,390,3,0,13,10
2020-06-11,90,19,1742,29,2,83,109
2020-06-11,38,13,2647,14,1,86,51
2020-06-11,0,0,30,0,0,0,0
2020-06-11,2,3,481,2,1,24,5
2020-06-11,39,18,3375,18,2,215,57
2020-06-11,4,2,397,0,0,11,6
2020-06-11,0,0,25,0,0,1,0
2020-06-11,19,12,707,6,2,43,31
2020-06-11,4,1,242,3,0,3,5
2020-06-11,0,0,51,0,0,2,0
2020-06-11,0,0,88,0,0,6,0
2020-06-11,238,68,4018,71,12,131,306
2020-06-11,30,7,717,8,0,64,37
2020-06-11,0,2,127,0,2,4,2
2020-06-11,0,0,14,0,0,0,0
2020-06-11,0,0,54,0,0,0,0
2020-06-11,194,77,4821,73,16,133,271
2020-06-11,0,0,106,0,0,7,0
2020-06-11,0,0,45,0,0,0,0
2020-06-11,1,0,42,0,0,2,1
2020-06-11,0,1,40,0,0,2,1
2020-06-11,1,0,47,0,0,0,1
2020-06-11,0,0,151,0,0,0,0
2020-06-11,5,37,448,3,7,15,42
2020-06-11,86,1,237,18,0,0,87
2020-06-11,22,29,1628,11,4,112,51
2020-06-11,35,6,780,7,0,11,41
2020-06-11,5,1,445,2,0,6,6
2020-06-11,0,0,65,0,0,4,0
2020-06-11,2,0,667,0,0,8,2
2020-06-11,26,7,1089,7,0,50,33
2020-06-11,29,2,199,8,0,5,31
2020-06-11,86,38,2968,32,7,145,124
2020-06-11,0,3,397,0,0,3,3
2020-06-11,0,0,180,0,0,3,0
2020-06-11,4,23,871,3,1,49,27
2020-06-11,1397,576,23666,415,97,1220,1973
2020-06-11,43,47,1360,11,10,46,90
2020-06-11,42,25,1366,15,2,17,67
2020-06-11,325,67,6976,156,16,368,392
2020-06-11,0,1,186,0,0,2,1
2020-06-11,0,1,51,0,0,3,1
2020-06-11,39,23,2501,13,5,105,62
2020-06-11,10,8,753,2,2,48,18
2020-06-11,0,0,25,0,0,0,0
2020-06-11,0,0,41,0,0,0,0
2020-06-11,1,8,352,0,0,2,9
2020-06-11,277,75,6187,133,16,325,352
2020-06-11,0,0,50,0,0,8,0
2020-06-11,29,18,1369,13,1,82,47
2020-06-11,67,32,2142,17,1,79,99
2020-06-11,0,1,235,0,1,10,1
2020-06-12,5,0,448,3,0,20,5
2020-06-12,0,0,88,0,0,6,0
2020-06-12,18,9,707,6,2,46,27
2020-06-12,81,1,237,16,0,2,82
2020-06-12,0,0,50,0,0,10,0
2020-06-12,4,38,871,3,3,42,42
2020-06-12,8,3,390,3,1,12,11
2020-06-12,0,0,40,0,0,2,0
2020-06-12,1,13,352,0,2,0,14
2020-06-12,69,33,2140,19,1,87,102
2020-06-12,12,13,780,8,0,25,25
2020-06-12,0,0,41,0,0,0,0
2020-06-12,0,0,136,0,0,6,0
2020-06-12,5,1,242,3,0,3,6
2020-06-12,0,0,30,0,0,0,0
2020-06-12,0,0,151,0,0,2,0
2020-06-12,0,1,65,0,1,5,1
2020-06-12,49,19,1366,16,1,16,68
2020-06-12,41,11,2647,15,1,91,52
2020-06-12,96,15,1742,36,1,72,111
2020-06-12,0,0,186,0,0,4,0
2020-06-12,46,63,1361,12,11,42,109
2020-06-12,0,8,397,0,1,1,8
2020-06-12,5,4,528,2,0,14,9
2020-06-12,0,2,110,0,2,0,2
2020-06-12,34,34,1369,13,3,84,68
2020-06-12,15,0,811,2,0,87,15
2020-06-12,7,8,753,1,1,46,15
2020-06-12,22,20,1628,10,3,111,42
2020-06-12,0,0,25,0,0,0,0
2020-06-12,0,0,45,0,0,0,0
2020-06-12,0,0,51,0,0,4,0
2020-06-12,0,0,180,0,0,5,0
2020-06-12,275,41,6210,131,13,328,316
2020-06-12,30,4,717,9,0,58,34
2020-06-12,0,0,54,0,0,0,0
2020-06-12,84,42,2968,35,6,120,126
2020-06-12,0,3,235,0,3,14,3
2020-06-12,2,3,471,2,0,24,5
2020-06-12,0,0,51,0,0,0,0
2020-06-12,0,1,106,0,1,6,1
2020-06-12,6,0,445,2,0,9,6
2020-06-12,0,0,14,0,0,0,0
2020-06-12,22,10,1089,7,1,51,32
2020-06-12,236,83,4018,74,14,139,319
2020-06-12,34,0,199,10,0,5,34
2020-06-12,0,0,25,0,0,1,0
2020-06-12,1,0,42,0,0,3,1
2020-06-12,43,17,3375,17,3,223,60
2020-06-12,35,32,2474,13,8,91,67
2020-06-12,1,0,47,0,0,0,1
2020-06-12,205,78,4821,77,16,138,283
2020-06-12,1383,487,23655,414,78,1228,1870
2020-06-12,4,6,397,0,0,15,10
2020-06-12,311,117,6976,150,27,384,428
2020-06-12,1,0,667,0,0,7,1
2020-06-13,18,9,1089,8,0,55,27
2020-06-13,0,0,186,1,1,2,0
2020-06-13,50,21,1366,17,3,10,71
2020-06-13,28,23,2444,11,5,84,51
2020-06-13,33,1,199,10,0,6,34
2020-06-13,36,6,717,7,3,58,42
2020-06-13,1,0,42,0,0,2,1
2020-06-13,0,3,235,0,3,11,3
2020-06-13,0,0,25,0,0,0,0
2020-06-13,64,34,2140,21,3,83,98
2020-06-13,10,2,390,3,0,12,12
2020-06-13,0,0,128,0,0,4,0
2020-06-13,4,5,397,0,0,10,9
2020-06-13,44,50,1354,13,8,51,94
2020-06-13,17,5,707,6,1,49,22
2020-06-13,5,6,871,2,0,47,11
2020-06-13,0,0,25,0,0,0,0
2020-06-13,41,9,2647,14,0,94,50
2020-06-13,0,0,50,0,0,12,0
2020-06-13,0,0,41,0,0,0,0
2020-06-13,235,101,3992,68,17,137,336
2020-06-13,0,0,51,0,0,2,0
2020-06-13,6,0,445,2,0,14,6
2020-06-13,2,6,449,2,1,23,8
2020-06-13,1285,483,23688,399,84,1262,1768
2020-06-13,3,1,242,2,0,5,4
2020-06-13,41,21,1369,19,1,86,62
2020-06-13,9,27,780,7,1,6,36
2020-06-13,0,0,45,0,0,0,0
2020-06-13,0,0,40,0,0,2,0
2020-06-13,1,13,352,0,2,0,14
2020-06-13,0,0,14,0,0,0,0
2020-06-13,336,70,6976,150,14,402,406
2020-06-13,284,58,6195,118,18,324,342
2020-06-13,78,8,237,18,0,0,86
2020-06-13,87,27,2968,33,3,150,114
2020-06-13,1,0,667,0,0,6,1
2020-06-13,3,0,448,3,1,20,3
2020-06-13,0,0,51,0,0,3,0
2020-06-13,0,0,30,0,0,0,0
2020-06-13,0,0,88,0,0,6,0
2020-06-13,23,24,1628,8,6,108,47
2020-06-13,0,1,110,0,1,0,1
2020-06-13,0,1,65,0,1,3,1
2020-06-13,35,14,3423,12,3,211,49
2020-06-13,1,0,47,0,0,0,1
2020-06-13,0,1,54,0,0,0,1
2020-06-13,15,3,811,2,0,91,18
2020-06-13,7,6,753,2,2,50,13
2020-06-13,79,28,1742,33,4,78,107
2020-06-13,0,0,106,0,0,6,0
2020-06-13,0,0,180,0,0,5,0
2020-06-13,204,81,4821,83,18,129,285
2020-06-13,0,0,151,0,0,0,0
2020-06-13,6,2,528,2,0,8,8
2020-06-13,0,5,397,0,0,3,5
2020-06-14,9,2,390,3,0,12,11
2020-06-14,0,0,45,0,0,0,0
2020-06-14,0,1,128,0,1,4,1
2020-06-14,49,25,1366,16,2,10,74
2020-06-14,0,0,50,0,0,10,0
2020-06-14,0,0,186,1,1,2,0
2020-06-14,3,0,448,3,0,19,3
2020-06-14,30,21,2441,12,5,90,51
2020-06-14,88,36,2968,33,9,149,124
2020-06-14,2,10,449,2,4,20,12
2020-06-14,79,11,237,20,0,0,90
2020-06-14,0,0,54,0,0,0,0
2020-06-14,40,9,2647,13,2,96,49
2020-06-14,1,0,47,0,0,0,1
2020-06-14,0,0,40,0,0,2,0
2020-06-14,11,4,811,1,0,95,15
2020-06-14,0,0,180,0,0,4,0
2020-06-14,0,0,667,0,0,7,0
2020-06-14,0,1,65,0,1,3,1
2020-06-14,7,0,445,3,0,13,7
2020-06-14,1288,509,23703,397,80,1283,1797
2020-06-14,18,11,1089,9,1,51,29
2020-06-14,0,0,25,0,0,0,0
2020-06-14,81,22,1742,32,3,76,103
2020-06-14,0,0,51,0,0,0,0
2020-06-14,2,1,397,0,1,2,3
2020-06-14,58,35,2135,21,3,79,93
2020-06-14,0,0,41,0,0,0,0
2020-06-14,0,0,14,0,0,0,0
2020-06-14,228,92,3992,70,19,120,320
2020-06-14,0,0,106,0,0,6,0
2020-06-14,282,84,6145,111,21,323,366
2020-06-14,7,6,753,2,2,49,13
2020-06-14,0,1,110,0,1,0,1
2020-06-14,38,2,199,9,0,3,40
2020-06-14,0,0,42,0,0,3,0
2020-06-14,0,0,88,0,0,6,0
2020-06-14,42,47,1354,12,7,55,89
2020-06-14,3,1,242,2,0,5,4
2020-06-14,37,4,717,8,2,59,41
2020-06-14,3,6,397,0,0,12,9
2020-06-14,14,7,707,6,1,49,21
2020-06-14,38,16,3423,12,3,204,54
2020-06-14,206,89,4821,77,18,140,295
2020-06-14,0,0,51,0,0,1,0
2020-06-14,0,4,235,0,4,10,4
2020-06-14,44,12,1369,16,1,87,56
2020-06-14,0,0,25,0,0,0,0
2020-06-14,5,0,528,2,0,8,5
2020-06-14,5,29,871,2,0,52,34
2020-06-14,0,0,151,0,0,0,0
2020-06-14,0,0,30,0,0,0,0
2020-06-14,38,2,780,6,1,23,40
2020-06-14,26,16,1628,9,3,121,42
2020-06-14,0,4,352,0,0,3,4
2020-06-14,321,100,6976,143,21,414,421
2020-06-15,221,74,4821,77,18,149,295
2020-06-15,6,0,445,2,0,16,6
2020-06-15,1,0,51,0,0,0,1
2020-06-15,0,0,14,0,0,0,0
2020-06-15,1,0,47,0,0,0,1
2020-06-15,6,30,871,3,0,46,36
2020-06-15,3,0,242,2,0,5,3
2020-06-15,38,16,3423,12,3,239,54
2020-06-15,38,1,199,10,0,2,39
2020-06-15,37,8,2647,10,0,94,45
2020-06-15,0,0,151,0,0,2,0
2020-06-15,5,2,528,2,0,7,7
2020-06-15,0,0,667,0,0,9,0
2020-06-15,16,7,707,6,1,44,23
2020-06-15,27,6,1628,7,2,115,33
2020-06-15,0,0,54,0,0,0,0
2020-06-15,61,25,2111,22,2,86,86
2020-06-15,46,3,780,8,1,12,49
2020-06-15,2,3,397,0,0,8,5
2020-06-15,0,0,30,0,0,0,0
2020-06-15,0,0,65,0,0,0,0
2020-06-15,3,1,447,2,0,26,4
2020-06-15,3,2,448,3,1,14,5
2020-06-15,90,17,1742,38,3,78,107
2020-06-15,0,0,88,0,0,6,0
2020-06-15,5,1,397,1,1,5,6
2020-06-15,0,0,40,0,0,2,0
2020-06-15,0,0,51,0,0,0,0
2020-06-15,0,2,235,0,2,6,2
2020-06-15,0,0,106,0,0,7,0
2020-06-15,0,0,25,0,0,0,0
2020-06-15,0,0,50,0,0,9,0
2020-06-15,42,7,717,9,0,63,49
2020-06-15,0,0,42,0,0,2,0
2020-06-15,1420,536,23659,404,88,1333,1956
2020-06-15,98,31,2968,37,9,148,129
2020-06-15,346,79,6976,138,21,417,425
2020-06-15,237,98,4071,65,16,136,335
2020-06-15,6,3,390,1,0,15,9
2020-06-15,44,39,1350,13,7,55,83
2020-06-15,0,0,186,0,0,3,0
2020-06-15,79,3,237,19,0,2,82
2020-06-15,46,13,1376,18,2,16,59
2020-06-15,0,0,25,0,0,0,0
2020-06-15,0,2,131,0,2,5,2
2020-06-15,43,18,1364,15,1,88,61
2020-06-15,17,5,1089,6,1,50,22
2020-06-15,0,0,45,0,0,0,0
2020-06-15,7,6,753,3,2,48,13
2020-06-15,14,2,811,1,0,93,16
2020-06-15,0,0,41,0,0,0,0
2020-06-15,0,1,180,0,1,5,1
2020-06-15,0,0,110,0,0,0,0
2020-06-15,0,5,352,0,1,2,5
2020-06-15,33,15,2428,15,5,104,48
2020-06-15,294,66,6129,120,13,356,360
2020-06-16,0,0,41,0,0,0,0
2020-06-16,0,1,134,0,0,7,1
2020-06-16,67,36,2129,21,3,86,103
2020-06-16,5,3,528,3,0,11,8
2020-06-16,47,0,199,10,0,2,47
2020-06-16,5,8,471,2,5,27,13
2020-06-16,0,0,30,0,0,0,0
2020-06-16,0,0,25,0,0,0,0
2020-06-16,0,0,151,0,0,0,0
2020-06-16,13,4,824,2,0,93,17
2020-06-16,0,0,25,0,0,0,0
2020-06-16,83,2,237,21,0,0,85
2020-06-16,32,16,3423,12,3,228,48
2020-06-16,96,14,1742,39,2,80,110
2020-06-16,0,0,51,0,0,2,0
2020-06-16,0,1,235,0,1,7,1
2020-06-16,17,11,1089,6,1,54,28
2020-06-16,47,45,1347,13,9,58,92
2020-06-16,47,14,1376,18,2,20,61
2020-06-16,0,0,667,0,0,9,0
2020-06-16,5,13,871,3,0,51,18
2020-06-16,0,0,50,0,0,9,0
2020-06-16,36,21,2457,13,8,87,57
2020-06-16,26,14,1628,9,4,108,40
2020-06-16,17,8,707,5,2,45,25
2020-06-16,1429,518,23667,412,87,1175,1947
2020-06-16,34,8,2647,8,0,91,42
2020-06-16,0,0,180,0,0,4,0
2020-06-16,42,8,717,13,1,57,50
2020-06-16,49,4,780,11,0,24,53
2020-06-16,6,3,390,1,0,14,9
2020-06-16,1,0,51,0,0,3,1
2020-06-16,0,0,45,0,0,0,0
2020-06-16,8,10,753,3,2,51,18
2020-06-16,229,64,4821,77,13,156,293
2020-06-16,1,0,47,0,0,0,1
2020-06-16,364,65,6976,151,18,455,429
2020-06-16,289,54,6168,130,12,320,343
2020-06-16,1,0,186,0,0,6,1
2020-06-16,6,2,242,3,0,5,8
2020-06-16,0,2,110,0,1,0,2
2020-06-16,3,1,397,0,0,7,4
2020-06-16,257,84,4071,65,18,136,341
2020-06-16,0,0,106,0,0,4,0
2020-06-16,95,38,2968,36,12,142,133
2020-06-16,6,0,445,2,0,17,6
2020-06-16,0,0,14,0,0,0,0
2020-06-16,0,1,88,0,0,6,1
2020-06-16,50,14,1369,16,3,89,64
2020-06-16,0,0,42,0,0,2,0
2020-06-16,3,0,448,3,0,10,3
2020-06-16,4,6,397,1,0,6,10
2020-06-16,0,0,54,0,0,0,0
2020-06-16,0,0,40,0,0,2,0
2020-06-16,1,7,352,0,1,0,8
2020-06-16,0,1,65,0,1,4,1
2020-06-17,351,74,6976,149,16,407,425
2020-06-17,4,3,528,4,1,7,7
2020-06-17,1446,512,23646,414,61,1151,1958
2020-06-17,1,0,51,0,0,1,1
2020-06-17,7,1,390,2,1,9,8
2020-06-17,34,18,2395,14,5,77,52
2020-06-17,0,0,45,0,0,0,0
2020-06-17,99,24,1412,45,0,31,123
2020-06-17,6,13,871,3,2,47,19
2020-06-17,46,3,780,10,1,23,49
2020-06-17,3,0,448,3,0,4,3
2020-06-17,0,0,180,0,0,4,0
2020-06-17,73,30,2138,16,1,81,103
2020-06-17,38,10,717,12,3,35,48
2020-06-17,0,0,151,0,0,0,0
2020-06-17,3,4,397,0,3,9,7
2020-06-17,37,64,1368,14,9,45,101
2020-06-17,6,4,242,3,0,3,10
2020-06-17,0,0,50,0,0,9,0
2020-06-17,5,0,445,1,0,18,5
2020-06-17,35,9,2647,8,3,86,44
2020-06-17,0,0,42,0,0,3,0
2020-06-17,2,0,186,0,0,6,2
2020-06-17,4,3,365,2,1,73,7
2020-06-17,3,6,397,0,0,6,9
2020-06-17,1,0,47,0,0,0,1
2020-06-17,0,0,106,0,0,6,0
2020-06-17,0,1,110,0,0,0,1
2020-06-17,49,25,1369,14,3,84,74
2020-06-17,0,2,88,0,0,11,2
2020-06-17,37,18,3438,15,0,204,55
2020-06-17,233,64,4821,76,12,146,297
2020-06-17,0,0,14,0,0,0,0
2020-06-17,13,6,707,4,0,52,19
2020-06-17,0,0,51,0,0,2,0
2020-06-17,0,0,25,0,0,0,0
2020-06-17,0,0,30,0,0,0,0
2020-06-17,285,94,4071,75,19,91,379
2020-06-17,0,0,88,0,0,6,0
2020-06-17,0,3,352,0,1,0,3
2020-06-17,23,9,1628,10,3,96,32
2020-06-17,0,0,41,0,0,0,0
2020-06-17,0,0,25,0,0,0,0
2020-06-17,86,3,237,20,0,0,89
2020-06-17,283,60,6235,130,17,324,343
2020-06-17,15,2,824,2,1,85,17
2020-06-17,50,11,1376,18,1,23,61
2020-06-17,1,3,65,1,0,2,4
2020-06-17,0,2,54,0,0,0,2
2020-06-17,6,10,753,2,1,51,16
2020-06-17,0,0,667,0,0,12,0
2020-06-17,48,1,199,10,0,4,49
2020-06-17,0,0,40,0,0,2,0
2020-06-17,2,0,145,0,0,9,2
2020-06-17,90,47,2968,36,13,135,137
2020-06-17,14,6,1089,6,1,50,20
2020-06-18,10,6,528,5,1,11,16
2020-06-18,288,63,6190,136,15,313,351
2020-06-18,6,2,450,3,0,19,8
2020-06-18,0,0,30,0,0,0,0
2020-06-18,25,18,1628,10,4,146,43
2020-06-18,18,11,707,5,0,53,29
2020-06-18,5,1,390,2,0,9,6
2020-06-18,89,14,1742,41,0,87,103
2020-06-18,0,0,42,0,0,2,0
2020-06-18,2,1,123,0,0,9,3
2020-06-18,1406,494,23644,403,88,1195,1900
2020-06-18,0,0,41,0,0,0,0
2020-06-18,0,2,54,0,0,0,2
2020-06-18,48,2,199,10,0,1,50
2020-06-18,72,1,237,16,0,6,73
2020-06-18,12,7,753,3,2,60,19
2020-06-18,1,0,667,0,0,8,1
2020-06-18,12,5,242,3,0,6,17
2020-06-18,1,0,47,0,0,0,1
2020-06-18,0,0,106,0,0,4,0
2020-06-18,47,4,780,8,0,11,51
2020-06-18,4,3,397,0,0,5,7
2020-06-18,0,1,50,0,0,8,1
2020-06-18,1,0,65,1,0,4,1
2020-06-18,4,0,445,1,0,8,4
2020-06-18,0,0,151,0,0,0,0
2020-06-18,72,26,2131,13,0,70,98
2020-06-18,15,9,1089,6,2,59,24
2020-06-18,0,0,25,0,0,1,0
2020-06-18,0,3,352,0,1,4,3
2020-06-18,292,129,4017,76,21,97,421
2020-06-18,2,2,397,1,0,10,4
2020-06-18,56,20,1376,22,5,23,76
2020-06-18,38,11,3438,17,2,205,49
2020-06-18,20,1,824,5,0,89,21
2020-06-18,5,11,871,3,1,64,16
2020-06-18,0,0,51,0,0,2,0
2020-06-18,253,60,4821,87,8,156,313
2020-06-18,0,0,88,0,0,6,0
2020-06-18,40,37,1372,13,10,39,77
2020-06-18,33,12,2647,8,2,155,45
2020-06-18,4,0,448,2,0,6,4
2020-06-18,0,0,45,0,0,0,0
2020-06-18,34,13,2462,13,1,180,47
2020-06-18,56,37,1369,21,3,88,93
2020-06-18,335,87,6976,141,15,412,422
2020-06-18,42,6,717,14,1,33,48
2020-06-18,77,53,2968,38,16,195,130
2020-06-18,0,0,14,0,0,0,0
2020-06-18,0,0,40,0,0,2,0
2020-06-18,0,0,25,0,0,0,0
2020-06-18,0,2,110,0,0,1,2
2020-06-18,0,0,180,0,0,4,0
2020-06-18,1,1,51,1,0,1,2
2020-06-18,2,1,186,0,0,4,3
2020-06-18,0,3,227,0,3,8,3
2020-06-19,80,0,237,17,0,5,80
2020-06-19,0,0,47,0,0,0,0
2020-06-19,5,0,390,3,0,12,5
2020-06-19,11,11,753,3,2,65,22
2020-06-19,0,1,352,0,1,1,1
2020-06-19,0,0,106,0,0,1,0
2020-06-19,0,0,88,0,0,6,0
2020-06-19,17,7,707,6,0,49,24
2020-06-19,4,4,871,3,1,57,8
2020-06-19,0,0,25,0,0,2,0
2020-06-19,0,0,151,0,0,2,0
2020-06-19,5,2,440,3,0,15,7
2020-06-19,3,8,397,0,0,4,11
2020-06-19,1426,494,23649,408,73,1197,1920
2020-06-19,9,1,242,3,0,5,10
2020-06-19,0,0,14,0,0,0,0
2020-06-19,0,0,30,0,0,0,0
2020-06-19,261,57,4821,90,9,147,318
2020-06-19,0,0,51,0,0,2,0
2020-06-19,49,1,199,10,0,4,50
2020-06-19,4,0,445,1,0,7,4
2020-06-19,0,3,235,0,3,9,3
2020-06-19,64,37,2135,16,2,72,101
2020-06-19,296,90,4013,72,25,91,386
2020-06-19,37,17,2479,16,5,180,54
2020-06-19,0,0,41,0,0,0,0
2020-06-19,1,0,667,1,0,1,1
2020-06-19,0,0,25,0,0,0,0
2020-06-19,4,4,397,1,2,7,8
2020-06-19,1,3,180,0,0,4,4
2020-06-19,30,11,1628,9,1,150,41
2020-06-19,93,10,1742,38,0,87,103
2020-06-19,2,3,123,0,0,5,5
2020-06-19,1,0,65,1,0,3,1
2020-06-19,4,1,448,2,1,9,5
2020-06-19,0,0,51,0,0,5,0
2020-06-19,344,66,6976,138,11,420,410
2020-06-19,15,5,1089,5,0,61,20
2020-06-19,0,0,45,0,0,0,0
2020-06-19,294,65,6214,143,10,302,359
2020-06-19,59,15,1376,19,2,56,74
2020-06-19,2,0,186,0,0,4,2
2020-06-19,43,38,1348,13,7,39,81
2020-06-19,18,1,824,5,0,87,19
2020-06-19,0,0,110,0,0,1,0
2020-06-19,0,4,54,0,0,0,4
2020-06-19,0,0,42,0,0,2,0
2020-06-19,30,9,2647,8,4,151,39
2020-06-19,0,1,50,0,0,9,1
2020-06-19,59,34,1364,23,4,86,93
2020-06-19,48,2,780,12,0,9,50
2020-06-19,10,1,528,5,0,11,11
2020-06-19,80,57,2968,36,20,192,137
2020-06-19,0,0,40,0,0,2,0
2020-06-19,46,4,717,17,1,53,50
2020-06-19,39,21,3438,18,3,209,60
2020-06-20,0,0,42,0,0,3,0
2020-06-20,0,2,235,0,2,9,2
2020-06-20,67,30,1364,23,4,97,97
2020-06-20,34,17,1628,8,6,145,51
2020-06-20,1,1,50,0,1,9,2
2020-06-20,363,83,6976,142,25,410,446
2020-06-20,0,0,41,0,0,0,0
2020-06-20,71,44,2134,14,3,80,115
2020-06-20,0,0,25,0,0,3,0
2020-06-20,280,50,6169,138,10,308,330
2020-06-20,5,0,871,3,0,92,5
2020-06-20,297,69,3959,77,23,113,366
2020-06-20,15,6,1089,7,0,62,21
2020-06-20,0,0,51,0,0,5,0
2020-06-20,0,0,180,0,0,6,0
2020-06-20,1453,516,23631,408,87,1276,1969
2020-06-20,52,5,717,16,1,46,57
2020-06-20,2,8,397,0,0,5,10
2020-06-20,103,13,1742,42,0,89,116
2020-06-20,1,0,667,1,0,3,1
2020-06-20,0,0,25,0,0,0,0
2020-06-20,0,4,54,0,0,0,4
2020-06-20,0,0,151,0,0,4,0
2020-06-20,0,1,352,0,1,4,1
2020-06-20,0,0,110,0,0,1,0
2020-06-20,0,0,47,0,0,0,0
2020-06-20,0,0,14,0,0,0,0
2020-06-20,0,0,88,0,0,6,0
2020-06-20,77,44,2968,33,12,203,121
2020-06-20,47,2,780,10,1,8,49
2020-06-20,9,1,242,3,1,3,10
2020-06-20,19,0,824,5,0,81,19
2020-06-20,5,0,390,3,0,9,5
2020-06-20,5,4,464,2,1,22,9
2020-06-20,0,0,30,0,0,0,0
2020-06-20,0,0,40,0,0,2,0
2020-06-20,89,0,237,20,0,4,89
2020-06-20,3,0,445,1,0,11,3
2020-06-20,0,0,51,0,0,1,0
2020-06-20,0,0,45,0,0,0,0
2020-06-20,3,0,186,1,0,3,3
2020-06-20,10,11,753,2,2,62,21
2020-06-20,67,20,1376,23,5,61,87
2020-06-20,4,3,397,2,0,9,7
2020-06-20,39,14,2452,19,4,171,53
2020-06-20,3,0,448,3,0,11,3
2020-06-20,47,26,1352,13,3,40,73
2020-06-20,252,78,4821,94,5,149,330
2020-06-20,1,0,65,1,0,4,1
2020-06-20,32,24,2647,10,5,140,56
2020-06-20,41,14,3438,20,1,212,55
2020-06-20,8,2,528,3,0,8,10
2020-06-20,44,0,199,8,0,2,44
2020-06-20,22,10,707,7,0,47,32
2020-06-20,0,0,106,0,0,2,0
2020-06-20,3,3,123,1,0,4,6
2020-06-21,0,1,110,0,0,2,1
2020-06-21,73,31,2126,18,2,83,104
2020-06-21,76,43,2968,30,12,203,119
2020-06-21,108,17,1742,41,0,90,125
2020-06-21,0,0,30,0,0,0,0
2020-06-21,277,49,6088,137,15,330,326
2020-06-21,95,0,237,21,0,1,95
2020-06-21,361,85,6976,142,29,406,446
2020-06-21,0,0,45,0,0,0,0
2020-06-21,0,0,42,0,0,3,0
2020-06-21,81,21,1376,24,2,58,102
2020-06-21,0,3,54,0,0,0,3
2020-06-21,18,9,1089,8,1,63,27
2020-06-21,37,7,2647,12,1,149,44
2020-06-21,3,0,445,2,0,11,3
2020-06-21,4,3,871,3,0,62,7
2020-06-21,0,1,352,0,1,3,1
2020-06-21,20,9,707,8,1,45,29
2020-06-21,5,4,397,2,0,11,9
2020-06-21,46,15,2450,22,6,184,61
2020-06-21,1515,486,23624,412,80,1316,2001
2020-06-21,0,0,47,0,0,0,0
2020-06-21,0,0,25,0,0,0,0
2020-06-21,270,74,4821,97,11,159,344
2020-06-21,0,2,235,0,2,8,2
2020-06-21,0,0,14,0,0,0,0
2020-06-21,46,8,717,19,2,43,54
2020-06-21,0,0,25,0,0,3,0
2020-06-21,5,3,397,0,0,5,8
2020-06-21,3,4,123,2,0,3,7
2020-06-21,0,0,151,0,0,5,0
2020-06-21,11,9,753,1,1,56,20
2020-06-21,4,2,461,2,0,26,6
2020-06-21,0,1,51,0,1,0,1
2020-06-21,51,37,1345,14,10,37,88
2020-06-21,0,0,51,0,0,6,0
2020-06-21,40,21,3438,21,0,229,61
2020-06-21,0,0,106,0,0,5,0
2020-06-21,299,106,3960,87,23,105,405
2020-06-21,18,0,824,6,0,82,18
2020-06-21,9,2,390,3,0,10,11
2020-06-21,3,1,186,1,1,0,4
2020-06-21,0,0,40,0,0,2,0
2020-06-21,0,1,88,0,0,6,1
2020-06-21,35,16,1628,10,7,147,51
2020-06-21,0,0,180,0,0,10,0
2020-06-21,2,1,667,1,1,2,3
2020-06-21,7,0,528,3,0,12,7
2020-06-21,9,3,242,3,0,3,12
2020-06-21,70,21,1369,24,3,96,91
2020-06-21,0,1,50,0,0,10,1
2020-06-21,49,5,780,10,1,13,54
2020-06-21,1,0,65,1,0,4,1
2020-06-21,45,0,199,7,0,3,45
2020-06-21,6,0,448,5,0,10,6
2020-06-21,0,0,41,0,0,0,0
2020-06-22,115,14,1742,44,0,89,129
2020-06-22,91,50,1376,22,5,58,141
2020-06-22,6,3,448,3,2,11,9
2020-06-22,1,0,65,1,0,4,1
2020-06-22,3,3,128,2,1,3,6
2020-06-22,0,0,42,0,0,3,0
2020-06-22,0,0,51,0,0,6,0
2020-06-22,1,0,186,1,0,0,1
2020-06-22,20,1,824,7,0,91,21
2020-06-22,0,0,45,0,0,0,0
2020-06-22,0,0,25,0,0,0,0
2020-06-22,0,2,54,0,0,0,2
2020-06-22,0,0,40,0,0,2,0
2020-06-22,0,0,180,0,0,10,0
2020-06-22,286,60,6067,137,18,357,346
2020-06-22,6,4,397,2,0,13,10
2020-06-22,4,3,445,3,1,21,7
2020-06-22,32,19,1579,10,3,164,51
2020-06-22,0,0,47,0,0,0,0
2020-06-22,301,84,4821,109,14,128,385
2020-06-22,6,1,871,4,1,58,7
2020-06-22,0,0,25,0,0,1,0
2020-06-22,83,39,2125,18,1,82,122
2020-06-22,0,0,51,0,0,0,0
2020-06-22,5,5,397,1,1,6,10
2020-06-22,46,8,2458,19,1,181,54
2020-06-22,0,0,151,0,0,4,0
2020-06-22,19,7,707,7,1,46,26
2020-06-22,0,0,106,0,0,4,0
2020-06-22,11,9,753,2,0,58,20
2020-06-22,95,0,237,17,0,0,95
2020-06-22,48,16,3438,25,0,229,64
2020-06-22,53,4,780,10,0,6,57
2020-06-22,78,34,2968,30,8,196,112
2020-06-22,4,0,445,3,0,6,4
2020-06-22,6,1,528,2,0,15,7
2020-06-22,0,0,110,0,0,2,0
2020-06-22,0,1,352,0,0,3,1
2020-06-22,73,19,1374,26,3,86,92
2020-06-22,51,7,717,20,1,36,58
2020-06-22,0,0,50,0,0,10,0
2020-06-22,2,0,667,1,0,4,2
2020-06-22,47,0,199,8,0,1,47
2020-06-22,1556,534,23612,406,76,1398,2090
2020-06-22,0,0,14,0,0,0,0
2020-06-22,376,90,6976,152,24,413,466
2020-06-22,7,2,242,3,0,4,9
2020-06-22,0,0,41,0,0,0,0
2020-06-22,1,0,235,1,0,7,1
2020-06-22,49,56,1342,14,13,38,105
2020-06-22,11,2,390,4,0,14,13
2020-06-22,40,7,2337,12,2,140,47
2020-06-22,19,4,1089,9,1,60,23
2020-06-22,316,107,3960,90,19,104,423
2020-06-22,0,0,30,0,0,0,0
2020-06-22,0,1,88,0,0,6,1
2020-06-23,0,0,40,0,0,2,0
2020-06-23,312,58,6183,146,11,338,370
2020-06-23,54,40,1350,14,9,40,94
2020-06-23,7,0,528,1,0,15,7
2020-06-23,1,0,51,1,0,4,1
2020-06-23,91,48,2133,22,0,83,139
2020-06-23,0,0,47,0,0,0,0
2020-06-23,0,0,106,0,0,5,0
2020-06-23,86,42,2968,33,11,196,128
2020-06-23,1,0,65,1,0,2,1
2020-06-23,50,15,2477,18,0,171,65
2020-06-23,1633,626,23601,416,100,1301,2259
2020-06-23,51,0,199,9,0,1,51
2020-06-23,0,0,30,0,0,0,0
2020-06-23,5,2,461,2,1,19,7
2020-06-23,23,3,707,7,0,46,26
2020-06-23,12,2,390,3,1,15,14
2020-06-23,406,79,6976,154,20,395,485
2020-06-23,10,3,753,2,0,62,13
2020-06-23,9,3,242,3,0,4,12
2020-06-23,0,0,41,0,0,0,0
2020-06-23,0,0,45,0,0,0,0
2020-06-23,0,0,51,0,0,0,0
2020-06-23,6,3,397,1,0,12,9
2020-06-23,0,0,25,0,0,0,0
2020-06-23,21,2,824,7,0,88,23
2020-06-23,56,5,780,11,0,16,61
2020-06-23,37,15,1579,8,2,159,52
2020-06-23,57,15,3438,31,0,225,72
2020-06-23,7,0,448,4,0,12,7
2020-06-23,3,2,126,2,0,4,5
2020-06-23,1,2,235,1,2,6,3
2020-06-23,1,0,151,0,0,5,1
2020-06-23,9,5,871,7,3,56,14
2020-06-23,45,8,2647,16,2,145,53
2020-06-23,0,1,88,0,0,6,1
2020-06-23,53,8,717,22,2,33,61
2020-06-23,1,0,186,1,0,2,1
2020-06-23,118,15,1742,43,1,87,133
2020-06-23,0,0,42,0,0,3,0
2020-06-23,22,5,1089,8,2,62,27
2020-06-23,82,16,1374,27,2,84,98
2020-06-23,0,1,54,0,0,0,1
2020-06-23,7,7,397,0,1,3,14
2020-06-23,93,0,237,18,0,2,93
2020-06-23,89,20,1376,23,3,61,109
2020-06-23,0,0,25,0,0,1,0
2020-06-23,6,1,445,1,0,10,7
2020-06-23,0,1,50,0,0,12,1
2020-06-23,1,1,352,1,0,1,2
2020-06-23,311,130,4821,111,22,130,441
2020-06-23,315,119,4010,92,23,98,434
2020-06-23,0,0,180,0,0,7,0
2020-06-23,0,1,110,0,1,0,1
2020-06-23,0,0,14,0,0,0,0
2020-06-23,3,0,667,1,0,5,3
2020-06-24,1,0,51,1,0,0,1
2020-06-24,14,2,390,5,0,9,16
2020-06-24,0,0,40,0,0,2,0
2020-06-24,0,1,110,0,0,0,1
2020-06-24,0,0,51,0,0,1,0
2020-06-24,0,0,14,0,0,0,0
2020-06-24,0,0,106,0,0,5,0
2020-06-24,46,9,2647,17,3,105,55
2020-06-24,14,3,242,4,0,2,17
2020-06-24,6,1,397,4,1,0,7
2020-06-24,1,0,88,0,0,6,1
2020-06-24,118,14,1742,44,2,80,132
2020-06-24,89,33,1376,25,3,52,122
2020-06-24,0,0,50,0,0,11,0
2020-06-24,1,2,352,1,1,2,3
2020-06-24,65,13,3438,31,0,215,78
2020-06-24,0,0,47,0,0,0,0
2020-06-24,21,4,824,9,0,81,25
2020-06-24,312,125,4010,95,27,100,437
2020-06-24,54,3,717,20,1,53,57
2020-06-24,0,2,54,0,0,0,2
2020-06-24,54,0,199,9,0,0,54
2020-06-24,3,0,667,1,0,7,3
2020-06-24,0,0,41,0,0,0,0
2020-06-24,0,1,42,0,0,4,1
2020-06-24,85,17,1374,31,0,81,102
2020-06-24,82,0,237,14,0,2,82
2020-06-24,8,8,753,2,1,54,16
2020-06-24,93,46,2113,22,2,86,139
2020-06-24,5,0,186,4,0,0,5
2020-06-24,7,1,871,4,1,55,8
2020-06-24,0,0,25,0,0,1,0
2020-06-24,56,3,780,9,0,6,59
2020-06-24,1,0,65,1,0,3,1
2020-06-24,331,101,4821,113,12,131,432
2020-06-24,1,0,235,1,0,7,1
2020-06-24,61,16,2491,14,4,97,77
2020-06-24,6,5,484,2,1,37,11
2020-06-24,0,0,30,0,0,0,0
2020-06-24,6,3,397,1,0,12,9
2020-06-24,3,0,139,3,0,4,3
2020-06-24,0,0,25,0,0,0,0
2020-06-24,52,34,1360,15,8,53,86
2020-06-24,9,4,528,2,0,15,13
2020-06-24,89,41,2968,31,9,147,130
2020-06-24,5,0,445,1,0,7,5
2020-06-24,24,5,1089,8,3,50,29
2020-06-24,333,50,6195,152,15,335,383
2020-06-24,1676,607,23580,430,93,1259,2283
2020-06-24,0,0,180,0,0,6,0
2020-06-24,437,106,6976,161,25,385,543
2020-06-24,6,1,448,4,1,8,7
2020-06-24,0,0,45,0,0,0,0
2020-06-24,0,0,151,0,0,5,0
2020-06-24,26,2,707,6,0,44,28
2020-06-24,39,19,1579,9,4,165,58
2020-06-25,91,49,2968,34,10,147,140
2020-06-25,0,0,106,0,0,5,0
2020-06-25,0,0,14,0,0,0,0
2020-06-25,4,1,667,1,1,1,5
2020-06-25,14,2,390,5,1,13,16
2020-06-25,76,1,237,16,0,6,77
2020-06-25,55,4,835,11,0,7,59
2020-06-25,0,2,110,0,2,1,2
2020-06-25,0,0,25,0,0,0,0
2020-06-25,123,14,1742,49,2,78,137
2020-06-25,60,38,1357,16,6,57,98
2020-06-25,0,0,47,0,0,0,0
2020-06-25,6,7,397,1,1,9,13
2020-06-25,7,4,871,4,2,54,11
2020-06-25,9,4,528,3,0,10,13
2020-06-25,1,0,51,1,0,1,1
2020-06-25,57,0,199,8,0,4,57
2020-06-25,0,0,42,0,0,4,0
2020-06-25,368,57,6148,154,14,294,425
2020-06-25,103,44,2022,23,3,74,147
2020-06-25,1,0,65,1,0,5,1
2020-06-25,1,0,235,1,0,11,1
2020-06-25,1,0,151,0,0,1,1
2020-06-25,0,0,51,0,0,1,0
2020-06-25,17,7,824,9,2,78,24
2020-06-25,42,18,1579,12,3,147,60
2020-06-25,6,0,448,2,0,5,6
2020-06-25,8,8,753,2,1,50,16
2020-06-25,25,4,707,7,1,45,29
2020-06-25,5,0,397,4,0,5,5
2020-06-25,1,1,50,1,0,9,2
2020-06-25,44,10,2647,13,4,104,54
2020-06-25,451,95,6976,166,23,383,546
2020-06-25,0,0,41,0,0,0,0
2020-06-25,101,36,1384,25,7,50,137
2020-06-25,7,1,477,4,0,35,8
2020-06-25,73,24,2491,20,4,93,97
2020-06-25,68,14,3438,26,0,186,82
2020-06-25,6,0,186,4,0,1,6
2020-06-25,55,4,717,24,2,50,59
2020-06-25,0,0,45,0,0,0,0
2020-06-25,0,0,25,0,0,1,0
2020-06-25,6,0,445,2,0,8,6
2020-06-25,3,1,121,3,1,3,4
2020-06-25,22,5,1089,10,1,49,27
2020-06-25,0,0,180,0,0,4,0
2020-06-25,0,0,40,0,0,2,0
2020-06-25,319,141,4010,105,23,86,460
2020-06-25,1,0,88,0,0,6,1
2020-06-25,338,98,4821,116,11,119,436
2020-06-25,1,2,352,1,2,1,3
2020-06-25,1698,539,23520,440,78,1234,2237
2020-06-25,13,1,242,6,0,1,14
2020-06-25,0,2,54,0,0,0,2
2020-06-25,93,21,1374,34,1,94,114
2020-06-25,0,0,30,0,0,0,0
2020-06-26,339,135,4028,98,19,103,474
2020-06-26,28,5,707,8,0,39,33
2020-06-26,1,5,124,1,1,4,6
2020-06-26,62,38,1355,18,6,57,100
2020-06-26,0,0,51,0,0,0,0
2020-06-26,349,97,4821,122,11,115,446
2020-06-26,7,1,471,2,0,36,8
2020-06-26,0,0,14,0,0,0,0
2020-06-26,0,0,65,0,0,3,0
2020-06-26,0,0,106,0,0,5,0
2020-06-26,5,1,445,1,0,15,6
2020-06-26,1,1,50,1,0,10,2
2020-06-26,17,2,824,10,0,81,19
2020-06-26,58,0,199,6,0,6,58
2020-06-26,0,1,47,0,0,0,1
2020-06-26,73,10,2510,19,2,78,83
2020-06-26,15,0,242,5,0,4,15
2020-06-26,92,41,2968,35,9,123,133
2020-06-26,54,14,2647,18,4,89,68
2020-06-26,0,0,30,0,0,0,0
2020-06-26,6,0,448,1,0,11,6
2020-06-26,0,0,180,0,0,6,0
2020-06-26,66,16,3438,26,0,188,82
2020-06-26,5,1,667,2,0,3,6
2020-06-26,0,1,41,0,0,0,1
2020-06-26,0,0,45,0,0,0,0
2020-06-26,1,0,51,1,0,2,1
2020-06-26,0,0,42,0,0,4,0
2020-06-26,362,65,6176,158,13,310,427
2020-06-26,467,93,6976,179,20,396,560
2020-06-26,13,8,390,5,0,13,21
2020-06-26,101,21,1369,35,2,84,122
2020-06-26,0,0,25,0,0,0,0
2020-06-26,0,1,54,0,0,0,1
2020-06-26,1,0,235,1,0,9,1
2020-06-26,0,0,40,0,0,1,0
2020-06-26,42,23,1579,10,2,132,65
2020-06-26,0,0,25,0,0,1,0
2020-06-26,71,3,237,15,0,10,74
2020-06-26,58,8,835,12,0,11,66
2020-06-26,8,5,753,3,0,33,13
2020-06-26,1,0,88,0,0,6,1
2020-06-26,2,3,352,0,0,2,5
2020-06-26,136,11,1742,46,2,73,147
2020-06-26,107,50,2018,24,4,73,157
2020-06-26,11,2,528,0,0,15,13
2020-06-26,20,1,1089,8,0,55,21
2020-06-26,6,0,186,4,0,3,6
2020-06-26,8,6,397,1,0,9,14
2020-06-26,0,1,110,0,1,1,1
2020-06-26,1,0,151,0,0,2,1
2020-06-26,8,4,871,4,1,50,12
2020-06-26,1717,579,23565,446,79,1289,2296
2020-06-26,53,6,717,20,1,74,59
2020-06-26,6,1,397,5,0,6,7
2020-06-26,116,36,1430,29,6,44,152
2020-06-27,77,18,3438,28,1,185,95
2020-06-27,0,1,54,0,0,0,1
2020-06-27,8,3,470,2,0,38,11
2020-06-27,0,0,25,0,0,2,0
2020-06-27,6,0,445,1,0,8,6
2020-06-27,1,0,51,0,0,0,1
2020-06-27,1,3,352,0,1,1,4
2020-06-27,5,0,667,1,0,3,5
2020-06-27,77,17,2438,20,8,79,94
2020-06-27,0,0,106,0,0,3,0
2020-06-27,353,79,4821,130,9,124,432
2020-06-27,56,16,2647,21,4,103,72
2020-06-27,15,0,242,6,0,3,15
2020-06-27,0,0,180,0,0,5,0
2020-06-27,126,28,1430,30,7,47,154
2020-06-27,23,4,1089,8,1,54,27
2020-06-27,0,0,40,0,0,2,0
2020-06-27,31,5,707,9,0,39,36
2020-06-27,65,41,1348,16,9,46,106
2020-06-27,19,2,824,11,0,84,21
2020-06-27,38,25,1579,10,3,130,63
2020-06-27,5,0,448,2,0,5,5
2020-06-27,60,5,717,21,1,70,65
2020-06-27,77,2,237,17,0,8,79
2020-06-27,340,145,3980,108,23,88,485
2020-06-27,0,3,110,0,2,0,3
2020-06-27,11,3,753,3,0,36,14
2020-06-27,0,0,45,0,0,0,0
2020-06-27,492,103,6976,170,22,401,595
2020-06-27,0,0,25,0,0,0,0
2020-06-27,0,0,65,0,0,5,0
2020-06-27,0,0,14,0,0,0,0
2020-06-27,54,1,199,6,0,5,55
2020-06-27,1,1,151,0,1,3,2
2020-06-27,12,10,528,0,0,15,22
2020-06-27,1,1,235,1,1,9,2
2020-06-27,111,53,2016,27,2,73,164
2020-06-27,1,0,50,1,0,9,1
2020-06-27,5,1,186,1,1,4,6
2020-06-27,9,6,397,1,0,4,15
2020-06-27,0,1,47,0,0,0,1
2020-06-27,0,0,41,0,0,0,0
2020-06-27,7,1,397,5,0,1,8
2020-06-27,1,3,126,1,1,7,4
2020-06-27,0,0,51,0,0,0,0
2020-06-27,10,3,871,5,3,49,13
2020-06-27,12,2,390,5,0,16,14
2020-06-27,0,0,30,0,0,0,0
2020-06-27,1,1,88,0,0,6,2
2020-06-27,54,7,835,10,0,13,61
2020-06-27,1710,606,23683,443,80,1244,2316
2020-06-27,98,31,1364,33,2,86,129
2020-06-27,142,34,1742,42,10,70,176
2020-06-27,99,40,2968,36,11,115,139
2020-06-27,0,0,42,0,0,3,0
2020-06-27,363,74,5950,154,14,320,437
2020-06-28,0,0,25,0,0,0,0
2020-06-28,367,115,3976,106,18,96,482
2020-06-28,1783,682,23562,469,97,1320,2465
2020-06-28,8,2,458,2,0,38,10
2020-06-28,102,39,2968,35,10,124,141
2020-06-28,1,1,50,1,0,10,2
2020-06-28,53,1,199,6,0,1,54
2020-06-28,7,0,445,1,0,17,7
2020-06-28,1,3,235,1,3,6,4
2020-06-28,27,5,1089,11,0,54,32
2020-06-28,485,110,6976,175,18,417,595
2020-06-28,13,5,753,4,0,33,18
2020-06-28,0,0,65,0,0,4,0
2020-06-28,0,0,41,0,0,0,0
2020-06-28,15,4,390,5,0,16,19
2020-06-28,2,0,110,2,0,1,2
2020-06-28,146,9,1742,53,1,75,155
2020-06-28,1,3,125,1,2,2,4
2020-06-28,3,1,186,1,1,1,4
2020-06-28,8,2,667,1,0,7,10
2020-06-28,66,32,1348,21,8,62,98
2020-06-28,9,10,397,0,0,7,19
2020-06-28,7,3,397,5,2,6,10
2020-06-28,0,0,88,0,0,6,0
2020-06-28,83,22,3438,32,1,187,105
2020-06-28,66,5,835,12,0,5,71
2020-06-28,9,7,528,0,1,15,16
2020-06-28,0,0,42,0,0,3,0
2020-06-28,118,48,2012,30,1,68,166
2020-06-28,0,0,30,0,0,0,0
2020-06-28,59,10,2647,22,3,103,69
2020-06-28,376,83,4821,135,12,124,459
2020-06-28,0,0,51,0,0,0,0
2020-06-28,108,28,1365,36,2,83,136
2020-06-28,11,1,871,6,1,48,12
2020-06-28,0,0,14,0,0,0,0
2020-06-28,0,0,180,0,0,5,0
2020-06-28,19,0,242,6,0,2,19
2020-06-28,0,0,106,0,0,2,0
2020-06-28,373,85,5865,160,18,314,458
2020-06-28,1,1,51,1,1,0,2
2020-06-28,32,18,1579,13,5,130,50
2020-06-28,0,0,25,0,0,3,0
2020-06-28,30,5,707,7,0,39,35
2020-06-28,0,0,45,0,0,0,0
2020-06-28,66,3,717,21,0,73,69
2020-06-28,1,3,352,0,1,1,4
2020-06-28,72,2,237,17,0,1,74
2020-06-28,5,0,448,2,0,4,5
2020-06-28,0,4,54,0,0,0,4
2020-06-28,87,19,2435,21,9,70,106
2020-06-28,129,31,1430,34,6,52,160
2020-06-28,0,1,47,0,0,0,1
2020-06-28,0,0,40,0,0,2,0
2020-06-28,1,0,151,0,0,1,1
2020-06-28,26,0,824,10,0,79,26
2020-06-29,510,114,6976,176,24,410,624
2020-06-29,87,18,3438,31,2,190,105
2020-06-29,0,0,88,0,0,6,0
2020-06-29,0,0,25,0,0,1,0
2020-06-29,39,5,707,8,0,42,44
2020-06-29,0,0,42,0,0,2,0
2020-06-29,1,0,151,0,0,0,1
2020-06-29,405,102,4001,109,21,111,507
2020-06-29,1,1,235,1,1,9,2
2020-06-29,6,1,448,2,1,9,7
2020-06-29,74,6,835,13,0,12,80
2020-06-29,2,0,110,2,0,1,2
2020-06-29,1889,622,23622,504,91,1239,2511
2020-06-29,9,6,528,0,0,16,15
2020-06-29,16,2,242,6,0,3,18
2020-06-29,25,4,390,8,1,8,29
2020-06-29,98,32,2430,28,6,80,130
2020-06-29,10,6,397,1,0,12,16
2020-06-29,1,0,51,1,0,1,1
2020-06-29,1,1,50,1,0,10,2
2020-06-29,62,8,717,19,2,79,70
2020-06-29,33,2,824,7,1,84,35
2020-06-29,74,37,1346,26,4,45,111
2020-06-29,0,0,65,0,0,4,0
2020-06-29,3,4,127,2,1,1,7
2020-06-29,116,54,2005,30,2,76,170
2020-06-29,0,0,47,0,0,0,0
2020-06-29,9,6,455,2,1,42,15
2020-06-29,70,2,237,16,0,5,72
2020-06-29,63,16,2647,22,4,120,79
2020-06-29,0,0,25,0,0,0,0
2020-06-29,113,29,1363,35,3,74,142
2020-06-29,3,1,186,1,0,1,4
2020-06-29,11,1,871,7,1,50,12
2020-06-29,1,0,51,1,0,0,1
2020-06-29,151,9,1742,53,2,74,160
2020-06-29,33,8,1089,15,1,55,41
2020-06-29,0,5,54,0,0,0,5
2020-06-29,55,1,199,6,0,2,56
2020-06-29,0,0,106,0,0,1,0
2020-06-29,0,0,14,0,0,0,0
2020-06-29,395,98,5848,156,26,324,493
2020-06-29,0,0,180,0,0,3,0
2020-06-29,0,3,352,0,1,2,3
2020-06-29,8,0,445,3,0,11,8
2020-06-29,0,0,30,0,0,0,0
2020-06-29,0,0,41,0,0,0,0
2020-06-29,111,35,2968,38,6,138,146
2020-06-29,0,0,45,0,0,0,0
2020-06-29,37,24,1579,14,5,142,61
2020-06-29,13,9,753,4,1,33,22
2020-06-29,7,3,397,6,2,0,10
2020-06-29,0,0,40,0,0,2,0
2020-06-29,9,3,667,1,0,7,12
2020-06-29,393,85,4821,138,10,140,478
2020-06-29,133,26,1430,35,3,53,159
2020-06-30,64,6,717,20,1,73,70
2020-06-30,1893,645,23639,526,102,1170,2538
2020-06-30,0,0,25,0,0,0,0
2020-06-30,72,2,237,18,0,3,74
2020-06-30,1,2,50,1,1,10,3
2020-06-30,0,0,30,0,0,0,0
2020-06-30,0,0,40,0,0,2,0
2020-06-30,1,0,151,0,0,1,1
2020-06-30,1,2,88,0,0,6,3
2020-06-30,68,12,2647,28,5,113,80
2020-06-30,3,1,235,1,1,3,4
2020-06-30,8,2,528,0,0,17,10
2020-06-30,11,4,871,7,1,50,15
2020-06-30,1,0,51,1,0,0,1
2020-06-30,9,3,456,3,1,42,12
2020-06-30,116,41,2968,43,6,143,157
2020-06-30,3,2,110,1,2,1,5
2020-06-30,0,0,65,0,0,6,0
2020-06-30,0,0,41,0,0,0,0
2020-06-30,5,0,445,3,0,8,5
2020-06-30,10,2,667,2,0,9,12
2020-06-30,0,0,42,0,0,3,0
2020-06-30,419,112,4001,117,21,105,531
2020-06-30,542,120,6976,192,20,386,662
2020-06-30,0,0,106,0,0,1,0
2020-06-30,106,21,2451,29,2,86,127
2020-06-30,0,0,180,0,0,4,0
2020-06-30,41,5,707,13,0,36,46
2020-06-30,163,12,1742,60,1,69,175
2020-06-30,0,0,45,0,0,0,0
2020-06-30,41,0,199,4,0,2,41
2020-06-30,406,85,4821,142,21,120,491
2020-06-30,4,3,121,2,0,4,7
2020-06-30,0,0,14,0,0,0,0
2020-06-30,36,5,824,7,0,89,41
2020-06-30,129,42,2016,33,4,74,171
2020-06-30,40,7,1089,18,1,49,47
2020-06-30,1,1,51,1,0,0,2
2020-06-30,13,11,753,4,1,35,24
2020-06-30,140,56,1430,37,8,42,196
2020-06-30,118,52,1363,35,4,78,170
2020-06-30,10,6,397,1,0,15,16
2020-06-30,73,6,835,14,0,11,79
2020-06-30,41,20,1579,17,6,140,61
2020-06-30,15,1,242,4,1,3,16
2020-06-30,6,0,448,2,0,9,6
2020-06-30,1,0,25,0,0,0,1
2020-06-30,7,2,397,7,1,1,9
2020-06-30,0,0,47,0,0,0,0
2020-06-30,391,62,6164,158,15,335,453
2020-06-30,4,1,186,1,1,0,5
2020-06-30,1,3,352,0,1,1,4
2020-06-30,0,0,54,0,0,0,0
2020-06-30,81,12,3438,33,1,177,93
2020-06-30,76,43,1346,22,12,43,119
2020-06-30,25,4,390,10,1,5,29
2020-07-01,109,27,2491,31,7,89,136
2020-07-01,79,2,237,19,0,6,81
2020-07-01,15,7,528,5,1,17,22
2020-07-01,30,2,390,12,0,5,32
2020-07-01,123,47,2968,43,12,141,170
2020-07-01,0,0,65,0,0,3,0
2020-07-01,431,116,4014,123,20,106,547
2020-07-01,13,20,753,4,1,28,33
2020-07-01,398,64,6183,159,16,319,462
2020-07-01,78,5,835,15,0,9,83
2020-07-01,50,21,1579,19,7,143,71
2020-07-01,128,35,1430,37,7,47,163
2020-07-01,17,9,242,4,2,5,26
2020-07-01,62,4,717,24,0,62,66
2020-07-01,10,0,397,1,0,21,10
2020-07-01,0,0,47,0,0,0,0
2020-07-01,428,88,4564,151,19,95,516
2020-07-01,2,0,50,2,0,8,2
2020-07-01,3,0,151,1,0,0,3
2020-07-01,7,1,397,7,1,41,8
2020-07-01,0,0,25,0,0,0,0
2020-07-01,1,3,352,1,1,2,4
2020-07-01,164,14,1742,58,0,70,178
2020-07-01,556,149,5725,193,34,346,705
2020-07-01,1,1,51,1,0,0,2
2020-07-01,0,0,180,0,0,4,0
2020-07-01,0,0,30,0,0,0,0
2020-07-01,1937,643,21731,537,95,1092,2580
2020-07-01,121,61,1372,38,6,82,182
2020-07-01,48,9,707,13,0,36,57
2020-07-01,1,0,51,0,0,0,1
2020-07-01,4,1,186,1,1,1,5
2020-07-01,125,24,2028,32,5,80,149
2020-07-01,40,1,199,6,1,3,41
2020-07-01,79,38,1328,24,8,47,117
2020-07-01,0,0,42,0,0,4,0
2020-07-01,0,0,106,0,0,4,0
2020-07-01,0,0,45,0,0,0,0
2020-07-01,82,18,3438,35,5,168,100
2020-07-01,45,10,1089,20,1,51,55
2020-07-01,71,14,2647,31,2,110,85
2020-07-01,41,2,824,10,0,81,43
2020-07-01,5,1,235,4,1,4,6
2020-07-01,0,0,14,0,0,0,0
2020-07-01,0,0,40,0,0,2,0
2020-07-01,0,2,41,0,0,0,2
2020-07-01,3,0,110,1,0,1,3
2020-07-01,7,1,667,2,0,6,8
2020-07-01,13,4,871,4,1,51,17
2020-07-01,1,0,25,0,0,1,1
2020-07-01,8,6,472,3,1,40,14
2020-07-01,4,2,122,2,0,4,6
2020-07-01,0,0,54,0,0,0,0
2020-07-01,7,2,428,1,2,3,9
2020-07-01,8,1,445,2,1,7,9
2020-07-01,0,2,88,0,0,6,2
2020-07-02,66,16,2647,30,1,102,82
2020-07-02,1,0,25,0,0,0,1
2020-07-02,17,22,753,4,0,24,39
2020-07-02,3,2,235,1,2,7,5
2020-07-02,0,0,106,0,0,1,0
2020-07-02,1,0,25,0,0,1,1
2020-07-02,0,0,30,0,0,0,0
2020-07-02,0,0,54,0,0,0,0
2020-07-02,4,0,151,1,0,1,4
2020-07-02,151,42,1430,37,6,54,193
2020-07-02,36,1,824,9,1,84,37
2020-07-02,10,3,397,3,0,28,13
2020-07-02,128,21,2492,34,6,82,149
2020-07-02,86,3,237,17,1,6,89
2020-07-02,38,1,199,7,1,1,39
2020-07-02,0,0,40,0,0,2,0
2020-07-02,17,1,528,2,0,21,18
2020-07-02,133,76,1372,35,13,83,209
2020-07-02,1,0,51,1,0,0,1
2020-07-02,438,91,4793,156,13,85,529
2020-07-02,64,6,717,24,1,61,70
2020-07-02,584,132,6694,187,21,326,716
2020-07-02,7,1,667,2,0,8,8
2020-07-02,0,0,14,0,0,0,0
2020-07-02,5,1,114,3,0,4,6
2020-07-02,80,42,1363,28,12,54,122
2020-07-02,1933,679,23057,546,86,1153,2612
2020-07-02,39,9,707,13,1,38,48
2020-07-02,7,2,397,3,0,43,9
2020-07-02,173,33,1742,56,1,67,206
2020-07-02,465,111,4014,120,17,92,576
2020-07-02,1,0,352,1,0,2,1
2020-07-02,56,20,1579,19,5,140,76
2020-07-02,9,3,428,4,2,3,12
2020-07-02,8,3,445,2,1,16,11
2020-07-02,0,0,42,0,0,3,0
2020-07-02,0,0,65,0,0,0,0
2020-07-02,27,3,390,8,0,12,30
2020-07-02,3,1,110,1,0,1,4
2020-07-02,380,79,6182,146,13,337,459
2020-07-02,0,0,180,0,0,2,0
2020-07-02,19,4,242,4,1,2,23
2020-07-02,6,3,186,0,0,4,9
2020-07-02,128,17,2029,34,1,68,145
2020-07-02,91,16,3438,33,2,172,107
2020-07-02,0,3,50,0,2,9,3
2020-07-02,1,0,51,0,0,1,1
2020-07-02,77,2,835,12,0,23,79
2020-07-02,12,3,871,3,1,50,15
2020-07-02,0,0,45,0,0,0,0
2020-07-02,0,0,41,0,0,0,0
2020-07-02,141,52,2968,45,10,129,193
2020-07-02,8,7,475,4,0,40,15
2020-07-02,0,2,88,0,0,6,2
2020-07-02,0,1,47,0,0,0,1
2020-07-02,52,4,1089,15,0,49,56
2020-07-03,133,21,2092,37,0,77,154
2020-07-03,11,6,397,3,0,26,17
2020-07-03,7,2,186,1,1,1,9
2020-07-03,1,0,151,1,0,0,1
2020-07-03,20,6,242,4,1,3,26
2020-07-03,10,9,528,5,1,8,19
2020-07-03,83,2,298,18,0,17,85
2020-07-03,6,2,397,4,0,43,8
2020-07-03,28,3,392,8,0,11,31
2020-07-03,8,1,667,2,0,7,9
2020-07-03,71,4,763,21,1,68,75
2020-07-03,0,0,180,0,0,1,0
2020-07-03,0,0,65,0,0,2,0
2020-07-03,472,99,4103,121,11,107,571
2020-07-03,8,3,476,4,0,39,11
2020-07-03,85,38,1549,26,5,56,123
2020-07-03,1,0,25,0,0,0,1
2020-07-03,56,4,1119,17,0,57,60
2020-07-03,7,2,428,4,0,6,9
2020-07-03,0,0,30,0,0,0,0
2020-07-03,75,3,835,12,0,25,78
2020-07-03,0,0,45,0,0,0,0
2020-07-03,1,0,65,0,0,0,1
2020-07-03,84,16,3438,36,2,171,100
2020-07-03,0,0,40,0,0,2,0
2020-07-03,165,41,1430,40,4,45,206
2020-07-03,1,0,51,1,0,1,1
2020-07-03,189,14,1832,67,0,80,203
2020-07-03,1,0,51,0,0,0,1
2020-07-03,1,0,352,1,0,2,1
2020-07-03,3,0,110,1,0,2,3
2020-07-03,129,15,2486,34,5,80,144
2020-07-03,0,0,50,0,0,12,0
2020-07-03,35,1,845,8,0,85,36
2020-07-03,38,9,707,14,1,35,47
2020-07-03,4,1,96,2,1,7,5
2020-07-03,39,1,199,7,1,0,40
2020-07-03,367,68,6316,148,9,318,435
2020-07-03,0,1,47,0,0,0,1
2020-07-03,15,3,862,3,1,48,18
2020-07-03,0,0,54,0,0,0,0
2020-07-03,451,88,4834,155,14,87,539
2020-07-03,9,1,445,3,0,17,10
2020-07-03,137,73,1367,34,8,78,210
2020-07-03,1947,696,23965,549,101,1189,2643
2020-07-03,0,0,14,0,0,0,0
2020-07-03,19,26,753,3,0,29,45
2020-07-03,70,15,2647,27,2,107,85
2020-07-03,0,0,41,0,0,0,0
2020-07-03,0,0,88,0,0,6,0
2020-07-03,0,0,42,0,0,4,0
2020-07-03,0,0,106,0,0,1,0
2020-07-03,594,150,7401,193,24,320,744
2020-07-03,54,21,1579,20,3,141,75
2020-07-03,3,1,235,2,1,8,4
2020-07-03,157,51,2968,46,9,126,208
2020-07-04,1,0,65,0,0,0,1
2020-07-04,0,0,65,0,0,3,0
2020-07-04,1,0,51,0,0,0,1
2020-07-04,0,0,14,0,0,0,0
2020-07-04,23,1,242,3,0,4,24
2020-07-04,87,4,298,19,0,16,91
2020-07-04,82,22,1549,30,5,50,104
2020-07-04,59,22,1562,25,4,135,81
2020-07-04,0,0,88,0,0,6,0
2020-07-04,15,12,528,2,0,21,27
2020-07-04,0,1,180,0,0,2,1
2020-07-04,9,0,186,2,0,1,9
2020-07-04,0,1,50,0,0,11,1
2020-07-04,461,96,4834,158,16,117,557
2020-07-04,69,7,763,21,3,73,76
2020-07-04,83,18,3438,36,2,186,101
2020-07-04,1,0,352,1,0,2,1
2020-07-04,1,0,151,0,0,6,1
2020-07-04,0,0,30,0,0,0,0
2020-07-04,46,2,199,6,2,2,48
2020-07-04,146,44,2968,44,8,137,190
2020-07-04,624,148,7401,197,18,403,772
2020-07-04,204,16,1832,67,0,80,220
2020-07-04,3,1,110,0,1,2,4
2020-07-04,0,0,54,0,0,0,0
2020-07-04,0,0,45,0,0,0,0
2020-07-04,8,0,408,5,0,4,8
2020-07-04,0,0,106,0,0,0,0
2020-07-04,147,75,1367,40,4,85,222
2020-07-04,2,2,235,2,2,7,4
2020-07-04,78,2,835,11,0,17,80
2020-07-04,38,1,845,8,0,88,39
2020-07-04,485,115,4070,123,17,120,600
2020-07-04,5,2,93,1,1,3,7
2020-07-04,0,0,41,0,0,0,0
2020-07-04,139,23,2094,38,0,78,162
2020-07-04,0,0,40,0,0,2,0
2020-07-04,38,7,707,11,0,44,45
2020-07-04,1,0,25,0,0,0,1
2020-07-04,155,39,1430,46,5,50,194
2020-07-04,1,0,51,1,0,0,1
2020-07-04,19,27,753,3,1,37,46
2020-07-04,10,5,397,2,0,25,15
2020-07-04,1921,653,23943,540,84,1336,2574
2020-07-04,18,8,862,5,1,51,26
2020-07-04,8,1,667,3,0,7,9
2020-07-04,10,2,445,5,1,13,12
2020-07-04,68,14,2647,26,1,102,82
2020-07-04,0,0,42,0,0,4,0
2020-07-04,6,1,397,4,0,0,7
2020-07-04,46,4,1057,16,0,63,50
2020-07-04,0,1,47,0,0,0,1
2020-07-04,8,4,476,4,1,38,12
2020-07-04,372,73,6267,156,11,344,445
2020-07-04,29,1,392,8,0,9,30
2020-07-04,142,25,2465,42,8,87,167
2020-07-05,0,2,50,0,1,10,2
2020-07-05,146,37,2968,48,10,134,183
2020-07-05,7,1,186,1,1,0,8
2020-07-05,2,0,235,2,0,7,2
2020-07-05,45,8,1050,15,0,67,53
2020-07-05,0,0,14,0,0,0,0
2020-07-05,0,0,41,0,0,0,0
2020-07-05,3,1,110,0,0,2,4
2020-07-05,84,26,3438,33,2,198,110
2020-07-05,0,0,30,0,0,0,0
2020-07-05,45,2,199,7,1,5,47
2020-07-05,49,39,1579,21,7,150,88
2020-07-05,0,0,151,0,0,2,0
2020-07-05,0,0,54,0,0,0,0
2020-07-05,22,19,753,4,4,35,41
2020-07-05,0,1,65,0,0,5,1
2020-07-05,0,0,45,0,0,0,0
2020-07-05,10,9,397,2,0,30,19
2020-07-05,67,6,763,18,3,72,73
2020-07-05,210,12,1832,64,0,74,222
2020-07-05,1,0,51,1,0,0,1
2020-07-05,148,21,2428,41,5,89,169
2020-07-05,1,0,65,0,0,0,1
2020-07-05,39,8,707,11,1,40,47
2020-07-05,38,2,845,6,0,91,40
2020-07-05,498,116,4065,130,18,130,614
2020-07-05,484,81,4834,164,11,112,565
2020-07-05,4,5,89,1,1,3,9
2020-07-05,0,1,47,0,0,0,1
2020-07-05,14,2,445,6,1,6,16
2020-07-05,6,1,667,3,0,5,7
2020-07-05,0,0,25,0,0,0,0
2020-07-05,77,26,1549,26,7,39,103
2020-07-05,24,0,242,4,0,3,24
2020-07-05,0,0,88,0,0,6,0
2020-07-05,32,8,392,9,2,7,40
2020-07-05,158,30,1430,39,2,45,188
2020-07-05,20,10,862,6,3,52,30
2020-07-05,1,1,352,1,0,2,2
2020-07-05,6,1,397,4,0,5,7
2020-07-05,154,59,1367,46,4,88,213
2020-07-05,17,4,528,3,1,18,21
2020-07-05,634,158,7401,203,23,418,792
2020-07-05,1969,676,23936,527,102,1295,2645
2020-07-05,374,67,6250,158,16,350,441
2020-07-05,89,4,298,20,0,15,93
2020-07-05,0,0,180,0,0,2,0
2020-07-05,140,23,2090,39,1,81,163
2020-07-05,78,2,835,9,0,17,80
2020-07-05,10,7,451,3,2,41,17
2020-07-05,0,0,106,0,0,1,0
2020-07-05,0,1,42,0,1,3,1
2020-07-05,0,0,40,0,0,2,0
2020-07-05,10,0,408,6,0,1,10
2020-07-05,73,11,2647,25,1,122,84
2020-07-05,1,0,51,0,0,2,1
2020-07-06,3,3,110,0,1,2,6
2020-07-06,168,74,1430,43,4,46,242
2020-07-06,1,0,151,0,0,3,1
2020-07-06,520,138,4110,130,16,124,658
2020-07-06,68,12,2647,27,1,120,80
2020-07-06,0,0,88,0,0,6,0
2020-07-06,72,8,763,21,2,68,80
2020-07-06,2004,666,23927,529,103,1334,2670
2020-07-06,22,11,862,8,5,48,33
2020-07-06,659,180,7416,224,26,406,839
2020-07-06,26,6,528,4,0,22,32
2020-07-06,11,2,453,3,2,40,13
2020-07-06,0,0,25,0,0,0,0
2020-07-06,1,0,51,0,0,2,1
2020-07-06,0,1,42,0,1,3,1
2020-07-06,0,0,106,0,0,1,0
2020-07-06,57,27,1579,22,8,143,84
2020-07-06,0,1,45,0,0,0,1
2020-07-06,88,16,3438,33,2,195,104
2020-07-06,9,0,186,2,0,0,9
2020-07-06,211,12,1832,60,1,85,223
2020-07-06,0,0,14,0,0,0,0
2020-07-06,26,15,753,5,5,30,41
2020-07-06,0,0,180,0,0,6,0
2020-07-06,3,3,114,1,0,6,6
2020-07-06,0,0,40,0,0,2,0
2020-07-06,20,1,445,7,1,14,21
2020-07-06,89,2,298,20,0,18,91
2020-07-06,48,7,1052,13,2,72,55
2020-07-06,0,0,65,0,0,4,0
2020-07-06,142,45,2968,50,10,132,187
2020-07-06,5,1,671,3,0,9,6
2020-07-06,11,2,397,2,0,29,13
2020-07-06,22,2,242,5,1,4,24
2020-07-06,148,14,2094,31,1,89,162
2020-07-06,157,15,2589,41,5,87,172
2020-07-06,38,5,707,15,1,35,43
2020-07-06,2,0,235,2,0,5,2
2020-07-06,35,2,845,9,0,84,37
2020-07-06,92,28,1549,30,8,47,120
2020-07-06,34,5,392,7,1,9,39
2020-07-06,12,1,466,7,1,1,13
2020-07-06,0,3,50,0,2,8,3
2020-07-06,0,0,30,0,0,0,0
2020-07-06,81,5,835,11,2,8,86
2020-07-06,1,0,51,1,0,2,1
2020-07-06,160,46,1372,41,5,99,206
2020-07-06,1,2,352,1,0,4,3
2020-07-06,7,0,397,6,0,5,7
2020-07-06,0,1,47,0,0,0,1
2020-07-06,0,0,54,0,0,0,0
2020-07-06,501,73,4834,160,10,129,574
2020-07-06,384,72,6614,159,16,339,456
2020-07-06,0,0,41,0,0,0,0
2020-07-06,1,0,65,0,0,0,1
2020-07-06,49,3,199,7,1,0,52
2020-07-07,0,0,54,0,0,0,0
2020-07-07,0,0,106,0,0,2,0
2020-07-07,2037,792,23880,522,108,1368,2829
2020-07-07,2,1,235,2,1,9,3
2020-07-07,1,0,110,0,0,2,1
2020-07-07,145,45,2968,51,13,133,190
2020-07-07,0,0,41,0,0,0,0
2020-07-07,168,41,1430,40,8,52,209
2020-07-07,164,13,2090,38,0,71,177
2020-07-07,0,0,180,0,0,3,0
2020-07-07,0,0,14,0,0,0,0
2020-07-07,679,138,7416,234,17,401,817
2020-07-07,1,0,51,0,0,2,1
2020-07-07,93,0,298,20,0,16,93
2020-07-07,0,0,30,0,0,0,0
2020-07-07,14,5,457,3,0,41,19
2020-07-07,0,1,45,0,0,0,1
2020-07-07,2,0,151,0,0,5,2
2020-07-07,166,49,1372,45,6,89,215
2020-07-07,27,28,753,5,0,27,55
2020-07-07,155,18,2875,46,3,79,173
2020-07-07,80,9,763,23,2,66,89
2020-07-07,37,2,845,10,0,90,39
2020-07-07,55,31,1579,19,7,142,86
2020-07-07,72,16,2647,25,1,107,88
2020-07-07,36,8,707,15,2,39,44
2020-07-07,1,1,82,1,0,6,2
2020-07-07,0,0,40,0,0,2,0
2020-07-07,0,1,88,0,0,6,1
2020-07-07,203,20,1832,56,2,86,223
2020-07-07,87,29,1549,33,5,48,116
2020-07-07,508,143,4110,122,14,124,651
2020-07-07,1,0,25,0,0,0,1
2020-07-07,24,9,862,9,2,43,33
2020-07-07,1,2,352,0,0,3,3
2020-07-07,52,2,199,7,0,7,54
2020-07-07,0,0,65,0,0,0,0
2020-07-07,2,3,671,1,2,8,5
2020-07-07,406,73,6649,154,12,311,479
2020-07-07,21,1,445,6,0,17,22
2020-07-07,36,8,392,8,0,16,44
2020-07-07,0,1,47,0,0,0,1
2020-07-07,511,68,4832,166,9,160,579
2020-07-07,0,0,50,0,0,9,0
2020-07-07,8,0,186,3,0,0,8
2020-07-07,7,1,397,7,0,1,8
2020-07-07,53,7,1052,11,2,66,60
2020-07-07,13,3,397,3,0,26,16
2020-07-07,1,1,51,1,0,3,2
2020-07-07,98,16,3438,42,2,172,114
2020-07-07,0,0,65,0,0,6,0
2020-07-07,21,2,242,4,1,4,23
2020-07-07,20,8,340,5,1,17,28
2020-07-07,78,7,835,10,1,17,85
2020-07-07,14,1,466,6,1,3,15
2020-07-07,0,1,42,0,1,3,1
2020-07-08,0,0,50,0,0,9,0
2020-07-08,0,0,45,0,0,0,0
2020-07-08,75,11,763,23,1,52,86
2020-07-08,691,124,7416,236,17,373,815
2020-07-08,0,0,54,0,0,0,0
2020-07-08,0,0,14,0,0,0,0
2020-07-08,73,15,2647,25,3,110,88
2020-07-08,24,11,862,6,1,50,35
2020-07-08,0,0,106,0,0,4,0
2020-07-08,14,4,460,3,0,39,18
2020-07-08,13,1,492,7,0,5,14
2020-07-08,215,12,1832,58,0,81,227
2020-07-08,33,10,392,8,1,15,43
2020-07-08,0,0,40,0,0,2,0
2020-07-08,0,1,65,0,0,0,1
2020-07-08,84,1,298,18,0,4,85
2020-07-08,28,28,753,6,1,26,56
2020-07-08,140,48,2968,55,8,127,188
2020-07-08,0,0,41,0,0,0,0
2020-07-08,1,0,51,1,0,3,1
2020-07-08,3,0,235,3,0,6,3
2020-07-08,1,2,110,0,1,0,3
2020-07-08,152,25,2913,43,3,79,177
2020-07-08,0,1,42,0,1,2,1
2020-07-08,11,0,186,6,0,4,11
2020-07-08,85,26,1549,32,5,44,111
2020-07-08,0,0,180,0,0,3,0
2020-07-08,2,1,151,0,0,4,3
2020-07-08,13,5,397,3,0,30,18
2020-07-08,0,0,51,0,0,1,0
2020-07-08,6,1,671,3,0,10,7
2020-07-08,0,0,30,0,0,0,0
2020-07-08,170,45,1372,50,5,81,215
2020-07-08,172,34,2098,40,3,74,206
2020-07-08,51,9,1050,14,1,64,60
2020-07-08,78,2,835,9,1,22,80
2020-07-08,19,3,242,3,0,2,22
2020-07-08,0,0,352,0,0,6,0
2020-07-08,2,0,25,0,0,0,2
2020-07-08,0,0,65,0,0,6,0
2020-07-08,505,94,4838,148,5,162,599
2020-07-08,186,58,1430,45,9,49,244
2020-07-08,43,1,845,9,0,89,44
2020-07-08,0,1,88,0,0,6,1
2020-07-08,107,18,3438,48,3,192,125
2020-07-08,27,6,340,5,0,20,33
2020-07-08,0,1,47,0,0,0,1
2020-07-08,68,39,1579,20,7,136,107
2020-07-08,1,1,101,1,0,6,2
2020-07-08,20,0,445,5,0,16,20
2020-07-08,407,76,6682,157,14,305,483
2020-07-08,37,8,707,10,4,42,45
2020-07-08,515,149,4104,117,10,121,664
2020-07-08,1995,822,23875,524,101,1311,2817
2020-07-08,8,0,397,5,0,2,8
2020-07-08,51,1,199,6,0,0,52
2020-07-09,0,0,41,0,0,0,0
2020-07-09,672,128,7401,227,24,402,800
2020-07-09,77,0,298,16,0,9,77
2020-07-09,39,8,707,11,3,45,47
2020-07-09,133,52,2968,53,13,128,185
2020-07-09,9,0,387,5,0,2,9
2020-07-09,0,0,54,0,0,0,0
2020-07-09,56,1,199,6,0,2,57
2020-07-09,217,10,1822,61,1,83,227
2020-07-09,0,0,14,0,0,0,0
2020-07-09,16,0,492,10,0,5,16
2020-07-09,32,6,392,9,0,20,38
2020-07-09,81,22,1549,30,6,48,103
2020-07-09,5,1,671,3,0,10,6
2020-07-09,522,78,4838,160,6,165,600
2020-07-09,0,0,51,0,0,2,0
2020-07-09,1,0,51,1,0,0,1
2020-07-09,15,0,186,5,0,1,15
2020-07-09,23,7,340,4,0,18,30
2020-07-09,0,0,50,0,0,9,0
2020-07-09,13,3,397,3,0,18,16
2020-07-09,0,0,151,0,0,4,0
2020-07-09,112,23,3438,45,4,193,135
2020-07-09,72,2,835,9,1,31,74
2020-07-09,2032,817,23906,548,107,1368,2849
2020-07-09,189,55,1430,49,6,41,244
2020-07-09,25,5,862,4,0,53,30
2020-07-09,0,0,88,0,0,6,0
2020-07-09,76,18,2647,28,1,109,94
2020-07-09,47,11,1053,14,1,65,58
2020-07-09,73,9,763,25,2,53,82
2020-07-09,77,35,1579,24,4,140,112
2020-07-09,27,21,753,4,3,27,48
2020-07-09,0,0,47,0,0,0,0
2020-07-09,0,1,65,0,0,0,1
2020-07-09,46,1,845,9,0,93,47
2020-07-09,167,61,1372,52,4,74,228
2020-07-09,179,50,2216,38,4,74,229
2020-07-09,0,0,180,0,0,4,0
2020-07-09,22,11,242,4,0,4,33
2020-07-09,0,0,106,0,0,4,0
2020-07-09,0,1,352,0,0,16,1
2020-07-09,404,85,6675,151,16,309,489
2020-07-09,0,1,42,0,1,2,1
2020-07-09,16,1,445,3,0,8,17
2020-07-09,0,0,65,0,0,5,0
2020-07-09,0,0,45,0,0,0,0
2020-07-09,0,0,33,0,0,0,0
2020-07-09,0,0,40,0,0,2,0
2020-07-09,10,5,461,3,2,35,15
2020-07-09,150,31,2927,45,3,87,181
2020-07-09,3,0,25,1,0,1,3
2020-07-09,1,1,110,0,1,0,2
2020-07-09,3,0,235,0,0,9,3
2020-07-09,1,2,91,1,0,3,3
2020-07-09,528,162,4104,116,15,129,690
2020-07-10,57,1,199,6,0,2,58
2020-07-10,13,4,397,3,0,18,17
2020-07-10,0,0,42,0,0,2,0
2020-07-10,74,0,298,16,0,9,74
2020-07-10,20,0,445,4,0,8,20
2020-07-10,0,0,51,0,0,2,0
2020-07-10,0,0,14,0,0,0,0
2020-07-10,2,1,110,0,1,1,3
2020-07-10,1,1,51,1,0,1,2
2020-07-10,0,0,45,0,0,0,0
2020-07-10,186,49,2222,39,7,71,235
2020-07-10,0,0,41,0,0,0,0
2020-07-10,30,8,242,5,1,4,38
2020-07-10,4,0,25,1,0,2,4
2020-07-10,2,0,180,0,0,7,2
2020-07-10,79,26,1549,28,4,52,105
2020-07-10,12,5,468,4,0,40,17
2020-07-10,0,0,33,0,0,0,0
2020-07-10,671,114,7401,231,23,390,785
2020-07-10,157,19,2908,51,5,93,176
2020-07-10,2093,684,23901,547,84,1327,2777
2020-07-10,2,0,151,0,0,4,2
2020-07-10,0,0,54,0,0,0,0
2020-07-10,30,6,392,9,1,20,36
2020-07-10,0,0,40,0,0,2,0
2020-07-10,31,18,753,5,3,25,49
2020-07-10,7,0,387,5,0,2,7
2020-07-10,72,9,763,25,1,73,81
2020-07-10,0,0,50,0,0,10,0
2020-07-10,117,25,3438,46,4,181,142
2020-07-10,29,12,340,8,3,14,41
2020-07-10,172,59,1393,46,6,87,231
2020-07-10,0,1,65,0,0,0,1
2020-07-10,69,2,835,9,0,33,71
2020-07-10,16,0,492,10,0,1,16
2020-07-10,28,8,862,5,2,53,36
2020-07-10,83,24,1579,24,5,136,107
2020-07-10,532,149,4123,116,14,146,681
2020-07-10,12,3,186,3,3,4,15
2020-07-10,0,0,47,0,0,0,0
2020-07-10,234,16,1822,64,0,112,250
2020-07-10,0,0,88,0,0,6,0
2020-07-10,0,0,106,0,0,3,0
2020-07-10,1,1,93,1,0,6,2
2020-07-10,48,14,1056,14,4,56,62
2020-07-10,41,5,707,10,1,38,46
2020-07-10,194,50,1430,53,9,36,244
2020-07-10,5,1,671,3,0,18,6
2020-07-10,411,79,6687,159,14,313,490
2020-07-10,558,84,4838,157,10,197,642
2020-07-10,1,1,65,0,0,6,2
2020-07-10,2,0,235,2,0,7,2
2020-07-10,76,21,2647,33,1,104,97
2020-07-10,48,0,845,10,0,95,48
2020-07-10,0,1,352,0,0,5,1
2020-07-10,137,46,2968,53,9,122,183
2020-07-11,0,0,51,0,0,3,0
2020-07-11,675,111,7401,233,18,378,786
2020-07-11,3,0,25,0,0,2,3
2020-07-11,3,1,110,0,1,1,4
2020-07-11,1,0,151,1,0,1,1
2020-07-11,65,0,199,6,0,2,65
2020-07-11,0,0,42,0,0,2,0
2020-07-11,511,136,4068,123,10,148,647
2020-07-11,188,44,1430,53,8,33,232
2020-07-11,172,46,1393,45,4,75,218
2020-07-11,83,17,1549,29,5,48,100
2020-07-11,3,2,671,1,2,4,5
2020-07-11,0,0,54,0,0,0,0
2020-07-11,0,0,14,0,0,0,0
2020-07-11,27,7,242,4,1,3,34
2020-07-11,0,0,50,0,0,9,0
2020-07-11,0,0,40,0,0,2,0
2020-07-11,25,11,340,4,2,14,36
2020-07-11,76,5,763,25,0,56,81
2020-07-11,76,0,298,17,0,10,76
2020-07-11,0,2,88,0,0,6,2
2020-07-11,11,0,186,6,0,0,11
2020-07-11,8,0,387,4,0,4,8
2020-07-11,2,0,180,0,0,7,2
2020-07-11,0,0,51,0,0,0,0
2020-07-11,79,18,2647,34,1,112,97
2020-07-11,74,3,835,9,1,23,77
2020-07-11,385,81,6441,141,17,300,466
2020-07-11,2,0,100,1,0,6,2
2020-07-11,0,3,65,0,0,0,3
2020-07-11,9,2,463,4,0,40,11
2020-07-11,2056,713,23980,566,84,1352,2769
2020-07-11,0,0,41,0,0,0,0
2020-07-11,1,0,106,1,0,0,1
2020-07-11,42,0,845,10,0,94,42
2020-07-11,249,24,1822,59,1,82,273
2020-07-11,2,0,235,2,0,9,2
2020-07-11,21,0,445,4,0,14,21
2020-07-11,0,0,33,0,0,0,0
2020-07-11,50,9,1054,15,2,54,59
2020-07-11,1,0,65,0,0,6,1
2020-07-11,0,1,352,0,0,5,1
2020-07-11,35,26,776,6,4,27,61
2020-07-11,121,20,3432,48,5,173,141
2020-07-11,564,88,4838,165,11,145,652
2020-07-11,15,1,492,9,1,0,16
2020-07-11,0,0,45,0,0,0,0
2020-07-11,25,8,862,4,1,55,33
2020-07-11,197,42,2223,38,4,78,239
2020-07-11,13,4,397,3,0,18,17
2020-07-11,41,11,707,11,2,38,52
2020-07-11,31,4,392,9,1,21,35
2020-07-11,79,24,1579,21,5,124,103
2020-07-11,144,44,2968,48,12,121,188
2020-07-11,0,1,47,0,0,0,1
2020-07-11,157,23,2874,47,11,82,180
2020-07-12,0,0,41,0,0,0,0
2020-07-12,513,122,4062,139,9,186,635
2020-07-12,76,8,763,22,1,57,84
2020-07-12,43,8,707,10,0,37,51
2020-07-12,11,0,186,4,0,2,11
2020-07-12,79,26,1579,22,5,125,105
2020-07-12,188,42,1397,40,4,69,230
2020-07-12,0,0,33,0,0,0,0
2020-07-12,203,38,2208,38,4,65,241
2020-07-12,16,1,492,8,1,2,17
2020-07-12,202,35,1430,53,8,38,237
2020-07-12,674,84,7401,235,10,443,758
2020-07-12,0,0,40,0,0,2,0
2020-07-12,43,0,845,10,0,93,43
2020-07-12,0,0,51,0,0,3,0
2020-07-12,25,9,862,5,2,50,34
2020-07-12,238,17,1822,57,0,86,255
2020-07-12,3,0,235,3,0,5,3
2020-07-12,0,0,45,0,0,0,0
2020-07-12,587,82,4838,166,12,177,669
2020-07-12,92,17,1549,31,5,45,109
2020-07-12,0,0,14,0,0,0,0
2020-07-12,73,0,298,17,0,9,73
2020-07-12,150,37,2968,50,9,139,187
2020-07-12,9,4,459,4,0,42,13
2020-07-12,0,0,54,0,0,0,0
2020-07-12,0,2,65,0,0,0,2
2020-07-12,8,0,387,5,0,0,8
2020-07-12,1,0,96,0,0,5,1
2020-07-12,34,4,242,4,1,3,38
2020-07-12,3,1,110,0,1,0,4
2020-07-12,0,4,88,0,0,6,4
2020-07-12,51,14,1057,13,4,55,65
2020-07-12,0,2,50,0,0,10,2
2020-07-12,29,1,392,9,1,23,30
2020-07-12,0,0,51,0,0,4,0
2020-07-12,64,0,199,6,0,2,64
2020-07-12,2,0,180,0,0,7,2
2020-07-12,27,8,340,3,0,27,35
2020-07-12,86,3,835,10,1,13,89
2020-07-12,2,0,25,0,0,3,2
2020-07-12,2103,670,23868,565,78,1502,2773
2020-07-12,0,0,42,0,0,2,0
2020-07-12,2,0,151,0,0,5,2
2020-07-12,38,25,776,6,5,20,63
2020-07-12,0,1,47,0,0,0,1
2020-07-12,1,1,106,0,1,1,2
2020-07-12,2,0,65,0,0,6,2
2020-07-12,129,20,3432,49,4,189,149
2020-07-12,0,2,352,0,0,5,2
2020-07-12,389,78,6398,148,11,370,467
2020-07-12,80,14,2647,34,2,122,94
2020-07-12,175,25,2860,58,9,87,200
2020-07-12,12,5,397,2,0,23,17
2020-07-12,19,0,445,5,0,10,19
2020-07-12,3,0,671,2,0,3,3
2020-07-13,212,40,2218,46,4,59,252
2020-07-13,712,83,7401,237,14,425,795
2020-07-13,240,13,1822,62,0,71,253
2020-07-13,2193,612,23866,576,92,1367,2805
2020-07-13,0,0,45,0,0,0,0
2020-07-13,89,20,2647,32,1,126,109
2020-07-13,81,7,763,27,1,60,88
2020-07-13,1,0,51,1,0,3,1
2020-07-13,12,0,186,7,0,3,12
2020-07-13,48,7,707,12,1,37,55
2020-07-13,0,1,41,0,0,0,1
2020-07-13,0,0,180,0,0,11,0
2020-07-13,182,58,1388,41,1,74,240
2020-07-13,0,0,47,0,0,0,0
2020-07-13,0,0,40,0,0,1,0
2020-07-13,0,3,50,0,2,10,3
2020-07-13,0,0,54,0,0,0,0
2020-07-13,40,27,766,8,3,25,67
2020-07-13,176,25,2863,61,7,66,201
2020-07-13,2,1,106,0,0,5,3
2020-07-13,9,2,387,6,1,4,11
2020-07-13,62,0,199,6,0,0,62
2020-07-13,139,27,3433,48,3,190,166
2020-07-13,29,0,392,8,0,27,29
2020-07-13,31,7,340,3,0,11,38
2020-07-13,538,124,4092,136,13,177,662
2020-07-13,0,0,14,0,0,0,0
2020-07-13,152,48,2968,52,9,144,200
2020-07-13,0,0,33,0,0,0,0
2020-07-13,10,4,459,4,0,44,14
2020-07-13,0,1,51,0,0,0,1
2020-07-13,2,0,25,0,0,3,2
2020-07-13,56,26,1057,11,5,59,82
2020-07-13,99,25,1549,31,5,54,124
2020-07-13,16,4,397,2,0,37,20
2020-07-13,0,1,65,0,0,0,1
2020-07-13,3,1,671,2,0,4,4
2020-07-13,0,1,352,0,0,6,1
2020-07-13,383,75,6392,147,16,360,458
2020-07-13,89,3,835,9,0,13,92
2020-07-13,616,64,4838,174,5,168,680
2020-07-13,19,0,445,4,0,12,19
2020-07-13,205,42,1430,52,4,39,247
2020-07-13,49,2,845,10,0,93,51
2020-07-13,0,0,42,0,0,4,0
2020-07-13,2,0,235,2,0,8,2
2020-07-13,2,0,65,0,0,8,2
2020-07-13,33,1,242,4,1,3,34
2020-07-13,81,0,298,22,0,7,81
2020-07-13,1,0,151,0,0,4,1
2020-07-13,27,11,858,7,3,40,38
2020-07-13,1,0,106,1,0,1,1
2020-07-13,4,2,110,1,1,1,6
2020-07-13,15,2,492,9,0,4,17
2020-07-13,0,4,88,0,0,6,4
2020-07-13,84,26,1579,25,5,134,110
2020-07-14,0,1,51,0,0,0,1
2020-07-14,722,87,7401,238,9,404,809
2020-07-14,197,39,1430,51,8,34,236
2020-07-14,4,1,671,3,0,15,5
2020-07-14,68,1,199,8,1,0,69
2020-07-14,0,0,180,0,0,8,0
2020-07-14,0,1,352,0,0,6,1
2020-07-14,81,10,763,29,0,56,91
2020-07-14,245,9,1822,62,0,77,254
2020-07-14,4,0,65,0,0,5,4
2020-07-14,550,166,4129,141,15,166,716
2020-07-14,394,88,6674,149,19,349,482
2020-07-14,49,1,845,9,0,89,50
2020-07-14,32,2,392,9,0,26,34
2020-07-14,3,0,151,0,0,3,3
2020-07-14,14,8,186,8,0,3,22
2020-07-14,0,4,50,0,3,9,4
2020-07-14,1,2,88,0,0,6,3
2020-07-14,169,26,2879,56,6,72,195
2020-07-14,1,0,106,1,0,0,1
2020-07-14,35,2,242,7,0,6,37
2020-07-14,0,1,65,0,0,0,1
2020-07-14,143,26,3435,52,3,155,169
2020-07-14,0,0,54,0,0,0,0
2020-07-14,14,6,397,3,0,31,20
2020-07-14,2173,726,23862,579,96,1297,2899
2020-07-14,20,0,445,5,0,9,20
2020-07-14,84,28,1579,24,8,128,112
2020-07-14,192,46,1393,44,2,77,238
2020-07-14,158,46,2968,56,8,144,204
2020-07-14,0,0,41,0,0,0,0
2020-07-14,101,19,1549,31,6,46,120
2020-07-14,90,15,2647,31,0,110,105
2020-07-14,45,27,770,10,3,12,72
2020-07-14,0,0,14,0,0,0,0
2020-07-14,59,18,1057,12,2,55,77
2020-07-14,2,0,235,2,0,9,2
2020-07-14,2,0,110,0,0,2,2
2020-07-14,0,0,40,0,0,2,0
2020-07-14,8,0,387,3,0,3,8
2020-07-14,0,0,47,0,0,0,0
2020-07-14,2,0,51,1,0,1,2
2020-07-14,1,1,98,0,0,2,2
2020-07-14,7,3,468,4,1,39,10
2020-07-14,17,1,492,9,0,0,18
2020-07-14,603,73,4838,174,5,158,676
2020-07-14,30,11,858,9,2,39,41
2020-07-14,83,2,298,23,1,6,85
2020-07-14,46,6,707,10,1,45,52
2020-07-14,0,0,45,0,0,0,0
2020-07-14,86,3,835,7,0,14,89
2020-07-14,30,10,340,3,0,18,40
2020-07-14,0,0,42,0,0,3,0
2020-07-14,219,51,2045,44,4,56,270
2020-07-14,2,0,25,0,0,3,2
2020-07-14,0,0,33,0,0,0,0
2020-07-15,2,1,235,2,1,8,3
2020-07-15,2,2,88,0,0,6,4
2020-07-15,81,36,1579,27,10,136,117
2020-07-15,0,3,352,0,1,3,3
2020-07-15,0,0,42,0,0,4,0
2020-07-15,4,1,671,3,0,20,5
2020-07-15,0,0,45,0,0,0,0
2020-07-15,0,0,40,0,0,2,0
2020-07-15,1,0,25,0,0,1,1
2020-07-15,0,1,41,0,0,0,1
2020-07-15,401,99,6670,144,19,348,500
2020-07-15,9,0,387,4,0,0,9
2020-07-15,0,0,54,0,0,0,0
2020-07-15,229,45,1890,42,5,60,274
2020-07-15,105,46,1549,29,6,44,151
2020-07-15,89,1,298,25,1,4,90
2020-07-15,2122,729,23884,557,100,1322,2851
2020-07-15,33,10,858,12,2,41,43
2020-07-15,3,0,65,0,0,4,3
2020-07-15,0,0,14,0,0,0,0
2020-07-15,19,1,445,5,0,9,20
2020-07-15,1,0,106,1,0,3,1
2020-07-15,72,2,199,10,1,1,74
2020-07-15,51,1,845,11,0,89,52
2020-07-15,28,4,340,3,0,19,32
2020-07-15,236,14,1822,67,1,68,250
2020-07-15,2,0,180,2,0,11,2
2020-07-15,46,4,707,12,0,45,50
2020-07-15,14,7,186,4,6,1,21
2020-07-15,45,24,770,10,1,16,69
2020-07-15,0,0,33,0,0,0,0
2020-07-15,589,67,4766,176,6,148,656
2020-07-15,2,0,151,0,0,1,2
2020-07-15,1,1,51,0,1,1,2
2020-07-15,146,37,3434,52,7,144,183
2020-07-15,159,43,2968,58,10,143,202
2020-07-15,184,20,2984,58,5,73,204
2020-07-15,0,0,47,0,0,0,0
2020-07-15,95,13,2647,32,0,114,108
2020-07-15,0,0,51,0,0,0,0
2020-07-15,0,1,65,0,0,0,1
2020-07-15,1,0,110,1,0,2,1
2020-07-15,193,42,1393,45,2,76,235
2020-07-15,3,4,109,0,1,1,7
2020-07-15,0,3,50,0,3,9,3
2020-07-15,56,21,1057,12,4,57,77
2020-07-15,29,1,392,7,0,28,30
2020-07-15,531,151,4141,134,14,158,682
2020-07-15,88,4,835,7,0,29,92
2020-07-15,711,102,7428,245,11,378,813
2020-07-15,77,9,763,26,0,60,86
2020-07-15,17,2,492,6,1,5,19
2020-07-15,9,2,465,4,0,34,11
2020-07-15,12,1,397,2,0,27,13
2020-07-15,33,3,242,7,0,6,36
2020-07-15,246,28,1430,55,4,38,274
2020-07-16,8,0,387,4,0,0,8
2020-07-16,3,0,151,0,0,1,3
2020-07-16,1,0,25,0,0,2,1
2020-07-16,51,5,707,17,1,36,56
2020-07-16,74,10,763,26,0,62,84
2020-07-16,17,2,445,5,0,9,19
2020-07-16,86,34,1579,29,7,131,120
2020-07-16,11,1,397,2,0,30,12
2020-07-16,51,30,771,8,1,30,81
2020-07-16,1,0,106,1,0,2,1
2020-07-16,2,1,65,0,1,4,3
2020-07-16,19,5,340,6,0,13,24
2020-07-16,0,0,51,0,0,0,0
2020-07-16,242,39,1901,45,3,65,281
2020-07-16,90,17,2647,27,0,117,107
2020-07-16,682,119,7428,235,13,391,801
2020-07-16,2,1,51,0,0,0,3
2020-07-16,0,0,14,0,0,0,0
2020-07-16,1,1,88,0,0,6,2
2020-07-16,26,3,392,7,2,27,29
2020-07-16,185,33,2920,59,8,76,218
2020-07-16,78,2,199,7,1,2,80
2020-07-16,14,0,186,11,0,0,14
2020-07-16,2,2,110,1,2,2,4
2020-07-16,0,1,47,0,0,0,1
2020-07-16,245,28,1822,68,0,65,273
2020-07-16,200,53,1393,49,2,77,253
2020-07-16,193,40,1430,54,4,39,233
2020-07-16,0,0,33,0,0,0,0
2020-07-16,104,31,1549,30,5,43,135
2020-07-16,10,2,477,5,0,37,12
2020-07-16,5,0,180,3,0,10,5
2020-07-16,2,3,235,2,3,9,5
2020-07-16,0,0,54,0,0,0,0
2020-07-16,0,0,42,0,0,4,0
2020-07-16,535,140,4131,130,15,158,675
2020-07-16,3,0,671,1,0,13,3
2020-07-16,18,1,492,7,0,2,19
2020-07-16,0,1,65,0,0,0,1
2020-07-16,0,0,50,0,0,10,0
2020-07-16,0,0,40,0,0,2,0
2020-07-16,86,7,835,7,1,26,93
2020-07-16,94,1,298,23,1,5,95
2020-07-16,0,0,41,0,0,0,0
2020-07-16,0,1,100,0,0,1,1
2020-07-16,32,14,858,14,1,39,46
2020-07-16,147,36,3433,50,5,158,183
2020-07-16,54,0,845,11,0,84,54
2020-07-16,2188,719,23989,604,93,1325,2907
2020-07-16,61,19,1057,15,4,59,80
2020-07-16,164,47,2968,50,6,142,211
2020-07-16,0,0,45,0,0,0,0
2020-07-16,1,3,352,0,0,6,4
2020-07-16,388,110,6692,142,24,337,498
2020-07-16,32,4,242,6,1,2,36
2020-07-16,600,76,4766,180,8,143,676
2020-07-17,33,0,242,6,0,3,33
2020-07-17,625,55,4766,174,7,149,680
2020-07-17,89,16,2647,26,1,112,105
2020-07-17,192,40,1430,59,4,38,232
2020-07-17,17,0,186,11,0,0,17
2020-07-17,0,0,51,0,0,6,0
2020-07-17,0,0,50,0,0,10,0
2020-07-17,240,44,1898,48,7,56,284
2020-07-17,4,1,151,0,0,1,5
2020-07-17,208,59,1399,50,5,85,267
2020-07-17,3,3,235,2,2,8,6
2020-07-17,52,5,707,19,0,38,57
2020-07-17,73,10,835,10,1,28,83
2020-07-17,0,0,41,0,0,0,0
2020-07-17,515,179,4108,133,24,151,694
2020-07-17,252,30,1822,72,3,67,282
2020-07-17,16,1,492,4,0,4,17
2020-07-17,74,14,763,26,1,63,88
2020-07-17,9,1,180,6,0,8,10
2020-07-17,1,0,106,1,0,2,1
2020-07-17,19,2,445,5,0,10,21
2020-07-17,38,21,858,15,2,32,59
2020-07-17,89,27,1579,31,1,132,116
2020-07-17,0,0,14,0,0,0,0
2020-07-17,0,0,65,0,0,0,0
2020-07-17,4,1,671,1,0,21,5
2020-07-17,196,26,2913,57,5,71,222
2020-07-17,2,0,65,0,0,13,2
2020-07-17,153,31,3432,46,4,160,184
2020-07-17,97,2,298,25,2,3,99
2020-07-17,2216,660,23968,571,73,1380,2876
2020-07-17,0,0,45,0,0,0,0
2020-07-17,157,49,2968,48,5,149,206
2020-07-17,13,7,467,6,0,34,20
2020-07-17,29,4,392,9,0,24,33
2020-07-17,79,2,199,7,1,2,81
2020-07-17,5,0,387,3,0,4,5
2020-07-17,0,0,54,0,0,0,0
2020-07-17,1,2,352,0,1,9,3
2020-07-17,45,1,845,11,0,89,46
2020-07-17,48,28,753,8,2,29,76
2020-07-17,33,7,340,4,0,14,40
2020-07-17,0,1,40,0,0,2,1
2020-07-17,692,92,7428,232,12,377,784
2020-07-17,0,1,42,0,0,3,1
2020-07-17,2,2,110,0,2,2,4
2020-07-17,1,1,51,0,0,0,2
2020-07-17,95,43,1550,31,7,44,138
2020-07-17,402,107,6699,153,20,358,509
2020-07-17,2,0,25,0,0,2,2
2020-07-17,0,1,47,0,0,0,1
2020-07-17,11,10,397,2,1,27,21
2020-07-17,60,20,1060,17,1,55,80
2020-07-17,1,1,88,0,0,6,2
2020-07-17,0,0,33,0,0,0,0
2020-07-17,1,1,84,1,1,3,2
2020-07-18,82,9,763,25,0,63,91
2020-07-18,0,0,45,0,0,0,0
2020-07-18,0,1,40,0,0,2,1
2020-07-18,3,0,235,2,0,7,3
2020-07-18,92,31,1550,29,7,50,123
2020-07-18,0,0,14,0,0,0,0
2020-07-18,205,32,1430,62,3,39,237
2020-07-18,665,64,7428,214,9,400,729
2020-07-18,26,10,340,3,0,9,36
2020-07-18,4,1,151,0,0,4,5
2020-07-18,9,1,180,1,0,13,10
2020-07-18,48,22,759,8,1,26,70
2020-07-18,2,0,65,0,0,4,2
2020-07-18,1,2,110,0,2,2,3
2020-07-18,205,52,1395,51,2,73,257
2020-07-18,37,13,858,13,1,32,50
2020-07-18,261,36,1898,51,5,58,297
2020-07-18,2232,608,23972,585,81,1398,2840
2020-07-18,11,9,397,2,1,26,20
2020-07-18,82,30,1579,27,2,152,112
2020-07-18,67,17,1058,17,1,62,84
2020-07-18,80,6,835,11,0,25,86
2020-07-18,0,1,42,0,0,2,1
2020-07-18,1,1,352,0,0,10,2
2020-07-18,0,0,54,0,0,0,0
2020-07-18,18,0,445,5,0,13,18
2020-07-18,4,0,671,1,0,17,4
2020-07-18,253,24,1822,66,2,67,277
2020-07-18,1,1,88,0,0,6,2
2020-07-18,92,1,298,24,1,6,93
2020-07-18,163,63,2968,49,4,151,226
2020-07-18,8,4,387,3,0,1,12
2020-07-18,611,88,4766,183,11,156,699
2020-07-18,91,16,2647,29,2,107,107
2020-07-18,1,1,51,0,0,0,2
2020-07-18,149,45,3432,43,5,163,194
2020-07-18,195,28,2878,66,3,72,223
2020-07-18,0,1,47,0,0,0,1
2020-07-18,31,2,392,10,1,20,33
2020-07-18,0,0,106,0,0,2,0
2020-07-18,0,0,51,0,0,6,0
2020-07-18,18,1,186,10,1,2,19
2020-07-18,0,0,65,0,0,0,0
2020-07-18,0,0,33,0,0,0,0
2020-07-18,0,0,41,0,0,0,0
2020-07-18,13,1,467,5,0,41,14
2020-07-18,35,0,242,4,0,3,35
2020-07-18,51,6,707,19,0,41,57
2020-07-18,1,2,94,1,1,8,3
2020-07-18,3,0,25,0,0,0,3
2020-07-18,1,5,50,1,3,8,6
2020-07-18,23,0,492,7,0,4,23
2020-07-18,396,91,6446,144,14,376,487
2020-07-18,507,170,4108,131,22,166,677
2020-07-18,43,1,845,12,0,89,44
2020-07-18,78,2,199,7,1,3,80
2020-07-19,13,0,186,8,0,2,13
2020-07-19,47,17,754,9,0,23,64
2020-07-19,91,27,1550,28,8,54,118
2020-07-19,0,0,65,0,0,0,0
2020-07-19,22,1,492,7,0,5,23
2020-07-19,1,1,50,1,0,8,2
2020-07-19,0,0,45,0,0,0,0
2020-07-19,0,1,42,0,0,2,1
2020-07-19,12,10,397,3,3,26,22
2020-07-19,0,1,47,0,0,0,1
2020-07-19,2218,616,23943,577,93,1443,2834
2020-07-19,209,39,1390,55,1,61,248
2020-07-19,0,1,40,0,0,1,1
2020-07-19,6,0,387,1,0,1,6
2020-07-19,4,1,151,0,0,4,5
2020-07-19,68,12,1058,18,1,52,80
2020-07-19,3,1,235,1,1,10,4
2020-07-19,0,0,106,0,0,4,0
2020-07-19,507,161,4032,131,27,156,668
2020-07-19,248,22,1822,64,2,78,270
2020-07-19,78,2,199,7,1,3,80
2020-07-19,35,1,242,6,0,1,36
2020-07-19,0,2,51,0,1,1,2
2020-07-19,613,61,4766,194,6,169,674
2020-07-19,666,81,7428,213,14,423,747
2020-07-19,32,3,392,11,0,25,35
2020-07-19,4,0,671,1,0,17,4
2020-07-19,96,13,2647,31,2,113,109
2020-07-19,210,38,1432,63,3,41,248
2020-07-19,95,1,298,24,0,2,96
2020-07-19,43,2,845,11,0,94,45
2020-07-19,159,69,2968,53,10,128,228
2020-07-19,2,0,65,0,0,6,2
2020-07-19,3,0,25,0,0,2,3
2020-07-19,2,1,88,0,0,6,3
2020-07-19,390,92,6387,142,16,368,482
2020-07-19,9,2,180,2,0,13,11
2020-07-19,88,33,1579,29,3,137,121
2020-07-19,30,18,340,9,3,14,48
2020-07-19,51,8,707,19,0,37,59
2020-07-19,18,0,445,2,0,20,18
2020-07-19,1,1,352,0,0,9,2
2020-07-19,204,37,2863,70,7,75,241
2020-07-19,82,6,763,26,0,67,88
2020-07-19,1,1,110,0,0,3,2
2020-07-19,2,0,51,0,0,0,2
2020-07-19,0,0,14,0,0,0,0
2020-07-19,0,0,54,0,0,0,0
2020-07-19,0,0,33,0,0,0,0
2020-07-19,0,0,41,0,0,0,0
2020-07-19,84,8,835,13,0,28,92
2020-07-19,1,2,103,1,1,7,3
2020-07-19,157,47,3432,45,4,196,204
2020-07-19,269,38,781,50,4,52,307
2020-07-19,11,6,463,5,1,38,17
2020-07-19,36,14,858,13,2,32,50
2020-07-20,41,15,858,14,3,31,56
2020-07-20,402,97,6611,151,21,365,499
2020-07-20,2,0,51,0,0,0,2
2020-07-20,0,2,42,0,0,2,2
2020-07-20,8,2,180,1,0,7,10
2020-07-20,12,0,186,7,0,13,12
2020-07-20,44,3,242,8,0,5,47
2020-07-20,0,0,45,0,0,0,0
2020-07-20,700,73,7428,234,13,404,773
2020-07-20,4,0,151,1,0,3,4
2020-07-20,0,0,65,0,0,0,0
2020-07-20,212,33,2907,59,9,106,245
2020-07-20,0,0,110,0,0,3,0
2020-07-20,1,0,40,1,0,1,1
2020-07-20,3,0,50,1,0,9,3
2020-07-20,0,1,51,0,0,1,1
2020-07-20,0,0,14,0,0,0,0
2020-07-20,2,0,65,0,0,5,2
2020-07-20,71,11,1054,18,2,56,82
2020-07-20,12,8,397,4,0,28,20
2020-07-20,2207,670,23351,594,90,1412,2877
2020-07-20,24,2,492,9,1,6,26
2020-07-20,52,6,707,17,0,43,58
2020-07-20,75,2,199,6,1,3,77
2020-07-20,2,0,25,0,0,1,2
2020-07-20,210,51,1390,55,2,65,261
2020-07-20,87,9,835,12,1,19,96
2020-07-20,16,0,445,3,0,13,16
2020-07-20,0,0,54,0,0,0,0
2020-07-20,32,11,340,10,1,18,43
2020-07-20,0,1,352,0,1,4,1
2020-07-20,41,3,845,12,0,88,44
2020-07-20,93,31,1579,36,4,143,124
2020-07-20,0,0,41,0,0,0,0
2020-07-20,168,41,3432,50,4,198,209
2020-07-20,607,69,4766,190,5,178,676
2020-07-20,220,50,1430,71,8,44,270
2020-07-20,2,2,88,0,0,6,4
2020-07-20,11,4,422,4,1,38,15
2020-07-20,1,1,124,1,0,2,2
2020-07-20,0,1,47,0,0,0,1
2020-07-20,29,4,392,10,0,20,33
2020-07-20,52,21,753,10,2,26,73
2020-07-20,95,10,2647,28,1,120,105
2020-07-20,283,53,781,52,6,46,336
2020-07-20,92,34,1550,28,8,48,126
2020-07-20,8,2,387,2,1,6,10
2020-07-20,171,59,2968,51,8,121,230
2020-07-20,0,0,33,0,0,0,0
2020-07-20,536,171,4093,135,22,160,707
2020-07-20,4,0,671,2,0,2,4
2020-07-20,0,0,106,0,0,5,0
2020-07-20,95,2,298,23,1,3,97
2020-07-20,2,1,235,2,1,8,3
2020-07-20,277,23,1773,65,2,91,300
2020-07-20,85,11,479,29,1,69,96
2020-07-21,0,0,65,0,0,4,0
2020-07-21,3,0,151,1,0,4,3
2020-07-21,22,2,445,6,1,12,24
2020-07-21,72,8,1052,20,2,50,80
2020-07-21,96,25,2505,28,1,115,121
2020-07-21,213,56,2901,69,10,80,269
2020-07-21,101,40,1579,39,6,132,141
2020-07-21,0,0,41,0,0,0,0
2020-07-21,2,2,50,1,1,8,4
2020-07-21,216,44,1430,65,7,43,260
2020-07-21,0,0,51,0,0,1,0
2020-07-21,528,160,4096,143,18,112,688
2020-07-21,0,3,45,0,0,0,3
2020-07-21,0,3,352,0,2,2,3
2020-07-21,221,45,1390,55,2,74,266
2020-07-21,45,3,845,10,0,84,48
2020-07-21,0,0,65,0,0,0,0
2020-07-21,0,0,106,0,0,5,0
2020-07-21,606,118,4766,181,13,157,724
2020-07-21,93,11,835,17,1,15,104
2020-07-21,0,0,14,0,0,0,0
2020-07-21,280,26,1726,66,1,99,306
2020-07-21,11,6,455,4,0,33,17
2020-07-21,45,13,350,13,1,22,58
2020-07-21,0,0,110,0,0,1,0
2020-07-21,4,0,25,2,0,0,4
2020-07-21,10,8,186,6,0,13,18
2020-07-21,176,63,2968,52,10,116,239
2020-07-21,0,2,47,0,0,0,2
2020-07-21,0,1,42,0,0,3,1
2020-07-21,3,1,51,1,0,1,4
2020-07-21,98,37,1550,27,4,42,135
2020-07-21,6,2,180,1,0,7,8
2020-07-21,2,1,235,2,1,8,3
2020-07-21,10,0,387,3,0,0,10
2020-07-21,80,1,199,9,1,1,81
2020-07-21,86,8,793,27,1,67,94
2020-07-21,53,33,753,11,6,17,86
2020-07-21,170,46,3433,51,6,163,216
2020-07-21,0,0,33,0,0,0,0
2020-07-21,40,18,858,9,6,36,58
2020-07-21,19,14,397,5,1,25,33
2020-07-21,1,0,40,1,0,1,1
2020-07-21,296,56,1929,59,2,44,352
2020-07-21,50,1,242,9,0,3,51
2020-07-21,0,0,88,0,0,6,0
2020-07-21,89,1,298,20,0,8,90
2020-07-21,1,2,107,1,0,2,3
2020-07-21,3,0,671,1,0,3,3
2020-07-21,51,5,707,20,1,41,56
2020-07-21,31,6,392,9,0,21,37
2020-07-21,27,1,492,9,0,7,28
2020-07-21,699,74,7403,233,10,400,773
2020-07-21,2210,620,23798,623,94,1252,2830
2020-07-21,401,84,6676,149,17,328,485
2020-07-21,0,0,54,0,0,0,0
2020-07-22,257,16,1251,57,1,17,273
2020-07-22,2,1,153,2,1,7,3
2020-07-22,1928,542,16107,556,82,827,2470
2020-07-22,53,35,449,13,3,-46,88
2020-07-22,11,4,277,4,0,2,15
2020-07-22,85,7,333,26,1,9,92
2020-07-22,1,0,48,0,0,0,1
2020-07-22,70,13,646,16,3,-9,83
2020-07-22,0,0,19,0,0,0,0
2020-07-22,41,2,763,11,1,-110,43
2020-07-22,93,46,1462,24,9,25,139
2020-07-22,2,0,25,1,0,1,2
2020-07-22,0,1,25,0,0,0,1
2020-07-22,0,0,25,0,0,0,0
2020-07-22,0,0,301,0,0,3,0
2020-07-22,0,0,0,0,0,0,0
2020-07-22,0,0,31,0,0,3,0
2020-07-22,166,75,1539,52,7,-8,241
2020-07-22,48,22,360,11,4,16,70
2020-07-22,105,6,186,18,1,12,111
2020-07-22,1,0,17,1,0,1,1
2020-07-22,2,1,121,1,0,1,3
2020-07-22,32,3,267,8,0,5,35
2020-07-22,38,11,143,5,2,-9,49
2020-07-22,5,1,151,1,1,1,6
2020-07-22,232,52,928,51,7,-5,284
2020-07-22,5,0,150,1,0,0,5
2020-07-22,0,0,0,0,0,0,0
2020-07-22,586,102,3268,197,15,185,688
2020-07-22,0,0,37,0,0,0,0
2020-07-22,221,46,1195,66,6,2,267
2020-07-22,0,0,52,0,0,3,0
2020-07-22,106,41,954,39,3,-11,147
2020-07-22,180,37,2781,50,3,60,217
2020-07-22,78,0,261,21,0,3,78
2020-07-22,351,82,4897,128,14,222,433
2020-07-22,2,0,25,1,0,4,2
2020-07-22,22,3,457,8,1,7,25
2020-07-22,13,1,186,8,0,0,14
2020-07-22,236,57,1298,65,10,-19,293
2020-07-22,295,57,1358,63,3,2,352
2020-07-22,534,139,4061,155,28,66,673
2020-07-22,4,0,392,2,0,6,4
2020-07-22,12,5,458,4,1,21,17
2020-07-22,0,2,98,0,1,2,2
2020-07-22,57,10,306,20,0,-18,67
2020-07-22,2,1,51,0,0,2,3
2020-07-22,26,1,410,8,1,-2,27
2020-07-22,0,0,0,0,0,0,0
2020-07-22,77,1,199,8,1,0,78
2020-07-22,7,7,255,4,0,15,14
2020-07-22,53,4,247,9,0,1,57
2020-07-22,690,61,4940,233,7,465,751
2020-07-22,96,17,2071,30,1,56,113
2020-07-22,0,0,106,0,0,4,0
2020-07-22,0,0,0,0,0,0,0
2020-07-23,0,0,19,0,0,0,0
2020-07-23,201,82,2073,47,9,90,283
2020-07-23,0,1,29,0,0,0,1
2020-07-23,523,138,3044,159,27,123,661
2020-07-23,297,79,1506,67,4,11,376
2020-07-23,0,1,259,0,0,1,1
2020-07-23,9,7,450,4,0,21,16
2020-07-23,108,45,1478,35,4,39,153
2020-07-23,17,20,255,4,1,17,37
2020-07-23,232,55,1105,52,6,31,287
2020-07-23,41,24,738,9,5,7,65
2020-07-23,78,6,673,25,2,62,84
2020-07-23,0,0,51,0,0,2,0
2020-07-23,1,2,153,1,2,12,3
2020-07-23,239,70,1800,69,10,61,309
2020-07-23,97,17,2272,28,0,100,114
2020-07-23,13,3,277,4,0,1,16
2020-07-23,3,0,151,1,0,3,3
2020-07-23,0,2,47,0,0,0,2
2020-07-23,215,32,1193,61,3,4,247
2020-07-23,0,1,25,0,0,0,1
2020-07-23,50,7,247,11,0,4,57
2020-07-23,4,0,661,2,0,1,4
2020-07-23,29,2,325,6,1,10,31
2020-07-23,52,12,360,12,0,18,64
2020-07-23,97,39,1437,20,12,24,136
2020-07-23,110,5,240,21,0,31,115
2020-07-23,0,2,98,0,0,3,2
2020-07-23,0,0,0,0,0,0,0
2020-07-23,0,0,51,0,0,1,0
2020-07-23,74,1,199,9,1,0,75
2020-07-23,2,2,121,1,1,5,4
2020-07-23,57,30,789,11,4,28,87
2020-07-23,600,104,3525,187,14,172,704
2020-07-23,2,0,25,1,0,5,2
2020-07-23,0,0,25,0,0,0,0
2020-07-23,356,86,5455,123,20,224,442
2020-07-23,31,0,452,11,0,5,31
2020-07-23,1,0,17,1,0,1,1
2020-07-23,5,1,150,1,0,0,6
2020-07-23,0,0,37,0,0,0,0
2020-07-23,0,0,10,0,0,0,0
2020-07-23,24,2,457,8,1,10,26
2020-07-23,80,0,261,21,0,9,80
2020-07-23,15,1,186,7,0,8,16
2020-07-23,68,12,806,18,2,15,80
2020-07-23,0,0,106,0,0,6,0
2020-07-23,269,24,1251,75,0,26,293
2020-07-23,0,0,31,0,0,2,0
2020-07-23,57,20,591,15,1,14,77
2020-07-23,3,0,25,1,0,0,3
2020-07-23,183,40,3130,53,5,105,223
2020-07-23,652,59,5076,215,8,446,711
2020-07-23,41,1,763,11,0,26,42
2020-07-23,2016,582,16525,595,75,830,2598
2020-07-23,0,2,48,0,0,0,2
2020-07-24,347,73,5526,121,14,252,420
2020-07-24,1,1,33,0,1,6,2
2020-07-24,40,16,740,9,3,7,56
2020-07-24,73,1,199,9,1,1,74
2020-07-24,0,0,25,0,0,0,0
2020-07-24,206,39,1116,49,5,33,245
2020-07-24,0,0,25,0,0,0,0
2020-07-24,77,0,261,21,0,5,77
2020-07-24,4,1,84,1,0,2,5
2020-07-24,95,15,2077,26,3,77,110
2020-07-24,0,6,269,0,1,1,6
2020-07-24,0,1,65,0,1,2,1
2020-07-24,233,47,1762,71,22,82,280
2020-07-24,0,0,51,0,0,2,0
2020-07-24,2033,595,17054,622,81,846,2628
2020-07-24,489,109,3378,165,22,59,598
2020-07-24,0,2,47,0,0,0,2
2020-07-24,11,1,277,4,0,0,12
2020-07-24,24,1,321,6,1,9,25
2020-07-24,62,13,821,17,0,16,75
2020-07-24,0,0,42,0,0,0,0
2020-07-24,11,1,96,6,0,1,12
2020-07-24,607,108,3889,177,15,159,715
2020-07-24,0,0,37,0,0,0,0
2020-07-24,2,0,29,0,0,3,2
2020-07-24,21,4,457,8,1,7,25
2020-07-24,80,5,666,24,1,53,85
2020-07-24,49,2,218,13,0,3,51
2020-07-24,95,44,1305,22,11,55,139
2020-07-24,18,21,255,5,1,10,39
2020-07-24,52,16,589,16,1,14,68
2020-07-24,311,65,1501,65,4,13,376
2020-07-24,0,0,31,0,0,3,0
2020-07-24,0,0,59,0,0,5,0
2020-07-24,52,29,745,13,3,34,81
2020-07-24,28,1,452,10,0,9,29
2020-07-24,47,2,763,12,0,23,49
2020-07-24,1,1,129,0,0,2,2
2020-07-24,5,0,561,2,0,6,5
2020-07-24,188,65,2035,51,6,111,253
2020-07-24,685,91,5584,203,17,383,776
2020-07-24,0,0,19,0,0,0,0
2020-07-24,1,0,149,1,2,14,1
2020-07-24,58,8,360,13,0,16,66
2020-07-24,221,39,1047,69,7,18,260
2020-07-24,6,0,150,2,0,5,6
2020-07-24,12,3,457,4,0,18,15
2020-07-24,0,0,51,0,0,1,0
2020-07-24,180,46,3092,51,4,111,226
2020-07-24,6,0,25,1,0,0,6
2020-07-24,97,50,1425,36,5,48,147
2020-07-24,1,2,48,0,0,0,3
2020-07-24,0,0,0,0,0,0,0
2020-07-24,1,0,17,1,0,1,1
2020-07-24,111,4,240,22,0,13,115
2020-07-24,254,26,1343,71,3,33,280
2020-07-25,72,10,805,19,1,16,82
2020-07-25,0,1,65,0,1,4,1
2020-07-25,1,0,29,0,0,3,1
2020-07-25,21,3,457,7,0,5,24
2020-07-25,0,0,25,0,0,0,0
2020-07-25,180,67,2025,58,7,105,247
2020-07-25,5,0,561,1,0,4,5
2020-07-25,298,59,1490,65,5,27,357
2020-07-25,2,0,48,0,0,0,2
2020-07-25,687,67,6095,201,9,387,754
2020-07-25,239,46,2494,76,6,77,285
2020-07-25,2017,535,18946,582,89,930,2552
2020-07-25,17,22,255,4,2,12,39
2020-07-25,205,43,1199,51,1,33,248
2020-07-25,90,33,1292,24,7,59,123
2020-07-25,6,0,25,1,0,0,6
2020-07-25,77,1,261,23,0,5,78
2020-07-25,483,127,3469,154,22,77,610
2020-07-25,0,2,47,0,0,0,2
2020-07-25,248,29,1398,62,2,39,277
2020-07-25,60,32,748,12,6,30,92
2020-07-25,111,3,240,21,0,12,114
2020-07-25,84,1,199,9,1,3,85
2020-07-25,0,2,114,0,0,5,2
2020-07-25,0,0,25,0,0,0,0
2020-07-25,7,0,150,2,0,5,7
2020-07-25,16,2,457,5,0,18,18
2020-07-25,22,1,308,8,1,9,23
2020-07-25,224,25,1099,73,6,30,249
2020-07-25,1,0,153,1,0,15,1
2020-07-25,53,0,255,11,0,6,53
2020-07-25,12,0,96,5,0,3,12
2020-07-25,0,0,56,0,0,5,0
2020-07-25,93,25,1987,26,5,79,118
2020-07-25,99,34,1402,37,5,45,133
2020-07-25,0,0,51,0,0,0,0
2020-07-25,0,1,327,0,0,1,1
2020-07-25,0,0,33,0,0,7,0
2020-07-25,1,0,51,0,0,1,1
2020-07-25,43,4,763,8,1,27,47
2020-07-25,26,2,452,9,0,9,28
2020-07-25,0,0,37,0,0,0,0
2020-07-25,0,0,51,0,0,2,0
2020-07-25,45,14,580,17,1,4,59
2020-07-25,638,100,4509,195,10,131,738
2020-07-25,79,3,666,24,0,54,82
2020-07-25,2,0,84,1,0,0,2
2020-07-25,55,9,360,10,1,16,64
2020-07-25,0,0,59,0,0,4,0
2020-07-25,0,0,19,0,0,0,0
2020-07-25,176,56,3088,55,4,100,232
2020-07-25,14,3,359,6,0,2,17
2020-07-25,1,0,17,1,0,1,1
2020-07-25,48,18,769,10,3,7,66
2020-07-25,354,88,6329,119,10,268,442
2020-07-25,0,0,0,0,0,0,0
2020-07-26,2,0,51,0,0,2,2
2020-07-26,0,0,37,0,0,0,0
2020-07-26,0,3,314,0,0,4,3
2020-07-26,39,3,763,9,1,27,42
2020-07-26,57,29,749,14,4,29,86
2020-07-26,0,0,65,0,0,4,0
2020-07-26,52,12,360,8,1,19,64
2020-07-26,1,2,112,1,0,5,3
2020-07-26,0,0,59,0,0,4,0
2020-07-26,1,0,17,0,0,1,1
2020-07-26,61,3,253,13,0,3,64
2020-07-26,488,142,3413,146,21,87,630
2020-07-26,85,29,1293,25,5,53,114
2020-07-26,369,89,6316,115,11,297,458
2020-07-26,46,15,766,11,2,9,61
2020-07-26,102,0,564,21,0,17,102
2020-07-26,1,0,29,0,0,4,1
2020-07-26,260,21,1369,64,3,39,281
2020-07-26,48,16,567,18,1,8,64
2020-07-26,21,2,307,8,0,11,23
2020-07-26,7,0,561,1,0,5,7
2020-07-26,0,0,51,0,0,2,0
2020-07-26,14,19,255,4,3,12,33
2020-07-26,171,46,3087,59,3,87,217
2020-07-26,2,0,84,1,0,0,2
2020-07-26,2,1,153,2,1,14,3
2020-07-26,103,27,1392,40,2,48,130
2020-07-26,0,0,25,0,0,0,0
2020-07-26,99,18,2000,30,6,89,117
2020-07-26,302,62,1491,52,5,22,364
2020-07-26,2,0,48,0,0,0,2
2020-07-26,188,69,2174,62,12,96,257
2020-07-26,7,1,150,2,0,2,8
2020-07-26,25,3,457,7,0,7,28
2020-07-26,246,47,2331,78,12,103,293
2020-07-26,2051,570,19906,596,81,912,2621
2020-07-26,0,3,56,0,1,4,3
2020-07-26,85,1,199,10,1,0,86
2020-07-26,6,0,25,1,0,1,6
2020-07-26,0,0,51,0,0,0,0
2020-07-26,13,2,359,4,0,13,15
2020-07-26,609,104,4522,195,8,136,713
2020-07-26,0,1,33,0,1,5,1
2020-07-26,0,0,19,0,0,0,0
2020-07-26,75,2,261,26,0,2,77
2020-07-26,227,36,1050,79,14,16,263
2020-07-26,209,39,1299,48,0,35,248
2020-07-26,13,0,96,5,0,1,13
2020-07-26,0,0,0,0,0,0,0
2020-07-26,13,4,471,4,0,22,17
2020-07-26,80,5,666,25,1,62,85
2020-07-26,22,1,451,8,0,10,23
2020-07-26,70,9,795,16,0,42,79
2020-07-26,661,46,6078,204,9,377,707
2020-07-26,0,2,47,0,0,0,2
2020-07-26,0,0,25,0,0,0,0
2020-07-27,595,93,4516,179,14,210,688
2020-07-27,0,0,19,0,0,0,0
2020-07-27,0,0,52,0,0,2,0
2020-07-27,198,51,2142,65,10,98,249
2020-07-27,487,122,3463,143,24,93,609
2020-07-27,25,1,451,8,1,11,26
2020-07-27,1,0,29,0,0,4,1
2020-07-27,1,0,84,0,0,2,1
2020-07-27,57,40,744,15,6,27,97
2020-07-27,3,0,153,2,0,12,3
2020-07-27,0,0,25,0,0,0,0
2020-07-27,253,50,2467,81,8,101,303
2020-07-27,0,0,41,0,0,0,0
2020-07-27,22,3,309,7,0,11,25
2020-07-27,175,48,3087,61,5,126,223
2020-07-27,85,1,199,10,1,0,86
2020-07-27,0,0,48,0,0,0,0
2020-07-27,6,0,25,1,0,0,6
2020-07-27,233,27,1046,75,5,23,260
2020-07-27,13,2,471,4,1,20,15
2020-07-27,71,15,729,17,1,24,86
2020-07-27,1,0,108,1,0,5,1
2020-07-27,1,1,65,0,0,4,2
2020-07-27,13,0,96,6,0,10,13
2020-07-27,0,0,25,0,0,0,0
2020-07-27,204,46,1171,50,4,26,250
2020-07-27,101,17,1989,34,1,95,118
2020-07-27,64,0,253,13,0,4,64
2020-07-27,0,0,0,0,0,0,0
2020-07-27,0,0,59,0,0,5,0
2020-07-27,24,3,457,6,0,11,27
2020-07-27,297,48,1470,51,7,26,345
2020-07-27,640,45,6182,203,9,383,685
2020-07-27,14,19,255,4,1,17,33
2020-07-27,39,0,763,7,0,30,39
2020-07-27,2,0,17,1,0,1,2
2020-07-27,42,17,691,10,2,3,59
2020-07-27,11,2,359,4,0,13,13
2020-07-27,255,20,1389,69,1,51,275
2020-07-27,8,0,561,1,0,4,8
2020-07-27,46,19,566,16,2,8,65
2020-07-27,105,31,1386,38,7,48,136
2020-07-27,1,1,33,1,1,6,2
2020-07-27,343,89,5889,108,8,287,432
2020-07-27,6,2,150,1,0,0,8
2020-07-27,0,1,51,0,0,0,1
2020-07-27,86,29,1297,24,8,53,115
2020-07-27,104,3,227,20,0,4,107
2020-07-27,55,5,360,10,0,15,60
2020-07-27,0,2,47,0,0,0,2
2020-07-27,2045,554,18716,576,93,901,2599
2020-07-27,3,0,51,1,0,1,3
2020-07-27,81,1,261,27,0,2,82
2020-07-27,79,8,666,24,1,59,87
2020-07-27,1,2,56,1,1,4,3
2020-07-27,0,3,314,0,1,6,3
2020-07-28,0,0,25,0,0,0,0
2020-07-28,608,102,4688,180,12,190,710
2020-07-28,392,110,6710,129,20,274,502
2020-07-28,7,0,25,2,0,0,7
2020-07-28,12,0,98,6,0,4,12
2020-07-28,0,1,51,0,0,0,1
2020-07-28,265,49,2440,81,7,84,314
2020-07-28,0,0,51,0,0,1,0
2020-07-28,52,1,240,12,0,4,53
2020-07-28,20,0,457,6,0,12,20
2020-07-28,265,14,1472,76,1,34,279
2020-07-28,10,0,561,1,0,6,10
2020-07-28,13,4,477,4,0,17,17
2020-07-28,49,4,360,8,0,17,53
2020-07-28,5,1,150,1,0,0,6
2020-07-28,48,12,572,17,1,6,60
2020-07-28,0,1,65,0,0,3,1
2020-07-28,75,0,199,9,0,1,75
2020-07-28,0,0,0,0,0,0,0
2020-07-28,284,49,1478,65,4,13,333
2020-07-28,1,0,29,0,0,4,1
2020-07-28,11,2,359,4,0,13,13
2020-07-28,107,16,1921,37,2,27,123
2020-07-28,1,0,56,1,0,4,1
2020-07-28,0,2,47,0,0,0,2
2020-07-28,1,0,84,0,0,2,1
2020-07-28,626,81,6238,204,11,354,707
2020-07-28,1,0,17,1,0,1,1
2020-07-28,87,45,1307,22,11,40,132
2020-07-28,490,142,3523,153,22,161,632
2020-07-28,1,0,153,1,0,7,1
2020-07-28,1,0,33,1,0,7,1
2020-07-28,181,43,3142,56,6,118,224
2020-07-28,0,0,41,0,0,0,0
2020-07-28,23,0,310,7,0,10,23
2020-07-28,26,2,451,11,1,6,28
2020-07-28,0,0,19,0,0,0,0
2020-07-28,10,9,255,5,1,14,19
2020-07-28,77,0,261,24,0,1,77
2020-07-28,0,0,59,0,0,6,0
2020-07-28,2022,575,20025,550,71,918,2597
2020-07-28,89,7,666,29,2,53,96
2020-07-28,59,32,735,14,2,26,91
2020-07-28,0,5,314,0,1,5,5
2020-07-28,1,1,122,0,0,4,2
2020-07-28,60,11,588,20,2,7,71
2020-07-28,105,7,227,20,0,4,112
2020-07-28,231,40,1018,74,7,21,271
2020-07-28,213,43,2343,64,3,114,256
2020-07-28,0,0,48,0,0,0,0
2020-07-28,108,39,1403,35,4,44,147
2020-07-28,3,1,51,1,0,0,4
2020-07-28,64,10,668,16,0,19,74
2020-07-28,0,0,25,0,0,0,0
2020-07-28,192,38,1175,50,5,25,230
2020-07-28,43,1,763,15,1,30,44
2020-07-29,85,7,666,28,2,55,92
2020-07-29,5,1,150,1,0,2,6
2020-07-29,475,104,3455,167,21,92,579
2020-07-29,110,35,1427,37,4,47,145
2020-07-29,0,0,25,0,0,0,0
2020-07-29,18,3,477,4,0,16,21
2020-07-29,0,0,41,0,0,0,0
2020-07-29,3,1,25,1,1,2,4
2020-07-29,56,15,746,22,3,13,71
2020-07-29,292,36,1479,67,3,13,328
2020-07-29,0,2,47,0,0,0,2
2020-07-29,366,82,6144,122,17,248,448
2020-07-29,10,0,359,5,0,13,10
2020-07-29,59,28,733,13,3,28,87
2020-07-29,23,0,315,9,0,7,23
2020-07-29,109,14,1991,39,2,44,123
2020-07-29,71,0,199,10,0,2,71
2020-07-29,0,0,66,0,0,3,0
2020-07-29,1,0,29,0,0,4,1
2020-07-29,49,1,253,8,0,4,50
2020-07-29,0,0,51,0,0,0,0
2020-07-29,0,1,48,0,0,0,1
2020-07-29,3,0,287,2,0,16,3
2020-07-29,1,0,17,1,0,1,1
2020-07-29,0,3,324,0,0,4,3
2020-07-29,0,0,0,0,0,0,0
2020-07-29,0,0,25,0,0,0,0
2020-07-29,67,0,261,23,0,1,67
2020-07-29,198,50,1223,49,4,28,248
2020-07-29,1,0,56,1,0,5,1
2020-07-29,2002,566,20193,578,57,877,2568
2020-07-29,0,0,59,0,0,4,0
2020-07-29,0,0,51,0,0,0,0
2020-07-29,187,54,3403,58,6,103,241
2020-07-29,1,0,84,0,0,2,1
2020-07-29,592,85,6225,189,12,360,677
2020-07-29,1,0,33,1,0,6,1
2020-07-29,64,15,697,16,2,14,79
2020-07-29,11,0,96,5,0,7,11
2020-07-29,44,17,564,16,3,6,61
2020-07-29,5,0,51,2,0,1,5
2020-07-29,27,0,451,8,0,5,27
2020-07-29,277,62,2529,83,8,79,339
2020-07-29,204,58,2401,59,10,94,262
2020-07-29,14,8,256,5,1,16,22
2020-07-29,97,10,673,19,0,9,107
2020-07-29,54,6,360,11,1,15,60
2020-07-29,78,35,1297,25,5,43,113
2020-07-29,19,0,457,8,0,7,19
2020-07-29,0,0,19,0,0,0,0
2020-07-29,233,41,1019,78,10,17,274
2020-07-29,215,15,1391,63,0,46,230
2020-07-29,1,1,104,1,0,4,2
2020-07-29,562,88,4566,176,16,165,650
2020-07-29,10,0,561,2,0,5,10
2020-07-29,53,1,763,17,0,15,54
2020-07-30,215,52,1014,71,5,20,267
2020-07-30,211,37,1226,49,3,30,248
2020-07-30,30,1,451,9,1,2,31
2020-07-30,95,4,669,16,0,7,99
2020-07-30,49,3,253,10,1,9,52
2020-07-30,313,40,1481,58,2,15,353
2020-07-30,0,0,41,0,0,0,0
2020-07-30,58,10,702,22,2,15,68
2020-07-30,0,0,29,0,0,3,0
2020-07-30,0,0,0,0,0,0,0
2020-07-30,1,1,125,1,0,5,2
2020-07-30,1,0,17,1,0,1,1
2020-07-30,0,2,47,0,0,0,2
2020-07-30,0,0,51,0,0,0,0
2020-07-30,0,0,33,0,0,8,0
2020-07-30,51,5,261,21,1,1,56
2020-07-30,0,0,51,0,0,0,0
2020-07-30,50,10,631,18,1,7,60
2020-07-30,101,18,2025,38,1,53,119
2020-07-30,0,0,25,0,0,0,0
2020-07-30,5,0,150,0,0,4,5
2020-07-30,2,1,84,1,0,1,3
2020-07-30,11,0,96,7,0,8,11
2020-07-30,0,0,59,0,0,5,0
2020-07-30,1904,553,20167,569,58,872,2457
2020-07-30,180,44,3108,51,6,118,224
2020-07-30,4,1,52,2,0,0,5
2020-07-30,23,2,311,9,0,11,25
2020-07-30,230,17,1391,76,2,40,247
2020-07-30,0,1,25,0,0,0,1
2020-07-30,593,62,6210,191,9,300,655
2020-07-30,0,3,48,0,0,0,3
2020-07-30,0,0,19,0,0,0,0
2020-07-30,87,3,666,26,0,60,90
2020-07-30,38,16,564,14,2,6,54
2020-07-30,198,47,2454,60,6,92,245
2020-07-30,16,2,477,4,0,17,18
2020-07-30,53,3,757,16,1,20,56
2020-07-30,56,5,360,11,1,20,61
2020-07-30,15,12,255,4,0,14,27
2020-07-30,106,38,1434,36,6,47,144
2020-07-30,281,48,2452,91,7,79,329
2020-07-30,596,81,4530,187,10,111,677
2020-07-30,0,1,260,0,0,4,1
2020-07-30,452,93,3391,153,14,99,545
2020-07-30,1,3,56,1,0,3,4
2020-07-30,59,37,730,12,0,27,96
2020-07-30,80,39,1300,22,8,47,119
2020-07-30,12,0,359,5,0,15,12
2020-07-30,1,0,235,1,0,16,1
2020-07-30,3,0,25,1,0,1,3
2020-07-30,348,72,6268,120,13,258,420
2020-07-30,10,0,561,3,0,5,10
2020-07-30,74,0,199,9,0,3,74
2020-07-30,17,0,457,7,0,6,17
2020-07-30,0,0,66,0,0,2,0
2020-07-31,546,38,6260,169,5,309,584
2020-07-31,239,17,1391,75,3,28,256
2020-07-31,102,19,2002,36,1,51,121
2020-07-31,8,0,448,3,0,6,8
2020-07-31,0,2,25,0,0,0,2
2020-07-31,1,3,56,1,0,4,4
2020-07-31,41,18,567,15,2,6,59
2020-07-31,196,35,3104,56,6,92,231
2020-07-31,309,34,1486,59,1,14,343
2020-07-31,221,39,922,71,5,14,260
2020-07-31,2,2,235,1,2,14,4
2020-07-31,265,41,2475,90,7,79,306
2020-07-31,447,94,3159,145,18,94,541
2020-07-31,0,4,263,0,1,5,4
2020-07-31,12,9,255,3,0,13,21
2020-07-31,39,14,506,16,1,3,53
2020-07-31,55,9,705,20,2,14,64
2020-07-31,8,0,150,0,0,0,8
2020-07-31,0,0,51,0,0,0,0
2020-07-31,50,0,261,20,0,3,50
2020-07-31,0,0,19,0,0,0,0
2020-07-31,1,1,48,0,0,0,2
2020-07-31,202,49,2486,58,5,102,251
2020-07-31,60,29,731,14,3,31,89
2020-07-31,315,66,6614,109,11,269,381
2020-07-31,98,7,714,15,0,8,105
2020-07-31,25,1,451,9,0,2,26
2020-07-31,0,2,47,0,0,0,2
2020-07-31,20,1,457,7,0,4,21
2020-07-31,45,2,757,15,0,16,47
2020-07-31,86,3,666,23,0,47,89
2020-07-31,2,3,116,1,0,8,5
2020-07-31,6,1,96,6,1,5,7
2020-07-31,0,0,41,0,0,0,0
2020-07-31,27,3,315,6,1,7,30
2020-07-31,0,1,53,0,0,0,1
2020-07-31,13,1,359,7,0,15,14
2020-07-31,1,0,25,1,0,1,1
2020-07-31,1856,516,20401,575,53,864,2372
2020-07-31,55,12,274,14,0,3,67
2020-07-31,85,40,1314,25,9,45,125
2020-07-31,72,0,199,9,0,1,72
2020-07-31,221,42,1226,52,2,34,263
2020-07-31,0,0,0,0,0,0,0
2020-07-31,0,0,29,0,0,4,0
2020-07-31,107,45,1448,39,4,50,152
2020-07-31,568,82,4442,184,8,117,650
2020-07-31,0,1,59,0,1,5,1
2020-07-31,0,2,25,0,0,0,2
2020-07-31,0,2,66,0,1,2,2
2020-07-31,0,0,33,0,0,7,0
2020-07-31,12,5,463,4,1,18,17
2020-07-31,51,0,253,10,0,9,51
2020-07-31,2,0,84,0,0,0,2
2020-07-31,5,0,51,2,0,2,5
2020-07-31,1,0,17,1,0,1,1
2020-08-01,43,1,757,16,0,18,44
2020-08-01,267,35,2466,91,7,86,302
2020-08-01,58,34,732,15,4,29,92
2020-08-01,1,0,17,0,0,2,1
2020-08-01,0,0,52,0,0,3,0
2020-08-01,2,2,189,2,2,4,4
2020-08-01,55,9,709,18,2,17,64
2020-08-01,43,13,478,16,1,6,56
2020-08-01,216,53,1019,77,5,17,269
2020-08-01,2,0,84,0,0,0,2
2020-08-01,13,5,463,4,0,20,18
2020-08-01,232,17,1391,77,3,30,249
2020-08-01,0,2,25,0,0,0,2
2020-08-01,1,4,116,0,0,8,5
2020-08-01,198,50,2478,56,7,99,248
2020-08-01,10,0,359,6,2,16,10
2020-08-01,54,7,274,12,0,3,61
2020-08-01,293,39,1505,58,3,12,332
2020-08-01,0,2,25,0,0,0,2
2020-08-01,0,0,0,0,0,0,0
2020-08-01,0,2,47,0,0,0,2
2020-08-01,108,9,714,19,0,10,117
2020-08-01,0,4,263,0,1,4,4
2020-08-01,1,2,56,1,0,4,3
2020-08-01,0,0,29,0,0,4,0
2020-08-01,435,111,3282,139,18,98,546
2020-08-01,20,1,457,7,0,4,21
2020-08-01,105,14,2005,39,1,52,119
2020-08-01,28,6,319,6,1,9,34
2020-08-01,1,0,66,0,0,2,1
2020-08-01,1784,557,19238,544,61,908,2341
2020-08-01,82,5,666,23,0,75,87
2020-08-01,48,18,576,15,2,9,66
2020-08-01,0,0,51,0,0,0,0
2020-08-01,8,1,96,7,0,3,9
2020-08-01,4,0,25,1,0,0,4
2020-08-01,8,0,448,3,0,6,8
2020-08-01,567,85,3802,186,11,164,652
2020-08-01,47,1,261,21,0,3,48
2020-08-01,100,48,1451,37,6,52,148
2020-08-01,83,42,1310,23,8,45,125
2020-08-01,29,2,451,11,0,11,31
2020-08-01,6,0,51,2,0,0,6
2020-08-01,0,0,33,0,0,8,0
2020-08-01,216,37,1223,51,4,30,253
2020-08-01,52,0,253,10,0,9,52
2020-08-01,183,33,3226,57,3,110,216
2020-08-01,0,0,41,0,0,0,0
2020-08-01,0,1,59,0,1,5,1
2020-08-01,8,0,150,0,0,0,8
2020-08-01,312,72,6156,107,18,282,384
2020-08-01,1,2,48,0,0,0,3
2020-08-01,72,0,199,9,0,1,72
2020-08-01,12,9,255,3,0,8,21
2020-08-01,554,64,5764,171,8,306,618
2020-08-01,0,0,19,0,0,0,0
2020-08-02,50,11,562,18,0,6,61
2020-08-02,2,0,189,2,0,5,2
2020-08-02,305,70,6123,113,10,304,375
2020-08-02,1757,506,19088,545,55,952,2263
2020-08-02,194,42,2434,55,9,91,236
2020-08-02,42,17,479,14,2,6,59
2020-08-02,0,4,258,0,1,4,4
2020-08-02,101,39,1442,38,7,60,140
2020-08-02,52,3,253,11,1,8,55
2020-08-02,1,0,48,0,0,0,1
2020-08-02,48,7,274,15,0,3,55
2020-08-02,213,45,922,65,1,21,258
2020-08-02,3,0,25,0,0,0,3
2020-08-02,98,11,1992,35,3,51,109
2020-08-02,55,12,683,19,2,23,67
2020-08-02,27,1,451,8,0,10,28
2020-08-02,53,0,261,21,0,2,53
2020-08-02,12,0,150,0,0,9,12
2020-08-02,73,1,199,8,1,3,74
2020-08-02,0,1,25,0,0,0,1
2020-08-02,82,37,1314,18,7,44,119
2020-08-02,555,50,5723,175,8,316,605
2020-08-02,1,2,25,1,0,0,3
2020-08-02,262,33,2319,83,8,91,295
2020-08-02,185,36,3225,57,4,93,221
2020-08-02,425,87,3237,133,20,95,512
2020-08-02,1,0,17,0,0,2,1
2020-08-02,0,2,47,0,0,0,2
2020-08-02,2,0,65,0,0,3,2
2020-08-02,88,6,666,25,0,48,94
2020-08-02,8,0,96,4,0,4,8
2020-08-02,295,33,1527,61,6,18,328
2020-08-02,12,0,51,4,0,0,12
2020-08-02,0,0,51,0,0,0,0
2020-08-02,44,3,757,16,0,15,47
2020-08-02,0,0,25,0,0,0,0
2020-08-02,3,0,29,0,0,4,3
2020-08-02,321,12,1292,72,4,35,333
2020-08-02,101,7,714,14,0,3,108
2020-08-02,0,0,52,0,0,4,0
2020-08-02,23,0,265,6,0,10,23
2020-08-02,26,3,320,6,0,8,29
2020-08-02,7,0,359,3,0,19,7
2020-08-02,0,0,0,0,0,0,0
2020-08-02,0,0,59,0,0,5,0
2020-08-02,0,0,19,0,0,0,0
2020-08-02,0,0,41,0,0,0,0
2020-08-02,8,0,561,3,0,4,8
2020-08-02,57,39,732,11,2,29,96
2020-08-02,13,3,452,5,0,21,16
2020-08-02,0,0,50,0,0,8,0
2020-08-02,205,47,1230,49,4,25,252
2020-08-02,575,67,3899,193,5,116,642
2020-08-02,12,9,276,3,0,12,21
2020-08-02,0,0,29,0,0,4,0
2020-08-02,2,0,84,0,0,1,2
2020-08-03,274,34,2452,87,3,90,308
2020-08-03,215,43,1212,48,4,38,258
2020-08-03,3,0,25,1,0,2,3
2020-08-03,44,12,553,17,1,6,56
2020-08-03,1,0,48,0,0,0,1
2020-08-03,297,39,1538,59,3,19,336
2020-08-03,10,0,150,0,0,11,10
2020-08-03,62,28,733,14,5,28,90
2020-08-03,2,1,84,0,0,1,3
2020-08-03,193,49,2334,55,6,84,242
2020-08-03,0,0,19,0,0,0,0
2020-08-03,0,0,41,0,0,0,0
2020-08-03,0,0,17,0,0,2,0
2020-08-03,0,1,25,0,0,0,1
2020-08-03,105,5,714,17,1,10,110
2020-08-03,539,66,5814,167,12,306,605
2020-08-03,41,17,480,13,1,7,58
2020-08-03,171,31,3201,52,2,110,202
2020-08-03,450,93,3278,133,19,88,543
2020-08-03,3,0,189,1,0,12,3
2020-08-03,99,40,1410,42,12,53,139
2020-08-03,11,1,477,4,0,21,12
2020-08-03,9,7,359,3,0,22,16
2020-08-03,0,1,25,0,0,0,1
2020-08-03,0,0,51,0,0,0,0
2020-08-03,0,0,65,0,0,8,0
2020-08-03,0,1,52,0,0,3,1
2020-08-03,0,2,264,0,0,7,2
2020-08-03,46,14,274,13,0,2,60
2020-08-03,10,1,51,4,0,0,11
2020-08-03,3,0,29,0,0,4,3
2020-08-03,88,41,1306,19,7,45,129
2020-08-03,23,5,313,5,1,12,28
2020-08-03,561,76,3822,188,10,126,637
2020-08-03,1768,541,19242,537,68,915,2309
2020-08-03,0,0,33,0,0,8,0
2020-08-03,47,3,757,19,0,11,50
2020-08-03,222,24,1392,80,7,43,246
2020-08-03,71,0,199,6,0,4,71
2020-08-03,89,15,1709,34,2,123,104
2020-08-03,0,0,0,0,0,0,0
2020-08-03,21,0,265,5,0,13,21
2020-08-03,7,0,434,3,0,8,7
2020-08-03,0,2,47,0,0,0,2
2020-08-03,82,7,666,25,0,43,89
2020-08-03,0,0,59,0,0,5,0
2020-08-03,222,31,1020,67,5,22,253
2020-08-03,15,11,276,3,3,11,26
2020-08-03,56,2,253,14,0,5,58
2020-08-03,0,2,109,0,1,9,2
2020-08-03,1,0,56,1,0,5,1
2020-08-03,7,0,96,6,0,4,7
2020-08-03,56,0,261,25,0,2,56
2020-08-03,58,15,682,14,3,26,73
2020-08-03,294,67,6136,103,14,323,361
2020-08-03,26,0,451,8,0,10,26
2020-08-04,311,93,6044,111,19,311,404
2020-08-04,9,1,359,3,0,21,10
2020-08-04,1741,556,19053,508,57,887,2297
2020-08-04,295,41,1557,55,5,13,336
2020-08-04,262,48,2462,87,6,89,310
2020-08-04,214,67,1014,54,10,21,281
2020-08-04,51,1,757,17,1,20,52
2020-08-04,12,4,477,4,1,23,16
2020-08-04,0,0,41,0,0,0,0
2020-08-04,0,0,51,0,0,4,0
2020-08-04,42,11,558,16,2,4,53
2020-08-04,10,0,51,3,0,1,10
2020-08-04,219,52,1219,50,3,21,271
2020-08-04,541,58,3810,174,6,131,599
2020-08-04,54,12,692,12,2,27,66
2020-08-04,3,0,25,1,0,1,3
2020-08-04,212,21,1435,66,2,44,233
2020-08-04,23,0,451,11,0,7,23
2020-08-04,2,3,48,0,0,0,5
2020-08-04,21,5,312,5,0,9,26
2020-08-04,22,0,265,5,0,10,22
2020-08-04,0,0,17,0,0,1,0
2020-08-04,171,29,3230,53,1,104,200
2020-08-04,0,2,47,0,0,0,2
2020-08-04,81,29,1306,21,6,39,110
2020-08-04,50,1,254,14,0,5,51
2020-08-04,0,0,0,0,0,0,0
2020-08-04,1,0,29,0,0,4,1
2020-08-04,95,41,1427,43,9,57,136
2020-08-04,536,44,5762,172,7,309,580
2020-08-04,70,0,199,9,0,1,70
2020-08-04,196,54,2363,53,10,93,250
2020-08-04,65,38,731,15,4,25,103
2020-08-04,12,9,276,6,1,12,21
2020-08-04,1,1,91,0,0,12,2
2020-08-04,12,0,150,0,0,8,12
2020-08-04,0,0,51,0,0,0,0
2020-08-04,114,4,714,15,2,6,118
2020-08-04,1,1,33,0,0,8,2
2020-08-04,5,1,96,5,0,8,6
2020-08-04,0,0,19,0,0,0,0
2020-08-04,46,3,274,14,1,2,49
2020-08-04,0,1,65,0,0,4,1
2020-08-04,1,0,56,0,0,5,1
2020-08-04,2,1,189,0,0,11,3
2020-08-04,0,4,25,0,0,0,4
2020-08-04,47,0,261,20,0,4,47
2020-08-04,0,2,267,0,0,7,2
2020-08-04,42,15,485,11,1,10,57
2020-08-04,0,0,25,0,0,0,0
2020-08-04,81,3,666,25,0,42,84
2020-08-04,411,100,3247,134,20,79,511
2020-08-04,92,12,1772,33,1,69,104
2020-08-04,0,0,59,0,0,7,0
2020-08-04,3,0,84,0,0,0,3
2020-08-04,5,0,437,3,0,3,5
2020-08-05,1,2,121,0,0,10,3
2020-08-05,80,14,1848,30,0,76,94
2020-08-05,206,48,1012,65,23,21,254
2020-08-05,73,1,193,9,1,8,74
2020-08-05,21,2,317,6,0,9,23
2020-08-05,0,2,47,0,0,0,2
2020-08-05,1680,602,19541,502,81,865,2282
2020-08-05,517,75,5991,171,8,319,592
2020-08-05,190,56,2414,49,7,98,246
2020-08-05,295,76,6159,100,12,314,371
2020-08-05,49,13,696,19,3,22,62
2020-08-05,0,0,59,0,0,3,0
2020-08-05,1,1,65,0,1,2,2
2020-08-05,47,0,261,19,0,4,47
2020-08-05,0,1,261,0,0,7,1
2020-08-05,84,0,666,29,0,39,84
2020-08-05,0,0,0,0,0,0,0
2020-08-05,168,31,3167,51,1,116,199
2020-08-05,296,40,1574,56,4,14,336
2020-08-05,1,0,17,0,0,1,1
2020-08-05,67,39,740,12,3,26,106
2020-08-05,89,37,1437,40,7,47,126
2020-08-05,45,5,274,13,0,1,50
2020-08-05,415,93,3422,128,12,85,508
2020-08-05,0,0,25,0,0,0,0
2020-08-05,1,0,29,0,0,4,1
2020-08-05,541,76,3783,170,7,128,617
2020-08-05,10,0,96,7,0,4,10
2020-08-05,52,1,691,17,1,22,53
2020-08-05,0,0,19,0,0,0,0
2020-08-05,7,0,440,3,0,33,7
2020-08-05,12,5,477,5,1,21,17
2020-08-05,223,57,1219,55,5,9,280
2020-08-05,2,0,25,1,0,0,2
2020-08-05,1,3,33,0,3,8,4
2020-08-05,51,0,254,13,0,5,51
2020-08-05,79,38,1318,26,5,37,117
2020-08-05,0,0,41,0,0,0,0
2020-08-05,2,1,84,0,0,1,3
2020-08-05,0,0,51,0,0,0,0
2020-08-05,262,48,2474,88,5,79,310
2020-08-05,26,3,451,10,0,5,29
2020-08-05,98,6,714,15,2,7,104
2020-08-05,0,2,25,0,0,0,2
2020-08-05,45,15,557,17,4,5,60
2020-08-05,2,1,189,1,1,4,3
2020-08-05,43,5,545,10,1,8,48
2020-08-05,1,4,48,0,0,0,5
2020-08-05,0,0,56,0,0,2,0
2020-08-05,222,7,1279,76,0,72,229
2020-08-05,6,0,51,3,0,1,6
2020-08-05,12,6,276,3,0,9,18
2020-08-05,0,0,51,0,0,3,0
2020-08-05,8,0,345,3,0,20,8
2020-08-05,25,0,265,5,0,8,25
2020-08-05,13,0,150,1,0,7,13
2020-08-06,85,9,1820,31,1,60,94
2020-08-06,1610,581,19413,499,73,836,2191
2020-08-06,511,47,5980,177,6,306,558
2020-08-06,1,0,17,1,0,0,1
2020-08-06,10,0,96,7,0,4,10
2020-08-06,250,59,2464,81,10,93,309
2020-08-06,82,6,666,27,2,39,88
2020-08-06,11,3,451,4,0,21,14
2020-08-06,2,0,59,1,0,2,2
2020-08-06,217,12,1297,72,0,45,229
2020-08-06,98,3,714,11,1,10,101
2020-08-06,175,50,2407,52,7,98,225
2020-08-06,196,26,1011,63,6,17,222
2020-08-06,0,0,19,0,0,0,0
2020-08-06,0,0,25,0,0,0,0
2020-08-06,0,0,41,0,0,0,0
2020-08-06,2,1,33,2,0,5,3
2020-08-06,14,0,150,2,0,5,14
2020-08-06,283,59,6023,95,12,295,342
2020-08-06,63,36,740,10,1,31,99
2020-08-06,0,5,51,0,2,3,5
2020-08-06,0,1,56,0,1,2,1
2020-08-06,0,0,25,0,0,0,0
2020-08-06,0,0,0,0,0,0,0
2020-08-06,0,2,47,0,0,0,2
2020-08-06,530,71,3791,169,6,123,601
2020-08-06,51,1,710,18,1,19,52
2020-08-06,0,0,35,0,0,0,0
2020-08-06,1,1,65,0,1,1,2
2020-08-06,24,3,309,6,0,8,27
2020-08-06,7,0,422,2,0,8,7
2020-08-06,1,1,260,0,0,7,2
2020-08-06,45,16,685,16,1,31,61
2020-08-06,28,0,265,7,0,8,28
2020-08-06,37,14,515,10,2,6,51
2020-08-06,8,1,359,4,1,20,9
2020-08-06,81,33,1314,23,8,37,114
2020-08-06,2,0,105,0,0,3,2
2020-08-06,3,2,48,0,0,0,5
2020-08-06,292,43,1579,55,6,17,335
2020-08-06,98,35,1435,43,3,46,133
2020-08-06,55,3,254,15,1,3,58
2020-08-06,409,106,3391,125,14,87,515
2020-08-06,2,2,84,0,1,1,4
2020-08-06,3,0,189,1,0,6,3
2020-08-06,216,58,1243,51,7,10,274
2020-08-06,12,13,276,3,2,11,25
2020-08-06,73,0,193,8,0,10,73
2020-08-06,1,0,29,0,0,4,1
2020-08-06,46,4,274,9,0,6,50
2020-08-06,23,1,451,8,0,6,24
2020-08-06,8,0,51,3,0,1,8
2020-08-06,49,0,261,17,0,5,49
2020-08-06,175,21,3072,53,2,101,196
2020-08-06,40,15,561,16,2,6,55
2020-08-06,2,1,25,1,0,1,3
2020-08-07,59,0,253,15,0,0,59
2020-08-07,12,4,451,3,0,21,16
2020-08-07,279,67,6017,91,19,301,346
2020-08-07,102,3,714,16,1,16,105
2020-08-07,1,4,52,0,2,2,5
2020-08-07,99,28,1430,42,4,45,127
2020-08-07,1,0,17,1,0,1,1
2020-08-07,17,0,150,9,0,7,17
2020-08-07,63,39,733,12,0,26,102
2020-08-07,167,47,2393,51,9,87,214
2020-08-07,4,0,65,4,0,2,4
2020-08-07,2,0,33,2,0,4,2
2020-08-07,2,0,113,0,0,8,2
2020-08-07,1,6,260,0,2,8,7
2020-08-07,2,0,59,2,0,2,2
2020-08-07,20,0,451,8,0,9,20
2020-08-07,48,3,710,20,0,22,51
2020-08-07,2,0,25,1,0,3,2
2020-08-07,42,16,695,12,2,27,58
2020-08-07,2,0,29,0,0,4,2
2020-08-07,7,3,359,4,3,17,10
2020-08-07,382,105,3419,118,14,99,487
2020-08-07,170,20,3047,55,2,99,190
2020-08-07,0,0,25,0,0,0,0
2020-08-07,13,5,276,4,0,12,18
2020-08-07,7,0,51,3,0,2,7
2020-08-07,0,0,35,0,0,0,0
2020-08-07,491,51,5706,167,8,247,542
2020-08-07,493,60,3786,157,8,136,553
2020-08-07,5,2,48,0,0,0,7
2020-08-07,79,11,1832,30,0,54,90
2020-08-07,0,0,25,0,0,0,0
2020-08-07,48,0,261,16,0,6,48
2020-08-07,80,6,666,29,1,40,86
2020-08-07,41,9,274,9,0,6,50
2020-08-07,3,0,189,2,0,9,3
2020-08-07,39,18,552,16,1,7,57
2020-08-07,279,45,1555,57,3,8,324
2020-08-07,259,74,2456,84,13,84,333
2020-08-07,71,0,193,18,0,9,71
2020-08-07,6,4,84,6,3,2,10
2020-08-07,24,2,313,5,0,8,26
2020-08-07,0,0,41,0,0,0,0
2020-08-07,0,2,47,0,0,0,2
2020-08-07,211,44,1249,48,3,22,255
2020-08-07,0,0,19,0,0,0,0
2020-08-07,82,22,1314,32,6,36,104
2020-08-07,0,1,56,0,1,4,1
2020-08-07,6,0,96,5,0,6,6
2020-08-07,30,0,265,24,0,9,30
2020-08-07,171,14,1022,73,0,13,185
2020-08-07,1568,478,18941,519,64,814,2046
2020-08-07,0,0,0,0,0,0,0
2020-08-07,214,15,1300,87,0,43,229
2020-08-07,6,0,427,1,0,8,6
2020-08-07,36,2,532,10,1,7,38
2020-08-08,2,0,59,2,0,4,2
2020-08-08,12,4,451,4,0,19,16
2020-08-08,3,0,103,0,0,4,3
2020-08-08,48,0,710,21,0,20,48
2020-08-08,36,13,547,10,2,7,49
2020-08-08,46,19,274,9,0,4,65
2020-08-08,23,0,451,7,0,12,23
2020-08-08,98,21,1434,38,4,44,119
2020-08-08,1,0,19,0,0,0,1
2020-08-08,78,27,1318,21,9,43,105
2020-08-08,0,0,41,0,0,0,0
2020-08-08,6,2,48,0,0,0,8
2020-08-08,37,20,553,16,1,4,57
2020-08-08,0,1,66,0,1,3,1
2020-08-08,2,1,33,2,1,5,3
2020-08-08,1,0,29,0,0,4,1
2020-08-08,19,0,319,6,0,8,19
2020-08-08,487,63,5660,163,11,333,550
2020-08-08,1,5,260,0,2,5,6
2020-08-08,1514,513,19208,476,66,820,2027
2020-08-08,373,77,3316,114,13,108,450
2020-08-08,4,0,427,1,0,6,4
2020-08-08,77,11,1800,29,2,63,88
2020-08-08,0,0,35,0,0,0,0
2020-08-08,13,7,276,3,0,12,20
2020-08-08,163,45,2376,58,6,92,208
2020-08-08,485,69,3755,153,8,137,554
2020-08-08,287,40,1563,54,0,13,327
2020-08-08,26,0,265,7,0,9,26
2020-08-08,1,3,84,0,2,0,4
2020-08-08,63,0,193,7,0,12,63
2020-08-08,13,0,150,1,0,7,13
2020-08-08,4,1,189,3,1,5,5
2020-08-08,48,0,261,14,0,8,48
2020-08-08,3,0,25,1,0,3,3
2020-08-08,6,0,359,2,0,19,6
2020-08-08,176,27,3040,57,6,109,203
2020-08-08,94,1,714,11,0,16,95
2020-08-08,0,1,56,0,1,4,1
2020-08-08,57,0,253,13,0,4,57
2020-08-08,0,0,25,0,0,0,0
2020-08-08,267,56,6149,90,11,324,323
2020-08-08,45,16,683,12,3,30,61
2020-08-08,0,0,25,0,0,0,0
2020-08-08,84,8,666,31,0,41,92
2020-08-08,8,0,96,5,0,2,8
2020-08-08,0,0,0,0,0,0,0
2020-08-08,8,0,51,2,0,1,8
2020-08-08,1,1,52,1,0,0,2
2020-08-08,219,14,1292,74,0,35,233
2020-08-08,167,11,1016,64,1,21,178
2020-08-08,66,27,737,13,1,28,93
2020-08-08,263,62,2435,87,6,96,325
2020-08-08,200,45,1248,48,2,19,245
2020-08-08,0,2,47,0,0,0,2
2020-08-08,1,0,17,1,0,1,1
2020-08-09,36,8,552,10,2,8,44
2020-08-09,184,27,3042,57,4,116,211
2020-08-09,0,0,0,0,0,0,0
2020-08-09,261,65,2443,82,11,104,326
2020-08-09,0,0,35,0,0,0,0
2020-08-09,2,2,33,2,1,5,4
2020-08-09,17,4,451,6,0,20,21
2020-08-09,176,12,1017,65,2,15,188
2020-08-09,0,0,25,0,0,0,0
2020-08-09,86,3,714,11,0,19,89
2020-08-09,16,1,321,5,0,10,17
2020-08-09,265,59,6135,92,12,346,324
2020-08-09,27,1,265,7,0,9,28
2020-08-09,6,1,48,0,0,0,7
2020-08-09,65,25,727,13,3,27,90
2020-08-09,42,15,546,19,2,4,57
2020-08-09,8,2,359,5,0,19,10
2020-08-09,59,0,193,5,0,12,59
2020-08-09,2,0,59,2,0,2,2
2020-08-09,77,5,666,31,0,41,82
2020-08-09,52,0,253,13,0,7,52
2020-08-09,39,17,682,12,2,29,56
2020-08-09,3,0,89,0,0,4,3
2020-08-09,20,1,451,7,1,11,21
2020-08-09,169,45,2340,55,2,92,214
2020-08-09,0,2,65,0,1,2,2
2020-08-09,468,53,5631,152,10,255,521
2020-08-09,1524,468,19199,490,59,819,1992
2020-08-09,3,0,189,2,0,8,3
2020-08-09,82,16,1740,31,2,70,98
2020-08-09,1,0,51,1,0,0,1
2020-08-09,46,8,274,8,3,7,54
2020-08-09,359,95,3300,112,10,123,454
2020-08-09,212,17,1282,72,0,37,229
2020-08-09,191,35,1244,49,2,21,226
2020-08-09,44,4,261,14,1,7,48
2020-08-09,77,25,1318,21,6,47,102
2020-08-09,4,0,25,1,0,3,4
2020-08-09,8,1,51,3,0,2,9
2020-08-09,9,0,96,4,0,4,9
2020-08-09,0,0,84,0,0,0,0
2020-08-09,0,0,41,0,0,0,0
2020-08-09,0,2,47,0,0,0,2
2020-08-09,0,1,56,0,1,5,1
2020-08-09,4,0,427,1,0,5,4
2020-08-09,104,37,1429,39,4,46,141
2020-08-09,1,0,19,0,0,0,1
2020-08-09,13,10,276,4,2,12,23
2020-08-09,486,67,3742,152,6,155,553
2020-08-09,1,6,256,0,3,5,7
2020-08-09,1,0,17,0,0,2,1
2020-08-09,0,0,25,0,0,0,0
2020-08-09,286,29,1547,53,0,13,315
2020-08-09,45,4,710,18,0,16,49
2020-08-09,1,1,29,0,0,4,2
2020-08-09,14,0,150,1,0,6,14
2020-08-10,0,0,25,0,0,0,0
2020-08-10,15,0,150,2,0,8,15
2020-08-10,39,0,261,13,1,7,39
2020-08-10,79,8,666,31,1,46,87
2020-08-10,3,1,33,2,1,5,4
2020-08-10,98,7,714,11,1,17,105
2020-08-10,18,2,319,3,1,10,20
2020-08-10,187,18,3034,56,2,118,205
2020-08-10,50,1,253,15,0,3,51
2020-08-10,468,81,3769,152,8,149,549
2020-08-10,65,34,736,13,4,29,99
2020-08-10,262,62,6132,95,18,345,324
2020-08-10,3,0,427,1,0,9,3
2020-08-10,5,2,48,0,0,0,7
2020-08-10,0,1,56,0,0,6,1
2020-08-10,166,38,2330,56,2,90,204
2020-08-10,0,2,47,0,0,0,2
2020-08-10,84,12,1747,28,4,76,96
2020-08-10,273,37,1555,58,1,10,310
2020-08-10,1538,446,19164,493,58,850,1984
2020-08-10,202,24,1280,71,2,35,226
2020-08-10,7,1,51,2,0,2,8
2020-08-10,1,0,17,1,0,1,1
2020-08-10,4,1,89,1,0,5,5
2020-08-10,0,0,35,0,0,0,0
2020-08-10,441,71,5632,141,13,272,512
2020-08-10,0,0,19,0,0,0,0
2020-08-10,205,65,1249,55,5,19,270
2020-08-10,4,0,189,4,0,6,4
2020-08-10,58,0,193,4,0,13,58
2020-08-10,19,3,451,4,0,21,22
2020-08-10,41,19,671,10,2,30,60
2020-08-10,79,33,1302,23,4,45,112
2020-08-10,1,1,51,1,0,2,2
2020-08-10,358,92,3318,112,8,110,450
2020-08-10,2,2,29,0,0,3,4
2020-08-10,24,1,265,7,0,8,25
2020-08-10,8,2,359,5,0,18,10
2020-08-10,2,6,263,0,2,4,8
2020-08-10,44,5,710,18,0,18,49
2020-08-10,171,7,1013,62,1,19,178
2020-08-10,0,2,65,0,0,6,2
2020-08-10,35,8,493,10,3,3,43
2020-08-10,2,0,59,2,0,1,2
2020-08-10,0,0,41,0,0,0,0
2020-08-10,0,0,0,0,0,0,0
2020-08-10,0,0,25,0,0,0,0
2020-08-10,38,15,274,9,3,5,53
2020-08-10,19,0,451,8,0,4,19
2020-08-10,99,30,1427,36,4,50,129
2020-08-10,265,48,2466,81,8,93,313
2020-08-10,1,0,84,0,0,0,1
2020-08-10,38,15,528,18,2,5,53
2020-08-10,8,0,96,5,0,4,8
2020-08-10,14,7,276,5,1,12,21
2020-08-10,6,0,25,1,0,3,6
2020-08-11,0,0,0,0,0,0,0
2020-08-11,2,2,90,0,1,7,4
2020-08-11,7,2,51,2,0,1,9
2020-08-11,165,16,1012,54,2,26,181
2020-08-11,67,24,741,14,3,31,91
2020-08-11,5,2,48,0,0,0,7
2020-08-11,3,0,33,2,0,5,3
2020-08-11,18,0,451,10,0,5,18
2020-08-11,14,0,321,4,0,11,14
2020-08-11,273,31,1551,56,1,8,304
2020-08-11,59,0,193,5,0,12,59
2020-08-11,1481,470,19342,481,66,871,1951
2020-08-11,0,0,25,0,0,0,0
2020-08-11,204,11,1282,73,1,29,215
2020-08-11,263,73,6146,99,20,325,336
2020-08-11,8,0,359,4,0,19,8
2020-08-11,88,14,1745,31,6,63,102
2020-08-11,260,31,2495,83,4,94,291
2020-08-11,335,101,3358,106,14,114,436
2020-08-11,0,0,25,0,0,0,0
2020-08-11,44,1,254,14,0,5,45
2020-08-11,1,0,17,1,0,1,1
2020-08-11,17,4,451,4,0,21,21
2020-08-11,43,10,503,12,0,4,53
2020-08-11,5,0,25,1,0,1,5
2020-08-11,47,14,685,11,1,27,61
2020-08-11,2,2,427,2,0,8,4
2020-08-11,440,66,5709,141,11,230,506
2020-08-11,170,53,2362,59,7,90,223
2020-08-11,0,0,56,0,0,5,0
2020-08-11,472,56,3903,162,11,139,528
2020-08-11,1,2,29,0,0,3,3
2020-08-11,2,3,268,0,0,3,5
2020-08-11,0,0,19,0,0,0,0
2020-08-11,75,14,666,26,5,40,89
2020-08-11,86,8,714,11,1,11,94
2020-08-11,95,27,1449,34,3,47,122
2020-08-11,0,0,41,0,0,0,0
2020-08-11,0,1,35,0,0,0,1
2020-08-11,14,0,150,3,0,6,14
2020-08-11,9,0,96,3,0,5,9
2020-08-11,54,5,710,16,1,19,59
2020-08-11,170,25,3051,49,3,115,195
2020-08-11,197,65,1249,51,4,15,262
2020-08-11,2,0,189,2,0,6,2
2020-08-11,1,0,84,0,0,1,1
2020-08-11,26,0,265,6,0,7,26
2020-08-11,0,2,65,0,0,6,2
2020-08-11,2,2,59,0,2,2,4
2020-08-11,44,11,274,8,1,7,55
2020-08-11,79,34,1309,25,4,46,113
2020-08-11,13,8,277,5,0,11,21
2020-08-11,2,1,52,1,0,1,3
2020-08-11,0,2,47,0,0,0,2
2020-08-11,36,1,261,12,0,14,37
2020-08-11,41,11,552,16,2,5,52
2020-08-12,0,0,0,0,0,0,0
2020-08-12,92,21,1804,31,4,53,113
2020-08-12,5,2,48,0,0,0,7
2020-08-12,37,9,274,6,0,7,46
2020-08-12,26,1,265,6,0,8,27
2020-08-12,0,1,65,0,0,2,1
2020-08-12,244,76,6163,98,18,298,320
2020-08-12,438,42,5738,143,6,211,480
2020-08-12,155,17,1015,50,2,27,172
2020-08-12,49,14,684,11,1,25,63
2020-08-12,307,84,3370,94,12,117,391
2020-08-12,0,0,25,0,0,0,0
2020-08-12,468,81,3962,159,12,137,549
2020-08-12,18,0,451,11,0,2,18
2020-08-12,12,12,276,3,1,11,24
2020-08-12,187,15,1286,75,2,31,202
2020-08-12,2,0,84,0,0,4,2
2020-08-12,11,4,321,4,0,8,15
2020-08-12,62,34,739,14,3,28,96
2020-08-12,16,0,150,4,0,4,16
2020-08-12,2,0,59,2,0,1,2
2020-08-12,172,46,2371,57,3,77,218
2020-08-12,0,0,25,0,0,0,0
2020-08-12,0,2,47,0,0,0,2
2020-08-12,4,0,438,2,0,3,4
2020-08-12,186,48,1250,50,4,19,234
2020-08-12,1415,472,19364,460,56,842,1887
2020-08-12,3,2,266,1,1,4,5
2020-08-12,0,0,41,0,0,0,0
2020-08-12,1,2,29,1,0,3,3
2020-08-12,0,1,56,0,0,3,1
2020-08-12,41,0,259,15,0,10,41
2020-08-12,6,0,351,3,0,24,6
2020-08-12,51,0,193,6,0,9,51
2020-08-12,100,28,1452,36,7,41,128
2020-08-12,73,6,666,26,1,42,79
2020-08-12,0,0,19,0,0,0,0
2020-08-12,5,0,51,2,0,2,5
2020-08-12,260,39,1568,57,2,9,299
2020-08-12,8,0,96,6,0,4,8
2020-08-12,43,1,253,12,1,5,44
2020-08-12,2,0,189,2,0,8,2
2020-08-12,253,38,2481,85,6,81,291
2020-08-12,167,25,3079,50,1,109,192
2020-08-12,84,6,714,8,1,11,90
2020-08-12,17,6,451,5,0,18,23
2020-08-12,76,29,1319,26,6,40,105
2020-08-12,37,9,555,15,1,4,46
2020-08-12,2,0,51,2,0,0,2
2020-08-12,1,0,17,1,0,1,1
2020-08-12,6,1,116,3,0,7,7
2020-08-12,0,0,35,0,0,0,0
2020-08-12,38,10,519,11,2,8,48
2020-08-12,46,4,710,16,1,19,50
2020-08-12,2,0,33,1,0,6,2
2020-08-12,6,0,25,2,0,0,6
2020-08-13,97,15,1445,39,2,40,112
2020-08-13,0,0,19,0,0,0,0
2020-08-13,145,14,1013,52,3,30,159
2020-08-13,0,0,25,0,0,0,0
2020-08-13,21,0,451,10,0,2,21
2020-08-13,31,9,274,5,0,10,40
2020-08-13,197,65,1318,57,8,9,262
2020-08-13,171,20,3135,57,2,98,191
2020-08-13,0,0,0,0,0,0,0
2020-08-13,54,3,729,18,0,21,57
2020-08-13,2,4,268,1,1,6,6
2020-08-13,0,2,47,0,0,0,2
2020-08-13,1,0,17,1,0,0,1
2020-08-13,97,13,1777,33,1,59,110
2020-08-13,4,1,29,2,0,2,5
2020-08-13,3,2,116,0,0,4,5
2020-08-13,481,70,3947,155,7,152,551
2020-08-13,165,40,2359,61,4,89,205
2020-08-13,244,65,6389,93,19,309,309
2020-08-13,250,37,1583,54,2,9,287
2020-08-13,172,16,1308,78,2,37,188
2020-08-13,15,0,150,4,0,8,15
2020-08-13,41,8,551,16,0,5,49
2020-08-13,6,0,438,1,0,2,6
2020-08-13,35,0,259,13,0,14,35
2020-08-13,0,0,59,0,0,5,0
2020-08-13,314,89,4371,91,12,117,403
2020-08-13,9,1,326,4,1,9,10
2020-08-13,0,0,65,0,0,3,0
2020-08-13,11,12,276,2,1,12,23
2020-08-13,44,1,253,13,0,4,45
2020-08-13,49,2,193,6,0,10,51
2020-08-13,7,0,51,2,0,3,7
2020-08-13,1393,520,19575,456,72,977,1913
2020-08-13,68,4,666,22,1,43,72
2020-08-13,5,0,96,4,0,5,5
2020-08-13,0,1,56,0,0,3,1
2020-08-13,6,0,359,3,0,20,6
2020-08-13,49,17,699,14,2,27,66
2020-08-13,0,0,25,0,0,0,0
2020-08-13,2,0,189,2,0,7,2
2020-08-13,0,0,35,0,0,0,0
2020-08-13,75,30,1321,28,7,48,105
2020-08-13,2,0,84,0,0,1,2
2020-08-13,12,1,312,3,0,26,13
2020-08-13,0,0,41,0,0,0,0
2020-08-13,1,0,51,1,0,1,1
2020-08-13,8,0,25,2,0,1,8
2020-08-13,42,4,504,11,0,7,46
2020-08-13,86,4,682,8,1,13,90
2020-08-13,240,29,2556,87,5,97,269
2020-08-13,53,23,736,13,2,28,76
2020-08-13,5,0,48,0,0,0,5
2020-08-13,436,50,5713,152,11,225,486
2020-08-13,25,0,265,5,0,7,25
2020-08-13,15,3,451,5,0,20,18
2020-08-14,0,4,52,0,1,1,4
2020-08-14,192,51,1308,55,8,13,243
2020-08-14,2,4,268,1,1,6,6
2020-08-14,7,0,447,2,0,4,7
2020-08-14,3,1,33,2,0,5,4
2020-08-14,1,0,189,1,0,10,1
2020-08-14,41,3,253,13,1,6,44
2020-08-14,0,0,25,0,0,0,0
2020-08-14,63,4,666,21,1,46,67
2020-08-14,149,17,1012,54,4,25,166
2020-08-14,9,12,276,2,0,10,21
2020-08-14,4,0,29,1,0,4,4
2020-08-14,0,0,0,0,0,0,0
2020-08-14,53,22,740,12,2,28,75
2020-08-14,7,1,51,1,0,4,8
2020-08-14,172,14,1305,75,1,24,186
2020-08-14,93,23,1442,37,2,51,116
2020-08-14,94,13,1820,34,1,62,107
2020-08-14,2,0,115,0,0,4,2
2020-08-14,20,0,451,10,0,1,20
2020-08-14,0,0,35,0,0,0,0
2020-08-14,1,0,17,1,0,0,1
2020-08-14,5,1,48,0,0,0,6
2020-08-14,1,0,59,1,0,2,1
2020-08-14,227,73,6548,90,13,334,300
2020-08-14,172,38,2358,61,7,92,210
2020-08-14,36,1,259,12,0,13,37
2020-08-14,0,0,65,0,0,4,0
2020-08-14,77,5,682,10,0,13,82
2020-08-14,2,1,84,0,1,1,3
2020-08-14,249,31,2537,85,4,95,280
2020-08-14,9,0,25,2,0,1,9
2020-08-14,164,16,3139,57,3,95,180
2020-08-14,13,6,329,4,1,13,19
2020-08-14,30,17,274,6,3,5,47
2020-08-14,17,3,451,5,0,22,20
2020-08-14,5,3,359,3,0,19,8
2020-08-14,249,23,1595,55,2,11,272
2020-08-14,78,22,1321,29,5,52,100
2020-08-14,48,2,729,17,0,16,50
2020-08-14,4,0,96,2,0,4,4
2020-08-14,45,9,564,13,2,6,54
2020-08-14,1357,556,19573,441,75,865,1913
2020-08-14,0,2,47,0,0,0,2
2020-08-14,0,0,41,0,0,0,0
2020-08-14,434,60,5616,138,12,221,494
2020-08-14,27,1,265,5,0,8,28
2020-08-14,49,6,564,18,1,5,55
2020-08-14,0,1,25,0,0,0,1
2020-08-14,13,0,150,4,0,7,13
2020-08-14,0,1,56,0,0,4,1
2020-08-14,58,10,697,15,2,28,68
2020-08-14,475,61,3769,145,13,141,536
2020-08-14,40,2,193,5,0,12,42
2020-08-14,315,95,3365,86,15,108,410
2020-08-14,0,0,19,0,0,0,0
2020-08-15,2,6,263,1,1,7,8
2020-08-15,1,0,59,1,0,4,1
2020-08-15,249,45,2532,83,7,102,294
2020-08-15,0,0,35,0,0,0,0
2020-08-15,10,1,150,4,0,5,11
2020-08-15,1,0,17,0,0,1,1
2020-08-15,221,52,6625,83,9,324,273
2020-08-15,2,1,84,0,1,2,3
2020-08-15,68,3,667,10,0,7,71
2020-08-15,6,4,359,4,0,18,10
2020-08-15,3,0,29,0,0,4,3
2020-08-15,2,0,48,0,0,0,2
2020-08-15,9,0,561,3,0,8,9
2020-08-15,2,0,33,1,0,5,2
2020-08-15,422,73,5800,133,13,220,495
2020-08-15,175,11,1307,71,0,27,186
2020-08-15,57,17,677,15,0,30,74
2020-08-15,0,1,52,0,0,3,1
2020-08-15,2,0,115,0,0,1,2
2020-08-15,198,49,1308,60,5,12,247
2020-08-15,34,0,253,13,0,8,34
2020-08-15,0,0,56,0,0,0,0
2020-08-15,94,24,1782,40,5,51,118
2020-08-15,0,2,47,0,0,0,2
2020-08-15,48,3,557,14,0,4,51
2020-08-15,1341,573,19553,442,85,837,1914
2020-08-15,0,0,41,0,0,0,0
2020-08-15,4,0,96,2,0,3,4
2020-08-15,7,0,51,1,0,4,7
2020-08-15,28,26,274,7,1,6,54
2020-08-15,18,3,451,6,0,23,21
2020-08-15,62,4,666,22,0,46,66
2020-08-15,9,9,276,3,0,10,18
2020-08-15,52,1,729,16,0,23,53
2020-08-15,140,24,1014,48,5,34,164
2020-08-15,2,0,189,2,0,11,2
2020-08-15,0,0,19,0,0,0,0
2020-08-15,42,3,193,5,0,11,45
2020-08-15,302,82,3325,94,11,100,384
2020-08-15,58,22,742,14,5,34,80
2020-08-15,181,48,2381,65,12,88,229
2020-08-15,95,24,1450,36,7,46,119
2020-08-15,20,0,451,10,0,5,20
2020-08-15,170,8,3117,56,1,95,178
2020-08-15,0,1,25,0,0,0,1
2020-08-15,27,0,265,5,0,9,27
2020-08-15,0,0,0,0,0,0,0
2020-08-15,0,1,66,0,0,4,1
2020-08-15,15,4,330,4,2,9,19
2020-08-15,245,30,1549,54,5,16,275
2020-08-15,71,27,1308,25,8,47,98
2020-08-15,445,96,3781,134,18,148,541
2020-08-15,36,1,259,12,0,14,37
2020-08-15,9,0,25,2,0,1,9
2020-08-15,0,0,25,0,0,0,0
2020-08-15,42,3,567,18,0,9,45
2020-08-16,21,0,451,9,0,4,21
2020-08-16,9,0,561,3,0,7,9
2020-08-16,171,10,1289,70,0,25,181
2020-08-16,3,0,29,0,0,4,3
2020-08-16,85,23,1740,34,4,62,108
2020-08-16,0,2,47,0,0,0,2
2020-08-16,2,0,189,2,0,8,2
2020-08-16,13,5,331,4,2,9,18
2020-08-16,47,8,552,13,1,2,55
2020-08-16,10,12,276,3,1,13,22
2020-08-16,0,0,25,0,0,0,0
2020-08-16,0,0,35,0,0,0,0
2020-08-16,235,39,1573,56,3,11,274
2020-08-16,2,4,259,1,1,7,6
2020-08-16,45,0,193,7,0,9,45
2020-08-16,58,13,670,16,0,27,71
2020-08-16,31,19,274,9,0,5,50
2020-08-16,0,0,56,0,0,4,0
2020-08-16,437,90,3764,130,18,149,527
2020-08-16,71,28,1306,23,8,51,99
2020-08-16,0,0,19,0,0,0,0
2020-08-16,35,1,259,14,0,8,36
2020-08-16,22,3,451,7,0,21,25
2020-08-16,7,0,51,2,0,3,7
2020-08-16,0,0,25,0,0,0,0
2020-08-16,0,36,253,0,12,5,36
2020-08-16,0,0,41,0,0,0,0
2020-08-16,98,31,1463,36,6,41,129
2020-08-16,1,0,59,1,0,5,1
2020-08-16,54,2,729,16,0,21,56
2020-08-16,2,1,33,1,1,6,3
2020-08-16,188,56,2371,63,10,93,244
2020-08-16,296,97,3340,90,14,92,393
2020-08-16,63,20,738,14,2,31,83
2020-08-16,8,0,359,2,0,17,8
2020-08-16,1,2,84,0,1,2,3
2020-08-16,27,1,265,4,0,9,28
2020-08-16,0,0,17,0,0,1,0
2020-08-16,2,1,48,0,0,0,3
2020-08-16,216,74,6615,93,12,324,290
2020-08-16,5,0,96,3,0,5,5
2020-08-16,251,48,2598,80,8,99,299
2020-08-16,1,1,108,0,0,4,2
2020-08-16,414,64,5716,132,17,209,478
2020-08-16,0,1,65,0,1,2,1
2020-08-16,9,0,150,4,0,8,9
2020-08-16,0,0,0,0,0,0,0
2020-08-16,68,2,667,9,0,14,70
2020-08-16,59,1,666,22,1,52,60
2020-08-16,146,26,1007,50,6,36,172
2020-08-16,9,0,25,1,0,2,9
2020-08-16,40,6,570,16,1,7,46
2020-08-16,173,11,3074,53,2,99,184
2020-08-16,188,63,1306,60,5,15,251
2020-08-16,1352,555,19678,436,85,881,1907
2020-08-16,0,1,51,0,0,3,1
2020-08-17,4,0,30,0,0,4,4
2020-08-17,12,15,276,3,1,14,27
2020-08-17,205,52,2335,69,10,82,257
2020-08-17,0,2,47,0,0,0,2
2020-08-17,0,1,65,0,0,1,1
2020-08-17,59,3,666,21,0,55,62
2020-08-17,441,80,3851,130,16,138,521
2020-08-17,196,65,1300,59,3,13,261
2020-08-17,25,13,274,6,2,7,38
2020-08-17,33,1,253,11,0,7,34
2020-08-17,36,1,259,13,0,14,37
2020-08-17,22,0,451,9,0,5,22
2020-08-17,300,100,3304,89,15,91,400
2020-08-17,170,13,1297,70,0,31,183
2020-08-17,0,0,0,0,0,0,0
2020-08-17,44,1,193,6,0,10,45
2020-08-17,2,1,33,1,1,5,3
2020-08-17,235,40,1593,59,4,11,275
2020-08-17,0,0,56,0,0,2,0
2020-08-17,39,6,560,19,1,6,45
2020-08-17,0,0,25,0,0,0,0
2020-08-17,20,3,451,6,0,25,23
2020-08-17,57,14,681,15,1,22,71
2020-08-17,6,0,96,5,0,5,6
2020-08-17,1,2,127,0,0,7,3
2020-08-17,0,0,25,0,0,0,0
2020-08-17,1,0,59,1,0,7,1
2020-08-17,65,25,732,11,2,30,90
2020-08-17,2,0,48,0,0,0,2
2020-08-17,170,18,3060,51,1,123,188
2020-08-17,97,29,1456,34,7,43,126
2020-08-17,1,0,84,0,0,3,1
2020-08-17,0,0,41,0,0,0,0
2020-08-17,83,26,1740,35,4,71,109
2020-08-17,0,0,51,0,0,3,0
2020-08-17,0,0,19,0,0,0,0
2020-08-17,6,0,359,4,0,22,6
2020-08-17,2,2,274,1,0,6,4
2020-08-17,250,44,2533,81,7,110,294
2020-08-17,1378,518,19489,435,69,854,1896
2020-08-17,0,0,189,0,0,8,0
2020-08-17,0,0,17,0,0,2,0
2020-08-17,70,26,1298,25,6,47,96
2020-08-17,0,0,35,0,0,0,0
2020-08-17,144,25,1013,51,4,30,169
2020-08-17,62,1,729,19,0,23,63
2020-08-17,9,0,25,1,0,2,9
2020-08-17,9,0,150,4,0,7,9
2020-08-17,68,3,682,12,0,17,71
2020-08-17,13,4,324,6,2,8,17
2020-08-17,7,0,51,2,0,2,7
2020-08-17,44,8,507,12,4,5,52
2020-08-17,27,1,265,5,0,10,28
2020-08-17,409,82,5727,124,12,225,491
2020-08-17,8,0,569,4,0,6,8
2020-08-17,229,74,6618,97,23,335,303
2020-08-18,58,1,729,20,0,17,59
2020-08-18,173,11,3101,54,1,108,184
2020-08-18,0,0,25,0,0,0,0
2020-08-18,6,0,51,1,0,2,6
2020-08-18,96,34,1473,28,5,47,130
2020-08-18,24,0,451,8,0,0,24
2020-08-18,15,2,451,5,0,21,17
2020-08-18,9,0,150,4,0,8,9
2020-08-18,301,108,3389,97,13,84,409
2020-08-18,36,3,254,12,1,7,39
2020-08-18,6,0,561,4,0,5,6
2020-08-18,0,7,261,0,2,3,7
2020-08-18,10,10,276,2,0,16,20
2020-08-18,26,0,265,4,0,11,26
2020-08-18,0,0,41,0,0,0,0
2020-08-18,200,50,2375,70,5,92,250
2020-08-18,43,5,514,11,1,5,48
2020-08-18,0,0,51,0,0,3,0
2020-08-18,29,11,274,7,0,5,40
2020-08-18,35,0,259,13,0,5,35
2020-08-18,3,2,33,2,1,3,5
2020-08-18,0,0,35,0,0,0,0
2020-08-18,419,76,5733,124,14,215,495
2020-08-18,440,89,3870,125,12,148,529
2020-08-18,0,2,47,0,0,0,2
2020-08-18,238,87,6637,85,20,305,325
2020-08-18,248,57,2582,81,7,104,305
2020-08-18,10,1,25,2,0,1,11
2020-08-18,1,0,84,0,0,3,1
2020-08-18,53,15,696,14,1,26,68
2020-08-18,183,58,1306,58,5,8,241
2020-08-18,1378,591,19641,433,55,864,1969
2020-08-18,0,0,19,0,0,0,0
2020-08-18,1,0,189,1,0,11,1
2020-08-18,96,36,1766,37,5,51,132
2020-08-18,13,6,324,4,2,7,19
2020-08-18,0,0,56,0,0,4,0
2020-08-18,0,0,25,0,0,0,0
2020-08-18,0,0,17,0,0,2,0
2020-08-18,59,4,682,12,0,17,63
2020-08-18,0,0,0,0,0,0,0
2020-08-18,0,2,65,0,0,5,2
2020-08-18,41,2,193,5,1,9,43
2020-08-18,7,1,96,3,1,4,8
2020-08-18,64,34,736,11,3,30,98
2020-08-18,2,1,48,0,0,0,3
2020-08-18,0,2,108,0,0,2,2
2020-08-18,43,6,565,17,0,7,49
2020-08-18,79,37,1308,27,8,52,116
2020-08-18,150,22,1012,54,4,22,172
2020-08-18,1,0,59,1,0,6,1
2020-08-18,233,27,1578,62,1,11,260
2020-08-18,3,2,29,0,0,4,5
2020-08-18,62,8,666,22,3,50,70
2020-08-18,6,0,359,2,0,25,6
2020-08-18,158,11,1298,68,0,42,169
2020-08-19,418,82,3862,123,7,146,500
2020-08-19,53,7,691,13,0,30,60
2020-08-19,0,1,135,0,0,3,1
2020-08-19,1347,551,19790,428,53,852,1898
2020-08-19,27,9,274,8,0,5,36
2020-08-19,0,0,17,0,0,2,0
2020-08-19,93,24,1476,26,3,42,117
2020-08-19,0,0,25,0,0,0,0
2020-08-19,164,20,3130,46,2,112,184
2020-08-19,167,12,1319,66,0,39,179
2020-08-19,0,2,47,0,0,0,2
2020-08-19,77,48,1317,31,9,49,125
2020-08-19,0,0,19,0,0,0,0
2020-08-19,400,59,5788,118,8,223,459
2020-08-19,0,0,41,0,0,0,0
2020-08-19,6,0,150,3,0,7,6
2020-08-19,26,0,265,4,0,10,26
2020-08-19,0,0,0,0,0,0,0
2020-08-19,40,2,193,7,1,7,42
2020-08-19,1,0,189,1,0,9,1
2020-08-19,41,5,577,18,0,6,46
2020-08-19,3,1,33,2,0,5,4
2020-08-19,40,6,526,10,1,7,46
2020-08-19,51,0,729,18,0,16,51
2020-08-19,9,0,25,1,0,2,9
2020-08-19,61,33,744,9,2,28,94
2020-08-19,0,0,56,0,0,4,0
2020-08-19,0,0,25,0,0,0,0
2020-08-19,60,3,682,12,0,15,63
2020-08-19,267,121,6028,90,18,89,388
2020-08-19,6,0,561,4,0,7,6
2020-08-19,149,25,1013,54,3,28,174
2020-08-19,23,0,451,7,0,8,23
2020-08-19,7,0,96,3,0,3,7
2020-08-19,2,2,48,0,0,0,4
2020-08-19,54,7,666,20,3,51,61
2020-08-19,1,0,84,0,0,3,1
2020-08-19,232,48,6742,91,13,283,280
2020-08-19,0,0,51,0,0,5,0
2020-08-19,28,0,259,11,0,11,28
2020-08-19,15,4,451,5,0,19,19
2020-08-19,2,0,59,2,0,4,2
2020-08-19,5,1,359,3,1,19,6
2020-08-19,0,2,267,0,0,4,2
2020-08-19,1,0,65,1,0,5,1
2020-08-19,2,2,29,0,0,4,4
2020-08-19,177,45,1308,57,5,13,222
2020-08-19,95,38,1864,39,6,47,133
2020-08-19,202,56,2410,68,4,95,258
2020-08-19,36,3,253,13,1,5,39
2020-08-19,229,57,2553,77,7,112,286
2020-08-19,4,0,51,0,0,1,4
2020-08-19,245,28,1592,61,3,15,273
2020-08-19,12,5,324,5,0,6,17
2020-08-19,0,0,35,0,0,0,0
2020-08-19,12,13,276,2,0,11,25
2020-08-20,4,0,51,0,0,0,4
2020-08-20,0,3,51,0,2,2,3
2020-08-20,0,0,25,0,0,0,0
2020-08-20,63,3,715,13,0,14,66
2020-08-20,204,50,2438,73,4,91,254
2020-08-20,2,0,29,0,0,4,2
2020-08-20,91,29,1478,25,3,47,120
2020-08-20,397,46,5738,117,9,211,443
2020-08-20,0,0,41,0,0,0,0
2020-08-20,0,0,25,0,0,0,0
2020-08-20,252,123,3414,81,21,105,375
2020-08-20,43,1,193,9,0,5,44
2020-08-20,27,11,274,7,1,6,38
2020-08-20,25,0,265,4,0,9,25
2020-08-20,0,0,65,0,0,4,0
2020-08-20,0,2,267,0,0,4,2
2020-08-20,40,6,571,10,0,4,46
2020-08-20,141,37,1011,48,3,28,178
2020-08-20,25,0,451,5,0,5,25
2020-08-20,10,0,96,9,0,4,10
2020-08-20,155,30,3110,46,5,101,185
2020-08-20,17,2,451,5,0,19,19
2020-08-20,5,0,561,4,0,7,5
2020-08-20,8,0,25,1,0,2,8
2020-08-20,1,0,19,0,0,0,1
2020-08-20,106,19,1867,41,3,53,125
2020-08-20,5,0,150,2,0,6,5
2020-08-20,11,8,324,5,2,7,19
2020-08-20,43,5,567,18,1,4,48
2020-08-20,29,0,259,13,0,6,29
2020-08-20,45,1,729,15,0,22,46
2020-08-20,54,9,666,18,1,51,63
2020-08-20,1,0,84,0,0,2,1
2020-08-20,220,64,6642,89,12,302,284
2020-08-20,1280,509,19794,420,58,823,1789
2020-08-20,0,0,0,0,0,0,0
2020-08-20,171,12,1308,61,1,38,183
2020-08-20,386,75,3878,116,11,137,461
2020-08-20,2,1,189,2,1,8,3
2020-08-20,0,0,56,0,0,4,0
2020-08-20,232,46,2516,77,7,92,278
2020-08-20,246,27,1578,60,3,14,273
2020-08-20,64,28,744,11,2,31,92
2020-08-20,12,6,276,1,1,10,18
2020-08-20,3,2,48,0,0,0,5
2020-08-20,0,0,35,0,0,0,0
2020-08-20,0,0,17,0,0,2,0
2020-08-20,180,40,1309,58,4,15,220
2020-08-20,0,2,47,0,0,0,2
2020-08-20,4,1,33,1,1,3,5
2020-08-20,73,57,1318,30,15,42,130
2020-08-20,56,9,701,19,1,26,65
2020-08-20,2,0,59,2,0,3,2
2020-08-20,2,1,123,0,0,2,3
2020-08-20,2,1,208,2,0,15,3
2020-08-20,33,1,253,15,1,4,34
2020-08-21,178,56,1308,54,6,14,234
2020-08-21,0,3,51,0,2,2,3
2020-08-21,100,16,1482,27,1,57,116
2020-08-21,0,0,41,0,0,0,0
2020-08-21,0,0,25,0,0,0,0
2020-08-21,0,2,65,0,0,2,2
2020-08-21,4,0,51,0,0,0,4
2020-08-21,1,1,84,0,0,3,2
2020-08-21,42,4,556,15,0,9,46
2020-08-21,224,45,2501,72,7,90,269
2020-08-21,207,53,2459,69,8,82,260
2020-08-21,0,0,35,0,0,0,0
2020-08-21,53,24,741,13,3,29,77
2020-08-21,140,24,1011,51,5,26,164
2020-08-21,33,0,253,13,0,6,33
2020-08-21,152,11,1289,58,1,33,163
2020-08-21,4,2,33,1,1,4,6
2020-08-21,39,5,522,9,0,6,44
2020-08-21,58,8,689,21,0,28,66
2020-08-21,247,105,3381,84,13,94,352
2020-08-21,19,0,451,5,0,8,19
2020-08-21,0,0,56,0,0,5,0
2020-08-21,49,1,729,15,0,22,50
2020-08-21,2,1,189,1,0,11,3
2020-08-21,11,7,276,1,3,15,18
2020-08-21,98,20,1856,34,3,59,118
2020-08-21,220,66,6626,91,14,282,286
2020-08-21,29,0,259,11,0,9,29
2020-08-21,9,1,96,8,0,4,10
2020-08-21,26,0,265,6,0,9,26
2020-08-21,365,81,3908,117,10,157,446
2020-08-21,52,7,666,21,2,46,59
2020-08-21,15,1,451,5,0,18,16
2020-08-21,155,23,3134,45,4,97,178
2020-08-21,1,6,249,1,1,5,7
2020-08-21,1,3,48,0,0,0,4
2020-08-21,74,44,1312,39,12,40,118
2020-08-21,8,0,25,2,0,1,8
2020-08-21,1,0,29,0,0,4,1
2020-08-21,58,3,715,11,0,17,61
2020-08-21,30,12,274,9,0,5,42
2020-08-21,5,0,561,2,0,6,5
2020-08-21,0,0,25,0,0,0,0
2020-08-21,246,37,1600,59,4,14,283
2020-08-21,0,0,17,0,0,2,0
2020-08-21,1,0,59,1,0,3,1
2020-08-21,0,2,47,0,0,0,2
2020-08-21,13,3,320,5,0,7,16
2020-08-21,0,0,0,0,0,0,0
2020-08-21,5,0,150,2,0,7,5
2020-08-21,3,0,208,3,0,13,3
2020-08-21,392,56,5786,110,8,217,448
2020-08-21,3,1,135,0,0,2,4
2020-08-21,38,1,193,10,0,4,39
2020-08-21,1,0,19,0,0,0,1
2020-08-21,1247,479,20155,412,54,817,1726
2020-08-22,0,0,25,0,0,0,0
2020-08-22,0,2,47,0,0,0,2
2020-08-22,81,36,1320,29,10,37,117
2020-08-22,99,19,1470,26,2,55,118
2020-08-22,17,1,265,4,0,8,18
2020-08-22,11,3,276,1,0,14,14
2020-08-22,0,2,51,0,1,2,2
2020-08-22,3,1,51,0,0,1,4
2020-08-22,0,0,65,0,0,3,0
2020-08-22,135,15,1007,43,0,34,150
2020-08-22,351,68,3855,109,9,157,419
2020-08-22,15,4,331,6,1,8,19
2020-08-22,0,0,19,0,0,0,0
2020-08-22,7,0,25,2,0,0,7
2020-08-22,0,0,56,0,0,5,0
2020-08-22,246,29,1581,59,1,8,275
2020-08-22,1219,482,19781,389,55,856,1701
2020-08-22,56,11,680,13,2,22,67
2020-08-22,0,0,29,0,0,4,0
2020-08-22,171,52,1307,57,2,13,223
2020-08-22,32,1,253,13,0,2,33
2020-08-22,36,3,193,8,0,5,39
2020-08-22,0,0,25,0,0,0,0
2020-08-22,155,8,1291,57,0,39,163
2020-08-22,222,49,6642,87,13,282,271
2020-08-22,152,18,3112,43,1,101,170
2020-08-22,1,0,84,0,0,3,1
2020-08-22,0,0,0,0,0,0,0
2020-08-22,380,46,5769,111,5,203,426
2020-08-22,233,86,3352,83,15,107,319
2020-08-22,0,0,17,0,0,2,0
2020-08-22,6,0,96,4,0,5,6
2020-08-22,2,0,48,0,0,0,2
2020-08-22,230,40,2471,69,8,104,270
2020-08-22,196,52,2434,65,9,86,248
2020-08-22,61,5,682,11,0,11,66
2020-08-22,3,2,113,0,0,2,5
2020-08-22,49,19,743,15,1,30,68
2020-08-22,54,4,666,19,0,51,58
2020-08-22,4,2,33,2,0,5,6
2020-08-22,0,0,41,0,0,0,0
2020-08-22,3,0,150,1,0,4,3
2020-08-22,46,1,729,16,0,18,47
2020-08-22,31,6,274,6,0,6,37
2020-08-22,1,4,271,1,1,2,5
2020-08-22,16,0,451,4,0,19,16
2020-08-22,2,0,189,1,0,11,2
2020-08-22,1,0,59,1,0,0,1
2020-08-22,31,0,259,13,0,10,31
2020-08-22,4,1,208,4,0,13,5
2020-08-22,24,0,451,8,0,7,24
2020-08-22,90,19,1837,34,2,58,109
2020-08-22,0,0,35,0,0,0,0
2020-08-22,7,1,561,3,1,8,8
2020-08-22,39,2,549,14,1,7,41
2020-08-22,39,10,512,10,1,5,49
2020-08-23,218,33,2402,66,7,96,251
2020-08-23,0,0,0,0,0,0,0
2020-08-23,42,1,729,15,0,19,43
2020-08-23,11,2,276,1,1,12,13
2020-08-23,0,0,41,0,0,0,0
2020-08-23,5,0,208,1,0,13,5
2020-08-23,40,9,483,6,1,4,49
2020-08-23,211,78,6630,84,16,302,289
2020-08-23,51,9,666,21,2,53,60
2020-08-23,388,58,5739,116,8,225,446
2020-08-23,79,32,1315,25,11,38,111
2020-08-23,1200,467,19582,375,59,892,1667
2020-08-23,6,0,25,2,0,1,6
2020-08-23,30,1,253,13,0,1,31
2020-08-23,133,27,1003,39,2,32,160
2020-08-23,21,0,451,7,0,11,21
2020-08-23,3,2,132,0,0,4,5
2020-08-23,0,0,29,0,0,4,0
2020-08-23,246,27,1575,57,2,17,273
2020-08-23,47,15,733,15,1,28,62
2020-08-23,7,0,96,5,0,6,7
2020-08-23,1,4,271,1,1,2,5
2020-08-23,43,2,546,15,0,5,45
2020-08-23,1,0,84,0,0,6,1
2020-08-23,15,1,451,5,1,20,16
2020-08-23,224,116,3270,82,16,103,340
2020-08-23,92,17,1823,37,4,69,109
2020-08-23,95,16,1450,27,2,61,111
2020-08-23,51,6,682,12,0,15,57
2020-08-23,33,1,259,10,0,5,34
2020-08-23,0,0,19,0,0,0,0
2020-08-23,0,0,25,0,0,0,0
2020-08-23,5,2,33,2,0,5,7
2020-08-23,1,0,189,1,0,10,1
2020-08-23,157,50,1303,53,3,16,207
2020-08-23,0,1,66,0,0,5,1
2020-08-23,187,46,2419,64,6,97,233
2020-08-23,1,0,48,0,0,0,1
2020-08-23,18,1,265,4,0,14,19
2020-08-23,57,8,673,14,4,21,65
2020-08-23,0,0,35,0,0,0,0
2020-08-23,7,0,561,3,0,7,7
2020-08-23,0,0,56,0,0,4,0
2020-08-23,0,0,51,0,0,2,0
2020-08-23,1,0,59,1,0,3,1
2020-08-23,14,5,319,7,0,5,19
2020-08-23,27,17,274,9,0,4,44
2020-08-23,35,3,193,8,0,6,38
2020-08-23,3,0,150,1,0,5,3
2020-08-23,154,15,3102,42,0,99,169
2020-08-23,3,0,51,0,0,2,3
2020-08-23,356,71,3841,98,5,176,427
2020-08-23,0,0,18,0,0,1,0
2020-08-23,148,6,1296,53,0,42,154
2020-08-23,0,0,25,0,0,0,0
2020-08-23,0,2,47,0,0,0,2
2020-08-24,0,0,25,0,0,0,0
2020-08-24,222,96,3309,79,15,94,318
2020-08-24,24,0,451,8,0,10,24
2020-08-24,0,0,25,0,0,0,0
2020-08-24,0,0,41,0,0,0,0
2020-08-24,0,0,56,0,0,4,0
2020-08-24,0,0,29,0,0,4,0
2020-08-24,0,2,51,0,1,1,2
2020-08-24,228,81,6610,83,16,302,309
2020-08-24,7,0,25,2,0,1,7
2020-08-24,17,1,265,3,0,18,18
2020-08-24,1186,450,19226,373,53,917,1636
2020-08-24,244,28,1590,54,0,20,272
2020-08-24,161,52,1294,41,3,16,213
2020-08-24,1,1,84,0,0,6,2
2020-08-24,29,1,253,12,0,2,30
2020-08-24,33,2,193,4,1,10,35
2020-08-24,11,2,451,5,0,21,13
2020-08-24,61,9,683,13,1,22,70
2020-08-24,154,7,1302,56,0,40,161
2020-08-24,91,19,1452,29,2,58,110
2020-08-24,11,10,276,1,1,9,21
2020-08-24,13,4,314,5,0,4,17
2020-08-24,2,0,150,1,0,8,2
2020-08-24,179,48,2396,69,7,92,227
2020-08-24,95,22,1806,35,3,75,117
2020-08-24,0,0,0,0,0,0,0
2020-08-24,1,4,271,1,1,2,5
2020-08-24,1,0,189,1,0,9,1
2020-08-24,0,0,19,0,0,0,0
2020-08-24,1,0,48,0,0,0,1
2020-08-24,42,4,531,9,0,5,46
2020-08-24,54,4,666,23,1,45,58
2020-08-24,76,25,1321,36,7,33,101
2020-08-24,131,22,1003,39,4,28,153
2020-08-24,5,1,208,1,0,13,6
2020-08-24,0,0,17,0,0,2,0
2020-08-24,7,0,561,3,0,5,7
2020-08-24,0,2,47,0,0,0,2
2020-08-24,49,8,686,12,0,16,57
2020-08-24,0,0,66,0,0,6,0
2020-08-24,335,67,3914,109,5,184,402
2020-08-24,3,2,127,0,0,3,5
2020-08-24,221,35,2458,64,3,111,256
2020-08-24,33,0,259,9,0,4,33
2020-08-24,147,16,3064,41,2,119,163
2020-08-24,40,1,729,14,1,24,41
2020-08-24,44,28,737,15,6,27,72
2020-08-24,5,1,33,2,1,4,6
2020-08-24,24,6,274,7,2,8,30
2020-08-24,4,0,51,0,0,4,4
2020-08-24,39,2,538,12,1,7,41
2020-08-24,8,0,96,4,0,8,8
2020-08-24,385,74,5748,113,15,242,459
2020-08-24,0,0,59,0,0,4,0
2020-08-24,0,0,35,0,0,0,0
2020-08-25,155,3,1308,58,0,41,158
2020-08-25,1,0,257,1,0,6,1
2020-08-25,0,0,59,0,0,4,0
2020-08-25,34,1,193,4,0,9,35
2020-08-25,0,0,17,0,0,2,0
2020-08-25,72,30,1318,36,6,41,102
2020-08-25,222,33,2475,58,4,111,255
2020-08-25,1,3,48,0,0,0,4
2020-08-25,17,1,451,6,1,6,18
2020-08-25,0,0,25,0,0,0,0
2020-08-25,5,1,208,1,0,13,6
2020-08-25,131,22,1003,39,2,33,153
2020-08-25,89,19,1837,34,5,72,108
2020-08-25,235,88,6631,84,16,273,323
2020-08-25,24,7,274,8,2,7,31
2020-08-25,25,0,253,9,0,7,25
2020-08-25,0,0,19,0,0,0,0
2020-08-25,4,4,33,3,1,4,8
2020-08-25,179,50,2398,65,7,89,229
2020-08-25,15,4,314,3,0,6,19
2020-08-25,1,1,65,0,0,5,2
2020-08-25,5,0,561,1,0,4,5
2020-08-25,6,0,25,2,0,1,6
2020-08-25,42,0,729,14,0,25,42
2020-08-25,2,0,84,0,0,6,2
2020-08-25,0,0,25,0,0,0,0
2020-08-25,159,52,1294,37,5,19,211
2020-08-25,12,1,451,5,0,18,13
2020-08-25,0,0,56,0,0,5,0
2020-08-25,321,59,3869,100,6,169,380
2020-08-25,41,26,737,16,4,26,67
2020-08-25,399,68,5809,113,9,194,467
2020-08-25,1168,517,19881,375,49,894,1685
2020-08-25,89,14,1452,32,2,51,103
2020-08-25,0,2,47,0,0,0,2
2020-08-25,20,0,265,4,0,14,20
2020-08-25,225,84,3376,78,13,91,309
2020-08-25,230,26,1593,53,1,16,256
2020-08-25,3,0,51,0,0,6,3
2020-08-25,0,0,29,0,0,4,0
2020-08-25,0,0,41,0,0,0,0
2020-08-25,0,0,35,0,0,0,0
2020-08-25,8,9,276,1,0,8,17
2020-08-25,51,5,686,12,0,11,56
2020-08-25,3,0,150,1,0,8,3
2020-08-25,148,12,3068,44,0,115,160
2020-08-25,43,6,514,11,2,4,49
2020-08-25,1,1,189,1,1,8,2
2020-08-25,0,0,0,0,0,0,0
2020-08-25,34,3,546,9,0,7,37
2020-08-25,0,0,51,0,0,4,0
2020-08-25,50,11,680,13,3,19,61
2020-08-25,2,0,119,0,0,4,2
2020-08-25,34,1,259,11,0,1,35
2020-08-25,7,0,97,3,0,9,7
2020-08-25,52,8,666,22,1,42,60
2020-08-26,61,6,686,12,0,10,67
2020-08-26,6,1,208,1,0,0,7
2020-08-26,137,24,1008,38,0,76,161
2020-08-26,7,0,97,4,0,7,7
2020-08-26,1168,466,20280,364,53,893,1634
2020-08-26,318,49,3893,102,4,159,367
2020-08-26,0,2,47,0,0,0,2
2020-08-26,51,10,693,12,1,26,61
2020-08-26,87,12,1868,37,7,54,99
2020-08-26,88,21,1483,34,1,57,109
2020-08-26,228,88,6649,83,23,264,316
2020-08-26,23,12,274,9,0,6,35
2020-08-26,24,3,253,9,0,6,27
2020-08-26,218,39,1584,49,3,15,257
2020-08-26,0,0,41,0,0,0,0
2020-08-26,215,39,2480,59,6,111,254
2020-08-26,0,0,25,0,0,0,0
2020-08-26,372,51,5810,112,4,214,423
2020-08-26,0,0,51,0,0,3,0
2020-08-26,19,1,265,4,0,11,20
2020-08-26,0,0,0,0,0,0,0
2020-08-26,4,0,561,0,0,10,4
2020-08-26,20,1,451,8,1,6,21
2020-08-26,0,0,19,0,0,0,0
2020-08-26,2,0,84,0,0,4,2
2020-08-26,1,1,189,1,1,9,2
2020-08-26,2,0,51,0,0,5,2
2020-08-26,0,0,29,0,0,0,0
2020-08-26,39,1,729,15,0,21,40
2020-08-26,142,19,2987,46,3,105,161
2020-08-26,8,10,276,1,1,13,18
2020-08-26,74,31,1321,31,3,45,105
2020-08-26,31,2,259,12,0,9,33
2020-08-26,13,5,451,5,2,19,18
2020-08-26,4,1,33,3,0,4,5
2020-08-26,4,0,25,2,0,1,4
2020-08-26,1,1,132,0,0,3,2
2020-08-26,1,2,48,0,0,0,3
2020-08-26,0,0,25,0,0,0,0
2020-08-26,34,1,193,3,0,10,35
2020-08-26,140,2,1317,50,0,43,142
2020-08-26,17,2,318,2,1,8,19
2020-08-26,1,1,65,0,1,4,2
2020-08-26,37,2,489,9,0,6,39
2020-08-26,39,4,533,9,1,5,43
2020-08-26,190,48,2416,69,9,78,238
2020-08-26,40,3,666,21,0,42,43
2020-08-26,0,0,29,0,0,4,0
2020-08-26,159,31,1309,38,2,18,190
2020-08-26,0,0,17,0,0,2,0
2020-08-26,1,1,269,1,0,5,2
2020-08-26,3,0,150,1,0,3,3
2020-08-26,38,16,741,12,2,27,54
2020-08-26,226,95,3376,81,14,97,321
2020-08-26,0,0,59,0,0,0,0
2020-08-26,0,0,56,0,0,5,0
2020-08-27,6,0,96,2,0,10,6
2020-08-27,0,0,35,0,0,0,0
2020-08-27,18,3,265,4,0,9,21
2020-08-27,0,0,19,0,0,0,0
2020-08-27,227,72,6664,79,16,274,299
2020-08-27,223,87,3346,82,16,97,310
2020-08-27,4,0,561,1,0,11,4
2020-08-27,33,2,546,9,0,6,35
2020-08-27,38,1,729,15,0,21,39
2020-08-27,40,2,666,19,0,51,42
2020-08-27,0,2,47,0,0,0,2
2020-08-27,215,34,1604,46,2,10,249
2020-08-27,78,24,1321,35,6,40,102
2020-08-27,40,4,546,11,0,6,44
2020-08-27,51,3,686,15,0,12,54
2020-08-27,19,0,451,6,0,5,19
2020-08-27,0,0,59,0,0,1,0
2020-08-27,52,8,696,14,1,33,60
2020-08-27,10,9,323,1,1,11,19
2020-08-27,1,1,65,0,0,2,2
2020-08-27,0,0,41,0,0,0,0
2020-08-27,4,0,51,0,0,3,4
2020-08-27,2,0,117,0,0,2,2
2020-08-27,0,0,29,0,0,4,0
2020-08-27,147,3,1306,53,0,44,150
2020-08-27,0,0,56,0,0,3,0
2020-08-27,5,1,208,1,0,12,6
2020-08-27,0,0,25,0,0,0,0
2020-08-27,10,0,48,0,0,0,10
2020-08-27,0,0,17,0,0,2,0
2020-08-27,140,18,3003,44,2,97,158
2020-08-27,0,0,25,0,0,0,0
2020-08-27,32,1,259,12,0,9,33
2020-08-27,1116,449,20182,356,46,889,1565
2020-08-27,0,0,0,0,0,0,0
2020-08-27,2,0,84,0,0,1,2
2020-08-27,166,39,1304,39,3,15,205
2020-08-27,1,2,189,1,1,9,3
2020-08-27,22,4,254,10,0,2,26
2020-08-27,306,55,3862,107,7,148,361
2020-08-27,12,5,451,3,1,22,17
2020-08-27,198,47,2445,67,20,77,245
2020-08-27,38,21,743,13,4,28,59
2020-08-27,207,30,2467,55,5,110,237
2020-08-27,3,0,25,2,0,1,3
2020-08-27,3,1,33,2,1,4,4
2020-08-27,99,22,1485,37,1,48,121
2020-08-27,33,0,193,4,0,8,33
2020-08-27,24,20,274,10,2,3,44
2020-08-27,351,49,5830,98,5,212,400
2020-08-27,137,21,1009,38,1,40,158
2020-08-27,0,0,51,0,0,2,0
2020-08-27,1,2,264,1,1,3,3
2020-08-27,7,8,276,1,1,12,15
2020-08-27,5,0,150,0,0,3,5
2020-08-27,79,12,1848,36,5,53,91
2020-08-28,2,0,84,0,0,1,2
2020-08-28,305,49,3851,111,4,159,354
2020-08-28,44,9,666,18,1,45,53
2020-08-28,216,81,3322,72,15,92,297
2020-08-28,31,5,536,8,0,7,36
2020-08-28,6,0,96,1,0,12,6
2020-08-28,202,46,2456,63,7,89,248
2020-08-28,14,2,451,3,0,19,16
2020-08-28,223,59,6645,79,7,271,282
2020-08-28,1,1,268,1,1,3,2
2020-08-28,139,15,3021,51,2,98,154
2020-08-28,0,0,41,0,0,0,0
2020-08-28,25,12,274,8,0,2,37
2020-08-28,0,0,25,0,0,0,0
2020-08-28,130,4,1302,49,0,45,134
2020-08-28,1089,423,19935,344,53,881,1512
2020-08-28,0,0,189,0,0,12,0
2020-08-28,24,2,254,9,2,1,26
2020-08-28,9,6,276,1,1,12,15
2020-08-28,32,0,259,9,0,11,32
2020-08-28,3,0,561,1,0,8,3
2020-08-28,41,21,742,14,4,27,62
2020-08-28,71,24,1309,33,3,45,95
2020-08-28,18,2,265,4,0,7,20
2020-08-28,5,0,150,0,0,3,5
2020-08-28,0,0,51,0,0,3,0
2020-08-28,3,0,208,1,0,13,3
2020-08-28,0,0,56,0,0,4,0
2020-08-28,92,28,1461,35,3,42,120
2020-08-28,19,0,451,6,0,4,19
2020-08-28,0,0,17,0,0,2,0
2020-08-28,202,28,2489,57,7,108,230
2020-08-28,4,0,51,1,0,4,4
2020-08-28,1,2,65,0,1,2,3
2020-08-28,32,0,193,4,0,8,32
2020-08-28,14,1,321,1,0,12,15
2020-08-28,74,18,1868,27,4,58,92
2020-08-28,0,0,47,0,0,0,0
2020-08-28,11,1,48,0,0,0,12
2020-08-28,124,20,1006,35,1,39,144
2020-08-28,0,0,29,0,0,4,0
2020-08-28,201,27,1600,43,1,13,228
2020-08-28,41,12,690,12,1,28,53
2020-08-28,0,0,19,0,0,0,0
2020-08-28,31,0,729,17,0,20,31
2020-08-28,2,0,33,2,0,6,2
2020-08-28,0,0,25,0,0,0,0
2020-08-28,0,0,35,0,0,0,0
2020-08-28,0,0,0,0,0,0,0
2020-08-28,2,0,125,0,0,4,2
2020-08-28,38,9,556,11,1,8,47
2020-08-28,2,0,25,2,0,1,2
2020-08-28,1,0,59,0,0,4,1
2020-08-28,156,34,1299,37,3,20,190
2020-08-28,341,46,5764,99,7,226,387
2020-08-28,51,4,686,13,0,12,55
2020-08-29,2,0,121,0,0,2,2
2020-08-29,292,42,3828,103,5,167,334
2020-08-29,5,0,96,2,0,6,5
2020-08-29,34,6,536,8,1,8,40
2020-08-29,145,39,1301,36,3,27,184
2020-08-29,0,0,25,0,0,0,0
2020-08-29,0,0,19,0,0,0,0
2020-08-29,43,5,666,18,2,52,48
2020-08-29,12,3,451,4,2,17,15
2020-08-29,0,0,0,0,0,0,0
2020-08-29,34,5,532,9,2,9,39
2020-08-29,41,12,697,12,4,27,53
2020-08-29,4,0,561,1,0,9,4
2020-08-29,0,0,47,0,0,0,0
2020-08-29,2,0,150,0,0,5,2
2020-08-29,31,0,729,16,0,20,31
2020-08-29,329,48,5754,99,8,250,377
2020-08-29,51,2,664,12,0,13,53
2020-08-29,1,0,189,1,0,11,1
2020-08-29,74,11,1839,26,3,52,85
2020-08-29,17,0,451,5,0,3,17
2020-08-29,0,0,35,0,0,0,0
2020-08-29,20,0,265,3,0,13,20
2020-08-29,95,10,1451,32,0,45,105
2020-08-29,2,1,208,0,0,11,3
2020-08-29,32,0,193,3,0,9,32
2020-08-29,0,0,29,0,0,4,0
2020-08-29,0,0,25,0,0,0,0
2020-08-29,0,0,56,0,0,4,0
2020-08-29,0,0,41,0,0,0,0
2020-08-29,11,3,318,12,0,11,14
2020-08-29,1,1,268,1,1,2,2
2020-08-29,0,1,51,0,0,4,1
2020-08-29,1,0,51,0,0,3,1
2020-08-29,2,1,33,2,1,4,3
2020-08-29,2,0,84,0,0,2,2
2020-08-29,144,22,3019,50,2,102,166
2020-08-29,2,0,25,2,0,1,2
2020-08-29,1,0,65,0,0,4,1
2020-08-29,118,6,1303,41,0,46,124
2020-08-29,230,73,6631,80,12,294,303
2020-08-29,25,2,253,9,0,4,27
2020-08-29,188,44,2426,58,6,76,232
2020-08-29,10,1,48,0,0,0,11
2020-08-29,217,88,3283,74,9,99,305
2020-08-29,27,9,274,8,1,3,36
2020-08-29,8,9,276,1,1,10,17
2020-08-29,109,24,1007,33,3,43,133
2020-08-29,1043,415,19773,345,44,862,1458
2020-08-29,31,0,259,8,0,18,31
2020-08-29,69,23,1300,32,5,45,92
2020-08-29,196,29,1587,48,5,17,225
2020-08-29,38,23,739,12,4,28,61
2020-08-29,200,45,2472,60,6,100,245
2020-08-29,1,0,59,0,0,2,1
2020-08-29,0,0,17,0,0,2,0
2020-08-30,1,0,59,0,0,1,1
2020-08-30,1057,386,19714,345,53,934,1443
2020-08-30,49,3,664,12,0,17,52
2020-08-30,317,61,5701,98,9,244,378
2020-08-30,36,4,666,17,0,51,40
2020-08-30,0,0,17,0,0,2,0
2020-08-30,2,2,108,0,2,2,4
2020-08-30,5,0,96,3,0,7,5
2020-08-30,39,20,742,12,2,29,59
2020-08-30,0,0,47,0,0,0,0
2020-08-30,28,9,274,11,0,4,37
2020-08-30,1,0,189,1,0,10,1
2020-08-30,2,0,150,0,0,6,2
2020-08-30,190,34,1572,44,3,19,224
2020-08-30,0,0,19,0,0,0,0
2020-08-30,10,3,451,4,0,20,13
2020-08-30,139,25,3007,47,1,95,164
2020-08-30,183,37,2414,53,3,89,220
2020-08-30,91,14,1456,29,3,57,105
2020-08-30,32,0,193,3,0,9,32
2020-08-30,13,0,265,2,0,13,13
2020-08-30,12,3,321,2,0,11,15
2020-08-30,1,1,268,1,1,2,2
2020-08-30,2,0,25,2,0,1,2
2020-08-30,33,3,511,8,0,12,36
2020-08-30,72,30,1287,28,6,45,102
2020-08-30,102,14,1005,30,1,43,116
2020-08-30,196,31,2463,55,2,109,227
2020-08-30,0,0,29,0,0,4,0
2020-08-30,0,0,56,0,0,4,0
2020-08-30,1,0,51,0,0,2,1
2020-08-30,2,2,33,2,0,4,4
2020-08-30,140,31,1305,37,2,24,171
2020-08-30,3,1,359,0,0,25,4
2020-08-30,10,1,48,0,0,0,11
2020-08-30,35,0,729,15,0,25,35
2020-08-30,234,71,6638,81,15,300,305
2020-08-30,0,0,52,0,0,5,0
2020-08-30,18,0,451,4,0,6,18
2020-08-30,283,54,3808,99,7,149,337
2020-08-30,0,0,25,0,0,0,0
2020-08-30,0,0,25,0,0,0,0
2020-08-30,70,10,1788,28,3,77,80
2020-08-30,115,4,1320,34,0,47,119
2020-08-30,25,1,253,10,0,3,26
2020-08-30,33,7,532,8,0,10,40
2020-08-30,2,0,84,0,0,4,2
2020-08-30,8,6,276,2,0,8,14
2020-08-30,28,0,259,8,0,16,28
2020-08-30,0,0,65,0,0,4,0
2020-08-30,45,12,688,14,5,28,57
2020-08-30,0,0,35,0,0,0,0
2020-08-30,3,0,561,1,0,11,3
2020-08-30,0,0,41,0,0,0,0
2020-08-30,0,0,0,0,0,0,0
2020-08-30,210,71,3322,73,5,96,281
2020-08-31,6,0,96,3,0,6,6
2020-08-31,29,12,274,11,2,5,41
2020-08-31,1,0,84,0,0,3,1
2020-08-31,0,0,41,0,0,0,0
2020-08-31,41,6,666,18,1,52,47
2020-08-31,0,0,19,0,0,0,0
2020-08-31,307,61,5714,93,10,254,368
2020-08-31,81,28,1450,25,5,57,109
2020-08-31,0,0,47,0,0,0,0
2020-08-31,30,0,729,15,0,25,30
2020-08-31,1,0,265,1,0,4,1
2020-08-31,10,1,48,0,0,0,11
2020-08-31,12,0,265,2,0,11,12
2020-08-31,143,46,1305,38,8,26,189
2020-08-31,2,0,150,0,0,6,2
2020-08-31,39,22,733,12,5,29,61
2020-08-31,0,0,52,0,0,3,0
2020-08-31,0,0,56,0,0,4,0
2020-08-31,2,4,109,0,2,4,6
2020-08-31,292,63,3843,98,7,168,355
2020-08-31,41,14,686,13,4,35,55
2020-08-31,74,12,1809,26,3,79,86
2020-08-31,173,46,2372,46,10,96,219
2020-08-31,9,4,276,2,0,9,13
2020-08-31,14,1,323,3,1,11,15
2020-08-31,102,14,1005,33,1,40,116
2020-08-31,216,54,3288,68,10,102,270
2020-08-31,27,1,253,11,0,4,28
2020-08-31,0,0,29,0,0,4,0
2020-08-31,2,0,25,2,0,1,2
2020-08-31,122,6,1309,42,0,46,128
2020-08-31,10,4,451,4,0,21,14
2020-08-31,32,6,537,8,0,6,38
2020-08-31,233,73,6632,84,11,307,306
2020-08-31,184,25,1568,48,1,21,209
2020-08-31,1048,415,19746,321,62,954,1463
2020-08-31,134,26,3072,45,1,109,160
2020-08-31,31,10,507,9,2,12,41
2020-08-31,0,0,35,0,0,0,0
2020-08-31,0,0,25,0,0,0,0
2020-08-31,0,0,25,0,0,0,0
2020-08-31,17,1,451,4,0,19,18
2020-08-31,39,1,193,9,1,2,40
2020-08-31,0,0,0,0,0,0,0
2020-08-31,0,0,17,0,0,2,0
2020-08-31,1,0,59,0,0,6,1
2020-08-31,1,0,351,0,0,21,1
2020-08-31,196,47,2464,52,7,121,243
2020-08-31,27,0,259,8,0,15,27
2020-08-31,65,15,1276,27,4,45,80
2020-08-31,2,0,561,1,0,7,2
2020-08-31,50,1,686,10,0,16,51
2020-08-31,2,1,33,2,0,4,3
2020-08-31,0,0,65,0,0,6,0
2020-08-31,0,0,189,0,0,13,0
2020-08-31,1,0,51,0,0,3,1
2020-09-01,2,0,59,1,0,4,2
2020-09-01,0,0,25,0,0,0,0
2020-09-01,1,2,263,1,0,4,3
2020-09-01,2,1,351,0,0,22,3
2020-09-01,135,43,1307,38,6,23,178
2020-09-01,26,1,253,12,0,3,27
2020-09-01,102,13,1004,31,3,42,115
2020-09-01,12,2,323,2,0,6,14
2020-09-01,4,0,150,2,0,4,4
2020-09-01,27,10,274,10,0,3,37
2020-09-01,295,64,5754,89,13,218,359
2020-09-01,7,0,96,4,0,4,7
2020-09-01,77,16,1873,24,3,68,93
2020-09-01,37,15,685,12,3,32,52
2020-09-01,28,1,729,16,1,21,29
2020-09-01,2,0,84,0,0,4,2
2020-09-01,2,0,51,0,0,4,2
2020-09-01,1,1,118,0,1,4,2
2020-09-01,0,0,41,0,0,0,0
2020-09-01,31,7,539,6,0,7,38
2020-09-01,9,4,451,4,1,22,13
2020-09-01,37,26,742,11,0,25,63
2020-09-01,38,0,193,9,0,2,38
2020-09-01,0,0,56,0,0,8,0
2020-09-01,0,0,25,0,0,0,0
2020-09-01,0,0,47,0,0,0,0
2020-09-01,17,0,451,3,0,19,17
2020-09-01,162,48,2395,49,8,87,210
2020-09-01,117,10,1321,39,0,43,127
2020-09-01,10,6,276,3,0,8,16
2020-09-01,0,0,35,0,0,0,0
2020-09-01,38,5,666,18,0,40,43
2020-09-01,207,57,3363,69,8,93,264
2020-09-01,1062,426,19849,320,52,933,1488
2020-09-01,13,0,265,2,0,10,13
2020-09-01,6,1,48,0,0,0,7
2020-09-01,0,0,51,0,0,2,0
2020-09-01,231,76,6640,85,11,305,307
2020-09-01,0,2,189,0,1,14,2
2020-09-01,76,22,1463,24,5,53,98
2020-09-01,50,2,664,10,0,15,52
2020-09-01,4,0,25,2,0,1,4
2020-09-01,0,0,0,0,0,0,0
2020-09-01,0,1,29,0,0,4,1
2020-09-01,0,0,17,0,0,2,0
2020-09-01,3,0,561,1,0,8,3
2020-09-01,132,27,3113,49,2,108,159
2020-09-01,0,0,19,0,0,0,0
2020-09-01,187,47,2481,54,6,106,234
2020-09-01,68,31,1301,27,5,47,99
2020-09-01,0,1,65,0,1,4,1
2020-09-01,2,2,33,2,2,4,4
2020-09-01,172,34,1573,48,2,18,206
2020-09-01,29,0,259,8,0,12,29
2020-09-01,283,66,3860,100,7,137,349
2020-09-01,29,8,498,12,1,9,37
2020-09-02,2,0,59,1,0,4,2
2020-09-02,61,30,1305,23,7,41,91
2020-09-02,17,1,451,3,0,12,18
2020-09-02,77,17,1459,26,5,62,94
2020-09-02,53,1,664,10,0,8,54
2020-09-02,130,28,3124,51,3,98,158
2020-09-02,39,5,666,16,0,45,44
2020-09-02,4,0,150,1,0,4,4
2020-09-02,161,27,1539,45,1,17,188
2020-09-02,992,386,19805,296,49,919,1378
2020-09-02,0,0,19,0,0,0,0
2020-09-02,103,22,1003,32,4,48,125
2020-09-02,38,20,740,12,2,28,58
2020-09-02,29,1,729,15,0,23,30
2020-09-02,25,9,274,10,0,5,34
2020-09-02,17,0,265,2,0,11,17
2020-09-02,0,0,56,0,0,8,0
2020-09-02,264,59,3851,92,9,134,323
2020-09-02,29,0,259,8,0,12,29
2020-09-02,220,70,6652,80,14,280,290
2020-09-02,9,5,451,3,1,20,14
2020-09-02,0,1,189,0,1,10,1
2020-09-02,120,6,1322,39,0,43,126
2020-09-02,0,0,47,0,0,0,0
2020-09-02,4,2,33,2,1,4,6
2020-09-02,4,0,561,1,0,10,4
2020-09-02,0,0,0,0,0,0,0
2020-09-02,36,11,690,12,3,25,47
2020-09-02,70,12,1854,21,4,61,82
2020-09-02,0,0,17,0,0,1,0
2020-09-02,3,0,51,0,0,4,3
2020-09-02,31,0,193,2,0,9,31
2020-09-02,0,0,35,0,0,0,0
2020-09-02,0,0,25,0,0,0,0
2020-09-02,2,1,84,0,0,5,3
2020-09-02,150,41,2404,44,6,95,191
2020-09-02,27,1,253,12,0,6,28
2020-09-02,32,6,533,8,0,8,38
2020-09-02,1,2,271,1,0,1,3
2020-09-02,0,0,51,0,0,1,0
2020-09-02,14,1,331,3,0,7,15
2020-09-02,11,4,276,3,1,10,15
2020-09-02,0,0,25,0,0,0,0
2020-09-02,1,0,351,1,0,23,1
2020-09-02,31,6,513,11,2,8,37
2020-09-02,189,67,3359,60,13,97,256
2020-09-02,1,0,48,0,0,0,1
2020-09-02,0,0,65,0,0,4,0
2020-09-02,1,1,129,0,0,5,2
2020-09-02,2,0,25,2,0,1,2
2020-09-02,0,0,41,0,0,0,0
2020-09-02,272,60,5612,79,10,202,332
2020-09-02,131,34,1296,36,7,22,165
2020-09-02,8,0,96,2,0,7,8
2020-09-02,193,29,2467,54,8,96,222
2020-09-02,0,1,29,0,0,4,1
2020-09-03,1,0,271,1,0,0,1
2020-09-03,32,13,547,9,1,8,45
2020-09-03,0,0,17,0,0,2,0
2020-09-03,0,0,47,0,0,0,0
2020-09-03,33,2,534,13,0,9,35
2020-09-03,0,0,19,0,0,0,0
2020-09-03,125,27,3124,49,2,90,152
2020-09-03,252,43,3878,89,4,138,295
2020-09-03,27,0,259,7,0,13,27
2020-09-03,185,37,3349,63,10,102,222
2020-09-03,5,0,33,3,0,5,5
2020-09-03,16,3,326,2,0,9,19
2020-09-03,8,0,97,1,0,7,8
2020-09-03,124,34,1295,35,4,19,158
2020-09-03,13,0,265,2,0,13,13
2020-09-03,93,19,1002,30,0,48,112
2020-09-03,0,0,29,0,0,4,0
2020-09-03,57,19,1314,24,4,42,76
2020-09-03,2,0,59,1,0,4,2
2020-09-03,0,2,189,0,2,9,2
2020-09-03,0,0,0,0,0,0,0
2020-09-03,9,7,277,3,1,9,16
2020-09-03,71,13,1461,24,3,56,84
2020-09-03,3,2,351,2,0,19,5
2020-09-03,0,0,25,0,0,0,0
2020-09-03,147,54,2401,43,4,95,201
2020-09-03,1,0,48,0,0,0,1
2020-09-03,0,0,51,0,0,2,0
2020-09-03,264,44,5614,77,9,221,308
2020-09-03,40,7,666,16,2,49,47
2020-09-03,190,32,2434,52,6,84,222
2020-09-03,25,12,274,9,0,5,37
2020-09-03,2,0,51,0,0,5,2
2020-09-03,1,0,129,0,0,5,1
2020-09-03,0,0,25,0,0,0,0
2020-09-03,20,1,451,3,0,14,21
2020-09-03,9,1,451,2,1,20,10
2020-09-03,27,1,729,15,0,21,28
2020-09-03,0,0,41,0,0,0,0
2020-09-03,46,5,664,7,0,17,51
2020-09-03,0,0,65,0,0,3,0
2020-09-03,2,0,25,2,0,1,2
2020-09-03,2,0,84,0,0,3,2
2020-09-03,0,0,56,0,0,8,0
2020-09-03,63,11,1848,21,4,58,74
2020-09-03,32,0,193,3,0,9,32
2020-09-03,984,362,19780,310,51,913,1346
2020-09-03,27,3,253,11,0,7,30
2020-09-03,156,25,1552,44,1,15,181
2020-09-03,41,24,744,13,3,28,65
2020-09-03,0,0,35,0,0,0,0
2020-09-03,218,71,6634,71,14,280,289
2020-09-03,4,0,150,1,0,1,4
2020-09-03,33,8,695,11,2,25,41
2020-09-03,119,6,1322,37,0,44,125
2020-09-03,4,0,561,1,0,10,4
2020-09-04,239,44,3864,87,7,167,283
2020-09-04,1,2,119,0,1,2,3
2020-09-04,1,1,48,0,0,0,2
2020-09-04,4,0,150,1,0,1,4
2020-09-04,37,6,519,13,0,7,43
2020-09-04,0,0,35,0,0,0,0
2020-09-04,0,0,19,0,0,0,0
2020-09-04,41,16,743,11,1,27,57
2020-09-04,0,1,189,0,1,7,1
2020-09-04,35,0,193,3,0,6,35
2020-09-04,8,2,276,3,0,7,10
2020-09-04,2,0,51,0,0,3,2
2020-09-04,37,5,686,12,2,27,42
2020-09-04,58,7,1860,23,0,56,65
2020-09-04,966,355,19804,305,52,907,1321
2020-09-04,25,0,259,7,0,12,25
2020-09-04,8,0,97,7,0,2,8
2020-09-04,0,0,51,0,0,2,0
2020-09-04,177,39,3380,64,9,98,216
2020-09-04,23,0,253,9,0,10,23
2020-09-04,2,0,59,1,0,4,2
2020-09-04,44,4,664,7,0,16,48
2020-09-04,3,3,561,1,0,5,6
2020-09-04,177,33,2480,52,5,90,210
2020-09-04,0,0,0,0,0,0,0
2020-09-04,142,35,2391,44,3,100,177
2020-09-04,3,1,351,2,0,21,4
2020-09-04,122,11,3083,42,0,96,133
2020-09-04,32,8,564,9,1,9,40
2020-09-04,1,1,269,1,1,2,2
2020-09-04,12,3,323,4,0,8,15
2020-09-04,98,1,1332,32,0,50,99
2020-09-04,3,0,25,2,0,1,3
2020-09-04,0,0,17,0,0,2,0
2020-09-04,15,0,451,3,0,15,15
2020-09-04,126,33,1296,37,2,12,159
2020-09-04,1,0,84,0,0,2,1
2020-09-04,26,3,729,17,0,20,29
2020-09-04,73,14,1519,27,5,68,87
2020-09-04,219,59,6616,80,17,282,278
2020-09-04,25,8,274,9,0,3,33
2020-09-04,0,0,25,0,0,0,0
2020-09-04,153,23,1498,44,3,12,176
2020-09-04,274,54,5576,83,6,220,328
2020-09-04,86,15,1005,29,0,41,101
2020-09-04,0,1,65,0,0,4,1
2020-09-04,4,1,33,3,0,5,5
2020-09-04,0,0,56,0,0,7,0
2020-09-04,7,3,451,3,1,20,10
2020-09-04,0,0,25,0,0,0,0
2020-09-04,0,1,29,0,0,4,1
2020-09-04,50,30,1269,22,6,52,80
2020-09-04,0,0,41,0,0,0,0
2020-09-04,16,0,265,3,0,14,16
2020-09-04,0,0,47,0,0,0,0
2020-09-04,37,6,666,14,3,53,43
2020-09-05,2,0,59,1,0,2,2
2020-09-05,15,1,451,4,0,17,16
2020-09-05,0,0,29,0,0,4,0
2020-09-05,1,0,84,1,0,3,1
2020-09-05,943,361,19813,305,43,926,1304
2020-09-05,27,2,729,10,0,18,29
2020-09-05,51,6,1808,22,0,64,57
2020-09-05,26,1,259,7,0,9,27
2020-09-05,52,4,664,7,0,18,56
2020-09-05,0,0,29,0,0,1,0
2020-09-05,0,0,47,0,0,0,0
2020-09-05,0,0,25,0,0,0,0
2020-09-05,145,42,2406,37,4,105,187
2020-09-05,0,1,51,0,0,4,1
2020-09-05,35,8,680,10,3,25,43
2020-09-05,1,0,48,0,0,0,1
2020-09-05,153,20,1515,44,1,22,173
2020-09-05,1,0,65,0,0,4,1
2020-09-05,3,1,561,1,0,4,4
2020-09-05,193,67,6611,82,12,276,260
2020-09-05,253,54,5615,77,6,231,307
2020-09-05,10,0,97,7,0,3,10
2020-09-05,88,16,1005,31,0,52,104
2020-09-05,42,21,744,11,2,27,63
2020-09-05,243,39,3822,86,4,156,282
2020-09-05,34,7,480,10,0,6,41
2020-09-05,131,31,1298,38,4,18,162
2020-09-05,1,0,25,1,0,2,1
2020-09-05,1,0,51,0,0,3,1
2020-09-05,124,17,2985,42,0,93,141
2020-09-05,83,4,1309,27,0,53,87
2020-09-05,1,1,269,1,1,3,2
2020-09-05,168,36,2424,50,3,92,204
2020-09-05,23,13,274,9,0,2,36
2020-09-05,0,0,56,0,0,7,0
2020-09-05,41,7,666,14,2,59,48
2020-09-05,50,27,1254,25,9,54,77
2020-09-05,26,3,254,10,2,7,29
2020-09-05,0,0,25,0,0,0,0
2020-09-05,0,0,189,0,0,12,0
2020-09-05,37,8,584,10,1,9,45
2020-09-05,32,1,193,3,0,8,33
2020-09-05,8,3,276,3,0,6,11
2020-09-05,6,1,451,3,0,18,7
2020-09-05,4,0,150,1,0,1,4
2020-09-05,13,7,330,5,0,9,20
2020-09-05,0,0,35,0,0,0,0
2020-09-05,0,0,17,0,0,2,0
2020-09-05,19,0,265,3,0,13,19
2020-09-05,3,2,351,3,2,18,5
2020-09-05,73,26,1528,26,3,50,99
2020-09-05,3,3,33,2,1,4,6
2020-09-05,0,0,41,0,0,0,0
2020-09-05,0,0,0,0,0,0,0
2020-09-05,0,0,19,0,0,0,0
2020-09-05,171,49,3319,62,7,91,220
2020-09-06,19,0,265,3,0,11,19
2020-09-06,0,0,25,0,0,0,0
2020-09-06,2,1,561,1,0,4,3
2020-09-06,0,0,47,0,0,0,0
2020-09-06,37,14,501,10,2,5,51
2020-09-06,0,1,65,0,1,3,1
2020-09-06,13,8,323,5,1,8,21
2020-09-06,57,17,1772,24,2,69,74
2020-09-06,30,1,259,10,0,6,31
2020-09-06,0,0,29,0,0,4,0
2020-09-06,0,1,48,0,0,0,1
2020-09-06,161,42,2391,70,1,92,203
2020-09-06,134,31,1296,37,5,18,165
2020-09-06,1,1,269,1,1,3,2
2020-09-06,0,1,51,0,0,6,1
2020-09-06,0,0,56,0,0,7,0
2020-09-06,0,0,0,0,0,0,0
2020-09-06,228,39,3785,89,4,151,267
2020-09-06,0,0,17,0,0,2,0
2020-09-06,2,2,33,1,1,5,4
2020-09-06,0,0,19,0,0,0,0
2020-09-06,2,0,59,2,0,4,2
2020-09-06,0,0,41,0,0,0,0
2020-09-06,0,0,25,0,0,0,0
2020-09-06,27,6,253,9,1,5,33
2020-09-06,2,0,51,0,0,4,2
2020-09-06,44,7,666,17,2,63,51
2020-09-06,152,18,1520,45,0,17,170
2020-09-06,9,1,97,6,1,4,10
2020-09-06,32,8,562,9,1,9,40
2020-09-06,30,16,677,11,6,23,46
2020-09-06,2,0,93,1,0,2,2
2020-09-06,195,71,6617,80,16,307,266
2020-09-06,28,1,729,8,0,18,29
2020-09-06,942,372,19715,312,40,929,1314
2020-09-06,7,3,451,4,0,22,10
2020-09-06,25,11,274,8,0,4,36
2020-09-06,0,0,189,0,0,10,0
2020-09-06,41,26,739,11,3,22,67
2020-09-06,0,0,35,0,0,0,0
2020-09-06,20,1,451,6,0,11,21
2020-09-06,55,4,664,8,0,15,59
2020-09-06,35,1,193,3,0,9,36
2020-09-06,1,0,25,1,0,1,1
2020-09-06,4,5,351,1,0,17,9
2020-09-06,171,59,3307,59,10,94,230
2020-09-06,5,0,150,2,0,1,5
2020-09-06,52,33,1249,28,11,51,85
2020-09-06,68,24,1522,26,2,53,92
2020-09-06,146,43,2405,40,2,114,189
2020-09-06,80,12,1277,25,0,56,92
2020-09-06,0,0,84,0,0,2,0
2020-09-06,9,5,276,3,1,8,14
2020-09-06,116,18,2936,41,1,95,134
2020-09-06,238,64,5534,75,9,242,302
2020-09-06,86,9,1004,28,0,50,95
2020-09-07,37,28,721,10,1,29,65
2020-09-07,142,38,1302,38,5,12,180
2020-09-07,0,0,19,0,0,0,0
2020-09-07,148,57,2371,38,5,113,205
2020-09-07,0,0,56,0,0,7,0
2020-09-07,27,9,533,8,1,10,36
2020-09-07,29,1,259,10,0,6,30
2020-09-07,58,21,1220,27,11,50,79
2020-09-07,2,1,561,1,0,5,3
2020-09-07,0,0,48,0,0,0,0
2020-09-07,0,0,29,0,0,4,0
2020-09-07,0,0,0,0,0,0,0
2020-09-07,211,72,6621,79,14,309,283
2020-09-07,32,2,193,3,0,9,34
2020-09-07,141,41,2412,51,5,104,182
2020-09-07,224,42,3811,85,5,162,266
2020-09-07,10,5,276,3,1,8,15
2020-09-07,39,15,673,10,2,21,54
2020-09-07,18,0,265,3,0,12,18
2020-09-07,1,0,59,1,0,5,1
2020-09-07,0,0,47,0,0,0,0
2020-09-07,0,0,65,0,0,3,0
2020-09-07,38,9,506,10,2,5,47
2020-09-07,2,0,127,1,0,7,2
2020-09-07,63,15,1742,26,1,63,78
2020-09-07,22,6,253,9,2,5,28
2020-09-07,10,2,451,4,1,21,12
2020-09-07,2,0,51,0,0,4,2
2020-09-07,1,1,33,1,0,6,2
2020-09-07,1,0,25,1,0,1,1
2020-09-07,28,0,729,8,0,20,28
2020-09-07,936,414,19650,308,48,954,1350
2020-09-07,153,16,1511,41,2,24,169
2020-09-07,0,0,189,0,0,12,0
2020-09-07,14,3,323,5,0,9,17
2020-09-07,8,0,96,6,0,1,8
2020-09-07,0,0,84,0,0,1,0
2020-09-07,1,1,269,1,1,3,2
2020-09-07,242,47,5578,70,11,222,289
2020-09-07,4,0,150,2,0,2,4
2020-09-07,57,2,664,10,0,17,59
2020-09-07,0,0,51,0,0,6,0
2020-09-07,87,12,1002,29,1,47,99
2020-09-07,0,0,25,0,0,0,0
2020-09-07,0,0,35,0,0,0,0
2020-09-07,175,68,3334,60,13,91,243
2020-09-07,0,0,17,0,0,2,0
2020-09-07,0,0,41,0,0,0,0
2020-09-07,0,0,25,0,0,0,0
2020-09-07,39,4,666,13,1,64,43
2020-09-07,118,15,2926,41,0,96,133
2020-09-07,5,2,351,1,0,19,7
2020-09-07,23,0,451,6,0,7,23
2020-09-07,25,6,274,9,0,2,31
2020-09-07,84,13,1281,26,2,51,97
2020-09-07,64,18,1499,25,2,46,82
2020-09-08,62,29,1505,25,4,41,91
2020-09-08,14,3,329,5,0,6,17
2020-09-08,10,5,451,4,0,22,15
2020-09-08,55,25,1216,24,4,49,80
2020-09-08,0,0,29,0,0,4,0
2020-09-08,14,2,277,3,0,8,16
2020-09-08,1,5,33,1,0,2,6
2020-09-08,0,0,189,0,0,10,0
2020-09-08,157,46,2416,58,6,95,203
2020-09-08,60,6,686,10,0,18,66
2020-09-08,0,0,56,0,0,7,0
2020-09-08,145,23,1520,33,3,29,168
2020-09-08,22,11,274,8,0,2,33
2020-09-08,154,50,2388,40,7,107,204
2020-09-08,17,0,265,3,0,10,17
2020-09-08,0,0,17,0,0,2,0
2020-09-08,0,0,0,0,0,0,0
2020-09-08,36,2,193,3,0,9,38
2020-09-08,940,415,19839,307,53,995,1355
2020-09-08,0,0,47,0,0,0,0
2020-09-08,64,18,1781,25,4,73,82
2020-09-08,0,0,51,0,0,3,0
2020-09-08,37,2,666,11,0,67,39
2020-09-08,4,0,351,2,0,21,4
2020-09-08,1,1,65,0,0,5,2
2020-09-08,0,2,48,0,0,0,2
2020-09-08,0,0,25,0,0,0,0
2020-09-08,89,9,1286,26,1,51,98
2020-09-08,121,16,3028,42,1,86,137
2020-09-08,2,1,561,1,0,6,3
2020-09-08,214,61,3814,84,5,172,275
2020-09-08,144,50,1307,41,5,12,194
2020-09-08,219,59,6638,81,15,332,278
2020-09-08,4,1,150,2,1,4,5
2020-09-08,0,0,41,0,0,0,0
2020-09-08,2,0,124,1,0,4,2
2020-09-08,1,0,51,0,0,6,1
2020-09-08,89,18,1007,30,5,40,107
2020-09-08,24,1,451,5,1,8,25
2020-09-08,3,1,269,1,1,3,4
2020-09-08,20,2,253,9,1,5,22
2020-09-08,0,1,84,0,1,0,1
2020-09-08,8,0,96,5,0,2,8
2020-09-08,22,0,259,9,0,3,22
2020-09-08,185,76,3370,62,19,100,261
2020-09-08,0,0,25,0,0,0,0
2020-09-08,1,0,59,1,0,4,1
2020-09-08,0,0,35,0,0,0,0
2020-09-08,33,10,543,8,1,10,43
2020-09-08,37,25,721,12,4,31,62
2020-09-08,0,0,19,0,0,0,0
2020-09-08,234,60,5578,62,14,223,294
2020-09-08,43,27,699,8,4,22,70
2020-09-08,36,6,505,11,1,4,42
2020-09-08,30,2,729,9,0,26,32
2020-09-08,0,0,25,0,0,2,0
2020-09-09,94,8,1305,25,2,48,102
2020-09-09,149,40,2391,38,8,105,189
2020-09-09,55,32,1227,25,7,36,87
2020-09-09,2,0,51,0,0,4,2
2020-09-09,5,1,351,2,0,19,6
2020-09-09,7,2,96,5,2,4,9
2020-09-09,1,0,59,1,0,4,1
2020-09-09,83,10,1004,31,1,48,93
2020-09-09,66,18,1825,25,4,58,84
2020-09-09,58,7,686,7,0,19,65
2020-09-09,0,0,25,0,0,2,0
2020-09-09,47,29,720,9,5,19,76
2020-09-09,0,0,29,0,0,3,0
2020-09-09,36,1,193,3,0,8,37
2020-09-09,0,0,41,0,0,0,0
2020-09-09,0,0,0,0,0,0,0
2020-09-09,1,0,84,0,0,3,1
2020-09-09,12,3,277,2,1,7,15
2020-09-09,127,14,3068,40,1,97,141
2020-09-09,27,1,729,9,0,24,28
2020-09-09,38,1,666,12,0,56,39
2020-09-09,239,70,5654,64,12,226,309
2020-09-09,889,365,19917,290,51,957,1254
2020-09-09,4,0,272,2,0,1,4
2020-09-09,0,0,189,0,0,10,0
2020-09-09,3,0,561,1,0,5,3
2020-09-09,2,0,124,1,0,6,2
2020-09-09,20,8,274,7,0,2,28
2020-09-09,155,35,2417,55,7,81,190
2020-09-09,0,4,48,0,0,0,4
2020-09-09,20,0,265,3,0,6,20
2020-09-09,1,0,65,0,0,2,1
2020-09-09,136,23,1298,43,3,15,159
2020-09-09,189,49,3385,57,10,83,238
2020-09-09,24,0,259,10,0,4,24
2020-09-09,0,0,17,0,0,2,0
2020-09-09,210,60,3836,81,6,161,270
2020-09-09,0,0,25,0,0,0,0
2020-09-09,31,3,563,9,0,5,34
2020-09-09,0,0,51,0,0,1,0
2020-09-09,0,0,35,0,0,0,0
2020-09-09,36,14,734,10,1,27,50
2020-09-09,8,1,451,3,0,19,9
2020-09-09,0,0,19,0,0,0,0
2020-09-09,21,0,451,5,0,4,21
2020-09-09,0,0,47,0,0,0,0
2020-09-09,2,3,33,2,1,4,5
2020-09-09,62,19,1490,26,2,35,81
2020-09-09,0,0,56,0,0,7,0
2020-09-09,133,24,1526,30,4,29,157
2020-09-09,1,0,150,1,0,5,1
2020-09-09,29,10,558,7,1,9,39
2020-09-09,18,1,253,9,0,7,19
2020-09-09,13,6,324,4,2,5,19
2020-09-09,0,0,25,0,0,0,0
2020-09-09,234,75,6648,86,13,302,309
2020-09-10,7,1,96,4,1,3,8
2020-09-10,2,0,51,0,0,4,2
2020-09-10,36,3,666,9,1,54,39
2020-09-10,0,2,65,0,0,2,2
2020-09-10,0,0,25,0,0,0,0
2020-09-10,4,1,272,2,0,1,5
2020-09-10,66,17,1508,25,4,41,83
2020-09-10,67,22,1839,24,8,58,89
2020-09-10,0,0,0,0,0,0,0
2020-09-10,31,1,193,3,0,8,32
2020-09-10,0,0,17,0,0,2,0
2020-09-10,0,0,19,0,0,0,0
2020-09-10,0,0,51,0,0,3,0
2020-09-10,0,0,25,0,0,2,0
2020-09-10,7,3,451,3,1,18,10
2020-09-10,114,18,3067,39,3,89,132
2020-09-10,0,2,48,0,0,0,2
2020-09-10,82,3,1303,20,1,55,85
2020-09-10,0,0,25,0,0,0,0
2020-09-10,4,1,351,2,0,17,5
2020-09-10,0,0,41,0,0,0,0
2020-09-10,10,6,325,3,0,9,16
2020-09-10,34,25,738,10,4,26,59
2020-09-10,34,17,706,11,5,33,51
2020-09-10,55,35,1236,20,7,43,90
2020-09-10,75,9,1005,32,2,33,84
2020-09-10,2,0,150,1,0,6,2
2020-09-10,151,32,2451,53,8,82,183
2020-09-10,1,0,189,1,0,7,1
2020-09-10,14,1,277,2,0,11,15
2020-09-10,877,342,19990,301,49,924,1219
2020-09-10,3,0,119,1,0,1,3
2020-09-10,19,5,274,7,0,2,24
2020-09-10,31,3,529,11,0,7,34
2020-09-10,205,54,3848,74,4,156,259
2020-09-10,223,54,5614,65,10,236,277
2020-09-10,122,21,1524,29,4,33,143
2020-09-10,53,6,686,6,0,20,59
2020-09-10,22,0,259,9,0,7,22
2020-09-10,28,0,729,9,0,29,28
2020-09-10,19,0,265,4,0,9,19
2020-09-10,27,8,566,6,3,8,35
2020-09-10,0,0,47,0,0,0,0
2020-09-10,125,30,1305,41,3,15,155
2020-09-10,1,0,59,1,0,4,1
2020-09-10,142,41,2432,39,6,88,183
2020-09-10,0,0,29,0,0,3,0
2020-09-10,3,0,561,1,0,5,3
2020-09-10,17,0,451,4,0,8,17
2020-09-10,1,0,84,0,0,1,1
2020-09-10,232,53,6636,87,11,287,285
2020-09-10,1,0,56,0,0,8,1
2020-09-10,2,5,33,2,2,3,7
2020-09-10,13,9,253,9,0,5,22
2020-09-10,180,51,3400,53,12,93,231
2020-09-10,0,0,35,0,0,0,0
2020-09-11,5,0,96,5,0,2,5
2020-09-11,0,0,29,0,0,3,0
2020-09-11,201,49,3846,67,10,149,250
2020-09-11,2,1,33,2,0,4,3
2020-09-11,0,3,48,0,0,0,3
2020-09-11,2,0,51,0,0,3,2
2020-09-11,119,44,1310,44,2,18,163
2020-09-11,66,17,1317,20,1,50,83
2020-09-11,112,15,1536,29,1,37,127
2020-09-11,73,20,1534,25,3,40,93
2020-09-11,16,0,276,2,0,7,16
2020-09-11,0,0,51,0,0,2,0
2020-09-11,28,1,729,9,0,33,29
2020-09-11,131,47,2444,33,10,100,178
2020-09-11,227,60,6637,88,12,281,287
2020-09-11,813,345,20020,275,59,942,1158
2020-09-11,15,1,253,8,0,2,16
2020-09-11,74,18,1831,22,4,67,92
2020-09-11,2,1,275,2,0,4,3
2020-09-11,11,0,451,3,0,8,11
2020-09-11,0,0,25,0,0,0,0
2020-09-11,34,18,740,10,1,32,52
2020-09-11,0,0,41,0,0,0,0
2020-09-11,0,0,25,0,0,3,0
2020-09-11,0,0,47,0,0,0,0
2020-09-11,3,0,561,1,0,5,3
2020-09-11,0,0,19,0,0,0,0
2020-09-11,171,61,3417,45,14,85,232
2020-09-11,135,26,2448,50,7,79,161
2020-09-11,9,2,325,2,1,10,11
2020-09-11,47,3,686,7,0,22,50
2020-09-11,0,0,35,0,0,0,0
2020-09-11,112,20,3067,41,1,82,132
2020-09-11,38,10,701,11,5,36,48
2020-09-11,18,7,274,6,0,3,25
2020-09-11,25,8,578,6,2,6,33
2020-09-11,1,0,56,0,0,6,1
2020-09-11,2,1,111,1,0,1,3
2020-09-11,2,0,59,1,0,2,2
2020-09-11,0,0,0,0,0,0,0
2020-09-11,25,0,259,9,0,12,25
2020-09-11,3,0,150,1,0,6,3
2020-09-11,0,0,17,0,0,1,0
2020-09-11,7,3,451,3,1,18,10
2020-09-11,33,4,666,8,1,57,37
2020-09-11,1,1,189,1,1,6,2
2020-09-11,20,1,265,4,0,9,21
2020-09-11,5,0,351,2,0,15,5
2020-09-11,1,0,84,0,0,2,1
2020-09-11,31,0,193,3,0,9,31
2020-09-11,0,0,25,0,0,0,0
2020-09-11,32,3,536,9,1,9,35
2020-09-11,68,15,1004,29,1,41,83
2020-09-11,55,25,1248,21,5,44,80
2020-09-11,215,47,5666,65,6,245,262
2020-09-11,0,1,65,0,1,4,1
2020-09-12,2,1,561,1,0,5,3
2020-09-12,0,0,35,0,0,0,0
2020-09-12,4,0,150,1,0,6,4
2020-09-12,5,1,351,2,0,16,6
2020-09-12,1,0,25,0,0,4,1
2020-09-12,2,0,189,1,0,6,2
2020-09-12,3,0,111,0,0,4,3
2020-09-12,15,1,253,9,0,1,16
2020-09-12,17,11,274,6,0,4,28
2020-09-12,72,15,1820,20,6,68,87
2020-09-12,0,0,29,0,0,3,0
2020-09-12,0,0,17,0,0,2,0
2020-09-12,2,0,84,1,0,1,2
2020-09-12,107,19,2888,39,2,97,126
2020-09-12,50,13,1201,24,4,50,63
2020-09-12,0,0,47,0,0,0,0
2020-09-12,10,1,318,2,0,9,11
2020-09-12,46,3,664,7,1,24,49
2020-09-12,0,0,41,0,0,0,0
2020-09-12,2,0,59,1,0,3,2
2020-09-12,0,0,51,0,0,4,0
2020-09-12,27,1,729,9,0,31,28
2020-09-12,70,11,1311,15,1,51,81
2020-09-12,27,7,594,7,0,9,34
2020-09-12,16,0,276,2,0,7,16
2020-09-12,36,1,511,8,0,12,37
2020-09-12,1,0,56,0,0,7,1
2020-09-12,775,375,19884,261,47,971,1150
2020-09-12,128,47,2427,49,9,82,175
2020-09-12,0,0,19,0,0,0,0
2020-09-12,0,0,25,0,0,0,0
2020-09-12,0,0,0,0,0,0,0
2020-09-12,218,59,6634,80,7,283,277
2020-09-12,157,43,3362,46,10,92,200
2020-09-12,114,34,1310,39,3,20,148
2020-09-12,8,2,451,3,0,21,10
2020-09-12,196,42,5767,58,5,235,238
2020-09-12,69,19,1541,24,3,40,88
2020-09-12,39,17,698,11,7,34,56
2020-09-12,70,6,1005,28,1,51,76
2020-09-12,38,22,745,10,1,29,60
2020-09-12,30,1,666,8,0,59,31
2020-09-12,12,0,451,1,0,8,12
2020-09-12,0,0,25,0,0,0,0
2020-09-12,0,3,48,0,0,0,3
2020-09-12,20,2,265,4,0,9,22
2020-09-12,23,0,193,3,0,10,23
2020-09-12,0,1,51,0,1,3,1
2020-09-12,2,3,33,2,0,4,5
2020-09-12,27,0,259,9,0,6,27
2020-09-12,111,26,1507,34,5,31,137
2020-09-12,2,1,277,2,0,1,3
2020-09-12,4,0,96,4,0,3,4
2020-09-12,121,47,2419,35,9,102,168
2020-09-12,190,36,3800,66,2,170,226
2020-09-12,0,1,65,0,0,3,1
2020-09-13,0,0,17,0,0,0,0
2020-09-13,3,0,150,1,0,6,3
2020-09-13,111,18,2956,41,2,97,129
2020-09-13,151,49,3363,48,10,95,200
2020-09-13,76,18,1816,21,5,79,94
2020-09-13,15,0,451,3,0,5,15
2020-09-13,0,0,51,0,0,4,0
2020-09-13,0,0,0,0,0,0,0
2020-09-13,27,0,193,3,0,9,27
2020-09-13,0,0,25,0,0,0,0
2020-09-13,101,21,1501,31,4,29,122
2020-09-13,18,1,265,5,0,15,19
2020-09-13,11,5,322,3,0,10,16
2020-09-13,0,3,48,0,0,0,3
2020-09-13,1,0,56,0,0,6,1
2020-09-13,21,1,259,7,0,5,22
2020-09-13,69,4,1309,18,1,51,73
2020-09-13,1,1,277,1,0,1,2
2020-09-13,2,0,59,1,0,1,2
2020-09-13,42,17,1194,20,3,55,59
2020-09-13,2,0,25,1,0,3,2
2020-09-13,193,45,5716,56,6,238,238
2020-09-13,8,0,451,4,0,26,8
2020-09-13,7,1,351,4,0,19,8
2020-09-13,0,0,19,0,0,0,0
2020-09-13,19,6,274,5,1,5,25
2020-09-13,0,0,35,0,0,0,0
2020-09-13,66,21,1000,28,3,51,87
2020-09-13,70,21,1539,28,2,51,91
2020-09-13,1,0,84,0,0,2,1
2020-09-13,0,1,65,0,0,3,1
2020-09-13,114,32,1309,34,3,22,146
2020-09-13,36,3,466,9,0,10,39
2020-09-13,12,2,253,7,1,1,14
2020-09-13,0,0,29,0,0,4,0
2020-09-13,183,34,3795,65,4,139,217
2020-09-13,225,61,6624,79,11,327,286
2020-09-13,28,0,729,8,0,36,28
2020-09-13,32,1,666,8,0,60,33
2020-09-13,2,1,561,0,0,7,3
2020-09-13,2,0,33,2,0,4,2
2020-09-13,33,16,742,9,2,33,49
2020-09-13,0,0,41,0,0,0,0
2020-09-13,4,0,96,3,0,5,4
2020-09-13,0,0,47,0,0,0,0
2020-09-13,115,47,2418,33,9,118,162
2020-09-13,129,38,2466,47,7,91,167
2020-09-13,31,7,587,8,0,8,38
2020-09-13,17,0,276,2,0,9,17
2020-09-13,0,0,25,0,0,0,0
2020-09-13,2,0,189,2,0,8,2
2020-09-13,4,0,98,0,0,4,4
2020-09-13,43,12,695,11,5,39,55
2020-09-13,772,330,19838,258,40,1010,1102
2020-09-13,42,5,664,7,0,25,47
2020-09-13,0,2,53,0,0,5,2
2020-09-14,5,0,150,1,0,5,5
2020-09-14,116,39,2456,46,7,102,155
2020-09-14,0,0,47,0,0,0,0
2020-09-14,7,2,351,4,0,18,9
2020-09-14,26,0,193,3,0,9,26
2020-09-14,118,37,2385,33,8,117,155
2020-09-14,201,51,5480,67,10,268,252
2020-09-14,47,17,1215,19,5,49,64
2020-09-14,36,5,563,8,0,10,41
2020-09-14,0,0,17,0,0,2,0
2020-09-14,0,0,51,0,0,6,0
2020-09-14,1,3,275,1,0,4,4
2020-09-14,1,0,84,0,0,2,1
2020-09-14,2,0,33,2,0,3,2
2020-09-14,2,0,59,1,0,4,2
2020-09-14,38,12,676,10,5,34,50
2020-09-14,0,1,53,0,0,4,1
2020-09-14,18,1,265,5,0,14,19
2020-09-14,1,0,29,0,0,4,1
2020-09-14,0,1,65,0,0,4,1
2020-09-14,20,1,259,6,0,6,21
2020-09-14,4,1,100,0,0,6,5
2020-09-14,9,0,451,4,0,23,9
2020-09-14,34,4,517,8,0,8,38
2020-09-14,225,48,6604,76,16,322,273
2020-09-14,0,0,35,0,0,0,0
2020-09-14,0,3,48,0,0,0,3
2020-09-14,1,0,25,0,0,3,1
2020-09-14,28,0,729,9,0,40,28
2020-09-14,67,25,1533,26,2,54,92
2020-09-14,30,2,666,8,1,62,32
2020-09-14,804,343,19858,244,56,1023,1147
2020-09-14,0,0,19,0,0,0,0
2020-09-14,118,28,1502,33,2,30,146
2020-09-14,0,0,56,0,0,8,0
2020-09-14,0,0,41,0,0,0,0
2020-09-14,18,0,276,2,0,9,18
2020-09-14,155,49,3342,49,12,95,204
2020-09-14,78,12,1817,21,5,86,90
2020-09-14,108,15,3052,38,2,110,123
2020-09-14,113,30,1316,34,4,22,143
2020-09-14,31,20,738,9,2,31,51
2020-09-14,4,0,96,3,0,4,4
2020-09-14,1,0,189,1,0,12,1
2020-09-14,0,0,0,0,0,0,0
2020-09-14,2,0,561,0,0,5,2
2020-09-14,0,0,25,0,0,0,0
2020-09-14,39,7,678,6,0,22,46
2020-09-14,76,5,1297,20,0,55,81
2020-09-14,61,21,997,25,2,48,82
2020-09-14,11,1,253,5,0,3,12
2020-09-14,186,53,3828,63,2,148,239
2020-09-14,14,0,451,3,0,6,14
2020-09-14,0,0,25,0,0,0,0
2020-09-14,21,4,274,6,0,5,25
2020-09-14,10,7,326,3,1,9,17
2020-09-15,71,6,1330,17,0,54,77
2020-09-15,202,56,5636,67,17,229,258
2020-09-15,0,0,29,0,0,3,0
2020-09-15,6,0,351,3,0,19,6
2020-09-15,110,44,2395,34,8,118,154
2020-09-15,30,13,743,9,2,30,43
2020-09-15,0,0,51,0,0,6,0
2020-09-15,0,0,189,0,0,11,0
2020-09-15,0,0,41,0,0,0,0
2020-09-15,0,0,25,0,0,0,0
2020-09-15,1,0,84,0,0,2,1
2020-09-15,3,1,111,0,0,4,4
2020-09-15,60,17,1510,23,1,53,77
2020-09-15,10,0,451,3,0,8,10
2020-09-15,21,9,274,4,2,6,30
2020-09-15,0,0,19,0,0,0,0
2020-09-15,68,13,1880,22,3,80,81
2020-09-15,21,1,259,6,0,7,22
2020-09-15,3,0,48,0,0,0,3
2020-09-15,19,0,265,5,0,16,19
2020-09-15,0,0,25,0,0,0,0
2020-09-15,9,2,318,1,0,10,11
2020-09-15,52,15,1225,20,3,51,67
2020-09-15,0,0,65,0,0,2,0
2020-09-15,11,5,253,6,1,4,16
2020-09-15,19,0,276,2,0,7,19
2020-09-15,26,3,729,8,0,36,29
2020-09-15,0,1,56,0,0,9,1
2020-09-15,180,57,3845,55,6,144,237
2020-09-15,3,0,96,1,0,5,3
2020-09-15,1,2,275,1,0,2,3
2020-09-15,109,29,1313,35,3,20,138
2020-09-15,0,0,35,0,0,0,0
2020-09-15,1,1,33,1,1,6,2
2020-09-15,780,348,20011,238,56,968,1128
2020-09-15,10,3,451,4,0,22,13
2020-09-15,40,13,678,5,1,19,53
2020-09-15,103,15,3058,41,3,101,118
2020-09-15,5,0,150,1,0,6,5
2020-09-15,40,12,684,11,7,21,52
2020-09-15,220,55,6621,78,14,303,275
2020-09-15,155,62,3402,47,16,102,217
2020-09-15,33,2,556,8,0,7,35
2020-09-15,0,0,51,0,0,2,0
2020-09-15,0,0,17,0,0,2,0
2020-09-15,1,0,59,0,0,4,1
2020-09-15,0,0,0,0,0,0,0
2020-09-15,2,0,561,0,0,3,2
2020-09-15,28,3,666,7,2,63,31
2020-09-15,117,20,1524,32,3,25,137
2020-09-15,1,0,25,0,0,2,1
2020-09-15,127,34,2502,44,8,88,161
2020-09-15,62,18,1003,25,0,49,80
2020-09-15,26,0,193,3,0,9,26
2020-09-15,0,0,47,0,0,0,0
2020-09-15,35,4,572,8,0,7,39
2020-09-16,0,0,25,0,0,0,0
2020-09-16,3,0,125,0,0,6,3
2020-09-16,32,2,527,8,0,6,34
2020-09-16,0,0,51,0,0,0,0
2020-09-16,0,0,0,0,0,0,0
2020-09-16,0,0,189,0,0,10,0
2020-09-16,1,0,59,1,0,4,1
2020-09-16,58,14,1010,22,4,37,72
2020-09-16,1,0,25,0,0,3,1
2020-09-16,23,2,666,4,1,55,25
2020-09-16,18,0,276,2,0,9,18
2020-09-16,10,1,451,3,0,8,11
2020-09-16,20,1,265,6,1,10,21
2020-09-16,39,14,702,14,7,16,53
2020-09-16,14,1,253,5,0,5,15
2020-09-16,101,46,2401,33,4,121,147
2020-09-16,70,3,1325,17,0,54,73
2020-09-16,31,0,729,9,0,34,31
2020-09-16,0,0,19,0,0,0,0
2020-09-16,198,53,5632,64,13,250,251
2020-09-16,186,59,3844,58,9,145,245
2020-09-16,48,13,1234,16,4,49,61
2020-09-16,11,1,451,5,0,21,12
2020-09-16,108,35,2363,43,8,87,143
2020-09-16,0,0,65,0,0,1,0
2020-09-16,0,0,51,0,0,3,0
2020-09-16,22,1,259,7,0,6,23
2020-09-16,1,0,56,0,0,9,1
2020-09-16,0,0,25,0,0,0,0
2020-09-16,99,32,1305,33,3,27,131
2020-09-16,103,15,3086,42,1,85,118
2020-09-16,100,26,1534,31,0,25,126
2020-09-16,0,0,29,0,0,4,0
2020-09-16,18,11,274,2,0,9,29
2020-09-16,1,0,33,1,0,6,1
2020-09-16,2,1,48,0,0,0,3
2020-09-16,53,28,1502,22,4,45,81
2020-09-16,739,379,20004,232,40,958,1118
2020-09-16,0,0,41,0,0,0,0
2020-09-16,0,0,17,0,0,2,0
2020-09-16,20,0,193,3,0,8,20
2020-09-16,158,60,3408,48,15,92,218
2020-09-16,32,6,580,8,0,11,38
2020-09-16,1,0,84,0,0,2,1
2020-09-16,6,1,150,1,0,4,7
2020-09-16,0,0,35,0,0,0,0
2020-09-16,1,2,267,0,1,5,3
2020-09-16,11,5,317,2,0,8,16
2020-09-16,43,10,678,6,1,20,53
2020-09-16,224,60,6620,79,12,306,284
2020-09-16,0,0,47,0,0,0,0
2020-09-16,3,0,96,2,0,3,3
2020-09-16,4,2,351,2,0,24,6
2020-09-16,29,15,746,9,1,26,44
2020-09-16,64,14,1881,20,8,68,78
2020-09-16,2,0,561,0,0,9,2
2020-09-17,4,3,351,2,0,24,7
2020-09-17,2,0,119,0,0,5,2
2020-09-17,2,2,48,0,0,0,4
2020-09-17,29,17,586,6,3,9,46
2020-09-17,0,0,35,0,0,0,0
2020-09-17,0,0,51,0,0,5,0
2020-09-17,0,0,51,0,0,0,0
2020-09-17,18,0,276,2,0,10,18
2020-09-17,114,16,3087,37,1,89,130
2020-09-17,10,9,320,2,1,9,19
2020-09-17,30,1,577,8,0,10,31
2020-09-17,2,0,561,0,0,7,2
2020-09-17,0,0,47,0,0,0,0
2020-09-17,1,0,84,0,0,2,1
2020-09-17,0,0,19,0,0,0,0
2020-09-17,20,0,259,8,0,5,20
2020-09-17,0,2,65,0,0,2,2
2020-09-17,0,0,41,0,0,0,0
2020-09-17,74,2,1304,21,0,57,76
2020-09-17,11,0,253,5,0,9,11
2020-09-17,98,21,1313,30,3,19,119
2020-09-17,0,0,33,0,0,6,0
2020-09-17,6,1,150,1,0,4,7
2020-09-17,9,0,451,3,0,13,9
2020-09-17,27,3,666,5,0,56,30
2020-09-17,143,67,3379,44,12,82,210
2020-09-17,46,20,1243,18,6,47,66
2020-09-17,23,1,265,6,1,10,24
2020-09-17,98,33,1548,30,1,23,131
2020-09-17,732,340,20066,228,36,941,1072
2020-09-17,38,9,678,6,0,21,47
2020-09-17,217,59,6630,77,14,286,276
2020-09-17,1,0,59,0,0,5,1
2020-09-17,60,13,1003,25,2,35,73
2020-09-17,201,59,5596,64,11,237,260
2020-09-17,109,32,2485,34,10,101,141
2020-09-17,2,0,25,0,0,2,2
2020-09-17,39,10,704,13,1,31,49
2020-09-17,98,37,2411,31,5,117,135
2020-09-17,30,0,702,8,0,33,30
2020-09-17,67,19,1806,23,7,61,86
2020-09-17,0,0,25,0,0,0,0
2020-09-17,23,0,193,4,0,8,23
2020-09-17,5,0,96,2,0,2,5
2020-09-17,0,0,189,0,0,10,0
2020-09-17,172,51,3832,55,8,146,223
2020-09-17,0,0,29,0,0,4,0
2020-09-17,0,0,17,0,0,2,0
2020-09-17,26,28,746,9,0,32,54
2020-09-17,19,10,274,2,1,12,29
2020-09-17,1,3,267,0,1,4,4
2020-09-17,0,0,0,0,0,0,0
2020-09-17,13,1,451,6,0,25,14
2020-09-17,55,25,1510,21,5,57,80
2020-09-17,0,0,25,0,0,0,0
2020-09-17,1,0,56,0,0,9,1
2020-09-18,99,39,2415,36,5,113,138
2020-09-18,0,0,51,0,0,1,0
2020-09-18,0,0,0,0,0,0,0
2020-09-18,3,0,132,0,0,3,3
2020-09-18,9,2,254,5,1,9,11
2020-09-18,13,12,274,3,2,5,25
2020-09-18,114,19,3097,39,2,97,133
2020-09-18,4,0,561,0,0,8,4
2020-09-18,148,51,3404,46,8,102,199
2020-09-18,34,1,702,8,1,38,35
2020-09-18,23,4,513,6,0,10,27
2020-09-18,38,6,678,6,0,24,44
2020-09-18,1,0,59,0,0,4,1
2020-09-18,169,47,3832,50,10,156,216
2020-09-18,202,50,5704,65,9,239,252
2020-09-18,0,0,19,0,0,0,0
2020-09-18,208,41,6631,71,11,284,249
2020-09-18,1,0,84,0,0,2,1
2020-09-18,0,0,29,0,0,4,0
2020-09-18,24,0,193,5,0,9,24
2020-09-18,110,41,2465,41,9,92,151
2020-09-18,0,0,25,0,0,0,0
2020-09-18,0,0,47,0,0,0,0
2020-09-18,17,0,276,2,0,10,17
2020-09-18,19,0,259,8,0,7,19
2020-09-18,0,0,41,0,0,0,0
2020-09-18,64,12,1872,20,4,62,76
2020-09-18,39,9,715,15,1,29,48
2020-09-18,0,1,66,0,1,3,1
2020-09-18,48,13,1256,21,3,51,61
2020-09-18,26,28,747,8,4,30,54
2020-09-18,0,1,33,0,0,7,1
2020-09-18,66,4,1320,18,0,57,70
2020-09-18,95,25,1316,30,1,29,120
2020-09-18,11,1,451,4,0,24,12
2020-09-18,0,0,35,0,0,0,0
2020-09-18,0,0,189,0,0,8,0
2020-09-18,765,363,20006,227,46,941,1128
2020-09-18,55,9,1002,24,1,37,64
2020-09-18,0,0,25,0,0,0,0
2020-09-18,1,0,56,0,0,9,1
2020-09-18,26,2,666,3,1,60,28
2020-09-18,7,4,317,2,0,9,11
2020-09-18,2,2,272,0,1,1,4
2020-09-18,27,10,593,7,0,7,37
2020-09-18,4,0,96,2,0,4,4
2020-09-18,21,1,265,6,0,8,22
2020-09-18,96,18,1538,31,1,21,114
2020-09-18,0,0,17,0,0,2,0
2020-09-18,2,1,48,0,0,0,3
2020-09-18,5,0,150,2,0,5,5
2020-09-18,3,0,25,0,0,1,3
2020-09-18,5,0,359,3,0,22,5
2020-09-18,0,0,51,0,0,4,0
2020-09-18,45,29,1499,20,8,56,74
2020-09-18,14,1,451,5,1,10,15
2020-09-19,72,4,1308,21,0,69,76
2020-09-19,0,0,51,0,0,4,0
2020-09-19,185,52,5674,65,7,246,237
2020-09-19,7,5,317,2,0,9,12
2020-09-19,3,0,561,0,0,11,3
2020-09-19,1,0,84,0,0,2,1
2020-09-19,114,34,2471,43,6,95,148
2020-09-19,0,0,47,0,0,0,0
2020-09-19,0,0,0,0,0,0,0
2020-09-19,138,54,3359,47,7,105,192
2020-09-19,4,0,359,2,0,26,4
2020-09-19,0,0,35,0,0,0,0
2020-09-19,111,20,3097,38,1,102,131
2020-09-19,58,9,1874,18,2,61,67
2020-09-19,26,11,593,6,0,7,37
2020-09-19,0,0,51,0,0,2,0
2020-09-19,3,0,82,0,0,2,3
2020-09-19,3,0,25,1,0,1,3
2020-09-19,39,6,707,13,0,32,45
2020-09-19,16,1,451,4,0,17,17
2020-09-19,10,2,451,4,0,19,12
2020-09-19,48,11,1251,18,4,54,59
2020-09-19,0,0,29,0,0,4,0
2020-09-19,167,54,3800,45,11,169,221
2020-09-19,0,0,25,0,0,0,0
2020-09-19,57,10,1002,24,0,39,67
2020-09-19,22,6,526,6,0,6,28
2020-09-19,2,2,272,0,1,1,4
2020-09-19,5,0,96,2,0,4,5
2020-09-19,95,48,2416,37,5,112,143
2020-09-19,20,0,193,4,0,11,20
2020-09-19,0,1,56,0,0,9,1
2020-09-19,32,2,702,7,2,30,34
2020-09-19,23,3,666,4,0,64,26
2020-09-19,0,0,189,0,0,6,0
2020-09-19,21,1,265,6,0,6,22
2020-09-19,94,18,1316,33,1,29,112
2020-09-19,92,23,1541,28,4,30,115
2020-09-19,749,328,19792,207,48,967,1077
2020-09-19,203,50,6634,72,10,314,253
2020-09-19,18,0,259,8,0,7,18
2020-09-19,0,0,25,0,0,0,0
2020-09-19,0,0,17,0,0,2,0
2020-09-19,2,3,48,0,0,0,5
2020-09-19,9,0,253,6,0,9,9
2020-09-19,51,25,1499,18,5,49,76
2020-09-19,36,8,664,4,0,26,44
2020-09-19,2,0,59,0,0,4,2
2020-09-19,24,30,747,8,4,31,54
2020-09-19,0,0,19,0,0,0,0
2020-09-19,0,0,33,0,0,7,0
2020-09-19,14,11,274,3,0,8,25
2020-09-19,17,0,276,2,0,9,17
2020-09-19,0,0,41,0,0,0,0
2020-09-19,5,0,150,1,0,8,5
2020-09-19,0,2,65,0,0,4,2
2020-09-20,23,3,666,5,1,64,26
2020-09-20,26,10,593,5,0,9,36
2020-09-20,0,0,17,0,0,2,0
2020-09-20,67,4,1281,19,0,64,71
2020-09-20,92,13,1528,30,2,29,105
2020-09-20,3,0,561,0,0,16,3
2020-09-20,120,30,2427,42,8,123,150
2020-09-20,0,1,51,0,1,3,1
2020-09-20,21,6,531,5,0,8,27
2020-09-20,20,0,259,8,0,7,20
2020-09-20,22,28,747,8,3,34,50
2020-09-20,0,0,189,0,0,6,0
2020-09-20,0,0,19,0,0,0,0
2020-09-20,3,3,48,0,0,0,6
2020-09-20,19,0,193,3,0,14,19
2020-09-20,98,46,2415,38,8,108,144
2020-09-20,0,0,29,0,0,4,0
2020-09-20,2,2,272,0,1,1,4
2020-09-20,0,0,35,0,0,0,0
2020-09-20,0,1,56,0,0,9,1
2020-09-20,0,0,25,0,0,0,0
2020-09-20,211,56,6626,73,12,300,267
2020-09-20,0,0,41,0,0,0,0
2020-09-20,8,4,317,2,0,10,12
2020-09-20,17,0,276,2,0,9,17
2020-09-20,0,0,33,0,0,6,0
2020-09-20,58,6,1002,24,0,37,64
2020-09-20,9,0,253,6,0,8,9
2020-09-20,3,1,97,0,0,3,4
2020-09-20,1,0,51,0,0,2,1
2020-09-20,3,0,59,0,0,2,3
2020-09-20,7,0,451,3,0,21,7
2020-09-20,745,368,19800,207,63,989,1113
2020-09-20,178,59,5614,64,13,235,237
2020-09-20,44,13,1248,19,3,59,57
2020-09-20,50,26,1498,17,5,55,76
2020-09-20,0,0,25,0,0,0,0
2020-09-20,113,22,3096,36,4,120,135
2020-09-20,34,8,707,12,0,33,42
2020-09-20,15,12,274,4,0,6,27
2020-09-20,0,0,47,0,0,0,0
2020-09-20,131,55,3315,47,6,112,186
2020-09-20,4,0,150,1,0,7,4
2020-09-20,4,0,25,1,0,1,4
2020-09-20,33,2,702,7,2,31,35
2020-09-20,156,62,3803,49,13,175,218
2020-09-20,92,21,1321,33,1,28,113
2020-09-20,13,0,451,4,0,20,13
2020-09-20,65,8,1859,21,2,62,73
2020-09-20,0,0,84,0,0,4,0
2020-09-20,19,1,265,5,0,8,20
2020-09-20,0,0,0,0,0,0,0
2020-09-20,37,10,664,8,0,21,47
2020-09-20,6,0,96,3,0,5,6
2020-09-20,0,2,65,0,1,3,2
2020-09-20,1,3,359,0,0,26,4
2020-09-21,0,0,29,0,0,4,0
2020-09-21,0,0,25,0,0,0,0
2020-09-21,3,1,133,0,0,4,4
2020-09-21,33,2,702,8,2,39,35
2020-09-21,170,64,5510,55,13,250,234
2020-09-21,69,2,1293,22,0,56,71
2020-09-21,68,2,1837,18,0,75,70
2020-09-21,0,0,47,0,0,0,0
2020-09-21,2,4,359,1,0,23,6
2020-09-21,3,3,48,0,0,0,6
2020-09-21,52,22,1492,18,3,54,74
2020-09-21,5,0,451,2,0,27,5
2020-09-21,4,3,276,0,1,4,7
2020-09-21,93,24,1297,29,0,27,117
2020-09-21,30,20,734,10,1,30,50
2020-09-21,13,14,274,5,0,7,27
2020-09-21,96,34,2337,36,5,115,130
2020-09-21,111,18,3051,34,0,109,129
2020-09-21,26,8,666,4,0,60,34
2020-09-21,1,0,51,0,0,3,1
2020-09-21,35,12,701,11,3,35,47
2020-09-21,12,1,451,3,1,13,13
2020-09-21,3,0,59,0,0,2,3
2020-09-21,21,0,193,2,0,9,21
2020-09-21,5,0,96,3,0,5,5
2020-09-21,0,0,41,0,0,0,0
2020-09-21,3,0,25,1,0,1,3
2020-09-21,146,52,3363,42,10,108,198
2020-09-21,15,0,276,2,0,10,15
2020-09-21,15,4,522,3,0,11,19
2020-09-21,0,1,66,0,0,5,1
2020-09-21,209,54,6623,68,12,320,263
2020-09-21,164,71,3849,46,12,172,235
2020-09-21,0,0,35,0,0,0,0
2020-09-21,23,0,259,9,0,7,23
2020-09-21,2,0,561,0,0,10,2
2020-09-21,19,1,265,5,0,11,20
2020-09-21,0,0,17,0,0,2,0
2020-09-21,0,0,33,0,0,6,0
2020-09-21,0,0,51,0,0,1,0
2020-09-21,132,29,2456,48,7,95,161
2020-09-21,8,5,324,2,0,11,13
2020-09-21,0,1,56,0,0,8,1
2020-09-21,0,0,84,0,0,3,0
2020-09-21,5,0,150,2,0,8,5
2020-09-21,60,18,1004,22,3,39,78
2020-09-21,0,0,19,0,0,0,0
2020-09-21,0,0,189,0,0,8,0
2020-09-21,11,0,253,6,0,11,11
2020-09-21,0,0,0,0,0,0,0
2020-09-21,89,17,1552,28,2,18,106
2020-09-21,0,0,25,0,0,0,0
2020-09-21,779,365,19865,222,46,988,1144
2020-09-21,39,11,1240,21,2,63,50
2020-09-21,21,13,568,4,1,11,34
2020-09-21,37,12,677,7,0,24,49
2020-09-22,0,0,19,0,0,0,0
2020-09-22,4,1,561,2,0,9,5
2020-09-22,92,26,1301,29,2,22,118
2020-09-22,210,50,6635,68,10,304,260
2020-09-22,45,14,1259,18,4,63,59
2020-09-22,0,0,0,0,0,0,0
2020-09-22,91,36,2370,35,5,117,127
2020-09-22,18,2,529,3,1,8,20
2020-09-22,3,2,124,0,0,7,5
2020-09-22,27,24,750,11,2,32,51
2020-09-22,0,1,66,0,0,4,1
2020-09-22,0,1,29,0,0,3,1
2020-09-22,82,23,1556,28,1,21,105
2020-09-22,0,0,35,0,0,0,0
2020-09-22,72,8,1857,19,3,68,80
2020-09-22,6,0,96,2,0,6,6
2020-09-22,6,0,150,2,0,4,6
2020-09-22,0,0,41,0,0,0,0
2020-09-22,162,72,3861,46,12,186,234
2020-09-22,138,33,2515,45,6,92,171
2020-09-22,175,64,5658,51,10,243,239
2020-09-22,69,1,1321,21,0,59,70
2020-09-22,49,25,1518,14,2,54,74
2020-09-22,4,0,451,1,0,30,4
2020-09-22,3,2,48,0,0,0,5
2020-09-22,0,0,47,0,0,0,0
2020-09-22,0,0,17,0,0,2,0
2020-09-22,0,0,25,0,0,0,0
2020-09-22,0,0,25,0,0,0,0
2020-09-22,0,0,84,0,0,3,0
2020-09-22,22,20,567,3,2,-5,42
2020-09-22,4,3,276,1,1,2,7
2020-09-22,15,15,274,5,1,5,30
2020-09-22,56,18,1001,21,3,39,74
2020-09-22,2,0,25,1,0,1,2
2020-09-22,0,0,189,0,0,12,0
2020-09-22,0,1,56,0,0,10,1
2020-09-22,21,6,666,6,0,61,27
2020-09-22,3,1,359,2,0,21,4
2020-09-22,41,9,677,7,0,23,50
2020-09-22,9,0,253,4,0,9,9
2020-09-22,22,0,193,2,0,13,22
2020-09-22,1,0,51,0,0,1,1
2020-09-22,150,64,3372,42,11,101,214
2020-09-22,753,392,20023,212,42,970,1145
2020-09-22,13,0,451,5,0,11,13
2020-09-22,17,0,276,3,0,6,17
2020-09-22,36,8,703,11,1,37,44
2020-09-22,114,8,3030,38,0,91,122
2020-09-22,0,0,33,0,0,3,0
2020-09-22,34,2,702,11,2,37,36
2020-09-22,0,1,51,0,1,2,1
2020-09-22,7,5,333,2,0,7,12
2020-09-22,26,0,259,7,0,6,26
2020-09-22,1,0,59,1,0,3,1
2020-09-22,14,2,265,4,0,10,16
2020-09-23,0,0,41,0,0,0,0
2020-09-23,2,0,59,1,0,2,2
2020-09-23,0,0,19,0,0,0,0
2020-09-23,12,0,265,3,0,12,12
2020-09-23,0,0,25,0,0,0,0
2020-09-23,1,0,25,1,0,3,1
2020-09-23,24,24,565,3,2,8,48
2020-09-23,0,0,29,0,0,3,0
2020-09-23,5,4,267,1,1,0,9
2020-09-23,18,8,511,4,0,5,26
2020-09-23,0,0,35,0,0,0,0
2020-09-23,0,0,25,0,0,0,0
2020-09-23,3,0,359,3,0,19,3
2020-09-23,7,3,325,2,1,13,10
2020-09-23,5,1,561,3,0,6,6
2020-09-23,0,0,47,0,0,0,0
2020-09-23,75,2,1341,21,0,55,77
2020-09-23,760,378,20078,216,62,989,1138
2020-09-23,1,0,56,0,0,8,1
2020-09-23,1,0,52,0,0,4,1
2020-09-23,109,11,3028,41,1,92,120
2020-09-23,39,13,677,6,0,22,52
2020-09-23,2,0,137,0,0,7,2
2020-09-23,8,0,253,4,0,10,8
2020-09-23,1,0,48,0,0,0,1
2020-09-23,12,0,451,6,0,5,12
2020-09-23,65,9,1891,18,5,64,74
2020-09-23,37,10,711,13,1,35,47
2020-09-23,3,0,451,1,0,28,3
2020-09-23,6,0,96,2,0,7,6
2020-09-23,8,0,150,2,0,5,8
2020-09-23,13,17,274,5,0,3,30
2020-09-23,15,0,193,2,0,13,15
2020-09-23,0,0,33,0,0,3,0
2020-09-23,91,24,1316,28,2,23,115
2020-09-23,92,43,2386,32,5,120,135
2020-09-23,17,0,276,2,0,7,17
2020-09-23,141,56,3401,40,10,114,197
2020-09-23,0,0,17,0,0,2,0
2020-09-23,200,53,6635,67,13,291,253
2020-09-23,0,0,189,0,0,5,0
2020-09-23,160,52,3848,49,7,180,212
2020-09-23,27,0,259,7,0,4,27
2020-09-23,44,20,1260,19,6,54,64
2020-09-23,0,0,0,0,0,0,0
2020-09-23,168,57,5625,42,10,217,225
2020-09-23,84,24,1556,26,3,24,108
2020-09-23,54,16,1000,19,2,41,70
2020-09-23,20,4,666,5,0,45,24
2020-09-23,0,0,51,0,0,2,0
2020-09-23,45,21,1523,13,2,40,66
2020-09-23,29,28,752,13,1,28,57
2020-09-23,27,0,702,11,0,31,27
2020-09-23,0,1,66,0,0,4,1
2020-09-23,0,0,84,0,0,0,0
2020-09-23,147,27,2493,43,6,87,174
2020-09-24,2,1,131,0,1,2,3
2020-09-24,18,0,193,2,0,12,18
2020-09-24,80,23,1561,24,1,24,103
2020-09-24,0,0,25,0,0,0,0
2020-09-24,715,319,20052,207,66,949,1034
2020-09-24,0,0,84,0,0,1,0
2020-09-24,157,69,5606,50,12,239,226
2020-09-24,0,0,19,0,0,0,0
2020-09-24,1,0,189,1,0,6,1
2020-09-24,2,0,25,1,0,0,2
2020-09-24,1,0,51,0,0,3,1
2020-09-24,12,0,265,2,0,12,12
2020-09-24,139,31,2498,34,7,79,170
2020-09-24,0,0,17,0,0,2,0
2020-09-24,0,0,47,0,0,0,0
2020-09-24,3,0,96,2,0,4,3
2020-09-24,4,0,59,1,0,0,4
2020-09-24,16,5,541,6,0,5,21
2020-09-24,0,0,66,0,0,4,0
2020-09-24,0,0,52,0,0,2,0
2020-09-24,82,32,1324,26,5,21,114
2020-09-24,5,0,561,2,0,7,5
2020-09-24,49,7,1003,20,2,44,56
2020-09-24,196,45,6629,65,8,300,241
2020-09-24,0,0,25,0,0,0,0
2020-09-24,28,0,702,10,0,31,28
2020-09-24,11,0,451,6,0,5,11
2020-09-24,4,1,272,1,0,1,5
2020-09-24,5,3,324,4,1,12,8
2020-09-24,11,0,253,5,0,14,11
2020-09-24,87,36,2383,31,8,122,123
2020-09-24,24,24,513,3,0,6,48
2020-09-24,39,20,1505,14,3,40,59
2020-09-24,111,10,3021,35,0,96,121
2020-09-24,35,12,689,14,2,32,47
2020-09-24,28,0,259,8,0,4,28
2020-09-24,152,42,3841,50,8,153,194
2020-09-24,3,1,451,1,0,29,4
2020-09-24,142,62,3429,39,8,110,204
2020-09-24,60,9,1898,16,5,49,69
2020-09-24,1,0,48,0,0,0,1
2020-09-24,0,0,0,0,0,0,0
2020-09-24,30,30,755,12,2,29,60
2020-09-24,11,12,221,4,1,7,23
2020-09-24,44,23,1266,16,6,56,67
2020-09-24,1,0,56,0,0,7,1
2020-09-24,72,2,1339,21,0,59,74
2020-09-24,0,0,41,0,0,0,0
2020-09-24,8,0,150,2,0,4,8
2020-09-24,0,0,33,0,0,5,0
2020-09-24,41,8,677,7,0,16,49
2020-09-24,18,0,276,3,0,9,18
2020-09-24,3,2,359,3,0,20,5
2020-09-24,0,0,35,0,0,0,0
2020-09-24,0,0,29,0,0,4,0
2020-09-24,23,4,666,5,0,50,27
2020-09-25,20,0,376,5,0,13,20
2020-09-25,12,0,451,7,0,6,12
2020-09-25,3,0,451,1,0,31,3
2020-09-25,25,0,259,9,0,9,25
2020-09-25,156,51,5578,47,7,232,207
2020-09-25,0,0,84,0,0,4,0
2020-09-25,76,28,1313,24,3,20,104
2020-09-25,13,0,265,2,0,10,13
2020-09-25,108,12,2999,38,1,100,120
2020-09-25,148,50,3858,47,6,150,198
2020-09-25,1,0,48,0,0,0,1
2020-09-25,10,0,253,4,0,15,10
2020-09-25,3,2,359,3,0,18,5
2020-09-25,0,0,35,0,0,0,0
2020-09-25,28,0,702,11,0,28,28
2020-09-25,32,13,700,11,2,30,45
2020-09-25,70,2,1334,20,0,57,72
2020-09-25,13,19,263,4,0,19,32
2020-09-25,5,0,59,1,0,2,5
2020-09-25,134,28,2479,31,3,74,162
2020-09-25,18,8,592,6,3,5,26
2020-09-25,0,0,29,0,0,4,0
2020-09-25,0,0,52,0,0,1,0
2020-09-25,3,0,96,2,0,5,3
2020-09-25,9,0,150,2,0,5,9
2020-09-25,0,0,17,0,0,2,0
2020-09-25,1,0,56,0,0,8,1
2020-09-25,0,0,51,0,0,2,0
2020-09-25,5,2,319,4,0,12,7
2020-09-25,0,2,65,0,1,2,2
2020-09-25,1,0,189,1,0,8,1
2020-09-25,692,336,20053,200,63,930,1028
2020-09-25,0,0,0,0,0,0,0
2020-09-25,86,27,2377,30,2,125,113
2020-09-25,2,1,130,0,1,5,3
2020-09-25,129,67,3395,36,9,106,196
2020-09-25,0,0,33,0,0,5,0
2020-09-25,0,0,41,0,0,0,0
2020-09-25,78,23,1566,20,1,20,101
2020-09-25,2,0,25,1,0,0,2
2020-09-25,196,39,6728,71,4,307,235
2020-09-25,6,0,561,2,0,11,6
2020-09-25,0,0,47,0,0,0,0
2020-09-25,0,0,25,0,0,0,0
2020-09-25,0,0,19,0,0,0,0
2020-09-25,24,4,666,6,0,49,28
2020-09-25,44,22,1268,16,6,53,66
2020-09-25,5,0,272,1,0,2,5
2020-09-25,61,11,1870,20,5,56,72
2020-09-25,13,0,193,1,0,14,13
2020-09-25,44,8,1007,19,1,52,52
2020-09-25,0,0,25,0,0,0,0
2020-09-25,25,20,752,11,2,34,45
2020-09-25,36,9,677,7,0,14,45
2020-09-25,18,15,549,4,1,8,33
2020-09-25,30,19,1502,13,3,54,49
2020-09-26,30,11,1492,13,1,54,41
2020-09-26,3,0,96,2,0,7,3
2020-09-26,3,0,277,2,0,2,3
2020-09-26,1,0,189,1,0,4,1
2020-09-26,131,25,2485,32,7,85,156
2020-09-26,0,0,51,0,0,2,0
2020-09-26,9,0,150,3,0,5,9
2020-09-26,46,18,1254,18,5,62,64
2020-09-26,0,0,51,0,0,2,0
2020-09-26,10,0,193,1,0,14,10
2020-09-26,32,10,664,6,0,13,42
2020-09-26,13,0,265,2,0,15,13
2020-09-26,21,5,666,4,1,56,26
2020-09-26,75,36,2363,24,6,118,111
2020-09-26,0,0,35,0,0,0,0
2020-09-26,69,19,1282,23,2,27,88
2020-09-26,19,0,376,5,0,12,19
2020-09-26,8,1,561,1,0,10,9
2020-09-26,3,1,451,1,0,28,4
2020-09-26,0,0,17,0,0,2,0
2020-09-26,0,0,0,0,0,0,0
2020-09-26,0,0,41,0,0,0,0
2020-09-26,4,0,59,1,0,3,4
2020-09-26,152,44,3825,47,4,159,196
2020-09-26,56,8,1859,18,3,63,64
2020-09-26,5,8,328,3,1,6,13
2020-09-26,0,0,29,0,0,4,0
2020-09-26,38,11,1013,19,1,52,49
2020-09-26,1,0,48,0,0,0,1
2020-09-26,13,0,451,7,0,4,13
2020-09-26,2,0,25,1,0,2,2
2020-09-26,13,3,263,4,0,21,16
2020-09-26,0,0,25,0,0,0,0
2020-09-26,1,0,84,0,0,0,1
2020-09-26,29,12,700,10,2,32,41
2020-09-26,1,0,56,0,0,6,1
2020-09-26,18,7,579,8,1,5,25
2020-09-26,93,11,2902,35,1,106,104
2020-09-26,135,46,3353,37,13,104,181
2020-09-26,66,4,1330,20,0,64,70
2020-09-26,197,42,6766,74,5,307,239
2020-09-26,25,25,756,11,2,37,50
2020-09-26,0,0,33,0,0,5,0
2020-09-26,0,1,65,0,0,5,1
2020-09-26,1,0,122,0,0,5,1
2020-09-26,164,36,5585,45,2,251,200
2020-09-26,25,0,259,10,0,5,25
2020-09-26,687,371,19966,206,71,977,1058
2020-09-26,18,19,545,3,3,8,37
2020-09-26,0,0,19,0,0,0,0
2020-09-26,9,0,253,4,0,13,9
2020-09-26,0,0,47,0,0,0,0
2020-09-26,29,0,702,10,0,28,29
2020-09-26,73,24,1533,19,3,16,97
2020-09-26,3,0,356,3,0,18,3
2020-09-26,0,0,25,0,0,0,0
2020-09-27,3,0,277,1,0,2,3
2020-09-27,22,28,747,10,5,31,50
2020-09-27,33,8,664,7,0,18,41
2020-09-27,0,0,35,0,0,0,0
2020-09-27,0,0,25,0,0,0,0
2020-09-27,32,20,1007,16,2,53,52
2020-09-27,0,0,47,0,0,0,0
2020-09-27,3,0,359,3,0,17,3
2020-09-27,1,0,189,1,0,4,1
2020-09-27,94,13,2882,33,3,106,107
2020-09-27,0,1,29,0,0,3,1
2020-09-27,3,0,96,3,0,3,3
2020-09-27,29,0,702,9,0,30,29
2020-09-27,20,0,259,8,0,6,20
2020-09-27,21,1,666,5,0,55,22
2020-09-27,13,0,451,8,0,4,13
2020-09-27,14,0,193,1,0,15,14
2020-09-27,0,0,25,0,0,0,0
2020-09-27,0,0,33,0,0,6,0
2020-09-27,31,13,1484,13,1,54,44
2020-09-27,12,9,263,3,0,21,21
2020-09-27,714,356,19933,205,61,998,1070
2020-09-27,184,48,6761,69,9,319,232
2020-09-27,76,37,2364,25,5,124,113
2020-09-27,67,3,1303,16,0,61,70
2020-09-27,48,11,1255,18,0,54,59
2020-09-27,0,0,19,0,0,0,0
2020-09-27,74,22,1555,20,2,14,96
2020-09-27,160,50,3812,47,5,171,210
2020-09-27,1,0,65,0,0,3,1
2020-09-27,2,1,451,1,0,29,3
2020-09-27,17,22,533,1,1,5,39
2020-09-27,0,0,17,0,0,2,0
2020-09-27,24,0,376,4,0,12,24
2020-09-27,1,0,48,0,0,0,1
2020-09-27,1,0,84,0,0,0,1
2020-09-27,2,0,25,1,0,2,2
2020-09-27,0,0,0,0,0,0,0
2020-09-27,54,6,1813,18,0,81,60
2020-09-27,7,7,326,3,0,14,14
2020-09-27,0,0,51,0,0,3,0
2020-09-27,119,35,2486,38,6,88,154
2020-09-27,1,0,56,0,0,6,1
2020-09-27,4,0,59,1,0,1,4
2020-09-27,0,0,41,0,0,0,0
2020-09-27,14,0,265,1,0,14,14
2020-09-27,9,1,253,4,0,11,10
2020-09-27,0,0,52,0,0,0,0
2020-09-27,1,6,561,0,1,11,7
2020-09-27,20,4,552,7,1,7,24
2020-09-27,29,9,675,9,0,31,38
2020-09-27,161,63,5518,46,4,257,224
2020-09-27,2,0,132,0,0,3,2
2020-09-27,59,20,1315,20,1,33,79
2020-09-27,7,0,150,3,0,5,7
2020-09-27,128,49,3340,36,10,111,177
2020-09-28,0,0,35,0,0,0,0
2020-09-28,13,0,265,1,0,13,13
2020-09-28,29,11,680,8,2,32,40
2020-09-28,1,0,48,0,0,0,1
2020-09-28,3,0,451,1,0,29,3
2020-09-28,1,0,84,0,0,6,1
2020-09-28,71,3,1304,14,0,68,74
2020-09-28,6,1,561,1,0,13,7
2020-09-28,0,0,0,0,0,0,0
2020-09-28,20,8,581,7,1,4,28
2020-09-28,125,35,2489,33,9,95,160
2020-09-28,30,0,702,8,0,29,30
2020-09-28,60,5,1828,17,1,88,65
2020-09-28,165,58,3831,48,8,173,223
2020-09-28,19,19,546,2,1,7,38
2020-09-28,0,0,25,0,0,0,0
2020-09-28,16,0,193,1,0,14,16
2020-09-28,0,1,56,0,0,7,1
2020-09-28,0,0,17,0,0,2,0
2020-09-28,26,1,666,6,0,56,27
2020-09-28,0,1,52,0,1,1,1
2020-09-28,0,0,25,0,0,0,0
2020-09-28,0,0,51,0,0,3,0
2020-09-28,0,1,29,0,0,4,1
2020-09-28,4,2,359,4,0,26,6
2020-09-28,10,10,271,4,0,10,20
2020-09-28,0,0,19,0,0,0,0
2020-09-28,734,291,19925,207,55,1043,1025
2020-09-28,24,28,742,9,2,30,52
2020-09-28,22,0,259,8,0,4,22
2020-09-28,0,0,41,0,0,0,0
2020-09-28,8,6,320,3,0,12,14
2020-09-28,6,0,150,3,0,5,6
2020-09-28,2,0,25,1,0,1,2
2020-09-28,93,18,2972,29,1,118,111
2020-09-28,0,0,47,0,0,0,0
2020-09-28,1,0,189,1,0,5,1
2020-09-28,25,0,376,5,0,16,25
2020-09-28,46,7,1244,14,1,62,53
2020-09-28,0,0,33,0,0,6,0
2020-09-28,125,57,3322,33,7,110,182
2020-09-28,30,15,1477,12,0,52,45
2020-09-28,76,14,1579,20,2,13,90
2020-09-28,35,18,1009,14,4,45,53
2020-09-28,1,1,65,0,1,2,2
2020-09-28,162,78,5626,46,10,239,240
2020-09-28,13,0,451,6,0,8,13
2020-09-28,2,3,275,1,1,2,5
2020-09-28,199,58,6770,68,19,338,257
2020-09-28,5,0,59,1,0,1,5
2020-09-28,3,0,96,2,0,5,3
2020-09-28,54,24,1310,21,1,29,78
2020-09-28,12,14,263,2,1,18,26
2020-09-28,79,35,2368,25,7,125,114
2020-09-28,2,0,134,0,0,4,2
2020-09-28,34,8,677,7,0,23,42
2020-09-29,13,0,451,6,0,3,13
2020-09-29,90,15,2970,29,4,104,105
2020-09-29,172,52,5747,48,9,231,224
2020-09-29,0,0,17,0,0,2,0
2020-09-29,122,38,2492,32,5,97,160
2020-09-29,18,21,562,2,4,8,39
2020-09-29,0,0,19,0,0,0,0
2020-09-29,0,0,41,0,0,0,0
2020-09-29,9,13,263,2,1,17,22
2020-09-29,1,0,51,1,0,2,1
2020-09-29,6,1,351,3,0,25,7
2020-09-29,0,1,56,0,0,7,1
2020-09-29,32,17,1509,13,3,49,49
2020-09-29,0,0,29,0,0,4,0
2020-09-29,0,0,47,0,0,0,0
2020-09-29,23,0,259,8,0,6,23
2020-09-29,48,14,1270,17,3,53,62
2020-09-29,7,8,326,3,1,11,15
2020-09-29,5,0,150,2,0,2,5
2020-09-29,50,30,1312,21,6,18,80
2020-09-29,4,0,96,3,0,3,4
2020-09-29,3,0,134,1,0,4,3
2020-09-29,2,3,277,1,0,3,5
2020-09-29,5,1,561,1,0,13,6
2020-09-29,130,52,3312,36,7,110,182
2020-09-29,23,0,376,4,0,14,23
2020-09-29,3,0,451,1,0,25,3
2020-09-29,20,1,193,2,1,13,21
2020-09-29,1,0,84,0,0,2,1
2020-09-29,26,17,696,7,5,12,43
2020-09-29,1,0,189,1,0,8,1
2020-09-29,1,1,65,0,1,3,2
2020-09-29,61,5,1866,16,1,73,66
2020-09-29,182,56,6775,65,9,309,238
2020-09-29,0,0,53,0,0,0,0
2020-09-29,13,1,265,1,0,9,14
2020-09-29,746,340,19969,205,49,1013,1086
2020-09-29,30,0,702,8,0,25,30
2020-09-29,23,0,666,6,0,50,23
2020-09-29,0,0,0,0,0,0,0
2020-09-29,73,5,1304,16,0,65,78
2020-09-29,1,0,25,1,0,1,1
2020-09-29,17,4,557,7,1,6,21
2020-09-29,22,22,744,7,0,38,44
2020-09-29,80,14,1574,23,4,14,94
2020-09-29,9,11,271,5,0,9,20
2020-09-29,0,0,25,0,0,0,0
2020-09-29,0,0,25,0,0,0,0
2020-09-29,78,47,2390,26,5,126,125
2020-09-29,33,20,1007,14,5,47,53
2020-09-29,170,55,3845,45,9,160,225
2020-09-29,1,0,48,0,0,0,1
2020-09-29,34,9,677,7,0,21,43
2020-09-29,0,0,35,0,0,0,0
2020-09-29,0,0,33,0,0,6,0
2020-09-29,5,0,59,1,0,1,5
2020-09-30,26,0,259,8,0,7,26
2020-09-30,93,17,2998,28,3,103,110
2020-09-30,6,0,351,3,0,31,6
2020-09-30,10,9,263,2,0,23,19
2020-09-30,46,10,1273,17,3,53,56
2020-09-30,0,0,35,0,0,0,0
2020-09-30,0,0,189,0,0,6,0
2020-09-30,11,0,271,5,0,6,11
2020-09-30,13,0,265,1,0,10,13
2020-09-30,0,0,52,0,0,0,0
2020-09-30,173,55,5746,45,13,218,228
2020-09-30,0,0,0,0,0,0,0
2020-09-30,0,1,29,0,0,4,1
2020-09-30,80,26,1562,22,1,21,106
2020-09-30,8,1,561,1,0,4,9
2020-09-30,165,58,3863,45,12,164,223
2020-09-30,7,4,325,4,0,9,11
2020-09-30,2,0,272,1,0,6,2
2020-09-30,9,0,451,3,0,4,9
2020-09-30,6,1,150,2,0,3,7
2020-09-30,0,0,47,0,0,0,0
2020-09-30,84,32,2415,27,2,121,116
2020-09-30,6,0,59,1,0,1,6
2020-09-30,1,2,65,0,0,1,3
2020-09-30,31,15,1515,10,3,49,46
2020-09-30,1,0,51,1,0,2,1
2020-09-30,1,0,451,0,0,25,1
2020-09-30,17,18,744,5,3,29,35
2020-09-30,0,0,25,0,0,0,0
2020-09-30,0,0,25,0,0,0,0
2020-09-30,0,0,19,0,0,0,0
2020-09-30,39,9,677,8,1,20,48
2020-09-30,15,5,509,6,0,7,20
2020-09-30,14,18,570,2,1,10,32
2020-09-30,5,0,48,0,0,0,5
2020-09-30,0,0,33,0,0,8,0
2020-09-30,730,371,20001,197,55,996,1101
2020-09-30,1,0,25,1,0,2,1
2020-09-30,119,27,2502,31,6,83,146
2020-09-30,0,0,17,0,0,2,0
2020-09-30,3,0,126,2,0,5,3
2020-09-30,119,45,3370,40,10,122,164
2020-09-30,20,0,376,6,0,10,20
2020-09-30,0,0,56,0,0,8,0
2020-09-30,15,0,193,2,0,12,15
2020-09-30,64,10,1881,15,2,75,74
2020-09-30,26,16,703,8,2,19,42
2020-09-30,58,21,1308,21,4,21,79
2020-09-30,187,43,6771,70,8,309,230
2020-09-30,6,0,96,4,0,3,6
2020-09-30,18,1,666,5,1,44,19
2020-09-30,0,0,41,0,0,0,0
2020-09-30,35,16,1008,14,2,40,51
2020-09-30,27,0,702,8,0,25,27
2020-09-30,70,5,1336,14,0,56,75
2020-09-30,2,0,84,0,0,2,2
2020-10-01,0,0,25,0,0,0,0
2020-10-01,31,17,1505,10,2,44,48
2020-10-01,9,14,263,2,0,19,23
2020-10-01,0,0,84,0,0,2,0
2020-10-01,94,19,1517,19,2,18,113
2020-10-01,10,1,265,1,0,9,11
2020-10-01,84,17,3013,28,1,88,101
2020-10-01,20,0,376,6,0,14,20
2020-10-01,0,0,48,0,0,0,0
2020-10-01,175,34,5721,48,1,237,209
2020-10-01,39,7,677,8,1,21,46
2020-10-01,1,0,25,1,0,2,1
2020-10-01,2,1,451,0,0,23,3
2020-10-01,130,59,3381,39,11,131,189
2020-10-01,7,1,561,0,0,8,8
2020-10-01,6,5,340,3,1,10,11
2020-10-01,9,0,271,3,0,4,9
2020-10-01,0,0,41,0,0,0,0
2020-10-01,1,0,65,0,0,1,1
2020-10-01,35,18,1013,14,3,42,53
2020-10-01,58,4,1343,15,0,73,62
2020-10-01,1,1,189,0,0,10,2
2020-10-01,0,0,0,0,0,0,0
2020-10-01,3,1,124,1,0,2,4
2020-10-01,6,0,451,2,0,7,6
2020-10-01,0,0,19,0,0,0,0
2020-10-01,0,0,33,0,0,7,0
2020-10-01,186,54,6775,73,12,302,240
2020-10-01,108,26,2491,29,7,86,134
2020-10-01,173,47,3861,43,6,163,220
2020-10-01,698,371,20041,202,53,989,1069
2020-10-01,0,0,47,0,0,0,0
2020-10-01,1,0,51,0,0,2,1
2020-10-01,23,0,259,6,0,10,23
2020-10-01,2,0,270,1,0,2,2
2020-10-01,1,0,17,0,0,2,1
2020-10-01,0,1,51,0,0,1,1
2020-10-01,4,0,96,2,0,7,4
2020-10-01,94,36,2433,28,5,101,130
2020-10-01,55,24,1309,19,3,21,79
2020-10-01,18,13,572,3,2,7,31
2020-10-01,8,1,150,3,0,4,9
2020-10-01,17,1,530,5,0,5,18
2020-10-01,0,0,56,0,0,10,0
2020-10-01,7,0,59,1,0,2,7
2020-10-01,0,1,29,0,0,4,1
2020-10-01,0,0,35,0,0,0,0
2020-10-01,8,1,200,5,0,14,9
2020-10-01,16,0,193,2,0,15,16
2020-10-01,29,13,711,10,1,26,42
2020-10-01,43,9,1271,14,2,49,52
2020-10-01,59,9,1864,14,2,76,68
2020-10-01,29,0,702,7,0,27,29
2020-10-01,0,0,25,0,0,0,0
2020-10-01,20,1,666,6,1,46,21
2020-10-01,19,20,743,6,1,33,39
2020-10-02,31,7,1479,10,1,46,38
2020-10-02,55,19,1310,19,0,17,74
2020-10-02,2,0,451,0,0,26,2
2020-10-02,160,53,5771,47,9,229,213
2020-10-02,164,48,3839,41,5,165,212
2020-10-02,8,1,200,3,0,15,9
2020-10-02,0,0,35,0,0,0,0
2020-10-02,0,0,25,0,0,0,0
2020-10-02,4,0,96,1,0,6,4
2020-10-02,0,0,56,0,0,6,0
2020-10-02,19,1,666,5,1,40,20
2020-10-02,1,0,25,1,0,2,1
2020-10-02,4,1,48,0,0,0,5
2020-10-02,97,18,1527,22,3,22,115
2020-10-02,3,0,137,1,0,4,3
2020-10-02,1,0,51,0,0,3,1
2020-10-02,22,13,568,3,1,7,35
2020-10-02,18,24,746,5,1,33,42
2020-10-02,7,0,265,2,0,11,7
2020-10-02,30,0,702,7,0,24,30
2020-10-02,0,0,47,0,0,0,0
2020-10-02,1,0,189,0,0,13,1
2020-10-02,0,0,84,0,0,2,0
2020-10-02,0,1,29,0,0,3,1
2020-10-02,8,0,150,3,0,4,8
2020-10-02,1,0,65,0,0,6,1
2020-10-02,39,19,1004,13,2,35,58
2020-10-02,2,0,270,1,0,3,2
2020-10-02,35,7,677,6,1,29,42
2020-10-02,203,56,6784,77,10,278,259
2020-10-02,135,66,3361,39,13,122,201
2020-10-02,39,13,1260,15,3,50,52
2020-10-02,0,0,51,0,0,0,0
2020-10-02,21,6,530,5,1,6,27
2020-10-02,0,0,19,0,0,0,0
2020-10-02,26,0,259,7,0,9,26
2020-10-02,673,324,20018,188,48,1001,997
2020-10-02,7,1,561,0,0,5,8
2020-10-02,82,19,3022,34,1,88,101
2020-10-02,5,0,59,1,0,1,5
2020-10-02,0,0,0,0,0,0,0
2020-10-02,7,6,263,1,0,25,13
2020-10-02,7,0,451,3,0,9,7
2020-10-02,13,0,193,1,0,13,13
2020-10-02,0,0,17,0,0,2,0
2020-10-02,7,5,336,2,1,12,12
2020-10-02,76,34,2380,27,4,103,110
2020-10-02,29,13,708,10,1,31,42
2020-10-02,0,0,25,0,0,0,0
2020-10-02,96,23,2496,32,3,97,119
2020-10-02,22,0,376,6,0,14,22
2020-10-02,9,1,271,3,0,10,10
2020-10-02,0,0,41,0,0,0,0
2020-10-02,63,3,1338,16,0,69,66
2020-10-02,0,0,33,0,0,5,0
2020-10-02,55,10,1846,16,5,71,65
2020-10-03,6,1,561,1,0,3,7
2020-10-03,12,0,451,4,0,12,12
2020-10-03,23,1,666,5,0,44,24
2020-10-03,0,0,47,0,0,0,0
2020-10-03,21,13,568,2,1,6,34
2020-10-03,0,0,35,0,0,0,0
2020-10-03,29,11,705,10,2,34,40
2020-10-03,55,17,1315,18,0,32,72
2020-10-03,38,16,1004,12,3,41,54
2020-10-03,3,0,120,1,0,4,3
2020-10-03,6,0,200,2,0,13,6
2020-10-03,0,0,0,0,0,0,0
2020-10-03,6,0,150,2,0,5,6
2020-10-03,2,4,48,0,0,0,6
2020-10-03,26,1,259,7,1,6,27
2020-10-03,26,7,518,7,1,6,33
2020-10-03,7,6,263,1,0,23,13
2020-10-03,155,52,5860,47,9,241,207
2020-10-03,50,7,1840,17,1,88,57
2020-10-03,63,4,1316,17,1,69,67
2020-10-03,102,16,1523,24,0,18,118
2020-10-03,0,0,84,0,0,0,0
2020-10-03,2,0,96,1,0,6,2
2020-10-03,0,0,51,0,0,6,0
2020-10-03,1,0,25,1,0,0,1
2020-10-03,0,0,56,0,0,8,0
2020-10-03,87,29,2494,28,4,91,116
2020-10-03,21,0,376,6,0,15,21
2020-10-03,0,0,25,0,0,0,0
2020-10-03,0,0,19,0,0,0,0
2020-10-03,29,0,702,5,0,24,29
2020-10-03,0,3,65,0,1,6,3
2020-10-03,1,0,189,0,0,10,1
2020-10-03,0,0,51,0,0,1,0
2020-10-03,0,0,25,0,0,0,0
2020-10-03,15,0,193,1,0,14,15
2020-10-03,36,9,664,9,2,30,45
2020-10-03,82,23,2921,30,2,109,105
2020-10-03,2,0,451,0,0,30,2
2020-10-03,0,0,41,0,0,0,0
2020-10-03,18,24,746,4,0,33,42
2020-10-03,6,0,265,2,0,9,6
2020-10-03,6,0,271,3,0,12,6
2020-10-03,170,54,3808,43,7,164,224
2020-10-03,0,0,29,0,0,4,0
2020-10-03,8,6,336,3,1,14,14
2020-10-03,2,0,250,1,0,7,2
2020-10-03,31,10,1478,9,1,45,41
2020-10-03,207,60,6770,68,13,296,267
2020-10-03,78,41,2396,27,6,101,119
2020-10-03,38,11,1253,15,3,51,49
2020-10-03,4,0,59,0,0,1,4
2020-10-03,0,0,17,0,0,2,0
2020-10-03,674,353,19912,188,51,988,1027
2020-10-03,135,67,3320,43,13,112,202
2020-10-03,0,0,33,0,0,4,0
2020-10-04,0,0,41,0,0,0,0
2020-10-04,1,1,84,1,0,0,2
2020-10-04,61,1,1317,19,0,70,62
2020-10-04,2,1,264,1,0,11,3
2020-10-04,168,42,5897,53,7,234,210
2020-10-04,6,1,200,2,0,12,7
2020-10-04,8,7,263,1,0,22,15
2020-10-04,8,0,451,4,0,18,8
2020-10-04,71,29,2379,23,6,115,100
2020-10-04,27,2,702,6,1,22,29
2020-10-04,21,17,553,2,2,7,38
2020-10-04,1,0,25,1,0,2,1
2020-10-04,35,11,1001,12,3,46,46
2020-10-04,203,53,6805,70,12,307,256
2020-10-04,4,0,451,0,0,30,4
2020-10-04,34,19,1490,7,2,51,53
2020-10-04,0,0,56,0,0,7,0
2020-10-04,0,0,47,0,0,0,0
2020-10-04,103,13,1515,23,2,17,116
2020-10-04,0,0,51,0,0,1,0
2020-10-04,16,0,376,5,0,13,16
2020-10-04,7,0,271,3,0,10,7
2020-10-04,28,12,676,9,1,32,40
2020-10-04,14,0,193,1,0,16,14
2020-10-04,24,0,259,10,0,6,24
2020-10-04,28,7,505,7,0,6,35
2020-10-04,52,9,1787,16,1,92,61
2020-10-04,87,20,2919,30,4,103,107
2020-10-04,0,0,25,0,0,0,0
2020-10-04,35,9,664,7,1,31,44
2020-10-04,4,0,59,1,0,3,4
2020-10-04,4,1,561,0,0,8,5
2020-10-04,0,0,65,0,0,4,0
2020-10-04,4,0,121,2,0,4,4
2020-10-04,22,34,747,4,2,29,56
2020-10-04,2,0,189,0,0,12,2
2020-10-04,31,11,1247,14,3,53,42
2020-10-04,0,0,29,0,0,4,0
2020-10-04,0,0,25,0,0,0,0
2020-10-04,133,68,3361,40,13,112,201
2020-10-04,0,0,19,0,0,0,0
2020-10-04,22,0,666,6,0,56,22
2020-10-04,1,0,96,0,0,6,1
2020-10-04,175,59,3825,49,8,180,234
2020-10-04,0,0,33,0,0,5,0
2020-10-04,0,0,0,0,0,0,0
2020-10-04,4,10,333,1,0,13,14
2020-10-04,0,0,35,0,0,0,0
2020-10-04,7,1,150,1,1,6,8
2020-10-04,2,4,48,0,0,0,6
2020-10-04,0,0,51,0,0,3,0
2020-10-04,4,0,265,2,0,10,4
2020-10-04,685,373,19854,201,51,1072,1058
2020-10-04,54,11,1316,20,1,39,65
2020-10-04,93,29,2474,27,3,104,122
2020-10-04,0,0,17,0,0,2,0
2020-10-05,1,0,189,1,0,11,1
2020-10-05,0,0,35,0,0,0,0
2020-10-05,83,23,3014,28,4,114,106
2020-10-05,5,0,150,3,0,4,5
2020-10-05,0,0,25,0,0,0,0
2020-10-05,4,0,265,2,0,10,4
2020-10-05,15,0,193,1,0,16,15
2020-10-05,96,29,2466,29,5,109,125
2020-10-05,107,18,1514,19,4,12,125
2020-10-05,5,4,325,1,0,16,9
2020-10-05,0,3,65,0,2,1,3
2020-10-05,0,0,84,0,0,0,0
2020-10-05,0,0,51,0,0,3,0
2020-10-05,0,0,25,0,0,0,0
2020-10-05,66,0,1335,16,0,67,66
2020-10-05,0,0,0,0,0,0,0
2020-10-05,8,0,451,4,0,15,8
2020-10-05,10,1,561,0,0,9,11
2020-10-05,30,13,1002,11,3,45,43
2020-10-05,20,10,545,4,1,9,30
2020-10-05,142,67,3390,42,16,115,209
2020-10-05,0,0,33,0,0,5,0
2020-10-05,0,0,19,0,0,0,0
2020-10-05,3,0,451,0,0,28,3
2020-10-05,5,1,271,2,0,14,6
2020-10-05,14,0,376,4,0,14,14
2020-10-05,26,12,682,8,2,29,38
2020-10-05,50,9,1812,16,0,86,59
2020-10-05,73,37,2381,23,6,110,110
2020-10-05,19,0,666,6,0,62,19
2020-10-05,20,25,729,4,1,30,45
2020-10-05,217,56,6773,66,10,313,273
2020-10-05,0,0,52,0,0,3,0
2020-10-05,2,3,264,1,0,11,5
2020-10-05,176,52,5698,63,10,210,228
2020-10-05,0,0,47,0,0,0,0
2020-10-05,0,0,25,0,0,3,0
2020-10-05,0,0,17,0,0,2,0
2020-10-05,0,0,41,0,0,0,0
2020-10-05,53,21,1313,21,2,37,74
2020-10-05,33,12,1227,14,4,56,45
2020-10-05,186,53,3844,50,6,169,239
2020-10-05,696,339,19975,195,47,1040,1035
2020-10-05,28,7,522,11,0,4,35
2020-10-05,27,0,259,10,0,2,27
2020-10-05,37,20,1500,7,3,59,57
2020-10-05,0,0,56,0,0,8,0
2020-10-05,34,8,677,9,1,25,42
2020-10-05,1,0,29,0,0,4,1
2020-10-05,5,0,59,0,0,0,5
2020-10-05,4,0,48,0,0,0,4
2020-10-05,24,1,702,5,1,26,25
2020-10-05,1,0,96,0,0,7,1
2020-10-05,8,6,263,1,0,25,14
2020-10-05,6,1,200,2,0,14,7
2020-10-05,4,0,133,2,0,3,4
2020-10-06,2,1,29,1,0,3,3
2020-10-06,0,0,56,0,0,10,0
2020-10-06,0,0,51,0,0,2,0
2020-10-06,0,0,33,0,0,4,0
2020-10-06,0,0,35,0,0,0,0
2020-10-06,20,31,747,4,2,32,51
2020-10-06,709,351,20081,197,58,943,1060
2020-10-06,15,0,376,4,0,10,15
2020-10-06,25,1,702,6,1,22,26
2020-10-06,0,4,48,0,0,0,4
2020-10-06,200,39,3848,52,5,157,239
2020-10-06,5,0,150,3,0,4,5
2020-10-06,2,3,252,1,0,8,5
2020-10-06,0,0,19,0,0,0,0
2020-10-06,0,0,84,0,0,2,0
2020-10-06,1,0,96,0,0,6,1
2020-10-06,7,0,561,0,0,6,7
2020-10-06,183,52,5822,64,7,214,235
2020-10-06,0,0,17,0,0,2,0
2020-10-06,0,3,65,0,2,2,3
2020-10-06,4,8,263,1,1,24,12
2020-10-06,34,6,570,11,0,7,40
2020-10-06,20,15,548,4,0,8,35
2020-10-06,0,0,25,0,0,0,0
2020-10-06,89,30,2386,29,2,91,119
2020-10-06,135,83,3419,38,16,122,218
2020-10-06,214,66,6780,63,7,311,280
2020-10-06,0,0,51,0,0,5,0
2020-10-06,28,8,677,9,0,17,36
2020-10-06,0,0,25,0,0,2,0
2020-10-06,0,0,41,0,0,0,0
2020-10-06,26,17,1005,11,1,46,43
2020-10-06,32,25,1526,6,4,56,57
2020-10-06,30,0,259,11,0,2,30
2020-10-06,75,40,2416,24,5,113,115
2020-10-06,2,0,451,0,0,25,2
2020-10-06,19,0,666,7,0,54,19
2020-10-06,45,15,1314,17,1,36,60
2020-10-06,65,3,1346,10,0,67,68
2020-10-06,77,23,3010,30,4,102,100
2020-10-06,4,0,271,1,0,9,4
2020-10-06,3,0,114,1,0,5,3
2020-10-06,0,0,0,0,0,0,0
2020-10-06,6,6,330,0,0,17,12
2020-10-06,0,0,189,0,0,8,0
2020-10-06,16,0,193,2,0,15,16
2020-10-06,0,0,47,0,0,0,0
2020-10-06,0,0,25,0,0,0,0
2020-10-06,100,22,1518,18,3,32,122
2020-10-06,47,7,1865,14,1,74,54
2020-10-06,8,0,451,5,0,5,8
2020-10-06,34,9,1233,16,4,60,43
2020-10-06,5,0,59,1,0,0,5
2020-10-06,6,1,265,2,0,14,7
2020-10-06,6,2,351,2,0,27,8
2020-10-06,24,10,697,8,0,30,34
2020-10-07,32,27,1527,6,6,53,59
2020-10-07,3,4,451,1,0,26,7
2020-10-07,0,0,51,0,0,4,0
2020-10-07,15,0,376,5,0,12,15
2020-10-07,77,25,3035,24,0,105,102
2020-10-07,0,0,25,0,0,2,0
2020-10-07,30,15,1004,10,2,51,45
2020-10-07,5,4,351,2,0,24,9
2020-10-07,2,1,129,1,1,5,3
2020-10-07,4,1,561,0,0,3,5
2020-10-07,205,44,3860,45,5,149,249
2020-10-07,3,1,264,1,0,8,4
2020-10-07,7,0,451,4,0,9,7
2020-10-07,0,2,48,0,0,0,2
2020-10-07,0,1,65,0,0,3,1
2020-10-07,0,1,33,0,0,5,1
2020-10-07,19,21,570,5,4,7,40
2020-10-07,0,0,35,0,0,0,0
2020-10-07,19,0,193,3,0,13,19
2020-10-07,0,0,0,0,0,0,0
2020-10-07,0,0,25,0,0,0,0
2020-10-07,0,0,17,0,0,2,0
2020-10-07,3,0,150,3,0,4,3
2020-10-07,0,0,19,0,0,0,0
2020-10-07,44,11,1900,16,1,70,55
2020-10-07,0,0,84,0,0,2,0
2020-10-07,0,0,47,0,0,0,0
2020-10-07,104,23,1545,12,2,32,127
2020-10-07,172,38,5770,62,3,219,210
2020-10-07,0,2,41,0,0,0,2
2020-10-07,4,1,271,1,0,8,5
2020-10-07,22,10,698,9,0,19,32
2020-10-07,62,3,1336,12,0,59,65
2020-10-07,26,0,259,9,0,1,26
2020-10-07,3,0,96,0,0,5,3
2020-10-07,1,1,29,0,0,4,2
2020-10-07,37,6,677,8,0,23,43
2020-10-07,135,74,3421,40,13,128,209
2020-10-07,31,8,579,7,0,10,39
2020-10-07,217,44,6784,63,9,308,261
2020-10-07,6,4,318,0,0,14,10
2020-10-07,25,0,702,8,0,18,25
2020-10-07,0,0,51,0,0,2,0
2020-10-07,0,0,56,0,0,10,0
2020-10-07,35,11,1227,20,1,56,46
2020-10-07,1,0,189,0,0,5,1
2020-10-07,724,353,20087,185,43,958,1077
2020-10-07,0,0,25,0,0,0,0
2020-10-07,20,0,666,7,0,48,20
2020-10-07,7,4,263,1,0,23,11
2020-10-07,16,33,754,4,4,26,49
2020-10-07,6,0,59,2,0,0,6
2020-10-07,46,14,1314,19,1,30,60
2020-10-07,7,0,265,2,0,15,7
2020-10-07,66,34,2417,25,3,116,100
2020-10-07,87,37,2499,30,4,78,124
2020-10-08,4,0,150,3,0,6,4
2020-10-08,39,5,1885,17,1,72,44
2020-10-08,30,8,560,5,1,7,38
2020-10-08,3,0,59,0,0,0,3
2020-10-08,31,11,1006,8,1,46,42
2020-10-08,26,0,259,9,0,2,26
2020-10-08,102,26,1544,18,1,23,128
2020-10-08,59,4,1338,11,0,56,63
2020-10-08,29,12,1532,5,4,45,41
2020-10-08,0,0,0,0,0,0,0
2020-10-08,85,45,2534,29,6,81,130
2020-10-08,0,0,56,0,0,10,0
2020-10-08,0,0,19,0,0,0,0
2020-10-08,0,0,35,0,0,0,0
2020-10-08,33,13,1252,20,0,48,46
2020-10-08,61,44,2416,21,4,106,105
2020-10-08,1,0,189,1,0,10,1
2020-10-08,0,0,33,0,0,8,0
2020-10-08,0,1,48,0,0,0,1
2020-10-08,0,0,84,0,0,1,0
2020-10-08,145,70,3434,39,14,112,215
2020-10-08,3,6,248,0,1,6,9
2020-10-08,5,0,96,0,0,6,5
2020-10-08,4,0,561,0,0,5,4
2020-10-08,21,23,583,5,1,9,44
2020-10-08,0,1,65,0,0,4,1
2020-10-08,207,51,3869,35,10,158,258
2020-10-08,0,0,41,0,0,0,0
2020-10-08,701,358,20130,184,38,920,1059
2020-10-08,18,24,749,4,1,26,42
2020-10-08,7,2,324,0,0,12,9
2020-10-08,3,0,451,1,0,25,3
2020-10-08,0,0,47,0,0,0,0
2020-10-08,2,0,351,2,0,25,2
2020-10-08,13,0,376,4,0,14,13
2020-10-08,0,0,51,0,0,2,0
2020-10-08,0,0,25,0,0,3,0
2020-10-08,16,0,193,4,0,12,16
2020-10-08,9,1,265,3,0,12,10
2020-10-08,1,1,123,0,1,6,2
2020-10-08,0,0,17,0,0,2,0
2020-10-08,215,47,6784,64,10,348,262
2020-10-08,36,6,677,6,0,25,42
2020-10-08,0,0,25,0,0,0,0
2020-10-08,0,0,25,0,0,0,0
2020-10-08,2,0,29,1,0,3,2
2020-10-08,0,0,51,0,0,6,0
2020-10-08,25,0,702,6,0,20,25
2020-10-08,7,6,271,2,0,4,13
2020-10-08,24,0,666,8,0,50,24
2020-10-08,79,19,3041,24,3,97,98
2020-10-08,176,44,5743,64,7,212,220
2020-10-08,50,27,1320,20,1,23,77
2020-10-08,7,0,451,3,0,7,7
2020-10-08,23,10,712,8,0,21,33
2020-10-08,8,11,263,1,2,22,19
2020-10-09,0,0,17,0,0,2,0
2020-10-09,715,329,20053,187,40,941,1044
2020-10-09,209,49,3839,33,8,163,258
2020-10-09,0,0,19,0,0,0,0
2020-10-09,0,0,25,0,0,0,0
2020-10-09,18,22,745,2,2,29,40
2020-10-09,93,23,1554,14,3,18,116
2020-10-09,0,0,0,0,0,0,0
2020-10-09,7,3,272,2,0,6,10
2020-10-09,0,0,51,0,0,4,0
2020-10-09,75,37,2482,27,5,75,112
2020-10-09,23,18,586,5,0,11,41
2020-10-09,27,3,702,6,0,21,30
2020-10-09,0,0,47,0,0,0,0
2020-10-09,69,23,3031,20,2,108,92
2020-10-09,59,41,2417,21,4,111,100
2020-10-09,13,0,376,4,0,14,13
2020-10-09,3,1,451,1,0,29,4
2020-10-09,23,1,666,6,0,50,24
2020-10-09,57,2,1345,11,0,55,59
2020-10-09,25,7,1007,6,5,51,32
2020-10-09,9,8,263,1,1,24,17
2020-10-09,7,0,265,1,0,12,7
2020-10-09,33,8,1907,14,2,72,41
2020-10-09,3,2,265,0,0,5,5
2020-10-09,146,57,3413,40,10,101,203
2020-10-09,34,17,1255,19,7,49,51
2020-10-09,0,0,48,0,0,0,0
2020-10-09,1,0,189,1,0,5,1
2020-10-09,0,0,25,0,0,0,0
2020-10-09,1,0,29,1,0,3,1
2020-10-09,0,0,35,0,0,0,0
2020-10-09,197,47,6783,59,10,295,244
2020-10-09,0,0,56,0,0,9,0
2020-10-09,17,0,193,3,0,13,17
2020-10-09,28,0,259,11,0,3,28
2020-10-09,10,2,334,0,0,16,12
2020-10-09,6,0,451,3,0,11,6
2020-10-09,4,0,150,4,0,3,4
2020-10-09,3,0,561,0,0,8,3
2020-10-09,0,0,41,0,0,0,0
2020-10-09,30,6,579,5,2,11,36
2020-10-09,0,0,25,0,0,3,0
2020-10-09,31,6,677,7,0,31,37
2020-10-09,3,0,96,0,0,11,3
2020-10-09,169,52,5786,61,10,223,221
2020-10-09,29,10,707,9,3,22,39
2020-10-09,0,0,51,0,0,1,0
2020-10-09,2,1,351,2,0,21,3
2020-10-09,1,0,123,0,0,5,1
2020-10-09,51,31,1313,19,2,24,82
2020-10-09,0,0,33,0,0,8,0
2020-10-09,30,14,1516,7,4,49,44
2020-10-09,3,0,59,0,0,0,3
2020-10-09,0,0,84,0,0,3,0
2020-10-09,0,0,65,0,0,5,0
2020-10-10,0,0,25,0,0,0,0
2020-10-10,135,56,3392,38,9,113,191
2020-10-10,52,27,1322,21,2,27,79
2020-10-10,2,0,116,0,0,5,2
2020-10-10,3,0,59,0,0,0,3
2020-10-10,2,2,351,0,0,24,4
2020-10-10,0,0,33,0,0,8,0
2020-10-10,3,0,255,0,0,9,3
2020-10-10,11,8,263,1,0,13,19
2020-10-10,30,18,1465,7,2,52,48
2020-10-10,33,4,1882,12,1,68,37
2020-10-10,5,2,561,0,0,5,7
2020-10-10,164,49,5768,57,5,237,213
2020-10-10,195,52,6797,51,8,318,247
2020-10-10,31,0,259,11,0,-1,31
2020-10-10,46,2,1085,13,0,55,48
2020-10-10,0,0,48,0,0,0,0
2020-10-10,3,0,150,3,0,7,3
2020-10-10,192,52,3788,35,9,171,244
2020-10-10,71,24,2926,20,2,110,95
2020-10-10,21,16,585,4,0,8,37
2020-10-10,6,3,272,2,0,9,9
2020-10-10,26,2,702,8,0,18,28
2020-10-10,17,0,376,4,0,17,17
2020-10-10,17,40,736,4,5,29,57
2020-10-10,8,7,332,0,0,11,15
2020-10-10,0,1,65,0,1,4,1
2020-10-10,693,360,19986,202,57,950,1053
2020-10-10,78,56,2517,27,7,79,134
2020-10-10,2,0,451,1,0,27,2
2020-10-10,85,19,1539,13,2,27,104
2020-10-10,0,0,19,0,0,0,0
2020-10-10,0,0,25,0,0,1,0
2020-10-10,1,0,189,1,0,8,1
2020-10-10,0,0,51,0,0,3,0
2020-10-10,0,0,41,0,0,0,0
2020-10-10,0,0,51,0,0,2,0
2020-10-10,32,8,664,5,1,32,40
2020-10-10,1,0,84,0,0,4,1
2020-10-10,1,0,29,0,0,4,1
2020-10-10,0,0,17,0,0,2,0
2020-10-10,0,0,0,0,0,0,0
2020-10-10,0,0,56,0,0,8,0
2020-10-10,24,0,666,6,0,52,24
2020-10-10,18,0,193,2,0,16,18
2020-10-10,0,0,25,0,0,0,0
2020-10-10,64,46,2422,24,5,121,110
2020-10-10,32,6,552,6,1,9,38
2020-10-10,0,0,47,0,0,0,0
2020-10-10,6,0,451,3,0,9,6
2020-10-10,0,0,35,0,0,0,0
2020-10-10,37,11,1239,18,3,55,48
2020-10-10,22,14,1006,5,0,57,36
2020-10-10,29,9,710,7,3,27,38
2020-10-10,2,0,96,0,0,10,2
2020-10-10,9,0,265,1,0,11,9
2020-10-11,77,54,2454,25,9,97,131
2020-10-11,0,0,51,0,0,1,0
2020-10-11,0,0,56,0,0,9,0
2020-10-11,173,51,6778,51,16,325,224
2020-10-11,19,0,666,5,0,64,19
2020-10-11,31,12,1235,18,1,59,43
2020-10-11,183,53,3799,42,15,164,236
2020-10-11,27,3,1801,11,1,83,30
2020-10-11,78,30,2910,23,4,117,108
2020-10-11,1,0,346,1,0,22,1
2020-10-11,0,0,41,0,0,0,0
2020-10-11,2,1,89,0,0,7,3
2020-10-11,6,2,271,2,1,10,8
2020-10-11,3,0,150,3,0,6,3
2020-10-11,1,0,65,0,0,4,1
2020-10-11,0,0,25,0,0,0,0
2020-10-11,0,0,33,0,0,6,0
2020-10-11,26,17,564,4,0,8,43
2020-10-11,34,2,259,11,0,1,36
2020-10-11,10,9,263,1,0,26,19
2020-10-11,29,8,677,6,2,40,37
2020-10-11,0,0,35,0,0,0,0
2020-10-11,19,35,729,3,3,32,54
2020-10-11,51,2,1326,13,0,59,53
2020-10-11,2,0,189,2,0,6,2
2020-10-11,98,14,1511,13,1,29,112
2020-10-11,0,0,19,0,0,0,0
2020-10-11,2,4,200,2,0,9,6
2020-10-11,692,353,19844,190,50,999,1045
2020-10-11,0,0,0,0,0,0,0
2020-10-11,28,7,664,4,0,33,35
2020-10-11,10,0,265,2,0,12,10
2020-10-11,0,0,47,0,0,0,0
2020-10-11,6,3,336,0,0,12,9
2020-10-11,167,43,5738,56,7,212,210
2020-10-11,20,0,389,5,0,16,20
2020-10-11,0,0,25,0,0,3,0
2020-10-11,26,6,527,6,0,8,32
2020-10-11,131,62,3383,36,9,110,193
2020-10-11,2,0,59,0,0,3,2
2020-10-11,4,1,561,0,0,5,5
2020-10-11,22,6,1004,6,1,51,28
2020-10-11,38,23,1452,7,3,40,61
2020-10-11,27,2,702,9,0,20,29
2020-10-11,5,0,96,2,0,5,5
2020-10-11,1,0,29,0,0,3,1
2020-10-11,0,0,17,0,0,2,0
2020-10-11,19,0,193,2,0,15,19
2020-10-11,1,0,51,0,0,2,1
2020-10-11,0,0,48,0,0,0,0
2020-10-11,54,25,1321,19,1,35,79
2020-10-11,61,44,2354,20,7,126,105
2020-10-11,6,0,451,4,0,13,6
2020-10-11,0,0,25,0,0,0,0
2020-10-11,1,0,84,0,0,4,1
2020-10-11,3,2,269,0,1,6,5
2020-10-12,1,0,29,0,0,2,1
2020-10-12,178,52,6778,57,14,321,230
2020-10-12,0,0,48,0,0,0,0
2020-10-12,32,9,1234,18,2,60,41
2020-10-12,1,0,189,1,0,10,1
2020-10-12,0,0,17,0,0,2,0
2020-10-12,1,0,451,0,0,25,1
2020-10-12,2,0,59,1,0,2,2
2020-10-12,0,0,14,0,0,0,0
2020-10-12,0,0,19,0,0,0,0
2020-10-12,0,0,25,0,0,3,0
2020-10-12,0,0,56,0,0,9,0
2020-10-12,6,0,451,4,0,10,6
2020-10-12,10,0,271,3,0,9,10
2020-10-12,0,0,25,0,0,0,0
2020-10-12,1,0,84,0,0,2,1
2020-10-12,4,1,264,1,1,3,5
2020-10-12,26,4,664,4,0,35,30
2020-10-12,28,0,702,9,0,20,28
2020-10-12,25,11,1008,6,1,47,36
2020-10-12,186,50,3811,42,8,168,236
2020-10-12,1,0,127,0,0,7,1
2020-10-12,29,11,683,5,3,33,40
2020-10-12,8,11,263,1,0,20,19
2020-10-12,54,9,1312,18,1,40,63
2020-10-12,23,6,539,6,1,7,29
2020-10-12,61,45,2332,19,9,124,106
2020-10-12,4,0,96,2,0,3,4
2020-10-12,146,55,3350,42,9,101,201
2020-10-12,5,3,328,0,0,14,8
2020-10-12,0,1,41,0,0,0,1
2020-10-12,26,19,1473,7,1,53,45
2020-10-12,20,0,389,5,0,16,20
2020-10-12,720,356,19946,197,48,1025,1076
2020-10-12,1,1,351,0,0,26,2
2020-10-12,28,2,1821,11,2,90,30
2020-10-12,29,16,552,6,0,6,45
2020-10-12,3,0,150,3,0,6,3
2020-10-12,0,0,35,0,0,0,0
2020-10-12,77,47,2417,19,8,101,124
2020-10-12,2,0,65,1,0,4,2
2020-10-12,31,0,259,12,0,0,31
2020-10-12,0,0,51,0,0,2,0
2020-10-12,19,0,193,2,0,14,19
2020-10-12,16,34,714,3,3,27,50
2020-10-12,53,3,1333,13,0,63,56
2020-10-12,11,1,265,1,0,16,12
2020-10-12,7,1,561,0,0,4,8
2020-10-12,21,5,666,7,2,61,26
2020-10-12,80,20,2883,25,2,124,100
2020-10-12,0,0,33,0,0,6,0
2020-10-12,160,49,5670,57,7,252,209
2020-10-12,0,0,25,0,0,0,0
2020-10-12,89,12,1525,18,0,36,101
2020-10-12,1,0,51,0,0,3,1
2020-10-12,0,0,47,0,0,0,0
2020-10-13,35,10,1242,18,2,54,45
2020-10-13,31,15,564,7,2,6,46
2020-10-13,2,1,65,1,0,3,3
2020-10-13,179,49,3852,40,5,161,228
2020-10-13,0,0,56,0,0,6,0
2020-10-13,187,56,6784,61,14,306,243
2020-10-13,1,0,84,0,0,1,1
2020-10-13,4,1,259,1,0,3,5
2020-10-13,1,0,150,1,0,5,1
2020-10-13,0,2,41,0,0,0,2
2020-10-13,91,14,1542,17,3,32,105
2020-10-13,1,0,29,0,0,3,1
2020-10-13,0,0,19,0,0,0,0
2020-10-13,2,1,451,0,0,26,3
2020-10-13,59,2,1323,17,0,60,61
2020-10-13,10,2,271,3,0,10,12
2020-10-13,23,4,581,6,0,8,27
2020-10-13,6,8,332,0,1,13,14
2020-10-13,18,2,666,7,2,56,20
2020-10-13,0,0,33,0,0,8,0
2020-10-13,14,2,193,2,0,12,16
2020-10-13,0,0,17,0,0,2,0
2020-10-13,21,18,1492,7,1,52,39
2020-10-13,0,0,51,0,0,1,0
2020-10-13,17,0,389,5,0,16,17
2020-10-13,1,3,351,0,0,24,4
2020-10-13,1,2,189,1,0,6,3
2020-10-13,149,59,3409,45,14,110,208
2020-10-13,0,0,47,0,0,0,0
2020-10-13,51,16,1302,17,0,29,67
2020-10-13,723,382,20029,196,49,983,1105
2020-10-13,6,0,451,2,0,6,6
2020-10-13,0,0,14,0,0,0,0
2020-10-13,80,22,2904,23,4,115,102
2020-10-13,28,13,1016,5,1,44,41
2020-10-13,27,4,1874,8,1,73,31
2020-10-13,165,48,5790,60,12,230,213
2020-10-13,1,5,561,0,0,5,6
2020-10-13,28,1,702,9,1,33,29
2020-10-13,0,0,35,0,0,0,0
2020-10-13,2,0,119,0,0,7,2
2020-10-13,0,0,25,0,0,3,0
2020-10-13,0,0,48,0,0,0,0
2020-10-13,18,34,738,4,2,25,52
2020-10-13,28,9,677,5,0,26,37
2020-10-13,74,46,2484,14,10,100,120
2020-10-13,63,32,2363,19,5,126,95
2020-10-13,0,0,25,0,0,0,0
2020-10-13,0,0,25,0,0,0,0
2020-10-13,30,0,259,13,0,3,30
2020-10-13,7,13,263,0,0,20,20
2020-10-13,0,1,51,0,0,2,1
2020-10-13,3,0,59,1,0,2,3
2020-10-13,28,9,694,4,2,27,37
2020-10-13,3,0,96,2,0,2,3
2020-10-13,11,0,265,1,0,15,11
2020-10-14,8,9,333,0,1,13,17
2020-10-14,75,36,2469,15,9,95,111
2020-10-14,24,6,704,6,0,31,30
2020-10-14,0,0,25,0,0,0,0
2020-10-14,149,69,3414,42,8,108,218
2020-10-14,4,0,59,0,0,2,4
2020-10-14,181,52,3871,41,2,169,233
2020-10-14,0,0,35,0,0,0,0
2020-10-14,13,14,736,2,1,28,27
2020-10-14,12,2,193,0,0,14,14
2020-10-14,735,372,20079,188,51,984,1107
2020-10-14,27,1,702,8,0,37,28
2020-10-14,0,0,56,0,0,8,0
2020-10-14,17,12,1498,5,2,48,29
2020-10-14,19,3,666,6,1,57,22
2020-10-14,67,0,1332,18,0,54,67
2020-10-14,0,0,150,0,0,4,0
2020-10-14,0,0,51,0,0,3,0
2020-10-14,34,0,259,14,0,2,34
2020-10-14,0,0,14,0,0,0,0
2020-10-14,8,0,265,0,0,14,8
2020-10-14,2,0,139,0,0,5,2
2020-10-14,1,0,65,1,0,2,1
2020-10-14,29,13,1241,13,3,58,42
2020-10-14,29,9,677,5,1,19,38
2020-10-14,1,0,96,1,0,2,1
2020-10-14,26,6,1907,7,1,71,32
2020-10-14,28,16,574,6,0,13,44
2020-10-14,0,0,41,0,0,0,0
2020-10-14,7,6,263,0,0,24,13
2020-10-14,0,0,19,0,0,0,0
2020-10-14,29,7,1015,4,0,51,36
2020-10-14,0,0,48,0,0,0,0
2020-10-14,59,40,2371,15,5,125,99
2020-10-14,181,43,6781,61,6,295,224
2020-10-14,10,0,271,2,0,12,10
2020-10-14,87,20,2924,25,3,106,107
2020-10-14,4,2,270,1,0,3,6
2020-10-14,17,1,389,5,0,16,18
2020-10-14,1,0,29,0,0,3,1
2020-10-14,0,1,189,0,1,6,1
2020-10-14,2,3,351,1,0,23,5
2020-10-14,94,22,1533,18,3,36,116
2020-10-14,0,0,25,0,0,0,0
2020-10-14,25,4,557,6,0,9,29
2020-10-14,4,2,451,0,0,23,6
2020-10-14,55,19,1302,15,2,32,74
2020-10-14,0,0,17,0,0,2,0
2020-10-14,1,0,84,0,0,2,1
2020-10-14,7,1,561,1,0,5,8
2020-10-14,3,0,451,2,0,7,3
2020-10-14,0,0,47,0,0,0,0
2020-10-14,164,48,5749,66,6,231,212
2020-10-14,0,0,33,0,0,8,0
2020-10-14,0,0,25,0,0,4,0
2020-10-14,0,0,51,0,0,2,0
2020-10-15,27,8,677,4,1,22,35
2020-10-15,0,0,14,0,0,0,0
2020-10-15,8,1,561,2,0,2,9
2020-10-15,170,33,5725,66,3,252,203
2020-10-15,0,0,33,0,0,8,0
2020-10-15,79,34,2466,18,8,82,113
2020-10-15,1,0,84,0,0,3,1
2020-10-15,0,0,41,0,0,0,0
2020-10-15,5,0,451,0,0,25,5
2020-10-15,21,8,1907,7,2,65,29
2020-10-15,11,2,271,1,0,10,13
2020-10-15,2,3,351,0,1,23,5
2020-10-15,20,14,1498,6,3,45,34
2020-10-15,0,1,56,0,0,8,1
2020-10-15,148,57,3437,44,9,113,205
2020-10-15,24,1,702,8,0,37,25
2020-10-15,59,1,1332,17,0,53,60
2020-10-15,0,0,51,0,0,4,0
2020-10-15,2,0,451,1,0,9,2
2020-10-15,26,4,561,7,1,7,30
2020-10-15,0,0,17,0,0,2,0
2020-10-15,16,2,666,5,1,53,18
2020-10-15,32,2,259,14,0,3,34
2020-10-15,0,0,47,0,0,0,0
2020-10-15,2,0,29,0,0,4,2
2020-10-15,24,16,574,6,0,6,40
2020-10-15,0,0,25,0,0,3,0
2020-10-15,28,10,1015,3,2,52,38
2020-10-15,0,0,25,0,0,0,0
2020-10-15,3,0,59,1,0,3,3
2020-10-15,0,0,150,0,0,7,0
2020-10-15,12,12,737,2,0,33,24
2020-10-15,5,0,96,3,0,3,5
2020-10-15,186,53,3836,45,5,159,239
2020-10-15,95,15,1526,17,0,33,110
2020-10-15,0,0,51,0,0,4,0
2020-10-15,84,19,2920,27,6,110,103
2020-10-15,1,4,66,1,1,2,5
2020-10-15,0,0,25,0,0,0,0
2020-10-15,25,8,704,7,0,29,33
2020-10-15,4,1,267,1,1,4,5
2020-10-15,746,340,20041,180,40,951,1086
2020-10-15,0,0,35,0,0,0,0
2020-10-15,57,42,2366,16,1,133,99
2020-10-15,0,0,48,0,0,0,0
2020-10-15,0,0,19,0,0,0,0
2020-10-15,0,0,189,0,0,8,0
2020-10-15,1,0,142,0,0,1,1
2020-10-15,13,1,193,2,0,14,14
2020-10-15,8,8,362,1,1,16,16
2020-10-15,8,9,263,0,0,18,17
2020-10-15,29,11,1245,18,1,50,40
2020-10-15,8,0,265,1,0,10,8
2020-10-15,15,0,389,5,0,14,15
2020-10-15,56,19,1302,17,0,31,75
2020-10-15,184,51,6790,62,11,293,235
2020-10-16,27,12,722,9,0,23,39
2020-10-16,136,67,3412,41,15,109,203
2020-10-16,0,0,41,0,0,0,0
2020-10-16,21,17,547,6,1,5,38
2020-10-16,4,4,264,1,3,2,8
2020-10-16,0,0,189,0,0,8,0
2020-10-16,0,0,19,0,0,0,0
2020-10-16,2,1,29,0,0,4,3
2020-10-16,0,0,48,0,0,0,0
2020-10-16,55,12,1309,15,3,31,67
2020-10-16,6,0,561,1,0,2,6
2020-10-16,0,0,47,0,0,0,0
2020-10-16,0,0,56,0,0,8,0
2020-10-16,0,0,84,0,0,2,0
2020-10-16,14,0,389,6,0,13,14
2020-10-16,20,4,2294,6,0,52,24
2020-10-16,0,0,25,0,0,3,0
2020-10-16,13,3,666,4,1,60,16
2020-10-16,0,0,138,0,0,0,0
2020-10-16,33,2,259,13,0,5,35
2020-10-16,25,0,702,8,0,38,25
2020-10-16,4,0,59,2,0,4,4
2020-10-16,159,40,5806,56,8,249,199
2020-10-16,9,1,265,0,0,15,10
2020-10-16,2,1,351,0,0,24,3
2020-10-16,11,22,736,4,4,29,33
2020-10-16,0,0,51,0,0,3,0
2020-10-16,0,0,25,0,0,0,0
2020-10-16,189,46,6781,65,9,318,235
2020-10-16,2,0,451,2,0,12,2
2020-10-16,9,1,272,1,1,12,10
2020-10-16,52,43,2356,17,2,130,95
2020-10-16,0,0,14,0,0,0,0
2020-10-16,0,0,51,0,0,2,0
2020-10-16,89,16,2928,29,1,111,105
2020-10-16,189,44,3836,46,4,161,233
2020-10-16,25,6,563,6,1,5,31
2020-10-16,0,0,35,0,0,0,0
2020-10-16,0,0,33,0,0,6,0
2020-10-16,92,17,1555,24,0,43,109
2020-10-16,1,0,65,1,0,3,1
2020-10-16,29,4,1238,18,1,54,33
2020-10-16,0,0,25,0,0,0,0
2020-10-16,8,8,263,0,0,25,16
2020-10-16,3,1,451,0,0,23,4
2020-10-16,58,1,1338,20,0,53,59
2020-10-16,84,33,2471,22,5,82,117
2020-10-16,30,10,1013,5,3,44,40
2020-10-16,21,13,1480,5,3,35,34
2020-10-16,752,324,19999,200,34,941,1076
2020-10-16,6,0,96,4,0,5,6
2020-10-16,31,5,677,4,0,31,36
2020-10-16,9,3,368,2,0,15,12
2020-10-16,0,0,17,0,0,2,0
2020-10-16,14,0,193,1,0,16,14
2020-10-16,0,0,150,0,0,5,0
2020-10-17,0,0,84,0,0,4,0
2020-10-17,0,0,51,0,0,2,0
2020-10-17,0,0,25,0,0,0,0
2020-10-17,7,7,263,0,1,25,14
2020-10-17,23,3,1854,8,1,65,26
2020-10-17,22,19,548,6,1,8,41
2020-10-17,23,4,560,4,0,4,27
2020-10-17,0,0,14,0,0,0,0
2020-10-17,25,8,1009,4,3,43,33
2020-10-17,0,0,56,0,0,8,0
2020-10-17,0,0,19,0,0,0,0
2020-10-17,15,0,193,1,0,15,15
2020-10-17,0,0,111,0,0,0,0
2020-10-17,5,0,59,2,0,0,5
2020-10-17,30,10,1234,13,3,63,40
2020-10-17,0,0,35,0,0,0,0
2020-10-17,26,17,1499,3,2,49,43
2020-10-17,0,0,150,0,0,6,0
2020-10-17,6,0,96,4,0,3,6
2020-10-17,7,0,272,2,0,12,7
2020-10-17,2,0,451,2,0,12,2
2020-10-17,9,4,365,2,0,14,13
2020-10-17,32,0,677,4,0,29,32
2020-10-17,153,65,3350,44,11,112,218
2020-10-17,0,0,189,0,0,10,0
2020-10-17,0,0,41,0,0,0,0
2020-10-17,60,8,1307,17,2,22,68
2020-10-17,21,7,686,6,3,30,28
2020-10-17,24,21,738,5,2,33,45
2020-10-17,1,0,65,1,0,2,1
2020-10-17,0,0,51,0,0,1,0
2020-10-17,12,0,389,6,0,11,12
2020-10-17,0,0,25,0,0,0,0
2020-10-17,9,1,265,0,0,14,10
2020-10-17,2,0,351,0,0,24,2
2020-10-17,0,0,25,0,0,3,0
2020-10-17,0,0,48,0,0,0,0
2020-10-17,0,0,47,0,0,0,0
2020-10-17,54,36,2340,19,5,133,90
2020-10-17,25,0,702,6,0,38,25
2020-10-17,3,2,266,1,2,3,5
2020-10-17,722,297,19935,197,31,929,1019
2020-10-17,0,0,33,0,0,6,0
2020-10-17,2,0,451,0,0,25,2
2020-10-17,12,2,666,3,1,61,14
2020-10-17,34,2,259,14,0,3,36
2020-10-17,84,17,2932,23,0,117,101
2020-10-17,1,0,29,0,0,2,1
2020-10-17,59,5,1281,18,0,60,64
2020-10-17,78,33,2460,21,5,90,111
2020-10-17,162,42,5706,59,12,250,204
2020-10-17,0,5,561,0,1,4,5
2020-10-17,86,23,1548,24,1,38,109
2020-10-17,185,51,6779,66,7,333,236
2020-10-17,265,45,3819,39,9,166,310
2020-10-17,0,0,17,0,0,1,0
2020-10-18,23,5,997,5,1,49,28
2020-10-18,0,0,25,0,0,3,0
2020-10-18,25,3,1794,8,2,80,28
2020-10-18,3,1,269,1,0,4,4
2020-10-18,22,9,507,5,1,8,31
2020-10-18,11,0,389,6,0,13,11
2020-10-18,168,42,5672,63,6,251,210
2020-10-18,20,7,670,5,2,35,27
2020-10-18,19,0,193,1,0,15,19
2020-10-18,1,0,117,0,0,2,1
2020-10-18,1,0,51,0,0,2,1
2020-10-18,0,0,19,0,0,0,0
2020-10-18,153,55,3319,43,9,118,208
2020-10-18,0,0,41,0,0,0,0
2020-10-18,6,1,59,2,0,2,7
2020-10-18,730,312,19873,216,30,960,1042
2020-10-18,7,1,561,1,0,7,8
2020-10-18,0,0,25,0,0,0,0
2020-10-18,0,1,84,0,0,0,1
2020-10-18,0,0,47,0,0,0,0
2020-10-18,0,0,33,0,0,8,0
2020-10-18,55,3,1323,17,0,60,58
2020-10-18,90,19,2908,26,1,123,109
2020-10-18,9,0,265,0,0,11,9
2020-10-18,1,0,150,1,0,5,1
2020-10-18,6,0,96,4,0,4,6
2020-10-18,2,0,65,1,0,3,2
2020-10-18,30,5,677,3,0,30,35
2020-10-18,30,10,1228,15,1,58,40
2020-10-18,20,0,702,7,0,40,20
2020-10-18,0,0,56,0,0,7,0
2020-10-18,181,47,3822,41,9,172,228
2020-10-18,2,0,451,2,0,13,2
2020-10-18,1,0,451,0,0,27,1
2020-10-18,1,0,29,1,0,3,1
2020-10-18,6,4,357,1,0,16,10
2020-10-18,0,0,35,0,0,0,0
2020-10-18,33,1,259,15,0,3,34
2020-10-18,8,5,263,1,0,17,13
2020-10-18,16,1,666,5,1,55,17
2020-10-18,0,0,14,0,0,0,0
2020-10-18,81,43,2491,23,12,100,124
2020-10-18,61,12,1298,15,2,20,73
2020-10-18,32,12,1480,4,0,52,44
2020-10-18,0,0,17,0,0,1,0
2020-10-18,6,1,272,2,0,11,7
2020-10-18,0,0,189,0,0,11,0
2020-10-18,0,0,25,0,0,0,0
2020-10-18,0,2,48,0,0,0,2
2020-10-18,0,0,51,0,0,2,0
2020-10-18,20,18,738,4,4,25,38
2020-10-18,96,20,1537,28,2,29,116
2020-10-18,20,20,560,5,0,9,40
2020-10-18,189,54,6765,63,10,331,243
2020-10-18,54,42,2329,20,5,128,96
2020-10-18,2,5,351,0,0,24,7
2020-10-19,0,0,41,0,0,0,0
2020-10-19,23,9,669,7,2,40,32
2020-10-19,2,0,460,0,0,31,2
2020-10-19,1,0,84,0,0,6,1
2020-10-19,23,5,976,4,0,53,28
2020-10-19,22,1,702,7,0,44,23
2020-10-19,18,0,666,4,0,58,18
2020-10-19,168,44,5647,63,5,256,212
2020-10-19,41,0,259,15,0,3,41
2020-10-19,0,0,51,0,0,3,0
2020-10-19,25,14,1493,5,1,52,39
2020-10-19,1,0,150,1,0,5,1
2020-10-19,10,0,265,1,0,11,10
2020-10-19,0,0,33,0,0,6,0
2020-10-19,100,17,1538,23,3,34,117
2020-10-19,0,0,25,0,0,0,0
2020-10-19,6,0,96,3,0,4,6
2020-10-19,30,4,1233,15,1,60,34
2020-10-19,6,1,59,2,0,2,7
2020-10-19,2,0,451,2,0,11,2
2020-10-19,191,48,6771,72,13,354,239
2020-10-19,28,7,677,1,0,38,35
2020-10-19,0,0,189,0,0,10,0
2020-10-19,59,17,1299,14,3,25,76
2020-10-19,758,364,19985,216,46,1006,1122
2020-10-19,1,1,138,0,1,6,2
2020-10-19,1,0,51,0,0,1,1
2020-10-19,2,1,65,1,1,2,3
2020-10-19,25,5,1758,8,2,78,30
2020-10-19,3,5,351,0,0,24,8
2020-10-19,20,5,514,4,0,7,25
2020-10-19,8,1,561,1,0,7,9
2020-10-19,0,0,25,0,0,3,0
2020-10-19,1,0,29,0,0,4,1
2020-10-19,9,0,389,5,0,14,9
2020-10-19,91,20,2914,26,1,123,111
2020-10-19,20,0,193,1,0,17,20
2020-10-19,5,7,357,1,0,16,12
2020-10-19,3,3,269,1,2,3,6
2020-10-19,0,0,19,0,0,0,0
2020-10-19,19,21,738,3,1,34,40
2020-10-19,53,48,2319,20,5,128,101
2020-10-19,157,60,3363,42,14,129,217
2020-10-19,0,0,14,0,0,0,0
2020-10-19,0,2,48,0,0,0,2
2020-10-19,0,0,25,0,0,0,0
2020-10-19,56,3,1312,18,0,52,59
2020-10-19,0,0,56,0,0,7,0
2020-10-19,80,29,2438,23,13,114,109
2020-10-19,0,0,35,0,0,0,0
2020-10-19,0,0,17,0,0,2,0
2020-10-19,0,0,47,0,0,0,0
2020-10-19,8,8,263,1,1,22,16
2020-10-19,22,18,546,4,2,6,40
2020-10-19,187,44,3853,40,7,162,231
2020-10-19,6,1,271,3,0,6,7
2020-10-20,3,0,460,0,0,29,3
2020-10-20,21,0,729,10,0,34,21
2020-10-20,8,0,561,1,0,3,8
2020-10-20,23,18,1493,7,4,54,41
2020-10-20,58,37,2354,18,5,127,95
2020-10-20,18,0,688,4,0,58,18
2020-10-20,6,0,451,3,0,7,6
2020-10-20,0,0,25,0,0,0,0
2020-10-20,0,0,48,0,0,0,0
2020-10-20,55,2,1349,17,0,49,57
2020-10-20,6,8,263,1,0,16,14
2020-10-20,0,0,25,0,0,3,0
2020-10-20,28,10,1247,15,4,30,38
2020-10-20,0,0,189,0,0,6,0
2020-10-20,82,25,2468,22,6,87,107
2020-10-20,22,8,1007,4,0,49,30
2020-10-20,777,322,20131,222,39,747,1099
2020-10-20,0,0,150,0,0,5,0
2020-10-20,0,2,351,0,0,27,2
2020-10-20,7,0,96,3,0,4,7
2020-10-20,1,0,84,0,0,0,1
2020-10-20,26,18,545,4,1,12,44
2020-10-20,1,0,52,0,0,2,1
2020-10-20,5,4,360,2,0,16,9
2020-10-20,21,4,1865,6,1,71,25
2020-10-20,0,0,33,0,0,5,0
2020-10-20,17,21,764,3,4,24,38
2020-10-20,0,0,29,0,0,3,0
2020-10-20,7,0,265,0,0,11,7
2020-10-20,52,26,1321,14,1,21,78
2020-10-20,5,1,59,2,0,2,6
2020-10-20,0,0,41,0,0,0,0
2020-10-20,0,0,35,0,0,0,0
2020-10-20,20,7,661,7,2,33,27
2020-10-20,26,10,677,2,0,27,36
2020-10-20,0,0,19,0,0,0,0
2020-10-20,3,4,256,1,0,7,7
2020-10-20,114,20,1652,24,1,27,134
2020-10-20,22,0,193,2,0,16,22
2020-10-20,198,31,4042,41,7,125,229
2020-10-20,1,0,120,0,0,5,1
2020-10-20,199,34,6894,69,8,319,233
2020-10-20,8,0,389,4,0,6,8
2020-10-20,174,52,5761,66,5,216,226
2020-10-20,40,0,259,15,0,1,40
2020-10-20,19,1,532,4,0,6,20
2020-10-20,2,0,65,2,0,1,2
2020-10-20,0,0,51,0,0,4,0
2020-10-20,7,0,271,3,0,5,7
2020-10-20,99,18,2989,25,1,48,117
2020-10-20,0,0,47,0,0,0,0
2020-10-20,0,0,25,0,0,0,0
2020-10-20,0,0,14,0,0,0,0
2020-10-20,0,0,17,0,0,2,0
2020-10-20,167,46,3467,37,14,15,213
2020-10-20,0,0,56,0,0,8,0
2020-10-21,0,0,48,0,0,0,0
2020-10-21,16,11,775,3,2,25,27
2020-10-21,20,1,717,9,0,30,21
2020-10-21,29,14,1251,18,4,50,43
2020-10-21,81,30,2453,19,5,81,111
2020-10-21,45,0,259,17,0,0,45
2020-10-21,17,1,688,3,0,64,18
2020-10-21,6,0,96,3,0,3,6
2020-10-21,26,10,1003,6,0,54,36
2020-10-21,0,0,189,0,0,2,0
2020-10-21,21,0,193,2,0,16,21
2020-10-21,110,19,1676,19,0,36,129
2020-10-21,0,0,35,0,0,0,0
2020-10-21,4,13,263,2,1,20,17
2020-10-21,168,50,5771,56,9,173,218
2020-10-21,0,0,17,0,0,2,0
2020-10-21,1,0,84,0,0,2,1
2020-10-21,0,0,47,0,0,0,0
2020-10-21,53,3,1364,19,0,58,56
2020-10-21,10,0,389,4,0,5,10
2020-10-21,23,10,566,4,3,9,33
2020-10-21,0,0,51,0,0,5,0
2020-10-21,3,1,275,1,1,4,4
2020-10-21,0,0,25,0,0,3,0
2020-10-21,769,290,20077,221,34,774,1059
2020-10-21,54,20,1371,12,3,22,74
2020-10-21,176,51,3491,41,16,78,227
2020-10-21,6,1,460,0,0,30,7
2020-10-21,6,0,271,2,0,10,6
2020-10-21,0,0,14,0,0,0,0
2020-10-21,0,0,33,0,0,6,0
2020-10-21,0,0,25,0,0,0,0
2020-10-21,22,3,683,8,1,35,25
2020-10-21,0,0,19,0,0,0,0
2020-10-21,7,0,561,1,0,1,7
2020-10-21,61,37,2564,16,3,121,98
2020-10-21,1,0,150,1,0,5,1
2020-10-21,27,6,677,2,0,18,33
2020-10-21,187,44,6898,67,8,305,231
2020-10-21,8,0,265,0,0,10,8
2020-10-21,0,0,41,0,0,0,0
2020-10-21,0,0,56,0,0,8,0
2020-10-21,0,0,25,0,0,0,0
2020-10-21,208,37,4052,48,5,108,245
2020-10-21,23,10,1894,7,5,59,33
2020-10-21,1,0,51,0,0,1,1
2020-10-21,0,0,29,0,0,4,0
2020-10-21,22,13,1509,6,2,50,35
2020-10-21,1,3,351,0,0,26,4
2020-10-21,23,0,538,5,0,8,23
2020-10-21,94,17,3037,23,4,56,111
2020-10-21,2,0,65,2,0,1,2
2020-10-21,5,5,360,2,0,12,10
2020-10-21,1,0,139,0,0,3,1
2020-10-21,7,0,59,2,0,2,7
2020-10-21,7,0,451,1,0,4,7
2020-10-22,89,20,3021,23,3,80,109
2020-10-22,4,0,268,1,0,3,4
2020-10-22,31,14,1257,19,2,53,45
2020-10-22,22,0,720,8,0,19,22
2020-10-22,21,12,376,3,2,7,33
2020-10-22,0,0,150,0,0,7,0
2020-10-22,188,47,6899,58,13,280,235
2020-10-22,23,3,544,5,1,10,26
2020-10-22,0,0,14,0,0,0,0
2020-10-22,1,1,51,0,0,3,2
2020-10-22,0,0,19,0,0,0,0
2020-10-22,161,57,3476,39,15,77,218
2020-10-22,28,1,677,4,0,19,29
2020-10-22,0,0,25,0,0,0,0
2020-10-22,0,0,56,0,0,8,0
2020-10-22,1,0,51,0,0,6,1
2020-10-22,0,0,47,0,0,0,0
2020-10-22,9,1,561,2,0,4,10
2020-10-22,22,1,193,2,1,14,23
2020-10-22,0,0,17,0,0,2,0
2020-10-22,0,1,48,0,0,0,1
2020-10-22,43,0,259,17,0,1,43
2020-10-22,2,3,120,1,0,4,5
2020-10-22,100,13,1665,21,0,37,113
2020-10-22,6,0,59,2,0,1,6
2020-10-22,0,0,25,0,0,0,0
2020-10-22,55,5,1348,20,0,59,60
2020-10-22,0,0,189,0,0,4,0
2020-10-22,770,262,20091,227,32,794,1032
2020-10-22,7,2,271,3,0,11,9
2020-10-22,5,8,263,2,1,19,13
2020-10-22,5,0,460,1,0,28,5
2020-10-22,23,3,1876,7,3,59,26
2020-10-22,0,0,33,0,0,5,0
2020-10-22,90,27,2483,16,7,71,117
2020-10-22,6,0,97,3,0,4,6
2020-10-22,2,0,84,0,0,2,2
2020-10-22,2,0,351,0,0,24,2
2020-10-22,13,0,688,2,0,53,13
2020-10-22,30,7,1004,7,1,41,37
2020-10-22,7,0,451,1,0,11,7
2020-10-22,10,0,389,5,0,7,10
2020-10-22,12,14,769,3,3,25,26
2020-10-22,53,20,1301,15,1,12,73
2020-10-22,162,41,5874,58,5,179,203
2020-10-22,0,0,25,0,0,3,0
2020-10-22,2,0,65,2,0,2,2
2020-10-22,8,0,265,0,0,11,8
2020-10-22,61,43,2575,15,3,125,104
2020-10-22,6,6,360,3,1,15,12
2020-10-22,0,0,41,0,0,0,0
2020-10-22,19,7,691,5,2,32,26
2020-10-22,215,48,4055,43,6,131,263
2020-10-22,0,0,35,0,0,0,0
2020-10-22,24,6,1467,7,2,46,30
2020-10-22,0,0,29,0,0,4,0
2020-10-23,0,0,47,0,0,0,0
2020-10-23,0,0,25,0,0,0,0
2020-10-23,92,26,2464,15,7,74,118
2020-10-23,30,4,1001,6,0,36,34
2020-10-23,8,0,460,1,0,26,8
2020-10-23,0,0,29,0,0,3,0
2020-10-23,100,15,1664,23,2,17,115
2020-10-23,11,0,688,2,0,51,11
2020-10-23,29,1,677,5,0,27,30
2020-10-23,56,3,1333,19,0,59,59
2020-10-23,42,1,259,16,0,2,43
2020-10-23,88,21,3012,16,2,70,109
2020-10-23,1,0,51,0,0,5,1
2020-10-23,159,42,5892,55,9,168,201
2020-10-23,9,1,265,0,0,14,10
2020-10-23,0,0,25,0,0,3,0
2020-10-23,0,0,25,0,0,0,0
2020-10-23,10,2,561,1,0,6,12
2020-10-23,7,0,451,1,0,8,7
2020-10-23,24,4,1893,7,3,53,28
2020-10-23,31,13,1254,14,4,51,44
2020-10-23,19,1,193,3,1,12,20
2020-10-23,0,0,14,0,0,0,0
2020-10-23,2,0,84,1,0,1,2
2020-10-23,10,0,97,3,0,4,10
2020-10-23,0,0,150,0,0,7,0
2020-10-23,20,11,564,2,2,9,31
2020-10-23,0,0,17,0,0,2,0
2020-10-23,151,58,3407,37,13,63,209
2020-10-23,4,6,357,2,1,21,10
2020-10-23,0,0,189,0,0,7,0
2020-10-23,0,0,41,0,0,0,0
2020-10-23,785,254,20067,229,27,754,1039
2020-10-23,4,1,275,1,1,4,5
2020-10-23,1,0,351,0,0,23,1
2020-10-23,20,0,533,5,0,7,20
2020-10-23,2,1,126,0,0,8,3
2020-10-23,212,51,4069,40,9,137,263
2020-10-23,0,1,48,0,0,0,1
2020-10-23,1,0,56,0,0,8,1
2020-10-23,53,21,1318,14,3,16,74
2020-10-23,0,0,35,0,0,0,0
2020-10-23,0,0,19,0,0,0,0
2020-10-23,7,2,271,2,1,11,9
2020-10-23,1,0,51,0,0,3,1
2020-10-23,11,0,389,4,0,7,11
2020-10-23,0,0,33,0,0,6,0
2020-10-23,15,10,795,4,1,31,25
2020-10-23,6,5,263,2,0,19,11
2020-10-23,21,0,717,8,0,20,21
2020-10-23,22,10,714,5,1,22,32
2020-10-23,2,1,65,2,1,3,3
2020-10-23,55,46,2404,11,7,121,101
2020-10-23,24,9,1475,9,1,28,33
2020-10-23,6,0,59,2,0,2,6
2020-10-23,185,50,7026,69,12,277,235
2020-10-24,1,0,351,0,0,23,1
2020-10-24,0,0,189,0,0,8,0
2020-10-24,54,27,2404,14,5,125,81
2020-10-24,27,1,677,5,0,27,28
2020-10-24,22,1,717,8,0,19,23
2020-10-24,9,0,688,2,0,53,9
2020-10-24,27,14,1256,13,7,60,41
2020-10-24,0,0,19,0,0,0,0
2020-10-24,23,13,1437,8,3,36,36
2020-10-24,3,9,357,0,2,17,12
2020-10-24,0,0,25,0,0,3,0
2020-10-24,0,0,17,0,0,2,0
2020-10-24,151,53,3357,34,9,64,204
2020-10-24,0,0,35,0,0,0,0
2020-10-24,0,0,47,0,0,0,0
2020-10-24,20,0,193,3,0,14,20
2020-10-24,0,0,25,0,0,0,0
2020-10-24,21,7,562,2,2,11,28
2020-10-24,96,21,1646,22,2,21,117
2020-10-24,0,0,48,0,0,0,0
2020-10-24,13,12,798,3,1,34,25
2020-10-24,2,0,84,0,0,2,2
2020-10-24,9,0,97,4,0,5,9
2020-10-24,23,5,1887,6,1,61,28
2020-10-24,0,0,14,0,0,0,0
2020-10-24,46,15,1323,12,2,15,61
2020-10-24,24,4,530,4,1,7,28
2020-10-24,1,0,51,0,0,2,1
2020-10-24,150,33,5818,55,5,189,183
2020-10-24,2,3,65,2,1,3,5
2020-10-24,33,4,1007,5,0,47,37
2020-10-24,767,294,19924,221,43,785,1061
2020-10-24,166,42,6988,67,3,289,208
2020-10-24,4,2,270,1,0,6,6
2020-10-24,53,3,1322,20,0,60,56
2020-10-24,0,0,33,0,0,6,0
2020-10-24,7,12,263,2,2,20,19
2020-10-24,7,4,460,1,0,26,11
2020-10-24,43,0,259,15,0,6,43
2020-10-24,1,0,41,0,0,0,1
2020-10-24,6,0,59,2,0,2,6
2020-10-24,203,60,4033,38,6,130,263
2020-10-24,0,0,29,0,0,4,0
2020-10-24,2,2,126,0,0,6,4
2020-10-24,10,0,389,3,0,8,10
2020-10-24,0,0,56,0,0,8,0
2020-10-24,21,12,693,4,1,29,33
2020-10-24,1,0,150,1,0,5,1
2020-10-24,84,29,2990,17,2,72,113
2020-10-24,5,0,451,1,0,12,5
2020-10-24,0,0,25,0,0,0,0
2020-10-24,10,1,561,3,0,5,11
2020-10-24,6,1,265,0,0,12,7
2020-10-24,3,0,51,0,0,4,3
2020-10-24,7,2,271,2,0,9,9
2020-10-24,91,29,2370,15,9,68,120
2020-10-25,0,0,56,0,0,11,0
2020-10-25,30,3,677,4,0,27,33
2020-10-25,5,0,265,0,0,18,5
2020-10-25,164,60,3368,37,11,79,224
2020-10-25,162,46,5740,59,5,168,208
2020-10-25,41,0,259,16,0,2,41
2020-10-25,0,0,35,0,0,0,0
2020-10-25,88,11,1644,24,1,22,99
2020-10-25,0,0,25,0,0,3,0
2020-10-25,6,0,453,1,0,12,6
2020-10-25,6,2,271,2,0,8,8
2020-10-25,0,0,47,0,0,0,0
2020-10-25,0,1,17,0,0,2,1
2020-10-25,0,0,29,0,0,4,0
2020-10-25,21,0,193,2,0,14,21
2020-10-25,21,9,691,5,1,31,30
2020-10-25,3,0,51,0,0,6,3
2020-10-25,1,0,84,0,0,0,1
2020-10-25,219,42,4016,45,7,128,261
2020-10-25,6,3,353,0,0,21,9
2020-10-25,24,12,1451,8,3,35,36
2020-10-25,11,10,263,3,1,18,21
2020-10-25,0,0,33,0,0,6,0
2020-10-25,29,3,1003,7,0,50,32
2020-10-25,10,2,561,3,0,5,12
2020-10-25,6,0,59,2,0,1,6
2020-10-25,0,0,48,0,0,0,0
2020-10-25,2,1,119,0,0,8,3
2020-10-25,0,0,14,0,0,0,0
2020-10-25,85,29,2959,16,3,93,114
2020-10-25,7,1,460,1,0,26,8
2020-10-25,2,4,65,2,0,1,6
2020-10-25,0,0,19,0,0,0,0
2020-10-25,10,0,389,3,0,8,10
2020-10-25,11,1,688,3,0,54,12
2020-10-25,747,291,19948,204,34,807,1038
2020-10-25,56,38,2420,16,4,119,94
2020-10-25,26,2,533,4,1,9,28
2020-10-25,13,16,783,3,2,25,29
2020-10-25,48,1,1305,19,0,59,49
2020-10-25,1,1,189,1,1,8,2
2020-10-25,162,45,6979,63,11,320,207
2020-10-25,0,0,25,0,0,0,0
2020-10-25,21,12,1256,10,5,55,33
2020-10-25,4,2,271,1,1,6,6
2020-10-25,1,0,51,0,0,0,1
2020-10-25,0,1,41,0,0,0,1
2020-10-25,23,11,545,2,1,12,34
2020-10-25,7,0,97,3,0,5,7
2020-10-25,53,21,1311,13,1,22,74
2020-10-25,30,3,717,7,1,26,33
2020-10-25,2,0,150,0,0,4,2
2020-10-25,0,0,25,0,0,0,0
2020-10-25,88,24,2338,14,8,70,112
2020-10-25,28,2,1824,7,0,69,30
2020-10-25,1,0,200,0,0,9,1
2020-10-26,32,6,679,6,0,20,38
2020-10-26,0,0,48,0,0,0,0
2020-10-26,29,3,1820,5,0,74,32
2020-10-26,0,0,35,0,0,0,0
2020-10-26,0,0,29,0,0,4,0
2020-10-26,26,11,1200,11,6,60,37
2020-10-26,11,1,688,3,0,62,12
2020-10-26,0,0,25,0,0,3,0
2020-10-26,1,0,52,0,0,2,1
2020-10-26,6,0,59,2,0,0,6
2020-10-26,22,0,193,2,0,15,22
2020-10-26,217,42,4030,48,8,125,259
2020-10-26,0,0,47,0,0,0,0
2020-10-26,29,0,717,8,0,25,29
2020-10-26,157,46,5738,56,8,191,203
2020-10-26,11,4,263,3,0,20,15
2020-10-26,5,1,351,0,0,19,6
2020-10-26,15,16,777,3,2,33,31
2020-10-26,20,6,697,4,0,33,26
2020-10-26,0,0,33,0,0,6,0
2020-10-26,54,14,1308,13,1,26,68
2020-10-26,176,49,6994,69,14,318,225
2020-10-26,2,0,65,2,0,2,2
2020-10-26,0,0,41,0,0,0,0
2020-10-26,1,0,84,0,0,0,1
2020-10-26,0,1,17,0,0,2,1
2020-10-26,0,0,19,0,0,0,0
2020-10-26,84,22,2421,13,9,91,106
2020-10-26,0,0,25,0,0,0,0
2020-10-26,58,31,2380,17,2,114,89
2020-10-26,30,4,556,5,2,9,34
2020-10-26,4,0,51,0,0,6,4
2020-10-26,95,12,1651,25,1,24,107
2020-10-26,26,12,1428,10,1,57,38
2020-10-26,8,0,453,1,0,12,8
2020-10-26,0,0,25,0,0,0,0
2020-10-26,1,3,144,0,1,5,4
2020-10-26,86,36,2944,20,4,82,122
2020-10-26,166,51,3386,58,9,77,217
2020-10-26,43,0,259,17,0,2,43
2020-10-26,0,0,14,0,0,0,0
2020-10-26,3,0,56,1,0,10,3
2020-10-26,11,0,561,3,0,2,11
2020-10-26,47,0,1313,18,0,63,47
2020-10-26,2,2,275,0,0,3,4
2020-10-26,755,276,19943,214,43,814,1031
2020-10-26,6,2,460,1,1,22,8
2020-10-26,1,1,189,1,1,8,2
2020-10-26,6,0,351,0,0,27,6
2020-10-26,5,0,265,0,0,15,5
2020-10-26,29,11,534,4,1,8,40
2020-10-26,8,0,271,2,0,10,8
2020-10-26,7,0,96,3,0,13,7
2020-10-26,10,0,389,3,0,7,10
2020-10-26,28,3,1004,8,1,51,31
2020-10-26,1,0,150,0,0,4,1
2020-10-27,177,36,5842,60,5,176,213
2020-10-27,10,0,453,3,0,9,10
2020-10-27,0,0,41,0,0,0,0
2020-10-27,0,0,29,0,0,4,0
2020-10-27,148,48,3437,32,11,69,196
2020-10-27,0,0,47,0,0,0,0
2020-10-27,18,3,700,5,0,35,21
2020-10-27,0,0,19,0,0,0,0
2020-10-27,31,1,1822,6,0,64,32
2020-10-27,6,1,59,2,0,2,7
2020-10-27,7,0,265,0,0,14,7
2020-10-27,233,35,3997,52,12,109,268
2020-10-27,96,16,1659,28,0,23,112
2020-10-27,33,10,1467,11,0,47,43
2020-10-27,44,0,259,14,0,1,44
2020-10-27,12,10,263,2,1,28,22
2020-10-27,58,34,2412,17,6,116,92
2020-10-27,27,11,550,7,0,8,38
2020-10-27,0,0,50,0,0,3,0
2020-10-27,79,26,3017,19,1,64,105
2020-10-27,0,0,25,0,0,0,0
2020-10-27,33,6,677,6,1,19,39
2020-10-27,2,0,65,2,0,2,2
2020-10-27,2,0,51,0,0,6,2
2020-10-27,0,0,150,0,0,4,0
2020-10-27,1,0,84,0,0,1,1
2020-10-27,7,0,351,2,0,22,7
2020-10-27,5,1,271,2,0,8,6
2020-10-27,46,1,1339,19,0,67,47
2020-10-27,0,0,35,0,0,0,0
2020-10-27,0,1,25,0,0,0,1
2020-10-27,182,59,6997,67,13,286,241
2020-10-27,8,0,96,3,0,5,8
2020-10-27,9,1,561,2,0,3,10
2020-10-27,2,0,56,1,0,7,2
2020-10-27,0,0,14,0,0,0,0
2020-10-27,0,0,48,0,0,0,0
2020-10-27,2,1,264,0,0,6,3
2020-10-27,76,20,2340,12,8,77,96
2020-10-27,26,4,983,7,0,41,30
2020-10-27,0,0,33,0,0,4,0
2020-10-27,59,21,1326,15,3,12,80
2020-10-27,7,0,460,1,0,29,7
2020-10-27,1,0,52,0,0,1,1
2020-10-27,1,1,189,1,1,7,2
2020-10-27,27,8,548,5,1,11,35
2020-10-27,5,3,450,0,0,17,8
2020-10-27,18,14,784,3,3,29,32
2020-10-27,1,1,131,0,0,4,2
2020-10-27,28,14,1213,11,3,56,42
2020-10-27,9,0,389,2,0,6,9
2020-10-27,11,0,688,3,0,61,11
2020-10-27,0,1,17,0,0,2,1
2020-10-27,19,0,193,3,0,14,19
2020-10-27,26,1,717,9,0,19,27
2020-10-27,750,267,20060,229,38,762,1017
2020-10-28,2,0,51,0,0,3,2
2020-10-28,0,0,47,0,0,0,0
2020-10-28,0,0,35,0,0,0,0
2020-10-28,2,1,271,0,0,7,3
2020-10-28,7,4,355,1,0,12,11
2020-10-28,231,43,4004,53,9,103,274
2020-10-28,22,9,565,4,0,9,31
2020-10-28,29,1,717,7,0,26,30
2020-10-28,82,24,3034,18,1,64,106
2020-10-28,12,9,263,3,0,28,21
2020-10-28,94,12,1670,29,1,23,106
2020-10-28,0,0,48,0,0,0,0
2020-10-28,13,0,193,2,0,15,13
2020-10-28,0,0,50,0,0,2,0
2020-10-28,29,5,1003,8,0,39,34
2020-10-28,7,0,271,2,0,6,7
2020-10-28,4,0,351,1,0,23,4
2020-10-28,15,9,692,3,1,34,24
2020-10-28,0,0,25,0,0,0,0
2020-10-28,0,0,25,0,0,0,0
2020-10-28,0,0,33,0,0,3,0
2020-10-28,9,1,688,1,0,63,10
2020-10-28,2,0,65,2,0,1,2
2020-10-28,10,0,453,3,0,5,10
2020-10-28,8,0,561,1,0,5,8
2020-10-28,43,5,1343,20,0,60,48
2020-10-28,36,6,677,6,1,19,42
2020-10-28,49,0,259,17,0,0,49
2020-10-28,83,26,2467,14,8,69,109
2020-10-28,149,63,3424,35,12,64,212
2020-10-28,58,17,1336,16,0,19,75
2020-10-28,6,0,59,2,0,0,6
2020-10-28,0,0,14,0,0,0,0
2020-10-28,0,0,41,0,0,0,0
2020-10-28,31,12,1476,5,4,52,43
2020-10-28,28,3,549,5,2,10,31
2020-10-28,2,0,112,1,0,4,2
2020-10-28,743,290,20061,222,41,738,1033
2020-10-28,3,0,56,1,0,8,3
2020-10-28,187,48,6993,66,8,269,235
2020-10-28,8,0,265,0,0,14,8
2020-10-28,22,23,798,4,1,29,45
2020-10-28,0,0,17,0,0,2,0
2020-10-28,1,0,52,0,0,2,1
2020-10-28,8,0,389,2,0,7,8
2020-10-28,6,0,460,2,0,29,6
2020-10-28,5,0,84,2,0,2,5
2020-10-28,1,1,189,1,1,5,2
2020-10-28,27,15,1234,10,5,62,42
2020-10-28,9,0,96,4,0,3,9
2020-10-28,35,1,1852,7,0,73,36
2020-10-28,0,0,150,0,0,4,0
2020-10-28,58,41,2415,17,6,117,99
2020-10-28,181,56,5847,59,10,183,237
2020-10-28,1,0,29,1,0,3,1
2020-10-28,0,0,19,0,0,0,0
2020-10-29,2,1,131,1,1,3,3
2020-10-29,24,17,797,6,2,26,41
2020-10-29,6,12,360,1,0,11,18
2020-10-29,26,0,717,10,0,23,26
2020-10-29,6,0,460,2,0,29,6
2020-10-29,0,0,25,0,0,0,0
2020-10-29,87,12,1653,25,0,23,99
2020-10-29,6,0,59,2,0,1,6
2020-10-29,2,0,51,0,0,2,2
2020-10-29,25,14,1247,9,4,60,39
2020-10-29,79,19,3014,19,2,74,98
2020-10-29,0,0,14,0,0,0,0
2020-10-29,11,9,263,3,1,25,20
2020-10-29,9,0,453,2,0,13,9
2020-10-29,6,0,351,0,0,24,6
2020-10-29,0,0,25,0,0,0,0
2020-10-29,68,27,1337,17,1,10,95
2020-10-29,3,2,65,1,1,1,5
2020-10-29,57,34,2417,14,5,126,91
2020-10-29,150,64,3370,33,7,83,214
2020-10-29,0,0,33,0,0,4,0
2020-10-29,3,0,270,0,0,8,3
2020-10-29,37,2,1874,8,1,71,39
2020-10-29,28,5,542,8,2,8,33
2020-10-29,22,7,669,4,0,35,29
2020-10-29,0,0,17,0,0,2,0
2020-10-29,8,0,389,2,0,10,8
2020-10-29,0,0,150,0,0,4,0
2020-10-29,10,0,96,5,0,3,10
2020-10-29,0,0,41,0,0,0,0
2020-10-29,0,0,47,0,0,0,0
2020-10-29,4,0,56,1,0,7,4
2020-10-29,11,2,561,2,0,7,13
2020-10-29,8,0,265,0,0,14,8
2020-10-29,1,0,189,1,0,6,1
2020-10-29,7,3,271,2,2,3,10
2020-10-29,0,0,50,0,0,3,0
2020-10-29,15,1,193,2,0,13,16
2020-10-29,1,0,30,0,0,4,1
2020-10-29,1,0,52,0,0,1,1
2020-10-29,182,51,5875,61,5,191,233
2020-10-29,44,2,1338,20,0,58,46
2020-10-29,9,1,688,2,0,51,10
2020-10-29,85,21,2472,14,6,79,106
2020-10-29,6,0,84,0,0,2,6
2020-10-29,0,0,35,0,0,0,0
2020-10-29,0,0,19,0,0,0,0
2020-10-29,45,1,259,16,1,0,46
2020-10-29,233,40,3980,58,12,100,273
2020-10-29,783,281,20056,221,44,722,1064
2020-10-29,32,10,1475,5,1,49,42
2020-10-29,24,10,563,4,0,10,34
2020-10-29,0,0,48,0,0,0,0
2020-10-29,42,9,681,6,1,18,51
2020-10-29,25,13,1014,6,1,37,38
2020-10-29,197,48,6992,73,6,275,245
2020-10-30,0,0,19,0,0,0,0
2020-10-30,29,10,572,4,0,9,39
2020-10-30,0,0,25,0,0,0,0
2020-10-30,9,1,688,3,0,58,10
2020-10-30,12,0,389,2,0,8,12
2020-10-30,27,11,1253,13,3,47,38
2020-10-30,4,1,200,0,0,9,5
2020-10-30,44,7,681,5,0,19,51
2020-10-30,0,0,17,0,0,2,0
2020-10-30,81,25,2467,19,4,69,106
2020-10-30,248,51,3970,54,10,97,299
2020-10-30,35,5,1861,6,1,77,40
2020-10-30,5,5,361,1,1,15,10
2020-10-30,0,0,50,0,0,2,0
2020-10-30,0,0,29,0,0,4,0
2020-10-30,2,0,189,1,0,8,2
2020-10-30,8,0,96,5,0,4,8
2020-10-30,3,1,65,2,0,1,4
2020-10-30,34,9,1482,5,1,43,43
2020-10-30,22,4,542,7,0,8,26
2020-10-30,0,0,33,0,0,6,0
2020-10-30,0,0,25,0,0,0,0
2020-10-30,0,0,14,0,0,0,0
2020-10-30,2,0,56,0,0,8,2
2020-10-30,28,8,1015,6,2,38,36
2020-10-30,70,14,1333,17,0,15,84
2020-10-30,212,40,6965,81,6,248,252
2020-10-30,53,5,1340,23,1,55,58
2020-10-30,68,42,2426,17,5,116,110
2020-10-30,0,0,35,0,0,0,0
2020-10-30,10,7,263,3,0,20,17
2020-10-30,0,0,150,0,0,3,0
2020-10-30,3,0,272,0,0,5,3
2020-10-30,0,0,47,0,0,0,0
2020-10-30,3,0,84,0,0,3,3
2020-10-30,1,0,51,0,0,0,1
2020-10-30,799,295,20077,222,36,730,1094
2020-10-30,0,1,41,0,0,0,1
2020-10-30,7,0,453,2,0,14,7
2020-10-30,44,0,259,13,0,3,44
2020-10-30,0,0,48,0,0,0,0
2020-10-30,17,1,193,3,0,14,18
2020-10-30,94,11,1633,26,1,25,105
2020-10-30,157,57,3360,38,10,56,214
2020-10-30,5,0,59,1,0,0,5
2020-10-30,9,0,271,2,0,7,9
2020-10-30,2,0,134,0,0,7,2
2020-10-30,8,3,561,2,0,4,11
2020-10-30,24,6,688,2,0,35,30
2020-10-30,8,1,265,0,0,8,9
2020-10-30,7,2,460,2,0,30,9
2020-10-30,27,15,793,4,3,28,42
2020-10-30,0,0,51,0,0,2,0
2020-10-30,25,0,717,10,0,20,25
2020-10-30,91,13,3033,22,1,73,104
2020-10-30,188,36,5849,58,5,174,224
2020-10-31,0,2,41,0,0,0,2
2020-10-31,0,0,29,0,0,4,0
2020-10-31,7,1,453,2,1,12,8
2020-10-31,83,9,3028,24,2,71,92
2020-10-31,0,0,35,0,0,0,0
2020-10-31,35,11,1478,7,1,51,46
2020-10-31,7,2,460,3,0,29,9
2020-10-31,9,0,561,3,0,4,9
2020-10-31,0,0,50,0,0,2,0
2020-10-31,30,16,792,6,3,23,46
2020-10-31,0,0,51,0,0,3,0
2020-10-31,25,0,717,9,0,24,25
2020-10-31,12,3,193,3,2,14,15
2020-10-31,0,0,14,0,0,0,0
2020-10-31,156,56,3312,34,10,76,212
2020-10-31,96,14,1643,25,1,29,110
2020-10-31,0,2,48,0,0,0,2
2020-10-31,1,0,150,1,0,4,1
2020-10-31,8,0,96,5,0,5,8
2020-10-31,0,0,17,0,0,2,0
2020-10-31,0,0,25,0,0,0,0
2020-10-31,5,0,59,0,0,4,5
2020-10-31,0,0,33,0,0,7,0
2020-10-31,2,0,259,0,0,4,2
2020-10-31,51,6,1287,23,0,59,57
2020-10-31,34,4,1803,6,0,85,38
2020-10-31,20,6,533,5,0,7,26
2020-10-31,1,1,121,0,0,5,2
2020-10-31,8,10,350,3,1,14,18
2020-10-31,19,12,710,3,2,35,31
2020-10-31,0,0,25,0,0,0,0
2020-10-31,777,302,20022,223,27,777,1079
2020-10-31,5,0,271,1,0,13,5
2020-10-31,0,0,19,0,0,0,0
2020-10-31,11,0,389,2,0,6,11
2020-10-31,3,1,65,2,0,3,4
2020-10-31,5,1,265,0,1,11,6
2020-10-31,77,25,2340,17,3,84,102
2020-10-31,6,9,359,1,0,17,15
2020-10-31,244,36,6958,95,5,258,280
2020-10-31,3,3,351,0,0,27,6
2020-10-31,241,47,3936,58,9,102,288
2020-10-31,62,49,2412,19,4,124,111
2020-10-31,66,18,1331,19,2,18,84
2020-10-31,40,5,685,4,0,19,45
2020-10-31,1,0,56,0,0,8,1
2020-10-31,24,6,1012,8,2,33,30
2020-10-31,0,0,52,0,0,3,0
2020-10-31,0,0,47,0,0,0,0
2020-10-31,2,0,189,1,0,6,2
2020-10-31,30,11,563,4,0,11,41
2020-10-31,10,1,688,3,1,62,11
2020-10-31,50,0,259,13,0,2,50
2020-10-31,3,0,84,0,0,5,3
2020-10-31,24,14,1240,11,7,49,38
2020-10-31,181,36,5833,55,9,191,217
2020-11-01,0,0,33,0,0,7,0
2020-11-01,5,0,59,0,0,1,5
2020-11-01,30,7,1006,8,3,40,37
2020-11-01,25,13,554,4,3,11,38
2020-11-01,6,0,271,1,0,16,6
2020-11-01,1,1,137,0,1,5,2
2020-11-01,29,14,1229,14,8,45,43
2020-11-01,4,0,189,0,0,8,4
2020-11-01,8,0,561,3,0,3,8
2020-11-01,46,4,1269,24,0,53,50
2020-11-01,3,0,265,0,0,11,3
2020-11-01,3,1,65,2,0,2,4
2020-11-01,37,10,681,3,0,24,47
2020-11-01,9,1,453,1,1,16,10
2020-11-01,7,1,460,3,0,30,8
2020-11-01,239,61,6946,86,10,278,300
2020-11-01,242,61,3910,58,14,104,303
2020-11-01,798,258,19895,223,39,781,1056
2020-11-01,10,1,688,2,0,58,11
2020-11-01,85,30,2432,21,4,86,115
2020-11-01,12,0,389,2,0,8,12
2020-11-01,5,0,96,4,0,2,5
2020-11-01,85,15,2977,21,1,77,100
2020-11-01,0,0,17,0,0,1,0
2020-11-01,3,0,84,0,0,4,3
2020-11-01,49,0,259,14,0,0,49
2020-11-01,0,0,41,0,0,0,0
2020-11-01,0,0,25,0,0,0,0
2020-11-01,0,2,48,0,0,0,2
2020-11-01,25,2,717,9,0,28,27
2020-11-01,0,0,35,0,0,0,0
2020-11-01,3,0,351,1,0,27,3
2020-11-01,35,17,1479,9,1,49,52
2020-11-01,1,0,56,0,0,8,1
2020-11-01,0,0,50,0,0,2,0
2020-11-01,0,0,51,0,0,4,0
2020-11-01,0,0,29,0,0,4,0
2020-11-01,0,0,51,0,0,6,0
2020-11-01,20,4,504,4,0,7,24
2020-11-01,71,22,1326,17,2,17,93
2020-11-01,5,12,355,1,1,16,17
2020-11-01,0,0,25,0,0,0,0
2020-11-01,102,7,1663,26,0,32,109
2020-11-01,183,18,5797,60,3,196,201
2020-11-01,179,52,3350,43,10,65,231
2020-11-01,8,10,350,3,1,20,18
2020-11-01,63,46,2394,18,6,125,109
2020-11-01,0,0,14,0,0,0,0
2020-11-01,17,10,676,4,3,37,27
2020-11-01,31,17,787,6,2,28,48
2020-11-01,37,3,1786,9,0,93,40
2020-11-01,1,0,150,1,0,5,1
2020-11-01,12,3,193,3,2,16,15
2020-11-01,0,0,19,0,0,0,0
2020-11-01,0,0,47,0,0,0,0
2020-11-01,3,1,246,0,0,0,4
2020-11-02,30,16,789,5,1,29,46
2020-11-02,28,0,717,11,0,28,28
2020-11-02,106,14,1674,26,3,31,120
2020-11-02,0,0,25,0,0,0,0
2020-11-02,0,0,25,0,0,0,0
2020-11-02,1,0,150,1,0,5,1
2020-11-02,48,0,259,14,0,1,48
2020-11-02,3,1,351,1,0,27,4
2020-11-02,4,0,265,1,0,9,4
2020-11-02,46,2,1307,22,1,56,48
2020-11-02,40,18,1472,10,2,41,58
2020-11-02,2,1,65,1,0,1,3
2020-11-02,91,21,2973,25,2,82,112
2020-11-02,23,2,533,4,0,8,25
2020-11-02,17,13,682,3,1,41,30
2020-11-02,8,0,271,2,0,14,8
2020-11-02,8,8,350,3,0,21,16
2020-11-02,0,0,51,0,0,6,0
2020-11-02,39,9,681,3,0,30,48
2020-11-02,3,0,59,0,0,2,3
2020-11-02,9,1,453,4,1,10,10
2020-11-02,29,9,1225,13,4,48,38
2020-11-02,0,0,47,0,0,0,0
2020-11-02,13,1,688,2,0,64,14
2020-11-02,0,0,51,0,0,5,0
2020-11-02,7,0,96,3,0,4,7
2020-11-02,243,54,3951,62,7,121,297
2020-11-02,0,0,41,0,0,0,0
2020-11-02,194,56,3363,53,7,60,250
2020-11-02,177,37,5744,60,9,197,214
2020-11-02,239,52,6957,87,12,289,291
2020-11-02,3,0,84,0,0,3,3
2020-11-02,7,0,460,2,0,26,7
2020-11-02,0,0,33,0,0,6,0
2020-11-02,5,9,358,1,2,16,14
2020-11-02,0,0,29,0,0,4,0
2020-11-02,0,0,35,0,0,0,0
2020-11-02,11,4,193,3,2,13,15
2020-11-02,36,2,1792,11,1,84,38
2020-11-02,0,0,14,0,0,0,0
2020-11-02,0,2,48,0,0,0,2
2020-11-02,2,0,259,0,0,2,2
2020-11-02,2,0,56,1,0,7,2
2020-11-02,27,11,552,3,1,7,38
2020-11-02,0,0,17,0,0,2,0
2020-11-02,2,0,50,1,0,0,2
2020-11-02,86,23,2392,22,6,100,109
2020-11-02,2,0,142,0,0,5,2
2020-11-02,74,24,1326,15,3,23,98
2020-11-02,2,0,189,1,0,8,2
2020-11-02,12,0,389,2,0,7,12
2020-11-02,69,41,2407,17,6,126,110
2020-11-02,9,0,561,4,0,2,9
2020-11-02,817,229,19933,238,24,807,1046
2020-11-02,0,0,19,0,0,0,0
2020-11-02,28,8,1007,6,2,42,36
2020-11-03,2,0,262,0,0,3,2
2020-11-03,3,0,189,2,0,10,3
2020-11-03,96,14,1677,29,3,20,110
2020-11-03,56,17,1347,15,4,21,73
2020-11-03,0,0,41,0,0,0,0
2020-11-03,3,0,50,1,0,1,3
2020-11-03,9,0,561,3,0,8,9
2020-11-03,32,0,717,12,0,32,32
2020-11-03,102,17,2999,27,2,77,119
2020-11-03,17,11,712,1,2,35,28
2020-11-03,182,42,5881,78,8,168,224
2020-11-03,31,5,1007,7,2,38,36
2020-11-03,5,7,358,2,0,14,12
2020-11-03,35,5,1889,11,1,65,40
2020-11-03,0,0,35,0,0,0,0
2020-11-03,12,3,688,2,2,57,15
2020-11-03,41,10,1490,11,4,45,51
2020-11-03,0,0,51,0,0,4,0
2020-11-03,0,0,19,0,0,0,0
2020-11-03,2,0,150,2,0,3,2
2020-11-03,31,10,1238,15,1,40,41
2020-11-03,0,1,51,0,1,4,1
2020-11-03,36,17,809,5,3,24,53
2020-11-03,1,0,29,0,0,4,1
2020-11-03,2,0,65,1,0,1,2
2020-11-03,6,2,460,2,0,22,8
2020-11-03,263,52,3952,66,9,96,315
2020-11-03,65,51,2484,16,4,114,116
2020-11-03,22,6,586,5,2,10,28
2020-11-03,41,10,681,3,0,21,51
2020-11-03,92,19,2520,19,6,91,111
2020-11-03,0,0,14,0,0,0,0
2020-11-03,2,0,56,1,0,8,2
2020-11-03,8,13,339,2,1,17,21
2020-11-03,0,0,33,0,0,8,0
2020-11-03,9,0,96,3,0,5,9
2020-11-03,0,0,17,0,0,2,0
2020-11-03,9,0,272,2,0,12,9
2020-11-03,0,0,47,0,0,0,0
2020-11-03,49,0,259,14,0,1,49
2020-11-03,243,52,6978,88,18,286,295
2020-11-03,13,0,389,3,0,7,13
2020-11-03,21,9,562,4,0,7,30
2020-11-03,2,0,84,0,0,3,2
2020-11-03,3,0,200,3,0,11,3
2020-11-03,825,303,20014,238,37,728,1128
2020-11-03,0,2,48,0,0,0,2
2020-11-03,12,1,453,3,1,7,13
2020-11-03,2,0,127,0,0,3,2
2020-11-03,0,0,25,0,0,0,0
2020-11-03,210,57,3405,56,8,63,267
2020-11-03,3,0,59,0,0,1,3
2020-11-03,53,2,1340,22,1,52,55
2020-11-03,3,0,265,1,0,1,3
2020-11-03,15,3,193,4,2,12,18
2020-11-03,0,0,25,0,0,0,0
2020-11-04,5,3,352,1,0,15,8
2020-11-04,8,0,460,2,0,23,8
2020-11-04,22,6,711,3,0,42,28
2020-11-04,94,29,2535,21,4,84,123
2020-11-04,0,0,14,0,0,0,0
2020-11-04,821,322,20000,238,46,693,1143
2020-11-04,278,51,6951,93,12,262,329
2020-11-04,2,0,273,0,0,3,2
2020-11-04,50,0,259,15,0,1,50
2020-11-04,0,1,48,0,0,0,1
2020-11-04,1,0,51,0,0,4,1
2020-11-04,0,0,35,0,0,0,0
2020-11-04,14,0,561,3,0,5,14
2020-11-04,34,4,1891,12,1,57,38
2020-11-04,0,0,19,0,0,0,0
2020-11-04,0,0,51,0,0,2,0
2020-11-04,11,0,389,20,0,6,11
2020-11-04,25,4,556,5,1,7,29
2020-11-04,12,3,688,3,1,59,15
2020-11-04,3,0,152,2,0,2,3
2020-11-04,8,0,272,4,0,11,8
2020-11-04,100,18,3036,26,0,81,118
2020-11-04,99,20,1656,26,2,20,119
2020-11-04,178,49,5879,76,7,189,227
2020-11-04,3,0,25,1,0,2,3
2020-11-04,0,0,33,0,0,8,0
2020-11-04,2,0,59,0,0,0,2
2020-11-04,0,0,25,0,0,0,0
2020-11-04,2,0,189,2,0,8,2
2020-11-04,15,3,193,2,1,14,18
2020-11-04,3,1,84,0,1,3,4
2020-11-04,281,58,3978,77,9,95,339
2020-11-04,35,11,809,4,0,26,46
2020-11-04,4,0,351,3,0,24,4
2020-11-04,26,9,1232,12,1,34,35
2020-11-04,32,5,1007,8,2,30,37
2020-11-04,201,60,3446,57,7,67,261
2020-11-04,0,0,47,0,0,0,0
2020-11-04,36,9,683,4,0,16,45
2020-11-04,2,0,56,1,0,8,2
2020-11-04,19,9,539,7,0,15,28
2020-11-04,39,4,1479,11,2,40,43
2020-11-04,9,9,329,1,0,8,18
2020-11-04,0,0,25,0,0,0,0
2020-11-04,0,0,17,0,0,2,0
2020-11-04,2,0,265,1,0,3,2
2020-11-04,11,0,453,4,0,12,11
2020-11-04,51,2,1328,21,0,51,53
2020-11-04,8,0,96,3,0,5,8
2020-11-04,61,15,1297,15,5,20,76
2020-11-04,36,0,717,12,0,24,36
2020-11-04,1,0,29,0,0,4,1
2020-11-04,0,0,41,0,0,0,0
2020-11-04,2,0,65,1,0,1,2
2020-11-04,3,0,120,0,0,4,3
2020-11-04,63,45,2505,17,6,122,108
2020-11-05,38,1,1031,7,1,35,39
2020-11-05,4,0,351,2,0,26,4
2020-11-05,0,0,33,0,0,8,0
2020-11-05,12,0,453,1,0,16,12
2020-11-05,15,0,688,3,0,58,15
2020-11-05,2,1,181,0,1,4,3
2020-11-05,22,3,535,7,0,6,25
2020-11-05,1,0,41,0,0,0,1
2020-11-05,38,11,677,6,1,16,49
2020-11-05,0,0,51,0,0,1,0
2020-11-05,0,0,47,0,0,0,0
2020-11-05,58,15,1296,15,0,18,73
2020-11-05,1,0,77,1,0,2,1
2020-11-05,9,0,271,4,0,11,9
2020-11-05,8,0,460,2,0,25,8
2020-11-05,103,20,1687,27,3,21,123
2020-11-05,2,0,59,0,0,0,2
2020-11-05,208,58,3419,54,14,70,266
2020-11-05,54,3,1265,20,0,47,57
2020-11-05,15,0,561,3,0,5,15
2020-11-05,33,3,1911,10,1,61,36
2020-11-05,177,46,5855,72,12,199,223
2020-11-05,38,0,717,11,0,24,38
2020-11-05,0,0,17,0,0,2,0
2020-11-05,1,0,51,0,0,3,1
2020-11-05,3,0,25,1,0,2,3
2020-11-05,20,13,540,7,0,17,33
2020-11-05,840,292,20185,254,31,688,1132
2020-11-05,3,0,189,3,0,7,3
2020-11-05,286,55,6949,94,15,258,341
2020-11-05,2,0,281,0,0,6,2
2020-11-05,66,43,2509,16,5,126,109
2020-11-05,1,0,56,1,0,7,1
2020-11-05,45,0,259,16,0,0,45
2020-11-05,0,0,14,0,0,0,0
2020-11-05,4,6,352,1,0,15,10
2020-11-05,283,49,4000,77,9,94,332
2020-11-05,2,0,177,2,0,5,2
2020-11-05,2,0,265,1,0,5,2
2020-11-05,1,0,29,0,0,4,1
2020-11-05,14,0,193,2,0,15,14
2020-11-05,1,0,25,0,0,0,1
2020-11-05,0,0,48,0,0,0,0
2020-11-05,7,6,283,1,0,10,13
2020-11-05,7,0,96,3,0,6,7
2020-11-05,11,0,389,16,0,8,11
2020-11-05,0,0,35,0,0,0,0
2020-11-05,0,0,19,0,0,0,0
2020-11-05,40,19,808,6,1,23,59
2020-11-05,40,5,1498,9,0,48,45
2020-11-05,100,21,3014,25,2,68,121
2020-11-05,30,5,1240,15,2,37,35
2020-11-05,0,0,25,0,0,0,0
2020-11-05,23,12,710,6,0,32,35
2020-11-05,90,18,2505,20,3,77,108
2020-11-05,5,1,133,1,0,4,6
2020-11-06,34,12,809,5,0,21,46
2020-11-06,103,16,1683,26,0,23,119
2020-11-06,1,0,59,0,0,3,1
2020-11-06,26,1,553,8,0,8,27
2020-11-06,2,0,189,2,0,8,2
2020-11-06,284,54,6949,95,15,255,338
2020-11-06,0,0,33,0,0,7,0
2020-11-06,2,0,56,1,0,8,2
2020-11-06,66,41,2508,17,3,116,107
2020-11-06,1,0,25,0,0,0,1
2020-11-06,25,13,548,7,0,19,38
2020-11-06,15,1,561,2,0,11,16
2020-11-06,0,0,51,0,0,3,0
2020-11-06,0,1,48,0,0,0,1
2020-11-06,2,0,41,0,0,0,2
2020-11-06,0,0,35,0,0,0,0
2020-11-06,39,13,1484,10,1,43,52
2020-11-06,38,4,1937,11,1,54,42
2020-11-06,9,0,389,3,0,7,9
2020-11-06,59,3,1266,20,0,51,62
2020-11-06,2,3,281,0,0,7,5
2020-11-06,36,0,717,12,0,19,36
2020-11-06,4,1,124,0,1,5,5
2020-11-06,3,0,177,2,0,7,3
2020-11-06,5,0,96,3,0,6,5
2020-11-06,4,0,51,0,0,4,4
2020-11-06,0,0,47,0,0,0,0
2020-11-06,41,3,679,6,0,15,44
2020-11-06,12,1,688,3,0,58,13
2020-11-06,12,0,271,6,0,10,12
2020-11-06,0,0,29,0,0,4,0
2020-11-06,1,1,265,1,0,5,2
2020-11-06,6,4,354,1,0,18,10
2020-11-06,7,0,460,2,0,24,7
2020-11-06,1,0,77,1,0,2,1
2020-11-06,202,46,3392,57,12,62,248
2020-11-06,281,43,4024,76,7,107,324
2020-11-06,104,26,2522,22,4,68,130
2020-11-06,8,0,453,1,0,14,8
2020-11-06,0,0,25,0,0,0,0
2020-11-06,4,1,351,2,0,25,5
2020-11-06,2,1,181,0,1,2,3
2020-11-06,103,14,3016,26,1,72,117
2020-11-06,199,33,5909,72,3,192,232
2020-11-06,20,11,717,6,0,32,31
2020-11-06,45,0,250,15,0,2,45
2020-11-06,0,0,17,0,0,2,0
2020-11-06,33,8,1245,7,3,33,41
2020-11-06,3,0,25,1,0,2,3
2020-11-06,0,0,14,0,0,0,0
2020-11-06,7,11,310,1,0,8,18
2020-11-06,58,9,1297,14,1,16,67
2020-11-06,17,0,193,2,0,14,17
2020-11-06,0,0,19,0,0,0,0
2020-11-06,44,5,1025,10,2,26,49
2020-11-06,851,255,20230,251,39,661,1106
2020-11-07,201,23,5952,72,5,200,224
2020-11-07,110,21,1673,22,3,17,131
2020-11-07,53,4,1028,13,0,27,57
2020-11-07,36,5,1903,8,2,56,41
2020-11-07,38,16,808,5,1,29,54
2020-11-07,0,0,17,0,0,2,0
2020-11-07,1,1,265,1,0,6,2
2020-11-07,3,0,177,3,0,4,3
2020-11-07,27,2,542,8,0,5,29
2020-11-07,37,3,679,6,0,21,40
2020-11-07,2,0,189,2,0,8,2
2020-11-07,1,0,19,0,0,0,1
2020-11-07,0,0,47,0,0,0,0
2020-11-07,6,1,460,3,0,28,7
2020-11-07,4,0,59,0,0,1,4
2020-11-07,3,0,51,0,0,3,3
2020-11-07,61,1,1276,19,0,58,62
2020-11-07,39,5,1233,19,1,34,44
2020-11-07,855,278,20173,251,34,695,1133
2020-11-07,0,0,25,0,0,0,0
2020-11-07,2,0,41,0,0,0,2
2020-11-07,3,0,56,2,0,6,3
2020-11-07,2,0,267,0,0,6,2
2020-11-07,4,0,96,3,0,6,4
2020-11-07,1,0,77,1,0,3,1
2020-11-07,9,0,688,2,0,46,9
2020-11-07,10,1,453,2,1,15,11
2020-11-07,61,6,1297,12,1,20,67
2020-11-07,0,0,14,0,0,0,0
2020-11-07,47,0,250,14,0,0,47
2020-11-07,0,0,51,0,0,3,0
2020-11-07,3,0,25,1,0,2,3
2020-11-07,0,0,29,0,0,4,0
2020-11-07,20,5,701,5,1,37,25
2020-11-07,38,12,1482,8,0,52,50
2020-11-07,6,13,310,1,0,8,19
2020-11-07,3,1,181,0,0,2,4
2020-11-07,10,0,271,5,0,11,10
2020-11-07,297,57,6955,92,14,252,354
2020-11-07,105,19,3020,26,1,69,124
2020-11-07,0,1,48,0,0,0,1
2020-11-07,120,24,2579,27,4,71,144
2020-11-07,17,1,561,2,0,6,18
2020-11-07,69,37,2479,18,5,106,106
2020-11-07,28,12,559,8,1,19,40
2020-11-07,0,0,35,0,0,0,0
2020-11-07,7,2,389,3,0,6,9
2020-11-07,4,1,124,0,1,3,5
2020-11-07,6,7,359,2,1,17,13
2020-11-07,16,0,193,2,0,13,16
2020-11-07,0,0,33,0,0,4,0
2020-11-07,33,0,717,10,0,22,33
2020-11-07,274,38,3983,69,9,119,312
2020-11-07,223,55,3387,62,14,65,278
2020-11-07,6,0,200,2,0,13,6
2020-11-07,1,0,25,0,0,0,1
2020-11-08,28,11,491,8,2,21,39
2020-11-08,2,1,270,0,0,4,3
2020-11-08,2,0,56,0,0,7,2
2020-11-08,4,0,177,2,0,6,4
2020-11-08,29,3,547,9,0,5,32
2020-11-08,14,0,193,2,0,15,14
2020-11-08,3,0,25,1,0,2,3
2020-11-08,4,0,265,2,0,8,4
2020-11-08,7,1,200,2,0,11,8
2020-11-08,1,0,25,0,0,0,1
2020-11-08,0,0,35,0,0,0,0
2020-11-08,19,1,561,3,0,6,20
2020-11-08,1,0,51,0,0,1,1
2020-11-08,0,0,25,0,0,0,0
2020-11-08,1,0,19,0,0,0,1
2020-11-08,0,0,47,0,0,0,0
2020-11-08,11,0,271,5,0,12,11
2020-11-08,40,2,1855,10,1,65,42
2020-11-08,32,0,717,9,0,24,32
2020-11-08,64,12,1275,16,1,21,76
2020-11-08,109,21,1668,26,1,-4,130
2020-11-08,1,0,77,1,0,1,1
2020-11-08,3,2,51,0,1,4,5
2020-11-08,10,0,453,1,0,11,10
2020-11-08,0,0,29,0,0,3,0
2020-11-08,0,0,48,0,0,0,0
2020-11-08,205,28,5875,76,7,193,233
2020-11-08,5,6,354,2,0,17,11
2020-11-08,4,0,59,0,0,1,4
2020-11-08,9,0,389,3,0,6,9
2020-11-08,69,48,2439,21,7,120,117
2020-11-08,5,7,310,1,1,8,12
2020-11-08,42,14,806,7,2,23,56
2020-11-08,50,0,250,15,0,0,50
2020-11-08,0,0,14,0,0,0,0
2020-11-08,0,0,33,0,0,4,0
2020-11-08,1,3,181,0,1,3,4
2020-11-08,228,58,3341,64,13,67,286
2020-11-08,10,0,688,3,0,50,10
2020-11-08,6,2,460,3,1,26,8
2020-11-08,289,37,3994,73,7,94,326
2020-11-08,2,0,41,0,0,0,2
2020-11-08,61,1,1269,19,0,50,62
2020-11-08,0,0,17,0,0,2,0
2020-11-08,55,1,1023,14,0,25,56
2020-11-08,136,22,2561,27,5,74,158
2020-11-08,46,17,1493,13,0,53,63
2020-11-08,111,27,2989,28,2,81,138
2020-11-08,4,0,96,3,0,4,4
2020-11-08,888,264,20059,250,33,769,1152
2020-11-08,40,8,1225,18,3,40,48
2020-11-08,20,7,695,4,0,38,27
2020-11-08,287,55,6948,91,13,265,342
2020-11-08,38,8,679,5,1,23,46
2020-11-08,2,0,189,2,0,5,2
2020-11-08,3,0,124,0,0,7,3
2020-11-09,2,0,41,0,0,0,2
2020-11-09,224,52,5797,79,14,200,276
2020-11-09,9,0,271,5,0,5,9
2020-11-09,110,24,2979,25,2,80,134
2020-11-09,1,0,19,0,0,0,1
2020-11-09,2,2,51,0,0,4,4
2020-11-09,12,0,453,0,0,13,12
2020-11-09,3,0,265,2,0,11,3
2020-11-09,4,0,96,1,0,2,4
2020-11-09,244,43,3392,70,11,95,287
2020-11-09,18,0,193,4,0,16,18
2020-11-09,22,2,544,5,0,4,24
2020-11-09,19,7,699,3,0,39,26
2020-11-09,4,1,189,4,1,5,5
2020-11-09,1,0,0,1,0,3,1
2020-11-09,55,4,1022,13,0,26,59
2020-11-09,0,0,29,0,0,4,0
2020-11-09,45,12,1485,14,2,44,57
2020-11-09,49,0,251,16,0,2,49
2020-11-09,8,0,389,3,0,7,8
2020-11-09,0,0,17,0,0,2,0
2020-11-09,24,2,561,3,0,3,26
2020-11-09,7,4,329,1,0,7,11
2020-11-09,65,2,1267,17,0,57,67
2020-11-09,112,24,1682,30,2,26,136
2020-11-09,63,45,2429,18,7,113,108
2020-11-09,8,0,351,3,0,23,8
2020-11-09,11,0,688,2,0,57,11
2020-11-09,299,53,6950,95,12,283,352
2020-11-09,5,0,116,1,0,1,5
2020-11-09,0,0,51,0,0,0,0
2020-11-09,0,0,47,0,0,0,0
2020-11-09,148,31,2567,28,5,80,179
2020-11-09,7,2,355,3,1,11,9
2020-11-09,0,0,48,0,0,0,0
2020-11-09,284,47,4001,79,5,93,331
2020-11-09,0,0,14,0,0,0,0
2020-11-09,33,0,717,10,0,24,33
2020-11-09,903,306,20064,249,48,778,1209
2020-11-09,0,0,25,0,0,0,0
2020-11-09,36,3,1856,11,1,68,39
2020-11-09,4,0,56,0,0,8,4
2020-11-09,38,8,679,5,1,26,46
2020-11-09,1,0,25,0,0,0,1
2020-11-09,41,9,1217,18,6,38,50
2020-11-09,44,9,806,6,3,28,53
2020-11-09,3,0,59,0,0,2,3
2020-11-09,0,0,33,0,0,3,0
2020-11-09,4,0,177,4,0,6,4
2020-11-09,0,0,35,0,0,0,0
2020-11-09,62,9,1269,15,2,19,71
2020-11-09,33,12,550,10,2,18,45
2020-11-09,2,3,258,0,0,6,5
2020-11-09,5,0,181,1,0,3,5
2020-11-09,1,0,77,1,0,2,1
2020-11-09,8,0,460,4,0,25,8
2020-11-10,2,0,78,2,0,1,2
2020-11-10,35,11,1238,11,1,40,46
2020-11-10,0,0,25,0,0,0,0
2020-11-10,18,0,193,4,0,16,18
2020-11-10,14,0,688,2,0,54,14
2020-11-10,49,10,803,6,3,28,59
2020-11-10,2,0,41,0,0,0,2
2020-11-10,22,11,725,2,1,33,33
2020-11-10,0,0,14,0,0,0,0
2020-11-10,158,25,2574,35,4,69,183
2020-11-10,8,9,329,2,0,7,17
2020-11-10,1,0,25,1,0,2,1
2020-11-10,31,0,561,4,0,3,31
2020-11-10,4,0,189,4,0,4,4
2020-11-10,121,24,1707,28,2,13,145
2020-11-10,5,0,133,1,0,1,5
2020-11-10,4,0,181,1,0,2,4
2020-11-10,1,0,48,0,0,0,1
2020-11-10,0,0,33,0,0,4,0
2020-11-10,14,0,272,6,0,5,14
2020-11-10,5,0,59,0,0,3,5
2020-11-10,35,4,1876,8,1,69,39
2020-11-10,953,317,20118,266,49,683,1270
2020-11-10,12,7,360,3,0,11,19
2020-11-10,244,40,5964,83,6,193,284
2020-11-10,4,0,56,1,0,6,4
2020-11-10,30,12,563,11,2,15,42
2020-11-10,109,26,3044,28,6,52,135
2020-11-10,0,0,25,0,0,0,0
2020-11-10,263,44,3450,70,9,102,307
2020-11-10,0,0,17,0,0,2,0
2020-11-10,294,61,6945,97,10,258,355
2020-11-10,45,14,1504,15,4,46,59
2020-11-10,1,0,19,0,0,0,1
2020-11-10,38,0,717,9,0,23,38
2020-11-10,4,0,177,4,0,6,4
2020-11-10,9,0,389,3,0,8,9
2020-11-10,42,8,679,4,1,24,50
2020-11-10,0,0,35,0,0,0,0
2020-11-10,0,0,47,0,0,0,0
2020-11-10,3,0,96,2,0,4,3
2020-11-10,51,0,266,16,0,2,51
2020-11-10,56,1,1266,15,0,64,57
2020-11-10,0,0,51,0,0,1,0
2020-11-10,286,63,4013,79,5,105,349
2020-11-10,21,10,562,5,1,5,31
2020-11-10,2,1,262,0,0,6,3
2020-11-10,3,0,51,0,0,3,3
2020-11-10,64,9,1288,18,2,9,73
2020-11-10,0,0,29,0,0,4,0
2020-11-10,3,0,265,2,0,10,3
2020-11-10,6,0,460,3,0,28,6
2020-11-10,70,51,2471,20,10,107,121
2020-11-10,13,0,453,1,0,5,13
2020-11-10,62,5,1030,15,0,24,67
2020-11-10,7,0,351,2,0,14,7
2020-11-11,7,0,177,5,0,4,7
2020-11-11,13,3,369,2,0,10,16
2020-11-11,942,323,20217,266,49,648,1265
2020-11-11,0,0,14,0,0,0,0
2020-11-11,17,0,272,9,0,7,17
2020-11-11,75,36,2453,19,6,96,111
2020-11-11,3,0,51,0,0,3,3
2020-11-11,37,6,1236,12,0,43,43
2020-11-11,1,0,25,1,0,3,1
2020-11-11,153,20,2470,34,3,104,173
2020-11-11,19,0,193,3,0,15,19
2020-11-11,6,0,181,1,0,2,6
2020-11-11,66,12,1295,16,3,15,78
2020-11-11,1,0,41,0,0,0,1
2020-11-11,303,41,6946,94,6,252,344
2020-11-11,106,15,3069,29,0,54,121
2020-11-11,7,0,460,3,0,28,7
2020-11-11,2,0,48,0,0,0,2
2020-11-11,0,0,33,0,0,4,0
2020-11-11,6,0,265,2,0,6,6
2020-11-11,123,16,1700,33,1,11,139
2020-11-11,9,0,351,2,0,26,9
2020-11-11,2,0,78,2,0,1,2
2020-11-11,59,9,1276,16,0,51,68
2020-11-11,271,52,3439,67,8,65,323
2020-11-11,43,6,679,4,0,18,49
2020-11-11,0,0,25,0,0,0,0
2020-11-11,36,7,1904,9,0,59,43
2020-11-11,30,14,563,10,2,15,44
2020-11-11,0,0,17,0,0,2,0
2020-11-11,21,10,738,2,1,37,31
2020-11-11,50,10,797,8,5,21,60
2020-11-11,4,0,56,1,0,6,4
2020-11-11,0,0,29,0,0,4,0
2020-11-11,0,0,35,0,0,0,0
2020-11-11,28,1,561,6,1,2,29
2020-11-11,12,0,389,4,0,7,12
2020-11-11,5,0,96,3,0,3,5
2020-11-11,12,0,688,2,0,57,12
2020-11-11,1,0,19,0,0,0,1
2020-11-11,0,0,47,0,0,0,0
2020-11-11,251,43,5921,89,6,192,294
2020-11-11,2,2,276,0,1,2,4
2020-11-11,0,0,51,0,0,2,0
2020-11-11,5,1,189,5,1,8,6
2020-11-11,21,2,585,5,0,6,23
2020-11-11,302,50,4067,84,2,107,352
2020-11-11,44,0,717,9,0,20,44
2020-11-11,69,4,1034,16,0,25,73
2020-11-11,4,0,142,1,0,3,4
2020-11-11,53,0,266,17,0,2,53
2020-11-11,50,8,1564,19,2,40,58
2020-11-11,8,11,329,2,0,16,19
2020-11-11,16,0,453,1,0,8,16
2020-11-11,0,0,25,0,0,0,0
2020-11-11,5,0,59,0,0,2,5
2020-11-12,62,2,1039,17,1,30,64
2020-11-12,966,314,20215,269,52,661,1280
2020-11-12,115,20,3045,29,1,72,135
2020-11-12,302,35,6943,98,7,244,337
2020-11-12,2,0,25,0,0,0,2
2020-11-12,0,0,35,0,0,0,0
2020-11-12,36,9,1235,12,1,41,45
2020-11-12,36,14,566,13,3,10,50
2020-11-12,18,9,581,5,0,4,27
2020-11-12,244,45,5916,95,6,193,289
2020-11-12,63,8,1287,13,0,54,71
2020-11-12,7,0,460,2,0,27,7
2020-11-12,3,0,25,3,0,0,3
2020-11-12,16,0,453,0,0,7,16
2020-11-12,11,6,365,2,0,7,17
2020-11-12,60,0,266,20,0,0,60
2020-11-12,0,0,47,0,0,0,0
2020-11-12,16,1,389,4,0,7,17
2020-11-12,4,0,189,4,0,7,4
2020-11-12,0,0,19,0,0,0,0
2020-11-12,0,0,14,0,0,0,0
2020-11-12,1,0,26,1,0,1,1
2020-11-12,11,14,329,2,0,16,25
2020-11-12,177,23,2561,41,2,64,200
2020-11-12,28,1,561,8,0,3,29
2020-11-12,0,0,17,0,0,2,0
2020-11-12,2,0,77,2,0,1,2
2020-11-12,20,0,193,3,0,13,20
2020-11-12,4,0,51,0,0,5,4
2020-11-12,120,19,1672,28,1,15,139
2020-11-12,13,2,688,4,0,58,15
2020-11-12,23,9,737,3,1,38,32
2020-11-12,3,4,279,1,1,2,7
2020-11-12,7,0,265,2,0,5,7
2020-11-12,0,0,29,0,0,3,0
2020-11-12,0,0,33,0,0,4,0
2020-11-12,286,57,3476,65,6,64,343
2020-11-12,43,2,717,8,0,18,45
2020-11-12,70,39,2434,20,5,102,109
2020-11-12,1,0,41,0,0,0,1
2020-11-12,9,0,97,3,0,7,9
2020-11-12,9,0,351,2,0,27,9
2020-11-12,0,0,51,0,0,2,0
2020-11-12,3,1,48,0,0,0,4
2020-11-12,0,0,25,0,0,0,0
2020-11-12,4,0,126,1,0,2,4
2020-11-12,40,7,679,3,0,18,47
2020-11-12,46,10,797,6,1,24,56
2020-11-12,74,15,1297,16,4,21,89
2020-11-12,50,7,1551,19,0,32,57
2020-11-12,7,0,59,2,0,3,7
2020-11-12,7,0,177,3,0,6,7
2020-11-12,7,0,181,0,0,4,7
2020-11-12,318,58,4102,86,7,93,376
2020-11-12,38,8,1851,10,1,62,46
2020-11-12,17,0,271,6,0,7,17
2020-11-13,1,0,33,1,0,4,1
2020-11-13,0,0,17,0,0,2,0
2020-11-13,0,0,47,0,0,0,0
2020-11-13,0,0,25,0,0,0,0
2020-11-13,17,0,271,6,0,7,17
2020-11-13,44,9,801,5,1,22,53
2020-11-13,8,0,351,1,0,28,8
2020-11-13,44,7,679,3,0,21,51
2020-11-13,4,0,189,4,0,6,4
2020-11-13,0,0,52,0,0,0,0
2020-11-13,36,7,1908,9,0,65,43
2020-11-13,36,11,1248,15,2,28,47
2020-11-13,44,2,717,8,0,23,46
2020-11-13,10,5,363,2,1,12,15
2020-11-13,0,0,19,0,0,0,0
2020-11-13,0,0,25,0,0,0,0
2020-11-13,19,1,453,1,1,10,20
2020-11-13,13,3,688,5,0,53,16
2020-11-13,4,1,51,0,0,6,5
2020-11-13,334,54,4089,83,8,95,388
2020-11-13,7,0,265,2,0,4,7
2020-11-13,1,0,29,1,0,3,1
2020-11-13,3,4,281,1,2,3,7
2020-11-13,26,0,193,3,0,13,26
2020-11-13,9,0,84,0,0,2,9
2020-11-13,4,0,126,1,0,2,4
2020-11-13,131,16,1657,32,2,22,147
2020-11-13,2,0,25,1,0,0,2
2020-11-13,46,10,1543,17,2,37,56
2020-11-13,172,18,2546,42,3,64,190
2020-11-13,68,6,1035,17,1,32,74
2020-11-13,235,37,5924,90,3,188,272
2020-11-13,63,3,1287,15,0,53,66
2020-11-13,1014,282,20222,276,24,658,1296
2020-11-13,19,6,734,4,0,34,25
2020-11-13,314,50,3461,73,4,56,364
2020-11-13,298,51,6941,99,4,255,349
2020-11-13,0,0,35,0,0,0,0
2020-11-13,41,12,577,12,0,10,53
2020-11-13,20,5,576,5,1,4,25
2020-11-13,3,1,48,0,0,0,4
2020-11-13,0,0,14,0,0,0,0
2020-11-13,27,1,561,8,0,3,28
2020-11-13,5,0,177,1,0,7,5
2020-11-13,63,0,266,18,0,3,63
2020-11-13,0,0,41,0,0,0,0
2020-11-13,84,16,1291,21,3,21,100
2020-11-13,7,0,59,2,0,3,7
2020-11-13,131,12,3063,36,1,66,143
2020-11-13,74,38,2458,20,6,98,112
2020-11-13,7,2,460,1,0,27,9
2020-11-13,2,1,77,2,0,1,3
2020-11-13,17,1,389,4,0,4,18
2020-11-13,10,0,96,3,0,6,10
2020-11-13,10,9,329,2,0,18,19
2020-11-13,4,0,25,3,0,0,4
2020-11-14,2,1,77,2,0,1,3
2020-11-14,0,0,25,0,0,0,0
2020-11-14,72,9,1030,17,0,29,81
2020-11-14,0,0,19,0,0,0,0
2020-11-14,4,0,189,4,0,6,4
2020-11-14,23,6,734,5,0,38,29
2020-11-14,19,0,389,3,0,3,19
2020-11-14,14,0,96,5,0,4,14
2020-11-14,15,4,688,5,0,60,19
2020-11-14,93,13,1284,19,2,24,106
2020-11-14,0,0,41,0,0,0,0
2020-11-14,22,22,561,6,1,8,44
2020-11-14,51,1,717,9,0,22,52
2020-11-14,170,23,2566,46,4,67,193
2020-11-14,3,3,281,1,2,4,6
2020-11-14,146,21,1673,33,1,17,167
2020-11-14,28,0,193,3,0,12,28
2020-11-14,4,1,126,2,0,4,5
2020-11-14,62,0,266,17,0,3,62
2020-11-14,38,8,554,11,0,7,46
2020-11-14,50,12,794,5,0,24,62
2020-11-14,12,0,84,1,0,2,12
2020-11-14,21,0,453,1,0,13,21
2020-11-14,4,2,48,0,0,0,6
2020-11-14,0,0,52,0,0,1,0
2020-11-14,10,6,329,2,0,19,16
2020-11-14,70,3,1269,14,0,47,73
2020-11-14,8,0,351,1,0,26,8
2020-11-14,362,57,4084,83,10,92,419
2020-11-14,0,0,17,0,0,2,0
2020-11-14,69,36,2483,19,6,100,105
2020-11-14,1049,346,20221,298,38,690,1395
2020-11-14,0,0,35,0,0,0,0
2020-11-14,13,0,271,4,0,11,13
2020-11-14,4,0,177,0,0,5,4
2020-11-14,8,2,460,1,2,25,10
2020-11-14,19,3,534,6,0,3,22
2020-11-14,54,6,675,6,0,21,60
2020-11-14,2,1,51,0,0,6,3
2020-11-14,0,0,29,0,0,3,0
2020-11-14,38,6,1241,20,0,35,44
2020-11-14,7,0,56,3,0,8,7
2020-11-14,242,44,5900,90,4,173,286
2020-11-14,310,58,3370,78,11,57,368
2020-11-14,45,12,1526,16,1,38,57
2020-11-14,1,0,25,1,0,2,1
2020-11-14,135,12,3032,38,2,72,147
2020-11-14,9,4,358,3,0,17,13
2020-11-14,0,0,25,0,0,0,0
2020-11-14,9,1,265,2,1,6,10
2020-11-14,0,0,14,0,0,0,0
2020-11-14,0,0,47,0,0,0,0
2020-11-14,317,46,6931,107,7,262,363
2020-11-14,38,2,1890,10,1,68,40
2020-11-14,9,0,59,2,0,1,9
2020-11-14,2,0,33,2,0,4,2
2020-11-15,7,0,351,2,0,25,7
2020-11-15,3,1,275,1,0,4,4
2020-11-15,53,13,794,6,1,20,66
2020-11-15,76,7,1005,19,1,28,83
2020-11-15,8,0,59,3,0,4,8
2020-11-15,4,1,118,2,0,3,5
2020-11-15,0,0,14,0,0,0,0
2020-11-15,10,0,460,1,0,34,10
2020-11-15,0,0,35,0,0,0,0
2020-11-15,317,53,6918,106,10,273,370
2020-11-15,54,5,675,6,0,26,59
2020-11-15,0,0,51,0,0,0,0
2020-11-15,2,0,77,2,0,2,2
2020-11-15,6,0,84,0,0,2,6
2020-11-15,40,5,1238,22,0,37,45
2020-11-15,18,2,551,6,2,4,20
2020-11-15,14,0,389,3,0,2,14
2020-11-15,94,14,1284,18,2,26,108
2020-11-15,2,0,25,1,0,1,2
2020-11-15,18,6,735,5,0,39,24
2020-11-15,7,0,56,3,0,7,7
2020-11-15,41,8,554,12,0,6,49
2020-11-15,15,0,96,6,0,4,15
2020-11-15,257,45,5853,85,3,192,302
2020-11-15,378,64,4083,88,12,109,442
2020-11-15,3,0,189,3,0,6,3
2020-11-15,0,0,47,0,0,0,0
2020-11-15,0,0,29,0,0,3,0
2020-11-15,150,8,3016,42,0,70,158
2020-11-15,3,2,48,0,0,0,5
2020-11-15,71,39,2483,22,5,107,110
2020-11-15,26,0,561,3,0,8,26
2020-11-15,0,0,25,0,0,0,0
2020-11-15,9,4,358,3,0,17,13
2020-11-15,1126,277,20107,308,43,654,1403
2020-11-15,39,3,1841,9,1,70,42
2020-11-15,2,0,33,2,0,5,2
2020-11-15,51,1,717,10,0,22,52
2020-11-15,172,20,2561,48,4,82,192
2020-11-15,0,1,41,0,0,0,1
2020-11-15,11,13,329,3,0,15,24
2020-11-15,1,0,19,0,0,0,1
2020-11-15,320,68,3372,74,12,46,388
2020-11-15,48,19,1526,16,2,40,67
2020-11-15,11,0,265,3,0,9,11
2020-11-15,21,0,453,2,0,13,21
2020-11-15,2,0,25,0,0,0,2
2020-11-15,155,12,1662,35,2,10,167
2020-11-15,28,1,193,4,0,13,29
2020-11-15,62,0,266,20,0,0,62
2020-11-15,5,1,177,1,0,4,6
2020-11-15,80,9,1266,17,0,51,89
2020-11-15,0,0,17,0,0,1,0
2020-11-15,13,0,271,5,0,11,13
2020-11-15,2,0,51,0,0,5,2
2020-11-15,17,5,688,4,0,55,22
2020-11-16,23,0,453,1,0,16,23
2020-11-16,14,0,96,8,0,2,14
2020-11-16,1,0,77,1,0,2,1
2020-11-16,102,20,1272,17,1,17,122
2020-11-16,0,0,17,0,0,2,0
2020-11-16,15,0,265,3,0,7,15
2020-11-16,19,5,688,3,0,62,24
2020-11-16,78,8,1005,18,1,30,86
2020-11-16,270,73,5829,79,13,204,343
2020-11-16,2,0,33,2,0,5,2
2020-11-16,5,0,189,5,0,5,5
2020-11-16,7,0,460,1,0,32,7
2020-11-16,151,21,1660,35,3,21,172
2020-11-16,1,0,25,0,0,0,1
2020-11-16,43,1,717,8,0,25,44
2020-11-16,2,0,25,1,0,0,2
2020-11-16,0,0,25,0,0,0,0
2020-11-16,11,5,329,3,1,14,16
2020-11-16,6,0,56,2,0,9,6
2020-11-16,338,59,3452,81,10,51,397
2020-11-16,153,9,2997,43,1,76,162
2020-11-16,41,8,558,12,1,7,49
2020-11-16,89,28,2438,24,3,110,117
2020-11-16,6,1,177,2,0,3,7
2020-11-16,345,57,6920,112,10,287,402
2020-11-16,411,69,4078,102,9,111,480
2020-11-16,2,5,274,1,2,3,7
2020-11-16,20,0,271,7,0,9,20
2020-11-16,68,18,793,9,3,22,86
2020-11-16,6,0,84,0,0,3,6
2020-11-16,49,5,1227,23,2,33,54
2020-11-16,0,0,51,0,0,3,0
2020-11-16,3,0,51,0,0,6,3
2020-11-16,22,5,708,6,0,40,27
2020-11-16,1188,286,20078,323,47,700,1474
2020-11-16,0,0,29,0,0,3,0
2020-11-16,63,21,1506,25,2,36,84
2020-11-16,86,11,1276,19,0,46,97
2020-11-16,60,6,683,6,0,29,66
2020-11-16,0,0,47,0,0,0,0
2020-11-16,38,6,1835,8,2,86,44
2020-11-16,33,1,193,4,0,12,34
2020-11-16,0,0,41,0,0,0,0
2020-11-16,12,2,360,3,0,14,14
2020-11-16,26,0,561,4,0,4,26
2020-11-16,4,0,133,2,0,0,4
2020-11-16,4,1,48,0,0,0,5
2020-11-16,7,0,351,2,0,25,7
2020-11-16,0,0,35,0,0,0,0
2020-11-16,14,0,389,4,0,4,14
2020-11-16,1,0,19,0,0,0,1
2020-11-16,0,0,14,0,0,0,0
2020-11-16,7,0,59,2,0,2,7
2020-11-16,64,2,265,19,0,1,66
2020-11-16,17,5,548,8,1,4,22
2020-11-16,191,29,2518,48,8,83,220
2020-11-17,20,0,265,4,0,5,20
2020-11-17,208,20,2585,47,6,61,228
2020-11-17,291,71,5937,90,10,171,362
2020-11-17,0,0,25,0,0,0,0
2020-11-17,7,0,59,3,0,2,7
2020-11-17,7,1,129,2,0,2,8
2020-11-17,1,0,33,1,0,5,1
2020-11-17,417,67,4095,107,12,96,484
2020-11-17,48,11,579,14,2,5,59
2020-11-17,50,8,1234,22,4,29,58
2020-11-17,13,2,361,3,0,16,15
2020-11-17,3,3,272,1,1,1,6
2020-11-17,19,0,271,9,0,6,19
2020-11-17,162,22,1676,33,3,15,184
2020-11-17,74,21,795,8,3,22,95
2020-11-17,23,0,453,2,0,12,23
2020-11-17,0,1,41,0,0,0,1
2020-11-17,2,0,25,1,0,0,2
2020-11-17,2,0,51,0,0,5,2
2020-11-17,26,0,561,4,0,7,26
2020-11-17,5,2,189,5,2,5,7
2020-11-17,1,0,77,1,0,3,1
2020-11-17,78,4,1006,18,2,26,82
2020-11-17,350,59,3469,86,12,46,409
2020-11-17,101,23,1288,14,2,19,124
2020-11-17,5,0,56,2,0,9,5
2020-11-17,20,0,688,3,0,60,20
2020-11-17,4,0,48,0,0,0,4
2020-11-17,0,0,52,0,0,2,0
2020-11-17,95,24,2474,22,4,99,119
2020-11-17,0,0,14,0,0,0,0
2020-11-17,62,1,265,19,0,1,63
2020-11-17,21,2,572,9,0,5,23
2020-11-17,37,11,1898,11,3,63,48
2020-11-17,0,0,25,0,0,0,0
2020-11-17,55,3,679,9,0,23,58
2020-11-17,87,9,1305,19,0,45,96
2020-11-17,163,16,3044,42,1,65,179
2020-11-17,367,51,6939,118,11,254,418
2020-11-17,1238,304,20249,349,31,607,1542
2020-11-17,7,0,84,2,0,1,7
2020-11-17,26,9,711,7,1,33,35
2020-11-17,1,0,17,0,0,2,1
2020-11-17,48,0,717,10,0,17,48
2020-11-17,14,0,96,7,0,2,14
2020-11-17,10,13,329,3,0,13,23
2020-11-17,3,0,177,3,0,2,3
2020-11-17,10,2,460,1,0,27,12
2020-11-17,0,0,29,0,0,4,0
2020-11-17,0,0,19,0,0,0,0
2020-11-17,5,0,351,1,0,24,5
2020-11-17,39,0,193,5,0,11,39
2020-11-17,0,0,47,0,0,0,0
2020-11-17,67,8,1536,25,0,42,75
2020-11-17,17,1,389,6,0,3,18
2020-11-17,0,0,35,0,0,0,0
2020-11-18,369,65,6942,117,9,247,434
2020-11-18,167,17,3059,48,0,53,184
2020-11-18,0,0,51,0,0,4,0
2020-11-18,10,0,59,3,0,0,10
2020-11-18,0,0,47,0,0,0,0
2020-11-18,362,65,3484,85,6,40,427
2020-11-18,103,30,2501,21,4,94,133
2020-11-18,48,0,717,9,0,17,48
2020-11-18,439,57,4093,119,8,89,496
2020-11-18,20,1,389,6,0,1,21
2020-11-18,12,0,460,2,0,22,12
2020-11-18,0,0,25,0,0,0,0
2020-11-18,5,0,351,1,0,26,5
2020-11-18,8,0,134,2,0,2,8
2020-11-18,67,3,265,19,0,2,70
2020-11-18,83,5,1033,20,1,33,88
2020-11-18,23,4,603,7,0,6,27
2020-11-18,1,0,25,0,0,0,1
2020-11-18,0,1,35,0,0,0,1
2020-11-18,50,7,1257,24,3,30,57
2020-11-18,4,0,48,0,0,0,4
2020-11-18,8,1,189,4,0,7,9
2020-11-18,81,27,804,11,1,25,108
2020-11-18,111,15,1295,15,1,22,126
2020-11-18,0,0,41,0,0,0,0
2020-11-18,57,6,679,7,1,23,63
2020-11-18,7,2,368,3,0,14,9
2020-11-18,8,0,84,2,0,1,8
2020-11-18,27,6,712,8,0,29,33
2020-11-18,227,22,2595,54,5,65,249
2020-11-18,0,0,19,0,0,0,0
2020-11-18,1298,330,20283,344,40,585,1628
2020-11-18,1,0,33,1,0,4,1
2020-11-18,22,0,271,7,0,11,22
2020-11-18,1,0,17,0,0,2,1
2020-11-18,12,9,329,3,0,17,21
2020-11-18,2,0,25,1,0,1,2
2020-11-18,67,16,1535,24,3,31,83
2020-11-18,170,19,1699,28,1,19,189
2020-11-18,0,0,14,0,0,0,0
2020-11-18,39,8,1933,10,2,52,47
2020-11-18,2,0,77,2,0,1,2
2020-11-18,22,0,453,2,0,12,22
2020-11-18,3,3,271,0,1,2,6
2020-11-18,12,0,96,7,0,2,12
2020-11-18,53,12,588,10,2,15,65
2020-11-18,304,55,5953,83,9,182,359
2020-11-18,5,0,177,5,0,6,5
2020-11-18,20,2,688,3,0,59,22
2020-11-18,95,7,1315,21,0,41,102
2020-11-18,22,0,265,4,0,6,22
2020-11-18,29,0,561,6,0,2,29
2020-11-18,40,0,193,5,0,11,40
2020-11-18,0,0,29,0,0,4,0
2020-11-18,1,1,51,0,1,2,2
2020-11-18,6,0,56,2,0,7,6
2020-11-19,458,54,4100,126,5,91,512
2020-11-19,9,1,460,1,0,23,10
2020-11-19,2,0,77,2,0,2,2
2020-11-19,48,0,717,9,0,21,48
2020-11-19,4,0,56,2,0,9,4
2020-11-19,54,1,1234,26,2,29,55
2020-11-19,22,1,389,8,0,1,23
2020-11-19,17,3,688,4,0,68,20
2020-11-19,0,0,52,0,0,3,0
2020-11-19,51,8,679,7,1,18,59
2020-11-19,86,23,808,12,1,25,109
2020-11-19,45,0,193,6,0,11,45
2020-11-19,178,18,3064,50,0,51,196
2020-11-19,12,1,119,4,0,2,13
2020-11-19,2,0,51,0,0,5,2
2020-11-19,1,0,25,1,0,1,1
2020-11-19,25,7,729,7,1,28,32
2020-11-19,0,0,19,0,0,0,0
2020-11-19,0,0,25,0,0,0,0
2020-11-19,101,8,1310,22,0,46,109
2020-11-19,333,41,5908,102,4,175,374
2020-11-19,68,12,1523,26,1,38,80
2020-11-19,26,5,591,8,1,6,31
2020-11-19,38,1,561,7,0,1,39
2020-11-19,24,1,453,3,0,14,25
2020-11-19,393,54,6939,118,12,238,447
2020-11-19,1391,304,20341,368,36,584,1695
2020-11-19,4,0,48,0,0,0,4
2020-11-19,1,0,25,0,0,0,1
2020-11-19,7,0,351,1,0,28,7
2020-11-19,0,0,41,0,0,0,0
2020-11-19,30,1,272,9,0,9,31
2020-11-19,5,0,177,5,0,4,5
2020-11-19,3,3,267,0,0,5,6
2020-11-19,112,7,1292,17,1,16,119
2020-11-19,22,0,265,5,0,6,22
2020-11-19,11,0,59,4,0,0,11
2020-11-19,8,0,189,4,0,10,8
2020-11-19,54,10,609,10,1,18,64
2020-11-19,13,0,96,7,0,0,13
2020-11-19,0,0,35,0,0,0,0
2020-11-19,42,4,1942,11,4,53,46
2020-11-19,8,0,84,2,0,1,8
2020-11-19,375,65,3478,99,7,38,440
2020-11-19,0,0,47,0,0,0,0
2020-11-19,12,9,329,4,0,12,21
2020-11-19,84,6,1036,22,2,22,90
2020-11-19,104,30,2506,23,5,88,134
2020-11-19,231,28,2596,50,4,64,259
2020-11-19,0,0,17,0,0,2,0
2020-11-19,7,2,364,3,0,20,9
2020-11-19,61,5,265,20,0,0,66
2020-11-19,1,0,29,1,0,2,1
2020-11-19,1,0,33,1,0,5,1
2020-11-19,171,29,1718,23,4,25,200
2020-11-19,0,0,14,0,0,0,0
2020-11-20,1,0,29,1,0,2,1
2020-11-20,88,21,806,9,3,21,109
2020-11-20,109,2,1301,20,0,42,111
2020-11-20,58,8,679,7,0,21,66
2020-11-20,411,51,6792,121,5,243,462
2020-11-20,47,0,193,6,0,11,47
2020-11-20,14,11,329,5,0,5,25
2020-11-20,14,0,96,7,0,1,14
2020-11-20,0,0,25,0,0,0,0
2020-11-20,0,0,17,0,0,1,0
2020-11-20,97,8,1034,24,3,30,105
2020-11-20,24,2,387,8,1,1,26
2020-11-20,24,7,575,6,3,5,31
2020-11-20,0,0,19,0,0,0,0
2020-11-20,239,27,2572,47,6,77,266
2020-11-20,5,2,48,0,0,0,7
2020-11-20,0,0,47,0,0,0,0
2020-11-20,59,5,265,18,0,0,64
2020-11-20,0,0,41,0,0,0,0
2020-11-20,24,0,265,6,0,2,24
2020-11-20,21,3,688,6,1,45,24
2020-11-20,1401,317,20307,363,45,614,1718
2020-11-20,1,0,25,0,0,0,1
2020-11-20,6,2,354,3,1,20,8
2020-11-20,2,0,77,2,0,1,2
2020-11-20,385,55,3439,98,6,51,440
2020-11-20,190,27,1698,30,2,20,217
2020-11-20,71,11,1548,22,0,37,82
2020-11-20,65,7,1237,29,3,13,72
2020-11-20,1,0,25,1,0,0,1
2020-11-20,3,1,277,0,0,0,4
2020-11-20,10,2,460,2,0,25,12
2020-11-20,57,8,585,11,0,13,65
2020-11-20,29,0,272,9,0,5,29
2020-11-20,0,0,33,0,0,3,0
2020-11-20,184,13,3054,50,1,56,197
2020-11-20,0,0,35,0,0,0,0
2020-11-20,5,0,177,5,0,5,5
2020-11-20,8,0,189,4,0,6,8
2020-11-20,127,16,1294,18,1,14,143
2020-11-20,97,31,2507,25,5,89,128
2020-11-20,5,0,56,2,0,9,5
2020-11-20,0,0,51,0,0,2,0
2020-11-20,6,0,351,1,0,28,6
2020-11-20,49,4,1921,10,3,57,53
2020-11-20,8,0,84,1,0,2,8
2020-11-20,0,0,14,0,0,0,0
2020-11-20,365,47,5955,88,8,190,412
2020-11-20,9,0,116,4,0,2,9
2020-11-20,509,52,4112,129,7,68,561
2020-11-20,3,0,51,0,0,4,3
2020-11-20,29,1,453,2,0,16,30
2020-11-20,11,0,59,5,0,1,11
2020-11-20,52,0,717,9,0,25,52
2020-11-20,26,12,741,7,1,34,38
2020-11-20,40,3,561,6,0,4,43
2020-11-21,380,39,5822,91,7,168,419
2020-11-21,108,24,2513,25,4,92,132
2020-11-21,495,64,4067,128,10,93,559
2020-11-21,1482,346,20246,391,48,647,1828
2020-11-21,439,46,6780,126,6,238,485
2020-11-21,12,0,59,4,0,1,12
2020-11-21,57,0,265,18,0,-1,57
2020-11-21,54,0,717,12,0,21,54
2020-11-21,9,0,115,3,0,2,9
2020-11-21,0,0,41,0,0,0,0
2020-11-21,0,0,19,0,0,0,0
2020-11-21,28,1,271,3,0,7,29
2020-11-21,1,0,17,0,0,2,1
2020-11-21,21,3,688,5,0,44,24
2020-11-21,21,0,265,5,0,5,21
2020-11-21,409,54,3387,96,7,47,463
2020-11-21,45,1,193,8,0,8,46
2020-11-21,60,7,581,11,0,11,67
2020-11-21,190,19,3047,55,1,48,209
2020-11-21,14,2,96,9,0,0,16
2020-11-21,0,0,47,0,0,0,0
2020-11-21,0,0,51,0,0,2,0
2020-11-21,4,0,56,2,0,9,4
2020-11-21,70,11,1553,24,2,37,81
2020-11-21,97,24,811,11,2,24,121
2020-11-21,25,0,388,8,0,2,25
2020-11-21,2,0,25,0,0,0,2
2020-11-21,2,0,51,1,0,3,2
2020-11-21,0,0,25,0,0,0,0
2020-11-21,6,0,506,2,0,25,6
2020-11-21,6,2,347,3,1,20,8
2020-11-21,1,0,25,1,0,1,1
2020-11-21,3,0,177,3,0,5,3
2020-11-21,52,5,1896,13,2,65,57
2020-11-21,117,3,1312,19,0,43,120
2020-11-21,11,1,460,2,0,26,12
2020-11-21,0,0,14,0,0,0,0
2020-11-21,203,21,1690,29,3,18,224
2020-11-21,1,0,29,1,0,3,1
2020-11-21,107,8,1036,31,3,23,115
2020-11-21,255,22,2563,52,4,83,277
2020-11-21,18,6,329,5,0,6,24
2020-11-21,1,0,77,1,0,2,1
2020-11-21,5,3,48,0,0,0,8
2020-11-21,10,0,189,5,0,5,10
2020-11-21,4,1,265,0,0,3,5
2020-11-21,9,0,84,2,0,0,9
2020-11-21,58,9,679,8,0,18,67
2020-11-21,62,6,1230,22,7,22,68
2020-11-21,129,6,1298,22,1,19,135
2020-11-21,23,0,453,2,0,14,23
2020-11-21,0,0,35,0,0,0,0
2020-11-21,0,0,33,0,0,3,0
2020-11-21,39,4,561,6,0,3,43
2020-11-21,24,0,576,6,0,6,24
2020-11-21,30,10,728,11,0,31,40
2020-11-22,0,0,25,0,0,0,0
2020-11-22,15,0,96,8,0,5,15
2020-11-22,63,10,1216,27,4,23,73
2020-11-22,16,1,460,3,1,26,17
2020-11-22,32,10,719,7,0,35,42
2020-11-22,25,0,453,2,0,14,25
2020-11-22,19,0,271,2,0,6,19
2020-11-22,0,0,47,0,0,0,0
2020-11-22,255,22,2549,52,6,82,277
2020-11-22,23,2,688,4,0,49,25
2020-11-22,20,10,329,6,1,4,30
2020-11-22,5,3,48,0,0,0,8
2020-11-22,232,15,1706,34,0,19,247
2020-11-22,47,2,1852,14,2,67,49
2020-11-22,0,0,14,0,0,0,0
2020-11-22,93,24,802,9,1,24,117
2020-11-22,24,0,387,8,0,2,24
2020-11-22,1,0,77,1,0,2,1
2020-11-22,2,0,25,1,0,1,2
2020-11-22,51,0,561,6,0,3,51
2020-11-22,527,53,4053,137,9,88,580
2020-11-22,428,58,5817,105,7,156,486
2020-11-22,25,6,563,6,1,6,31
2020-11-22,0,0,35,0,0,0,0
2020-11-22,10,0,123,3,0,5,10
2020-11-22,1,0,29,1,0,3,1
2020-11-22,58,1,717,13,1,20,59
2020-11-22,5,0,506,2,0,28,5
2020-11-22,4,2,271,0,1,2,6
2020-11-22,8,0,56,2,0,8,8
2020-11-22,110,6,1040,33,2,25,116
2020-11-22,2,0,51,1,0,2,2
2020-11-22,79,11,1547,24,1,45,90
2020-11-22,115,35,2486,23,3,114,150
2020-11-22,409,65,3351,96,11,44,474
2020-11-22,1575,344,20163,404,59,654,1919
2020-11-22,51,0,265,16,0,2,51
2020-11-22,120,6,1291,21,0,46,126
2020-11-22,2,0,177,2,0,5,2
2020-11-22,197,21,3021,54,3,71,218
2020-11-22,58,11,587,14,0,16,69
2020-11-22,50,7,679,8,0,22,57
2020-11-22,446,47,6801,131,8,237,493
2020-11-22,11,0,59,4,0,0,11
2020-11-22,2,0,33,2,0,5,2
2020-11-22,138,20,1297,25,1,18,158
2020-11-22,1,0,25,0,0,0,1
2020-11-22,0,0,19,0,0,0,0
2020-11-22,47,0,193,7,0,11,47
2020-11-22,1,0,17,0,0,2,1
2020-11-22,26,0,265,5,0,5,26
2020-11-22,8,3,352,3,0,22,11
2020-11-22,0,0,52,0,0,3,0
2020-11-22,12,0,84,2,0,1,12
2020-11-22,0,0,41,0,0,0,0
2020-11-22,10,0,189,5,0,7,10
2020-11-23,470,56,6797,140,12,245,526
2020-11-23,463,80,5814,116,10,183,543
2020-11-23,8,0,56,1,0,9,8
2020-11-23,8,2,142,4,0,3,10
2020-11-23,583,75,4082,140,11,80,658
2020-11-23,14,0,84,2,0,2,14
2020-11-23,4,0,25,0,0,0,4
2020-11-23,156,9,1298,25,0,17,165
2020-11-23,51,1,265,15,0,4,52
2020-11-23,253,31,2542,49,7,90,284
2020-11-23,64,2,717,13,2,23,66
2020-11-23,21,0,271,2,0,13,21
2020-11-23,12,0,177,5,0,5,12
2020-11-23,3,0,25,1,0,1,3
2020-11-23,123,26,2479,26,2,104,149
2020-11-23,43,2,193,7,0,11,45
2020-11-23,1,0,52,0,0,2,1
2020-11-23,31,0,265,6,0,5,31
2020-11-23,0,0,47,0,0,0,0
2020-11-23,4,5,271,0,1,2,9
2020-11-23,64,6,1226,30,2,26,70
2020-11-23,1,0,17,0,0,2,1
2020-11-23,114,8,1036,32,3,30,122
2020-11-23,420,78,3347,107,10,52,498
2020-11-23,8,0,59,4,0,0,8
2020-11-23,0,0,35,0,0,0,0
2020-11-23,27,0,385,8,0,1,27
2020-11-23,0,0,41,0,0,0,0
2020-11-23,1,0,29,1,0,3,1
2020-11-23,255,13,1715,40,0,20,268
2020-11-23,24,3,688,4,1,52,27
2020-11-23,1682,296,20138,422,47,689,1978
2020-11-23,48,0,561,7,0,5,48
2020-11-23,6,0,351,1,0,29,6
2020-11-23,40,4,712,7,0,35,44
2020-11-23,13,3,460,3,0,28,16
2020-11-23,0,0,14,0,0,0,0
2020-11-23,1,0,77,1,0,2,1
2020-11-23,32,0,453,4,0,14,32
2020-11-23,29,0,558,5,0,8,29
2020-11-23,56,12,679,8,1,24,68
2020-11-23,94,14,1564,25,1,50,108
2020-11-23,20,0,96,7,0,8,20
2020-11-23,2,0,33,2,0,4,2
2020-11-23,61,7,575,14,1,12,68
2020-11-23,132,1,1282,24,0,43,133
2020-11-23,52,1,1834,15,0,66,53
2020-11-23,201,24,3006,48,4,68,225
2020-11-23,3,0,51,1,0,3,3
2020-11-23,0,0,19,0,0,0,0
2020-11-23,8,4,355,4,0,19,12
2020-11-23,11,0,189,5,0,4,11
2020-11-23,0,0,25,0,0,0,0
2020-11-23,101,18,792,11,1,26,119
2020-11-23,5,2,48,0,0,0,7
2020-11-23,21,14,329,5,1,4,35
2020-11-24,259,29,1729,37,5,14,288
2020-11-24,33,0,382,9,0,1,33
2020-11-24,0,0,19,0,0,0,0
2020-11-24,217,20,3041,51,3,48,237
2020-11-24,11,1,189,6,0,7,12
2020-11-24,3,0,25,1,0,1,3
2020-11-24,42,1,193,7,0,10,43
2020-11-24,12,0,177,3,0,4,12
2020-11-24,0,0,51,0,0,1,0
2020-11-24,10,0,56,2,0,8,10
2020-11-24,59,1,265,14,0,4,60
2020-11-24,10,3,460,2,0,23,13
2020-11-24,7,3,359,4,0,17,10
2020-11-24,162,7,1291,25,0,18,169
2020-11-24,1,0,41,0,0,0,1
2020-11-24,63,11,588,15,2,12,74
2020-11-24,455,72,3441,116,14,61,527
2020-11-24,0,0,14,0,0,0,0
2020-11-24,126,3,1293,25,0,39,129
2020-11-24,138,38,2505,32,5,98,176
2020-11-24,30,6,607,5,0,4,36
2020-11-24,9,1,84,2,0,0,10
2020-11-24,26,4,688,4,2,44,30
2020-11-24,265,30,2551,49,5,87,295
2020-11-24,3,0,25,0,0,0,3
2020-11-24,10,0,59,4,0,0,10
2020-11-24,2,0,29,0,0,4,2
2020-11-24,8,1,351,3,0,27,9
2020-11-24,16,0,96,6,0,11,16
2020-11-24,51,0,561,8,0,4,51
2020-11-24,72,15,679,8,1,24,87
2020-11-24,110,15,795,9,2,23,125
2020-11-24,3,5,267,0,1,1,8
2020-11-24,45,6,720,7,2,31,51
2020-11-24,2,0,77,2,0,2,2
2020-11-24,3,0,48,0,0,0,3
2020-11-24,479,47,6034,115,5,201,526
2020-11-24,21,0,271,4,0,11,21
2020-11-24,62,1,1873,19,0,55,63
2020-11-24,606,67,4093,145,13,65,673
2020-11-24,64,2,717,13,2,17,66
2020-11-24,0,0,35,0,0,0,0
2020-11-24,109,13,1040,31,4,24,122
2020-11-24,510,44,6807,145,6,219,554
2020-11-24,86,6,1541,22,0,50,92
2020-11-24,77,8,1235,26,2,21,85
2020-11-24,33,0,453,4,0,11,33
2020-11-24,0,0,47,0,0,0,0
2020-11-24,4,0,51,0,0,3,4
2020-11-24,0,0,25,0,0,0,0
2020-11-24,0,0,17,0,0,2,0
2020-11-24,1809,388,20182,437,44,636,2197
2020-11-24,1,0,33,1,0,5,1
2020-11-24,12,1,133,3,0,4,13
2020-11-24,30,0,265,6,0,3,30
2020-11-24,22,12,329,6,0,3,34
2020-11-25,143,50,2536,37,6,97,193
2020-11-25,171,15,1297,28,0,17,186
2020-11-25,490,65,3449,112,13,57,555
2020-11-25,28,0,453,4,0,15,28
2020-11-25,0,0,41,0,0,0,0
2020-11-25,0,0,25,0,0,0,0
2020-11-25,1893,301,20201,461,36,611,2194
2020-11-25,628,66,4088,155,10,72,694
2020-11-25,54,0,561,9,0,2,54
2020-11-25,28,3,582,4,0,7,31
2020-11-25,3,0,25,2,0,1,3
2020-11-25,4,0,25,0,0,0,4
2020-11-25,10,0,177,4,0,4,10
2020-11-25,17,0,271,6,0,9,17
2020-11-25,65,13,581,16,2,16,78
2020-11-25,44,1,193,7,0,11,45
2020-11-25,136,3,1293,29,0,46,139
2020-11-25,0,0,14,0,0,0,0
2020-11-25,9,0,59,4,0,0,9
2020-11-25,92,8,1541,21,0,49,100
2020-11-25,279,20,2510,49,5,88,299
2020-11-25,73,9,679,7,0,24,82
2020-11-25,499,38,5909,130,3,164,537
2020-11-25,229,24,3043,58,4,47,253
2020-11-25,59,1,265,14,0,4,60
2020-11-25,9,2,190,5,0,4,11
2020-11-25,0,0,51,0,0,4,0
2020-11-25,2,0,77,0,0,3,2
2020-11-25,106,18,798,6,4,25,124
2020-11-25,1,0,33,1,0,4,1
2020-11-25,0,0,47,0,0,0,0
2020-11-25,1,0,19,0,0,0,1
2020-11-25,7,5,362,4,0,18,12
2020-11-25,32,0,382,9,0,1,32
2020-11-25,11,0,84,3,0,1,11
2020-11-25,13,1,138,3,1,4,14
2020-11-25,1,0,29,0,0,4,1
2020-11-25,32,1,688,8,0,44,33
2020-11-25,1,0,35,0,0,0,1
2020-11-25,67,3,717,12,2,18,70
2020-11-25,84,3,1240,21,1,29,87
2020-11-25,30,0,265,6,0,3,30
2020-11-25,0,0,17,0,0,2,0
2020-11-25,14,0,97,5,0,7,14
2020-11-25,4,0,48,0,0,0,4
2020-11-25,12,0,56,2,0,8,12
2020-11-25,46,6,727,7,1,27,52
2020-11-25,3,0,51,0,0,3,3
2020-11-25,110,10,1038,32,2,25,120
2020-11-25,10,0,351,4,0,28,10
2020-11-25,1,3,280,0,0,2,4
2020-11-25,22,13,329,6,0,12,35
2020-11-25,258,17,1717,45,2,20,275
2020-11-25,64,6,1864,20,2,50,70
2020-11-25,545,42,6801,154,11,218,587
2020-11-25,9,1,460,2,0,22,10
2020-11-26,506,36,5930,139,1,164,542
2020-11-26,563,41,6811,164,8,220,604
2020-11-26,25,0,265,7,0,2,25
2020-11-26,9,1,460,1,0,23,10
2020-11-26,143,4,1285,32,1,48,147
2020-11-26,81,11,1229,18,10,31,92
2020-11-26,2,1,275,0,0,2,3
2020-11-26,79,6,679,7,1,27,85
2020-11-26,265,15,1669,39,2,14,280
2020-11-26,32,1,451,8,0,15,33
2020-11-26,47,5,708,8,1,28,52
2020-11-26,11,2,190,4,0,9,13
2020-11-26,30,2,565,6,0,9,32
2020-11-26,62,0,265,15,0,7,62
2020-11-26,0,0,41,0,0,0,0
2020-11-26,3,0,25,2,0,0,3
2020-11-26,60,0,561,11,0,3,60
2020-11-26,1,0,33,1,0,4,1
2020-11-26,4,0,51,0,0,2,4
2020-11-26,656,48,4074,167,8,69,704
2020-11-26,107,14,1039,32,5,24,121
2020-11-26,31,0,688,8,0,43,31
2020-11-26,3,0,25,0,0,0,3
2020-11-26,230,23,3034,70,2,46,253
2020-11-26,32,0,382,7,0,3,32
2020-11-26,498,77,3381,115,15,58,575
2020-11-26,0,0,14,0,0,0,0
2020-11-26,4,0,48,0,0,0,4
2020-11-26,3,0,77,0,0,3,3
2020-11-26,12,1,177,5,0,0,13
2020-11-26,0,0,25,0,0,0,0
2020-11-26,23,0,271,6,0,11,23
2020-11-26,50,0,193,6,0,12,50
2020-11-26,1951,301,20202,484,52,589,2252
2020-11-26,1,0,29,0,0,4,1
2020-11-26,11,0,84,4,0,0,11
2020-11-26,0,0,47,0,0,0,0
2020-11-26,13,0,56,2,0,7,13
2020-11-26,70,4,1836,20,0,56,74
2020-11-26,90,9,1530,19,4,51,99
2020-11-26,13,0,97,5,0,7,13
2020-11-26,1,0,35,0,0,0,1
2020-11-26,71,2,717,12,1,21,73
2020-11-26,263,22,2547,50,3,73,285
2020-11-26,11,0,59,4,0,2,11
2020-11-26,0,0,19,0,0,0,0
2020-11-26,118,22,799,9,8,23,140
2020-11-26,6,2,355,3,0,18,8
2020-11-26,0,0,52,0,0,3,0
2020-11-26,186,14,1296,33,1,17,200
2020-11-26,23,6,329,6,0,16,29
2020-11-26,13,2,125,3,0,5,15
2020-11-26,157,54,2524,40,6,88,211
2020-11-26,67,15,565,19,2,19,82
2020-11-26,0,0,17,0,0,2,0
2020-11-26,10,0,351,4,0,26,10
2020-11-27,25,10,329,7,0,16,35
2020-11-27,181,20,1294,34,0,19,201
2020-11-27,12,0,59,4,0,1,12
2020-11-27,84,10,1220,29,4,26,94
2020-11-27,661,64,4055,162,10,86,725
2020-11-27,0,0,19,0,0,0,0
2020-11-27,10,0,460,1,0,24,10
2020-11-27,533,47,3371,112,11,55,580
2020-11-27,76,2,717,13,1,23,78
2020-11-27,52,0,193,7,0,10,52
2020-11-27,12,0,84,3,0,1,12
2020-11-27,3,0,51,0,0,4,3
2020-11-27,14,6,177,5,1,2,20
2020-11-27,12,0,141,3,0,4,12
2020-11-27,2,0,77,0,0,3,2
2020-11-27,70,0,265,14,0,8,70
2020-11-27,57,0,561,10,0,5,57
2020-11-27,246,22,3012,72,4,63,268
2020-11-27,2049,299,20087,501,58,612,2348
2020-11-27,81,3,679,9,1,27,84
2020-11-27,7,3,353,3,0,14,10
2020-11-27,0,0,25,0,0,0,0
2020-11-27,0,0,14,0,0,0,0
2020-11-27,46,6,716,9,1,31,52
2020-11-27,3,2,273,0,0,4,5
2020-11-27,18,0,97,5,0,8,18
2020-11-27,31,4,536,4,0,10,35
2020-11-27,1,0,29,0,0,4,1
2020-11-27,534,35,5854,138,3,157,569
2020-11-27,0,0,47,0,0,0,0
2020-11-27,35,0,382,6,0,2,35
2020-11-27,274,20,1656,50,4,17,294
2020-11-27,13,0,56,2,0,7,13
2020-11-27,0,0,41,0,0,0,0
2020-11-27,22,0,271,8,0,8,22
2020-11-27,0,0,35,0,0,0,0
2020-11-27,86,12,1506,19,2,55,98
2020-11-27,112,14,1047,27,6,34,126
2020-11-27,11,1,190,4,0,7,12
2020-11-27,8,0,48,0,0,0,8
2020-11-27,11,0,351,4,0,29,11
2020-11-27,599,38,6786,167,5,245,637
2020-11-27,163,41,2491,42,4,98,204
2020-11-27,72,4,1775,25,1,59,76
2020-11-27,37,2,451,5,1,13,39
2020-11-27,165,3,1269,33,0,47,168
2020-11-27,28,0,265,8,0,4,28
2020-11-27,33,2,688,7,0,58,35
2020-11-27,0,0,52,0,0,1,0
2020-11-27,4,0,25,2,0,0,4
2020-11-27,3,0,25,0,0,0,3
2020-11-27,128,13,801,12,3,22,141
2020-11-27,284,18,2541,53,3,72,302
2020-11-27,62,11,548,18,2,17,73
2020-11-27,1,0,33,1,0,5,1
2020-11-27,1,0,17,0,0,2,1
2020-11-28,5,0,25,0,0,0,5
2020-11-28,90,18,1535,21,2,46,108
2020-11-28,0,1,17,0,0,2,1
2020-11-28,0,0,41,0,0,0,0
2020-11-28,728,64,4018,170,8,82,792
2020-11-28,597,48,5953,148,5,157,645
2020-11-28,88,8,1216,35,2,24,96
2020-11-28,25,7,329,6,0,13,32
2020-11-28,19,0,271,9,0,7,19
2020-11-28,90,4,679,10,1,22,94
2020-11-28,8,5,357,3,0,16,13
2020-11-28,2,3,266,0,0,0,5
2020-11-28,40,0,382,4,0,4,40
2020-11-28,2185,328,20124,522,46,614,2513
2020-11-28,186,18,1294,34,0,23,204
2020-11-28,28,4,546,5,0,9,32
2020-11-28,0,0,35,0,0,0,0
2020-11-28,1,0,33,1,0,5,1
2020-11-28,0,0,25,0,0,0,0
2020-11-28,14,0,56,2,0,7,14
2020-11-28,2,0,77,0,0,2,2
2020-11-28,166,1,1289,37,0,42,167
2020-11-28,124,15,797,11,2,24,139
2020-11-28,1,0,29,0,0,4,1
2020-11-28,1,0,51,0,0,4,1
2020-11-28,77,3,1762,24,1,65,80
2020-11-28,573,63,3404,116,13,53,636
2020-11-28,627,46,6796,169,3,260,673
2020-11-28,56,0,193,8,0,10,56
2020-11-28,168,38,2506,48,5,88,206
2020-11-28,10,0,84,2,0,3,10
2020-11-28,9,0,48,0,0,0,9
2020-11-28,0,0,14,0,0,0,0
2020-11-28,64,11,560,17,3,13,75
2020-11-28,13,0,59,5,0,1,13
2020-11-28,125,13,1037,25,5,28,138
2020-11-28,32,0,265,9,0,1,32
2020-11-28,15,0,114,4,0,2,15
2020-11-28,15,2,190,5,1,2,17
2020-11-28,0,0,52,0,0,0,0
2020-11-28,72,0,265,13,0,4,72
2020-11-28,5,0,25,2,0,1,5
2020-11-28,303,23,2549,61,4,81,326
2020-11-28,45,2,451,6,2,10,47
2020-11-28,72,1,717,14,1,24,73
2020-11-28,12,0,177,4,0,3,12
2020-11-28,55,0,561,9,0,3,55
2020-11-28,263,18,3034,73,2,63,281
2020-11-28,0,0,47,0,0,0,0
2020-11-28,39,1,688,7,0,56,40
2020-11-28,6,0,460,1,0,24,6
2020-11-28,11,0,351,4,0,29,11
2020-11-28,278,32,1707,53,4,17,310
2020-11-28,50,6,720,7,2,35,56
2020-11-28,0,0,19,0,0,0,0
2020-11-28,20,0,96,7,0,7,20
2020-11-29,47,0,382,6,0,6,47
2020-11-29,0,0,19,0,0,0,0
2020-11-29,58,9,727,13,1,38,67
2020-11-29,161,5,1273,37,0,43,166
2020-11-29,1,0,29,0,0,4,1
2020-11-29,11,0,59,5,0,0,11
2020-11-29,316,29,2536,69,4,76,345
2020-11-29,3,0,25,0,0,0,3
2020-11-29,38,0,265,10,0,2,38
2020-11-29,658,40,6798,168,4,258,698
2020-11-29,96,3,679,12,0,23,99
2020-11-29,781,58,4041,171,5,88,839
2020-11-29,28,0,271,11,0,4,28
2020-11-29,10,0,56,1,0,9,10
2020-11-29,0,0,41,0,0,0,0
2020-11-29,189,11,1293,36,2,22,200
2020-11-29,16,0,190,5,0,5,16
2020-11-29,2316,335,20078,558,39,603,2651
2020-11-29,5,0,460,1,0,26,5
2020-11-29,82,1,717,16,1,24,83
2020-11-29,3,0,33,3,0,3,3
2020-11-29,289,14,3063,80,2,58,303
2020-11-29,34,1,520,6,0,5,35
2020-11-29,59,14,547,15,3,15,73
2020-11-29,10,3,360,3,0,18,13
2020-11-29,287,25,1707,56,1,14,312
2020-11-29,0,0,47,0,0,0,0
2020-11-29,71,1,265,13,0,4,72
2020-11-29,10,0,84,2,0,4,10
2020-11-29,0,0,25,0,0,0,0
2020-11-29,2,2,269,0,1,2,4
2020-11-29,125,13,791,13,3,23,138
2020-11-29,106,17,1541,26,1,42,123
2020-11-29,0,1,17,0,0,2,1
2020-11-29,24,7,329,7,0,14,31
2020-11-29,42,3,688,9,1,58,45
2020-11-29,585,81,3417,129,15,47,666
2020-11-29,134,11,1031,29,5,34,145
2020-11-29,9,0,48,0,0,0,9
2020-11-29,56,0,561,10,0,3,56
2020-11-29,11,0,177,4,0,5,11
2020-11-29,0,0,35,0,0,0,0
2020-11-29,46,0,451,5,0,19,46
2020-11-29,6,0,25,3,0,1,6
2020-11-29,171,33,2500,52,7,98,204
2020-11-29,10,0,351,4,0,27,10
2020-11-29,19,1,116,5,1,0,20
2020-11-29,1,0,51,0,0,4,1
2020-11-29,92,13,1219,33,2,17,105
2020-11-29,58,0,193,8,0,10,58
2020-11-29,0,0,14,0,0,0,0
2020-11-29,0,0,51,0,0,1,0
2020-11-29,21,0,96,8,0,5,21
2020-11-29,83,1,1727,24,0,71,84
2020-11-29,2,0,77,0,0,3,2
2020-11-29,605,59,5921,146,9,162,664
2020-11-30,0,0,14,0,0,0,0
2020-11-30,18,0,97,7,0,6,18
2020-11-30,81,0,717,19,0,22,81
2020-11-30,21,13,329,6,0,15,34
2020-11-30,648,57,5861,158,8,149,705
2020-11-30,5,2,270,1,1,1,7
2020-11-30,200,22,1291,43,3,21,222
2020-11-30,66,13,550,18,3,12,79
2020-11-30,138,8,1034,28,3,29,146
2020-11-30,31,0,271,11,0,4,31
2020-11-30,35,9,544,5,3,5,44
2020-11-30,12,0,177,4,0,1,12
2020-11-30,50,2,688,13,1,51,52
2020-11-30,1,0,19,0,0,0,1
2020-11-30,184,2,1283,41,0,39,186
2020-11-30,344,25,2530,71,9,78,369
2020-11-30,91,0,1771,28,0,73,91
2020-11-30,13,0,84,3,0,2,13
2020-11-30,4,0,33,2,0,5,4
2020-11-30,11,4,343,4,1,16,15
2020-11-30,102,25,1525,25,5,47,127
2020-11-30,82,0,265,14,0,2,82
2020-11-30,2,0,78,0,0,3,2
2020-11-30,52,0,193,6,0,12,52
2020-11-30,7,2,460,1,0,22,9
2020-11-30,0,0,51,0,0,1,0
2020-11-30,65,9,718,13,2,36,74
2020-11-30,10,0,351,6,0,22,10
2020-11-30,11,0,59,4,0,0,11
2020-11-30,696,35,6808,183,4,252,731
2020-11-30,600,83,3470,127,8,53,683
2020-11-30,0,0,35,0,0,0,0
2020-11-30,6,0,25,3,0,1,6
2020-11-30,40,0,265,9,0,2,40
2020-11-30,2439,304,20151,576,36,602,2743
2020-11-30,41,0,382,8,0,7,41
2020-11-30,1,0,29,1,0,3,1
2020-11-30,19,1,140,3,1,3,20
2020-11-30,5,0,25,0,0,0,5
2020-11-30,0,0,17,0,0,2,0
2020-11-30,856,78,4093,177,8,68,934
2020-11-30,12,0,56,2,0,10,12
2020-11-30,99,10,683,14,1,20,109
2020-11-30,131,12,773,14,3,25,143
2020-11-30,0,0,47,0,0,0,0
2020-11-30,2,1,51,0,0,3,3
2020-11-30,45,0,451,7,0,14,45
2020-11-30,0,0,25,0,0,0,0
2020-11-30,291,17,3049,83,2,50,308
2020-11-30,188,35,2519,51,4,104,223
2020-11-30,15,0,190,3,0,6,15
2020-11-30,9,1,48,0,0,0,10
2020-11-30,305,31,1744,54,1,12,336
2020-11-30,94,8,1233,34,3,23,102
2020-11-30,62,0,561,10,0,3,62
2020-11-30,0,0,41,0,0,0,0
2020-12-01,8,0,25,3,0,0,8
2020-12-01,2,0,17,0,0,2,2
2020-12-01,2572,310,20310,601,41,574,2882
2020-12-01,12,0,56,3,0,9,12
2020-12-01,11,0,59,4,0,1,11
2020-12-01,189,1,1305,41,0,35,190
2020-12-01,0,0,14,0,0,0,0
2020-12-01,0,0,47,0,0,0,0
2020-12-01,130,20,780,17,3,24,150
2020-12-01,210,18,1293,39,3,25,228
2020-12-01,363,22,2595,77,5,64,385
2020-12-01,73,0,265,16,0,0,73
2020-12-01,5,0,25,0,0,0,5
2020-12-01,45,1,451,6,0,16,46
2020-12-01,15,2,344,4,0,12,17
2020-12-01,2,1,51,1,0,2,3
2020-12-01,1,0,29,1,0,2,1
2020-12-01,38,5,585,5,2,4,43
2020-12-01,1,0,41,0,0,0,1
2020-12-01,42,0,382,9,0,7,42
2020-12-01,14,1,190,1,1,80,15
2020-12-01,6,0,33,2,0,5,6
2020-12-01,29,0,271,12,0,1,29
2020-12-01,0,0,35,0,0,0,0
2020-12-01,5,5,280,1,2,3,10
2020-12-01,150,12,1036,39,1,28,162
2020-12-01,883,82,4105,192,10,54,965
2020-12-01,685,48,6825,197,7,210,733
2020-12-01,0,0,25,0,0,0,0
2020-12-01,112,21,1547,27,7,41,133
2020-12-01,98,14,1234,40,3,24,112
2020-12-01,47,1,688,14,0,47,48
2020-12-01,0,0,51,0,0,2,0
2020-12-01,2,0,78,0,0,2,2
2020-12-01,14,0,84,4,0,0,14
2020-12-01,25,13,329,7,0,15,38
2020-12-01,689,67,6047,171,8,123,756
2020-12-01,12,0,177,4,0,1,12
2020-12-01,85,1,717,17,0,25,86
2020-12-01,11,0,351,7,0,22,11
2020-12-01,69,12,551,21,3,12,81
2020-12-01,56,0,193,6,0,10,56
2020-12-01,53,0,561,9,0,2,53
2020-12-01,9,1,460,1,0,20,10
2020-12-01,10,0,48,0,0,0,10
2020-12-01,293,19,3081,87,2,43,312
2020-12-01,45,0,265,8,0,1,45
2020-12-01,2,0,19,0,0,0,2
2020-12-01,72,6,744,17,1,40,78
2020-12-01,88,3,1831,27,0,63,91
2020-12-01,187,47,2552,57,3,75,234
2020-12-01,92,11,683,11,1,21,103
2020-12-01,291,27,1732,61,3,9,318
2020-12-01,628,76,3485,126,8,44,704
2020-12-01,20,0,97,9,0,6,20
2020-12-01,16,1,128,4,1,4,17
2020-12-02,116,15,1564,27,1,55,131
2020-12-02,82,1,717,17,0,20,83
2020-12-02,67,11,559,21,2,12,78
2020-12-02,735,49,6072,179,6,114,784
2020-12-02,649,72,3515,124,5,44,721
2020-12-02,2668,336,20383,632,25,528,3004
2020-12-02,11,0,84,2,0,1,11
2020-12-02,1,0,19,0,0,0,1
2020-12-02,93,5,1894,28,0,62,98
2020-12-02,2,0,29,0,0,4,2
2020-12-02,0,0,47,0,0,0,0
2020-12-02,7,0,25,0,0,0,7
2020-12-02,5,6,281,2,1,2,11
2020-12-02,11,0,59,3,0,2,11
2020-12-02,0,0,77,0,0,2,0
2020-12-02,4,0,51,2,0,3,4
2020-12-02,338,29,1736,62,2,10,367
2020-12-02,195,43,2563,58,5,85,238
2020-12-02,0,0,14,0,0,0,0
2020-12-02,98,13,1252,39,4,18,111
2020-12-02,20,0,96,11,0,6,20
2020-12-02,13,0,190,1,0,8,13
2020-12-02,131,14,783,19,2,25,145
2020-12-02,705,56,6842,204,4,219,761
2020-12-02,82,1,265,18,0,2,83
2020-12-02,53,0,561,8,0,4,53
2020-12-02,179,5,1299,42,0,31,184
2020-12-02,44,1,451,6,1,12,45
2020-12-02,0,0,25,0,0,0,0
2020-12-02,359,29,2600,76,4,71,388
2020-12-02,11,0,177,4,0,1,11
2020-12-02,1,0,41,0,0,0,1
2020-12-02,8,1,460,1,0,26,9
2020-12-02,47,0,382,9,0,5,47
2020-12-02,11,0,48,0,0,0,11
2020-12-02,904,98,4039,192,12,57,1002
2020-12-02,57,3,688,16,0,46,60
2020-12-02,37,0,265,10,0,1,37
2020-12-02,0,0,51,0,0,3,0
2020-12-02,100,10,679,12,1,22,110
2020-12-02,5,0,33,3,0,5,5
2020-12-02,16,4,348,6,0,12,20
2020-12-02,17,0,128,3,0,6,17
2020-12-02,38,4,609,5,0,4,42
2020-12-02,15,0,56,3,0,8,15
2020-12-02,70,6,735,21,1,43,76
2020-12-02,162,7,1042,41,1,27,169
2020-12-02,58,1,193,11,0,7,59
2020-12-02,9,0,25,3,0,0,9
2020-12-02,28,10,329,8,0,10,38
2020-12-02,304,23,3073,83,2,56,327
2020-12-02,2,0,17,0,0,2,2
2020-12-02,0,0,35,0,0,0,0
2020-12-02,12,0,351,6,0,22,12
2020-12-02,32,0,271,7,0,4,32
2020-12-02,219,18,1291,41,2,24,237
2020-12-03,11,0,59,2,0,1,11
2020-12-03,5,0,33,2,0,5,5
2020-12-03,373,23,2578,71,4,79,396
2020-12-03,5,0,51,3,0,2,5
2020-12-03,1,0,19,0,0,0,1
2020-12-03,18,0,96,11,0,3,18
2020-12-03,0,0,51,0,0,2,0
2020-12-03,11,0,84,2,0,2,11
2020-12-03,206,49,2586,58,3,91,255
2020-12-03,104,15,1246,43,6,19,119
2020-12-03,13,0,460,1,0,24,13
2020-12-03,2,0,29,0,0,2,2
2020-12-03,16,2,123,4,1,4,18
2020-12-03,7,0,282,2,0,4,7
2020-12-03,37,5,613,6,1,7,42
2020-12-03,43,0,382,8,0,6,43
2020-12-03,47,1,451,7,1,21,48
2020-12-03,2769,328,20371,644,38,486,3097
2020-12-03,16,3,350,6,0,11,19
2020-12-03,160,5,1040,46,1,24,165
2020-12-03,10,0,48,0,0,0,10
2020-12-03,3,0,17,0,0,2,3
2020-12-03,6,0,25,3,0,0,6
2020-12-03,91,1,265,21,0,1,92
2020-12-03,1,0,35,0,0,0,1
2020-12-03,2,0,77,0,0,2,2
2020-12-03,0,0,14,0,0,0,0
2020-12-03,340,38,1715,66,4,11,378
2020-12-03,93,5,1902,34,1,53,98
2020-12-03,0,0,47,0,0,0,0
2020-12-03,15,1,190,4,0,7,16
2020-12-03,59,1,688,16,0,40,60
2020-12-03,218,13,1291,49,2,18,231
2020-12-03,76,7,738,22,0,38,83
2020-12-03,39,0,265,10,0,1,39
2020-12-03,10,0,177,3,0,3,10
2020-12-03,107,10,682,11,2,18,117
2020-12-03,38,0,271,7,0,10,38
2020-12-03,122,14,1573,36,3,35,136
2020-12-03,90,1,717,23,0,14,91
2020-12-03,182,6,1310,39,0,39,188
2020-12-03,746,64,6088,195,6,133,810
2020-12-03,1,2,41,0,0,0,3
2020-12-03,64,14,575,18,1,12,78
2020-12-03,11,0,25,0,0,0,11
2020-12-03,307,23,3090,79,2,51,330
2020-12-03,743,54,6829,207,4,210,797
2020-12-03,144,19,787,22,0,23,163
2020-12-03,51,0,561,11,0,8,51
2020-12-03,60,0,193,12,0,7,60
2020-12-03,12,1,351,4,1,24,13
2020-12-03,0,0,25,0,0,0,0
2020-12-03,658,81,3529,135,5,45,739
2020-12-03,13,3,56,3,0,8,16
2020-12-03,880,84,4025,199,9,64,964
2020-12-03,29,10,275,7,1,3,39
2020-12-04,11,0,84,1,0,0,11
2020-12-04,9,0,48,0,0,0,9
2020-12-04,90,0,265,27,0,1,90
2020-12-04,10,0,100,3,0,8,10
2020-12-04,90,2,717,24,1,15,92
2020-12-04,2878,319,20148,666,34,479,3197
2020-12-04,78,11,738,19,1,38,89
2020-12-04,9,0,59,1,0,0,9
2020-12-04,0,0,51,0,0,4,0
2020-12-04,41,0,265,10,0,5,41
2020-12-04,69,14,583,19,1,12,83
2020-12-04,41,3,595,7,1,6,44
2020-12-04,842,45,6194,193,6,121,887
2020-12-04,46,1,386,10,0,4,47
2020-12-04,12,0,56,3,0,6,12
2020-12-04,15,1,116,4,0,5,16
2020-12-04,213,38,2562,61,3,91,251
2020-12-04,63,0,121,10,0,0,63
2020-12-04,15,1,351,6,0,13,16
2020-12-04,29,0,271,8,0,5,29
2020-12-04,354,36,1672,58,0,5,390
2020-12-04,913,85,4037,209,8,63,998
2020-12-04,7,2,281,1,2,5,9
2020-12-04,2,0,77,1,0,1,2
2020-12-04,6,0,51,3,0,1,6
2020-12-04,18,0,96,10,0,5,18
2020-12-04,126,17,1570,35,3,39,143
2020-12-04,54,0,688,15,0,60,54
2020-12-04,28,10,275,7,0,9,38
2020-12-04,15,0,460,1,0,22,15
2020-12-04,19,0,190,5,0,6,19
2020-12-04,0,0,14,0,0,0,0
2020-12-04,0,0,41,0,0,0,0
2020-12-04,104,2,641,11,1,10,106
2020-12-04,198,5,1121,39,1,33,203
2020-12-04,378,21,2560,71,2,73,399
2020-12-04,96,3,1909,33,2,59,99
2020-12-04,49,0,561,11,0,8,49
2020-12-04,2,0,29,1,0,3,2
2020-12-04,332,23,3090,84,2,47,355
2020-12-04,1,0,47,0,0,0,1
2020-12-04,772,35,6824,200,2,210,807
2020-12-04,51,1,451,8,0,15,52
2020-12-04,8,0,200,3,1,13,8
2020-12-04,1,0,17,0,0,2,1
2020-12-04,4,0,33,2,0,5,4
2020-12-04,687,101,3519,145,6,55,788
2020-12-04,5,0,25,0,0,0,5
2020-12-04,1,0,19,0,0,0,1
2020-12-04,111,15,1175,43,1,16,126
2020-12-04,148,15,784,20,0,25,163
2020-12-04,0,0,35,0,0,0,0
2020-12-04,225,12,1285,45,2,16,237
2020-12-04,172,15,944,47,3,9,187
2020-12-04,0,0,25,0,0,0,0
2020-12-04,5,0,25,2,0,0,5
2020-12-05,21,0,352,7,0,16,21
2020-12-05,82,8,739,20,0,38,90
2020-12-05,72,13,585,22,0,12,85
2020-12-05,57,0,451,6,0,9,57
2020-12-05,8,0,200,5,0,10,8
2020-12-05,115,4,638,12,1,10,119
2020-12-05,147,23,755,25,3,21,170
2020-12-05,187,12,1017,54,2,6,199
2020-12-05,117,10,1198,46,1,23,127
2020-12-05,11,0,460,1,0,19,11
2020-12-05,0,0,35,0,0,0,0
2020-12-05,7,2,278,1,0,5,9
2020-12-05,19,0,96,11,0,7,19
2020-12-05,7,0,51,2,0,1,7
2020-12-05,958,78,4002,225,5,72,1036
2020-12-05,1,0,19,0,0,0,1
2020-12-05,44,1,382,8,0,4,45
2020-12-05,2,0,29,1,0,3,2
2020-12-05,0,0,25,0,0,0,0
2020-12-05,12,0,56,3,0,7,12
2020-12-05,2,1,77,1,0,1,3
2020-12-05,16,1,109,5,0,1,17
2020-12-05,371,30,2540,67,6,65,401
2020-12-05,1,0,41,0,0,0,1
2020-12-05,0,0,51,0,0,4,0
2020-12-05,9,0,48,0,0,0,9
2020-12-05,43,0,261,9,0,3,43
2020-12-05,111,6,1882,34,0,57,117
2020-12-05,50,1,688,12,0,51,51
2020-12-05,336,21,3062,84,1,56,357
2020-12-05,2,0,33,2,0,5,2
2020-12-05,22,0,190,5,0,6,22
2020-12-05,2,4,47,0,0,0,6
2020-12-05,790,45,6980,205,11,198,835
2020-12-05,848,54,5957,209,5,120,902
2020-12-05,2988,340,20033,705,56,425,3328
2020-12-05,671,116,3506,143,7,50,787
2020-12-05,0,0,14,0,0,0,0
2020-12-05,33,0,271,9,0,4,33
2020-12-05,10,0,59,2,0,0,10
2020-12-05,87,3,717,24,1,20,90
2020-12-05,133,17,1584,35,2,45,150
2020-12-05,41,8,563,8,1,8,49
2020-12-05,199,3,1084,46,0,30,202
2020-12-05,31,11,275,6,1,8,42
2020-12-05,227,32,2556,58,3,98,259
2020-12-05,1,0,17,0,0,2,1
2020-12-05,8,1,76,3,0,8,9
2020-12-05,5,0,25,0,0,0,5
2020-12-05,5,0,25,2,0,0,5
2020-12-05,217,15,1294,48,3,17,232
2020-12-05,7,0,84,0,0,2,7
2020-12-05,396,24,1636,61,3,6,420
2020-12-05,49,0,561,11,0,9,49
2020-12-05,66,0,114,9,0,3,66
2020-12-05,96,0,265,29,0,2,96
2020-12-06,138,20,1566,35,0,66,158
2020-12-06,817,54,6935,216,5,223,871
2020-12-06,9,0,48,0,0,0,9
2020-12-06,97,2,717,19,1,23,99
2020-12-06,700,117,3464,146,7,52,817
2020-12-06,13,0,56,2,0,8,13
2020-12-06,110,5,1834,32,0,71,115
2020-12-06,2,4,47,0,0,0,6
2020-12-06,0,0,25,0,0,0,0
2020-12-06,17,1,109,4,0,5,18
2020-12-06,7,0,51,3,0,2,7
2020-12-06,374,24,2539,76,5,76,398
2020-12-06,48,9,531,11,4,12,57
2020-12-06,2,1,77,2,0,1,3
2020-12-06,35,0,271,8,0,7,35
2020-12-06,98,0,265,28,0,0,98
2020-12-06,69,0,121,9,0,3,69
2020-12-06,13,1,460,5,0,20,14
2020-12-06,48,0,561,12,0,10,48
2020-12-06,408,28,1648,66,1,7,436
2020-12-06,0,0,51,0,0,5,0
2020-12-06,20,0,96,12,0,4,20
2020-12-06,3113,377,20053,754,57,480,3490
2020-12-06,154,17,758,27,2,21,171
2020-12-06,82,10,735,22,0,33,92
2020-12-06,118,8,634,16,1,8,126
2020-12-06,7,0,271,1,0,3,7
2020-12-06,11,1,200,4,0,11,12
2020-12-06,4,0,25,2,0,0,4
2020-12-06,3,0,29,0,0,4,3
2020-12-06,5,0,25,0,0,0,5
2020-12-06,49,0,382,7,0,6,49
2020-12-06,18,2,190,8,2,6,20
2020-12-06,69,10,556,21,0,11,79
2020-12-06,877,44,5882,218,8,117,921
2020-12-06,199,27,1018,50,4,4,226
2020-12-06,122,11,1184,46,2,27,133
2020-12-06,209,12,1296,47,1,18,221
2020-12-06,51,0,451,6,0,15,51
2020-12-06,10,0,59,2,0,1,10
2020-12-06,2,0,19,0,0,0,2
2020-12-06,207,2,1092,47,0,31,209
2020-12-06,7,0,71,3,0,7,7
2020-12-06,9,0,184,1,0,2,9
2020-12-06,226,40,2544,60,2,98,266
2020-12-06,46,0,261,8,0,9,46
2020-12-06,1,0,41,0,0,0,1
2020-12-06,59,2,688,11,0,57,61
2020-12-06,20,0,343,6,0,15,20
2020-12-06,354,14,3062,87,1,53,368
2020-12-06,2,0,33,2,0,4,2
2020-12-06,0,0,35,0,0,0,0
2020-12-06,984,76,3987,212,6,71,1060
2020-12-06,0,0,14,0,0,0,0
2020-12-06,27,9,275,6,1,5,36
2020-12-06,0,0,17,0,0,2,0
2020-12-07,37,0,271,6,0,8,37
2020-12-07,12,3,460,5,0,22,15
2020-12-07,420,35,1658,77,5,9,455
2020-12-07,128,8,1176,46,3,33,136
2020-12-07,67,8,550,18,0,13,75
2020-12-07,18,0,123,4,0,2,18
2020-12-07,0,0,17,0,0,2,0
2020-12-07,3,0,29,0,0,4,3
2020-12-07,199,9,1019,49,3,9,208
2020-12-07,12,0,59,2,0,2,12
2020-12-07,49,0,372,6,0,6,49
2020-12-07,7,0,84,0,0,3,7
2020-12-07,3299,354,19993,774,44,497,3653
2020-12-07,2,0,77,2,0,1,2
2020-12-07,0,0,12,0,0,0,0
2020-12-07,7,0,51,3,0,2,7
2020-12-07,149,13,764,24,2,23,162
2020-12-07,5,0,47,0,0,0,5
2020-12-07,2,0,19,0,0,0,2
2020-12-07,75,2,111,8,1,0,77
2020-12-07,140,16,1548,34,2,45,156
2020-12-07,83,12,742,20,1,34,95
2020-12-07,946,78,5891,238,9,113,1024
2020-12-07,1,0,51,1,0,2,1
2020-12-07,42,0,261,10,0,7,42
2020-12-07,376,22,3053,90,6,63,398
2020-12-07,24,12,275,8,0,1,36
2020-12-07,232,36,2527,57,4,97,268
2020-12-07,54,1,451,5,0,13,55
2020-12-07,6,0,25,0,0,0,6
2020-12-07,13,0,56,3,0,7,13
2020-12-07,0,0,35,0,0,0,0
2020-12-07,47,3,564,13,1,11,50
2020-12-07,0,0,14,0,0,0,0
2020-12-07,7,0,25,2,0,0,7
2020-12-07,1,0,33,1,0,4,1
2020-12-07,126,9,638,16,1,15,135
2020-12-07,23,0,96,11,0,2,23
2020-12-07,996,104,4021,216,9,63,1100
2020-12-07,117,6,1876,31,0,65,123
2020-12-07,8,1,48,0,0,0,9
2020-12-07,17,3,347,7,0,13,20
2020-12-07,64,0,688,12,0,57,64
2020-12-07,46,0,561,13,0,11,46
2020-12-07,733,115,3494,144,7,53,848
2020-12-07,385,27,2544,81,4,78,412
2020-12-07,231,13,1292,49,2,16,244
2020-12-07,20,1,190,9,1,5,21
2020-12-07,8,1,276,0,0,3,9
2020-12-07,121,1,265,28,0,0,122
2020-12-07,216,8,1121,49,0,20,224
2020-12-07,867,41,6928,220,4,211,908
2020-12-07,105,1,717,20,0,15,106
2020-12-07,9,0,73,2,0,7,9
2020-12-07,0,0,25,0,0,0,0
2020-12-07,12,1,200,3,0,12,13
2020-12-08,874,59,6836,229,6,195,933
2020-12-08,80,2,127,8,1,0,82
2020-12-08,64,3,688,13,0,56,67
2020-12-08,247,13,1290,52,4,14,260
2020-12-08,121,1,265,28,0,3,122
2020-12-08,143,16,1562,39,3,34,159
2020-12-08,3433,337,20119,793,54,462,3770
2020-12-08,5,0,25,0,0,0,5
2020-12-08,454,38,1663,74,3,7,492
2020-12-08,14,0,126,5,0,4,14
2020-12-08,27,10,275,8,0,1,37
2020-12-08,45,0,261,11,0,3,45
2020-12-08,392,21,3074,92,4,38,413
2020-12-08,7,0,78,2,0,4,7
2020-12-08,768,127,3535,172,9,49,895
2020-12-08,242,38,2541,63,5,87,280
2020-12-08,6,1,269,1,0,6,7
2020-12-08,44,2,561,12,0,13,46
2020-12-08,1053,87,4010,217,6,82,1140
2020-12-08,0,0,14,0,0,0,0
2020-12-08,7,0,25,2,0,0,7
2020-12-08,112,1,717,19,0,16,113
2020-12-08,0,0,12,0,0,0,0
2020-12-08,4,0,77,2,0,1,4
2020-12-08,74,14,591,18,0,17,88
2020-12-08,15,1,200,2,0,22,16
2020-12-08,158,17,768,23,2,20,175
2020-12-08,51,9,580,9,2,10,60
2020-12-08,1,0,35,0,0,0,1
2020-12-08,1,0,33,1,0,5,1
2020-12-08,48,0,372,10,0,4,48
2020-12-08,3,0,19,0,0,0,3
2020-12-08,13,0,56,3,0,8,13
2020-12-08,5,0,47,0,0,0,5
2020-12-08,0,0,17,0,0,2,0
2020-12-08,3,0,51,1,0,2,3
2020-12-08,26,0,96,11,0,2,26
2020-12-08,6,0,84,0,0,2,6
2020-12-08,15,0,460,6,0,20,15
2020-12-08,87,10,754,19,1,35,97
2020-12-08,20,4,336,7,0,13,24
2020-12-08,17,0,59,1,0,2,17
2020-12-08,37,0,271,6,0,9,37
2020-12-08,0,0,25,0,0,0,0
2020-12-08,3,0,29,1,0,3,3
2020-12-08,398,24,2584,85,1,67,422
2020-12-08,128,13,638,14,2,15,141
2020-12-08,218,9,1019,52,3,5,227
2020-12-08,225,4,1134,54,0,20,229
2020-12-08,974,80,6023,239,14,111,1054
2020-12-08,63,3,451,9,0,7,66
2020-12-08,24,0,190,13,0,4,24
2020-12-08,4,0,48,0,0,0,4
2020-12-08,115,5,1877,31,0,53,120
2020-12-08,131,4,1206,46,1,31,135
2020-12-08,7,0,51,3,0,2,7
2020-12-09,2,1,48,0,0,0,3
2020-12-09,2,0,33,1,0,5,2
2020-12-09,145,7,1218,48,1,31,152
2020-12-09,24,0,96,13,0,2,24
2020-12-09,3,0,51,1,0,1,3
2020-12-09,72,3,688,15,0,43,75
2020-12-09,3,1,278,1,0,5,4
2020-12-09,96,14,764,24,1,31,110
2020-12-09,225,13,1016,59,2,3,238
2020-12-09,7,0,84,0,0,2,7
2020-12-09,164,5,1563,40,0,33,169
2020-12-09,4,0,77,2,0,1,4
2020-12-09,82,16,583,21,2,13,98
2020-12-09,127,0,265,32,0,2,127
2020-12-09,1,0,17,0,0,2,1
2020-12-09,1,0,35,0,0,0,1
2020-12-09,41,0,271,7,0,8,41
2020-12-09,31,12,275,9,0,7,43
2020-12-09,0,0,14,0,0,0,0
2020-12-09,6,0,25,1,0,0,6
2020-12-09,3,0,29,3,0,1,3
2020-12-09,460,31,1583,95,2,8,491
2020-12-09,9,0,79,2,0,7,9
2020-12-09,138,12,637,15,1,7,150
2020-12-09,1094,92,4020,226,5,50,1186
2020-12-09,2,0,19,0,0,0,2
2020-12-09,29,4,339,7,0,8,33
2020-12-09,1025,68,6041,257,10,108,1093
2020-12-09,905,50,6862,240,5,199,955
2020-12-09,0,0,12,0,0,0,0
2020-12-09,254,47,2550,69,8,75,301
2020-12-09,114,1,908,18,0,18,115
2020-12-09,47,0,372,10,0,1,47
2020-12-09,13,0,129,5,0,2,13
2020-12-09,2,0,25,0,0,0,2
2020-12-09,11,0,56,2,0,10,11
2020-12-09,3624,370,20120,819,29,468,3994
2020-12-09,9,0,51,3,0,2,9
2020-12-09,775,132,3239,171,10,72,907
2020-12-09,166,17,764,20,1,18,183
2020-12-09,62,3,451,8,0,6,65
2020-12-09,73,1,123,7,1,1,74
2020-12-09,398,24,2481,79,5,55,422
2020-12-09,25,0,190,11,0,4,25
2020-12-09,5,0,47,0,0,0,5
2020-12-09,49,0,261,11,0,4,49
2020-12-09,229,9,1153,52,0,19,238
2020-12-09,258,12,1290,53,3,17,270
2020-12-09,60,5,605,10,1,10,65
2020-12-09,0,0,25,0,0,0,0
2020-12-09,411,22,3119,98,2,34,433
2020-12-09,13,0,59,1,0,3,13
2020-12-09,121,6,1928,33,0,45,127
2020-12-09,46,0,561,13,0,13,46
2020-12-09,17,1,460,6,0,22,18
2020-12-09,14,1,200,3,0,11,15
2020-12-10,1122,50,6011,265,5,97,1172
2020-12-10,10,0,25,2,0,0,10
2020-12-10,39,0,271,5,0,6,39
2020-12-10,77,0,127,7,0,5,77
2020-12-10,422,15,2620,82,5,63,437
2020-12-10,25,0,190,14,0,4,25
2020-12-10,268,8,1288,47,2,21,276
2020-12-10,118,1,1917,33,0,35,119
2020-12-10,49,0,261,11,0,5,49
2020-12-10,98,14,761,22,2,29,112
2020-12-10,0,0,25,0,0,0,0
2020-12-10,49,0,561,10,0,13,49
2020-12-10,1132,109,4029,234,7,71,1241
2020-12-10,25,5,335,8,0,9,30
2020-12-10,3,1,29,3,0,0,4
2020-12-10,5,0,47,0,0,0,5
2020-12-10,3,1,48,0,0,5,4
2020-12-10,278,34,2550,81,5,70,312
2020-12-10,0,0,14,0,0,0,0
2020-12-10,3,0,33,3,0,2,3
2020-12-10,24,0,96,12,0,3,24
2020-12-10,176,18,757,21,0,21,194
2020-12-10,11,0,56,2,0,10,11
2020-12-10,8,0,84,0,0,1,8
2020-12-10,4,0,77,2,0,1,4
2020-12-10,419,19,3127,97,4,35,438
2020-12-10,127,0,265,33,0,1,127
2020-12-10,14,1,255,7,0,4,15
2020-12-10,809,141,3517,170,9,53,950
2020-12-10,4,1,260,3,0,3,5
2020-12-10,3850,323,20075,856,38,440,4173
2020-12-10,7,0,79,2,0,7,7
2020-12-10,146,12,1217,52,2,32,158
2020-12-10,2,0,35,0,0,0,2
2020-12-10,136,5,636,14,0,10,141
2020-12-10,902,61,6963,245,11,194,963
2020-12-10,18,2,117,5,0,2,20
2020-12-10,31,5,275,9,0,5,36
2020-12-10,156,8,1572,32,1,38,164
2020-12-10,0,0,12,0,0,0,0
2020-12-10,68,9,599,9,2,9,77
2020-12-10,1,0,17,0,0,1,1
2020-12-10,73,3,688,17,0,37,76
2020-12-10,61,3,451,6,0,8,64
2020-12-10,2,0,19,0,0,0,2
2020-12-10,2,0,51,1,0,1,2
2020-12-10,9,0,51,3,0,0,9
2020-12-10,236,11,1170,52,0,22,247
2020-12-10,119,3,717,18,0,23,122
2020-12-10,2,0,25,0,0,0,2
2020-12-10,45,0,372,9,0,2,45
2020-12-10,88,14,592,22,1,15,102
2020-12-10,472,41,1570,79,8,11,513
2020-12-10,233,8,1020,59,2,3,241
2020-12-10,13,0,59,1,0,2,13
2020-12-10,19,1,460,4,0,21,20
2020-12-11,28,4,275,10,0,6,32
2020-12-11,433,20,2623,85,5,57,453
2020-12-11,855,149,3498,171,10,46,1004
2020-12-11,462,29,1557,89,4,14,491
2020-12-11,45,0,271,8,0,4,45
2020-12-11,24,0,96,12,0,14,24
2020-12-11,66,3,451,9,0,8,69
2020-12-11,19,0,460,5,0,19,19
2020-12-11,7,0,86,2,0,7,7
2020-12-11,174,9,636,15,0,8,183
2020-12-11,10,0,51,3,0,0,10
2020-12-11,928,73,6884,261,13,182,1001
2020-12-11,176,18,734,17,2,3,194
2020-12-11,60,0,561,8,0,12,60
2020-12-11,247,9,1020,65,0,4,256
2020-12-11,8,0,25,2,0,0,8
2020-12-11,8,0,84,1,0,2,8
2020-12-11,1150,76,6029,273,10,104,1226
2020-12-11,287,8,1287,58,1,13,295
2020-12-11,1,0,17,0,0,2,1
2020-12-11,124,3,717,21,0,20,127
2020-12-11,124,0,265,30,0,1,124
2020-12-11,3,1,48,0,0,5,4
2020-12-11,0,0,25,0,0,0,0
2020-12-11,103,9,756,25,1,32,112
2020-12-11,91,12,585,27,0,9,103
2020-12-11,4,0,25,0,0,0,4
2020-12-11,26,4,343,8,0,8,30
2020-12-11,4,1,29,1,0,3,5
2020-12-11,1,0,35,0,0,0,1
2020-12-11,11,0,59,1,0,2,11
2020-12-11,26,1,190,11,0,3,27
2020-12-11,281,36,2553,77,5,63,317
2020-12-11,431,19,3123,97,5,42,450
2020-12-11,48,0,372,9,0,0,48
2020-12-11,0,0,14,0,0,0,0
2020-12-11,17,2,125,4,0,2,19
2020-12-11,5,0,47,0,0,0,5
2020-12-11,4,0,260,2,0,5,4
2020-12-11,75,0,688,21,0,38,75
2020-12-11,155,11,1568,35,0,40,166
2020-12-11,18,1,259,11,0,9,19
2020-12-11,152,11,1213,54,2,36,163
2020-12-11,248,5,1163,58,0,15,253
2020-12-11,9,0,56,2,0,10,9
2020-12-11,73,0,129,7,0,0,73
2020-12-11,127,8,1926,33,0,45,135
2020-12-11,1154,86,4041,247,7,59,1240
2020-12-11,5,0,77,2,0,1,5
2020-12-11,4009,353,20255,845,47,444,4362
2020-12-11,2,0,19,0,0,0,2
2020-12-11,70,5,576,10,2,17,75
2020-12-11,0,0,12,0,0,0,0
2020-12-11,50,0,261,15,0,1,50
2020-12-11,2,0,51,1,0,1,2
2020-12-11,4,0,33,4,0,3,4
2020-12-12,7,0,86,2,0,7,7
2020-12-12,77,0,117,5,0,2,77
2020-12-12,286,34,2549,79,7,67,320
2020-12-12,25,5,343,11,1,7,30
2020-12-12,173,13,1565,41,1,35,186
2020-12-12,2,0,19,0,0,0,2
2020-12-12,5,1,29,2,0,2,6
2020-12-12,299,8,1292,56,3,21,307
2020-12-12,5,0,47,0,0,0,5
2020-12-12,18,2,121,4,0,2,20
2020-12-12,0,0,14,0,0,0,0
2020-12-12,1,0,17,0,0,2,1
2020-12-12,1236,71,6047,284,5,98,1307
2020-12-12,4203,365,20166,883,53,392,4568
2020-12-12,12,0,59,2,0,3,12
2020-12-12,173,11,1203,60,3,31,184
2020-12-12,976,61,6869,265,9,193,1037
2020-12-12,2,0,51,1,0,3,2
2020-12-12,135,0,265,32,0,2,135
2020-12-12,4,0,25,0,0,0,4
2020-12-12,78,1,688,20,0,45,79
2020-12-12,65,1,451,9,0,11,66
2020-12-12,32,6,275,7,0,12,38
2020-12-12,5,0,33,4,0,3,5
2020-12-12,94,10,589,25,2,9,104
2020-12-12,8,0,56,2,0,10,8
2020-12-12,2,0,48,0,0,5,2
2020-12-12,102,9,741,24,0,37,111
2020-12-12,262,8,940,62,0,5,270
2020-12-12,130,4,1916,35,2,44,134
2020-12-12,1,0,12,0,0,0,1
2020-12-12,52,0,372,10,0,3,52
2020-12-12,176,6,636,15,0,7,182
2020-12-12,120,6,717,23,0,18,126
2020-12-12,25,1,190,10,0,7,26
2020-12-12,1234,88,4033,249,9,62,1322
2020-12-12,4,1,264,2,1,8,5
2020-12-12,9,0,25,2,0,0,9
2020-12-12,18,0,254,6,0,2,18
2020-12-12,25,3,460,7,0,23,28
2020-12-12,273,9,1122,62,0,18,282
2020-12-12,901,95,3480,169,10,39,996
2020-12-12,8,0,56,3,0,2,8
2020-12-12,451,14,3085,104,2,45,465
2020-12-12,7,0,84,1,0,3,7
2020-12-12,1,0,35,0,0,0,1
2020-12-12,61,2,561,14,1,8,63
2020-12-12,456,19,2600,87,3,70,475
2020-12-12,0,0,25,0,0,0,0
2020-12-12,65,6,584,10,1,20,71
2020-12-12,11,0,51,2,0,3,11
2020-12-12,450,39,1557,89,3,12,489
2020-12-12,4,0,77,2,0,1,4
2020-12-12,62,1,261,15,0,3,63
2020-12-12,43,0,271,8,0,7,43
2020-12-12,173,13,746,15,1,3,186
2020-12-13,26,5,339,11,0,5,31
2020-12-13,70,10,572,11,3,21,80
2020-12-13,11,0,59,2,0,1,11
2020-12-13,14,0,88,2,0,6,14
2020-12-13,277,8,929,66,0,6,285
2020-12-13,27,2,190,8,0,8,29
2020-12-13,6,0,25,0,0,0,6
2020-12-13,0,0,12,0,0,0,0
2020-12-13,302,47,2540,88,6,74,349
2020-12-13,32,1,460,8,0,23,33
2020-12-13,8,0,56,2,0,10,8
2020-12-13,62,2,261,15,0,2,64
2020-12-13,181,11,1191,59,4,27,192
2020-12-13,994,40,6868,275,1,179,1034
2020-12-13,75,0,119,6,0,3,75
2020-12-13,182,10,748,18,3,7,192
2020-12-13,5,0,47,0,0,0,5
2020-12-13,89,1,688,21,0,48,90
2020-12-13,65,1,561,14,1,7,66
2020-12-13,139,4,1867,36,1,54,143
2020-12-13,0,0,14,0,0,0,0
2020-12-13,0,0,19,0,0,0,0
2020-12-13,930,110,3499,184,7,31,1040
2020-12-13,7,0,33,4,0,3,7
2020-12-13,4403,372,20090,935,52,404,4775
2020-12-13,103,10,581,29,1,8,113
2020-12-13,13,0,51,4,0,0,13
2020-12-13,127,6,717,23,0,19,133
2020-12-13,20,0,265,7,0,6,20
2020-12-13,41,0,271,8,0,6,41
2020-12-13,3,0,48,0,0,5,3
2020-12-13,1277,87,4037,264,5,55,1364
2020-12-13,4,3,270,2,0,11,7
2020-12-13,295,6,1125,66,0,10,301
2020-12-13,18,2,133,3,0,4,20
2020-12-13,317,13,1294,57,3,12,330
2020-12-13,6,1,29,2,0,2,7
2020-12-13,177,17,1546,44,2,50,194
2020-12-13,178,4,636,13,0,9,182
2020-12-13,3,0,51,1,0,2,3
2020-12-13,1287,71,5968,288,5,86,1358
2020-12-13,53,0,372,11,0,4,53
2020-12-13,11,0,25,2,0,0,11
2020-12-13,4,0,77,2,0,3,4
2020-12-13,34,0,275,8,0,11,34
2020-12-13,105,10,746,26,1,38,115
2020-12-13,0,0,25,0,0,0,0
2020-12-13,458,49,1559,90,8,13,507
2020-12-13,143,0,265,31,0,0,143
2020-12-13,1,0,35,0,0,0,1
2020-12-13,480,23,3106,108,4,54,503
2020-12-13,463,17,2582,87,4,79,480
2020-12-13,7,0,84,1,0,3,7
2020-12-13,77,0,451,14,0,11,77
2020-12-13,24,0,96,11,0,3,24
2020-12-13,1,0,17,0,0,1,1
2020-12-14,4656,314,20115,988,38,390,4970
2020-12-14,30,3,335,12,0,4,33
2020-12-14,330,44,2532,95,3,73,374
2020-12-14,1371,89,6002,296,16,101,1460
2020-12-14,75,0,126,6,0,3,75
2020-12-14,18,1,134,2,1,2,19
2020-12-14,1,0,51,0,0,3,1
2020-12-14,41,0,271,8,0,10,41
2020-12-14,11,0,25,2,0,0,11
2020-12-14,19,1,252,7,1,6,20
2020-12-14,1019,63,6867,282,8,193,1082
2020-12-14,178,4,636,15,0,8,182
2020-12-14,284,4,1150,61,0,16,288
2020-12-14,185,15,1538,44,2,38,200
2020-12-14,293,8,927,71,1,4,301
2020-12-14,29,1,190,8,1,7,30
2020-12-14,13,0,51,3,0,2,13
2020-12-14,5,0,77,2,0,2,5
2020-12-14,77,0,451,14,0,13,77
2020-12-14,32,0,460,9,0,20,32
2020-12-14,1319,96,4072,273,8,59,1415
2020-12-14,76,4,545,13,1,20,80
2020-12-14,15,0,88,3,0,7,15
2020-12-14,111,10,749,27,0,36,121
2020-12-14,0,0,19,0,0,0,0
2020-12-14,107,13,575,32,1,8,120
2020-12-14,210,10,1208,58,4,32,220
2020-12-14,0,0,25,0,0,0,0
2020-12-14,57,0,372,9,0,4,57
2020-12-14,5,0,47,0,0,0,5
2020-12-14,91,0,688,23,0,46,91
2020-12-14,511,27,3101,124,2,66,538
2020-12-14,151,0,265,31,0,1,151
2020-12-14,1,0,35,0,0,0,1
2020-12-14,35,3,275,7,1,13,38
2020-12-14,150,3,1861,39,1,63,153
2020-12-14,491,37,1582,73,3,16,528
2020-12-14,4,0,84,0,0,3,4
2020-12-14,133,7,717,25,1,16,140
2020-12-14,972,106,3485,195,6,27,1078
2020-12-14,12,0,59,2,0,2,12
2020-12-14,0,0,14,0,0,0,0
2020-12-14,4,1,56,2,0,8,5
2020-12-14,473,21,2572,90,4,86,494
2020-12-14,26,0,97,14,0,5,26
2020-12-14,3,0,48,0,0,5,3
2020-12-14,1,0,17,0,0,2,1
2020-12-14,60,0,561,13,0,8,60
2020-12-14,6,0,33,4,0,3,6
2020-12-14,5,1,29,0,0,4,6
2020-12-14,4,0,25,0,0,0,4
2020-12-14,184,11,752,23,3,0,195
2020-12-14,334,14,1296,60,5,16,348
2020-12-14,0,0,12,0,0,0,0
2020-12-14,61,1,261,13,0,4,62
2020-12-14,4,3,266,3,1,11,7
2020-12-15,1486,81,6070,319,11,95,1567
2020-12-15,6,1,56,2,0,8,7
2020-12-15,1413,92,4075,271,8,53,1505
2020-12-15,1,0,51,1,0,1,1
2020-12-15,34,2,460,8,0,21,36
2020-12-15,1000,116,3536,212,7,26,1116
2020-12-15,187,11,736,26,2,2,198
2020-12-15,34,2,347,12,0,4,36
2020-12-15,4864,344,20253,991,35,369,5208
2020-12-15,148,4,717,24,1,12,152
2020-12-15,46,0,271,9,0,7,46
2020-12-15,470,22,2627,93,8,83,492
2020-12-15,0,0,12,0,0,0,0
2020-12-15,6,0,33,4,0,3,6
2020-12-15,6,0,25,0,0,0,6
2020-12-15,15,0,51,3,0,0,15
2020-12-15,0,0,14,0,0,0,0
2020-12-15,13,0,59,2,0,1,13
2020-12-15,1103,70,6878,298,9,175,1173
2020-12-15,90,2,688,24,1,37,92
2020-12-15,16,0,88,3,0,6,16
2020-12-15,36,11,275,7,0,11,47
2020-12-15,334,20,1296,59,6,7,354
2020-12-15,535,18,3100,133,3,39,553
2020-12-15,173,7,636,19,2,12,180
2020-12-15,226,7,1218,59,3,30,233
2020-12-15,2,0,35,0,0,0,2
2020-12-15,121,11,537,32,1,11,132
2020-12-15,27,0,96,16,0,1,27
2020-12-15,332,45,2556,93,5,72,377
2020-12-15,79,0,132,7,0,4,79
2020-12-15,141,3,1903,42,0,48,144
2020-12-15,84,0,451,13,0,12,84
2020-12-15,66,3,549,11,1,23,69
2020-12-15,4,0,48,0,0,5,4
2020-12-15,20,0,119,1,0,2,20
2020-12-15,296,3,1148,64,0,19,299
2020-12-15,163,1,265,35,0,3,164
2020-12-15,18,0,250,6,0,6,18
2020-12-15,32,1,190,9,0,7,33
2020-12-15,110,14,748,27,0,34,124
2020-12-15,188,9,1541,48,2,31,197
2020-12-15,12,0,25,3,0,0,12
2020-12-15,7,0,29,0,0,4,7
2020-12-15,5,0,47,0,0,0,5
2020-12-15,491,40,1576,86,2,11,531
2020-12-15,7,0,77,2,0,2,7
2020-12-15,65,0,561,15,0,7,65
2020-12-15,4,3,278,2,2,14,7
2020-12-15,54,0,372,10,0,2,54
2020-12-15,0,0,25,0,0,0,0
2020-12-15,305,4,959,72,0,6,309
2020-12-15,59,0,261,14,0,2,59
2020-12-15,3,0,84,1,0,1,3
2020-12-15,0,0,19,0,0,0,0
2020-12-15,2,0,17,0,0,2,2
2020-12-16,97,5,688,24,2,37,102
2020-12-16,527,30,1583,91,5,10,557
2020-12-16,3,0,84,0,0,4,3
2020-12-16,6,3,274,3,2,14,9
2020-12-16,196,10,1508,50,1,28,206
2020-12-16,1054,85,3530,216,7,29,1139
2020-12-16,65,2,569,11,0,23,67
2020-12-16,5,0,47,0,0,0,5
2020-12-16,315,8,955,75,1,4,323
2020-12-16,24,0,96,14,0,1,24
2020-12-16,13,0,51,3,0,0,13
2020-12-16,11,0,59,1,0,1,11
2020-12-16,478,31,2611,102,3,70,509
2020-12-16,59,0,271,12,0,7,59
2020-12-16,1519,96,6058,343,15,79,1615
2020-12-16,28,0,190,10,0,4,28
2020-12-16,34,1,460,9,1,19,35
2020-12-16,1458,127,4063,285,12,41,1585
2020-12-16,4,0,77,1,0,2,4
2020-12-16,145,2,717,24,1,15,147
2020-12-16,0,0,25,0,0,0,0
2020-12-16,72,0,567,13,0,5,72
2020-12-16,5,0,48,0,0,5,5
2020-12-16,105,16,586,32,1,9,121
2020-12-16,1,0,51,1,0,0,1
2020-12-16,0,0,19,0,0,0,0
2020-12-16,303,8,1166,62,0,25,311
2020-12-16,336,39,2558,89,5,73,375
2020-12-16,179,9,728,27,2,5,188
2020-12-16,12,0,25,3,0,0,12
2020-12-16,22,1,254,7,0,6,23
2020-12-16,0,0,12,0,0,0,0
2020-12-16,2,0,17,0,0,2,2
2020-12-16,35,3,349,10,0,5,38
2020-12-16,4,0,35,0,0,0,4
2020-12-16,4,0,33,2,0,4,4
2020-12-16,75,0,127,7,0,0,75
2020-12-16,9,0,56,2,0,9,9
2020-12-16,58,0,372,11,0,2,58
2020-12-16,173,9,636,16,2,12,182
2020-12-16,116,13,758,31,1,28,129
2020-12-16,40,9,275,6,0,9,49
2020-12-16,0,0,14,0,0,0,0
2020-12-16,7,0,29,2,0,2,7
2020-12-16,230,11,1222,63,4,35,241
2020-12-16,14,0,96,3,0,5,14
2020-12-16,86,1,451,11,0,14,87
2020-12-16,1126,60,6798,295,6,168,1186
2020-12-16,165,0,265,38,0,0,165
2020-12-16,18,0,136,3,0,0,18
2020-12-16,7,0,25,0,0,0,7
2020-12-16,5100,366,20253,1035,36,338,5466
2020-12-16,53,1,261,13,0,2,54
2020-12-16,559,26,3126,127,1,46,585
2020-12-16,140,3,1943,41,0,51,143
2020-12-16,334,20,1307,56,4,12,354
2020-12-17,9,0,29,2,0,2,9
2020-12-17,6,0,25,0,0,0,6
2020-12-17,4,0,33,2,0,4,4
2020-12-17,7,4,275,3,2,11,11
2020-12-17,13,0,25,3,0,0,13
2020-12-17,184,11,751,23,3,21,195
2020-12-17,1,0,51,1,0,0,1
2020-12-17,240,19,1215,64,3,31,259
2020-12-17,8,0,59,1,0,2,8
2020-12-17,0,0,14,0,0,0,0
2020-12-17,151,2,717,29,0,18,153
2020-12-17,25,0,190,9,0,4,25
2020-12-17,553,39,1618,106,0,13,592
2020-12-17,152,9,1951,39,3,43,161
2020-12-17,5424,339,20282,1115,29,316,5763
2020-12-17,13,0,96,4,0,4,13
2020-12-17,5,0,48,0,0,5,5
2020-12-17,17,0,125,5,0,0,17
2020-12-17,77,0,124,8,0,0,77
2020-12-17,106,19,592,32,1,14,125
2020-12-17,70,3,598,14,1,20,73
2020-12-17,54,0,261,12,0,2,54
2020-12-17,0,0,25,0,0,0,0
2020-12-17,561,27,3129,131,1,49,588
2020-12-17,31,2,342,8,0,8,33
2020-12-17,1557,78,6054,358,16,90,1635
2020-12-17,59,0,372,12,0,2,59
2020-12-17,352,50,2557,93,3,65,402
2020-12-17,1492,100,4094,291,8,40,1592
2020-12-17,5,0,47,0,0,0,5
2020-12-17,70,4,567,12,0,4,74
2020-12-17,98,5,688,23,2,38,103
2020-12-17,35,1,460,9,0,19,36
2020-12-17,22,2,249,7,2,5,24
2020-12-17,6,0,77,1,0,2,6
2020-12-17,23,0,96,12,0,5,23
2020-12-17,84,0,451,13,0,9,84
2020-12-17,315,5,1161,70,0,13,320
2020-12-17,1164,55,6833,305,9,172,1219
2020-12-17,1092,94,3488,224,7,18,1186
2020-12-17,42,2,275,6,0,10,44
2020-12-17,1,0,17,0,0,2,1
2020-12-17,177,6,638,18,0,13,183
2020-12-17,340,14,1306,58,2,11,354
2020-12-17,313,10,957,75,2,4,323
2020-12-17,0,0,19,0,0,0,0
2020-12-17,6,0,84,0,0,4,6
2020-12-17,58,0,271,15,0,4,58
2020-12-17,0,0,12,0,0,0,0
2020-12-17,197,15,1506,58,6,29,212
2020-12-17,13,0,51,2,0,1,13
2020-12-17,7,0,56,2,0,7,7
2020-12-17,174,0,265,40,0,0,174
2020-12-17,471,22,2626,103,5,72,493
2020-12-17,6,0,35,0,0,0,6
2020-12-17,129,9,750,29,1,28,138
2020-12-18,38,1,460,10,0,19,39
2020-12-18,75,2,599,13,0,21,77
2020-12-18,5,0,35,0,0,0,5
2020-12-18,592,25,3134,135,5,43,617
2020-12-18,323,11,963,77,1,3,334
2020-12-18,190,14,753,28,1,23,204
2020-12-18,5,0,47,0,0,0,5
2020-12-18,12,0,51,1,0,0,12
2020-12-18,1601,74,6084,361,13,103,1675
2020-12-18,312,5,1161,71,0,15,317
2020-12-18,5,0,33,3,0,4,5
2020-12-18,13,0,96,4,0,4,13
2020-12-18,8,0,59,1,0,2,8
2020-12-18,58,0,271,15,0,4,58
2020-12-18,6,0,25,0,0,0,6
2020-12-18,10,0,29,0,0,4,10
2020-12-18,486,22,2627,108,6,73,508
2020-12-18,38,2,275,7,0,6,40
2020-12-18,353,49,2529,92,9,70,402
2020-12-18,58,0,372,12,0,3,58
2020-12-18,67,4,567,14,0,4,71
2020-12-18,17,1,125,6,0,0,18
2020-12-18,29,2,335,8,1,7,31
2020-12-18,5549,323,20349,1156,25,308,5872
2020-12-18,109,16,595,32,1,12,125
2020-12-18,102,5,688,21,1,40,107
2020-12-18,54,0,261,12,0,2,54
2020-12-18,0,0,25,0,0,0,0
2020-12-18,1169,88,3563,226,7,33,1257
2020-12-18,352,10,1306,62,0,12,362
2020-12-18,1204,49,6818,310,6,183,1253
2020-12-18,2,0,52,2,0,2,2
2020-12-18,12,0,25,3,0,0,12
2020-12-18,153,9,1922,41,2,43,162
2020-12-18,185,8,627,21,0,14,193
2020-12-18,9,1,276,3,0,10,10
2020-12-18,139,14,750,27,3,37,153
2020-12-18,8,0,77,3,0,2,8
2020-12-18,77,0,124,8,0,0,77
2020-12-18,0,0,12,0,0,0,0
2020-12-18,243,13,1208,61,0,34,256
2020-12-18,223,12,1513,60,2,27,235
2020-12-18,565,33,1586,107,4,13,598
2020-12-18,0,0,19,0,0,0,0
2020-12-18,1508,137,4093,293,10,42,1645
2020-12-18,179,0,265,40,0,0,179
2020-12-18,5,0,48,0,0,5,5
2020-12-18,0,0,14,0,0,0,0
2020-12-18,6,0,61,2,0,8,6
2020-12-18,6,0,84,0,0,4,6
2020-12-18,23,0,96,11,0,5,23
2020-12-18,22,0,190,8,0,5,22
2020-12-18,22,1,249,8,0,5,23
2020-12-18,74,0,451,11,0,13,74
2020-12-18,164,2,717,29,0,15,166
2020-12-18,0,0,17,0,0,2,0
2020-12-19,199,0,265,40,0,2,199
2020-12-19,5,0,33,3,0,4,5
2020-12-19,1211,53,6825,316,8,209,1264
2020-12-19,12,0,25,3,0,0,12
2020-12-19,0,0,14,0,0,0,0
2020-12-19,164,6,1924,39,0,61,170
2020-12-19,19,0,252,6,0,5,19
2020-12-19,10,0,77,3,0,2,10
2020-12-19,592,22,3125,134,3,35,614
2020-12-19,17,3,134,4,1,1,20
2020-12-19,343,11,1302,64,1,10,354
2020-12-19,1682,75,6072,375,11,116,1757
2020-12-19,23,1,96,12,0,2,24
2020-12-19,189,12,748,29,2,22,201
2020-12-19,0,0,19,0,0,0,0
2020-12-19,8,0,56,2,0,8,8
2020-12-19,71,3,576,17,0,21,74
2020-12-19,8,0,96,3,0,5,8
2020-12-19,59,0,373,14,0,2,59
2020-12-19,61,0,271,17,0,0,61
2020-12-19,1178,102,3550,235,8,37,1280
2020-12-19,184,2,624,23,0,12,186
2020-12-19,10,0,29,0,0,4,10
2020-12-19,136,11,739,26,2,29,147
2020-12-19,57,0,261,12,0,5,57
2020-12-19,9,0,59,2,0,2,9
2020-12-19,60,1,567,8,1,4,61
2020-12-19,228,11,1518,59,2,38,239
2020-12-19,2,0,53,2,0,3,2
2020-12-19,5,0,35,0,0,0,5
2020-12-19,359,42,2529,100,10,75,401
2020-12-19,0,0,12,0,0,0,0
2020-12-19,114,19,581,32,1,13,133
2020-12-19,1508,126,4073,299,5,44,1634
2020-12-19,21,0,190,8,0,4,21
2020-12-19,105,3,688,23,1,46,108
2020-12-19,90,0,451,17,0,5,90
2020-12-19,575,30,1566,109,6,8,605
2020-12-19,0,0,17,0,0,2,0
2020-12-19,22,4,335,9,1,10,26
2020-12-19,477,25,2635,110,5,63,502
2020-12-19,0,0,25,0,0,0,0
2020-12-19,92,0,120,8,0,0,92
2020-12-19,40,4,275,9,1,7,44
2020-12-19,5,0,25,0,0,0,5
2020-12-19,331,6,1152,72,0,22,337
2020-12-19,171,2,717,30,0,10,173
2020-12-19,6,0,48,0,0,5,6
2020-12-19,5709,309,20319,1175,23,328,6018
2020-12-19,338,9,956,80,2,0,347
2020-12-19,265,14,1218,71,2,38,279
2020-12-19,10,0,84,0,0,4,10
2020-12-19,7,1,275,3,0,10,8
2020-12-19,5,0,47,0,0,0,5
2020-12-19,40,0,460,10,0,20,40
2020-12-19,11,0,51,1,0,0,11
2020-12-20,333,6,971,76,2,2,339
2020-12-20,88,1,451,9,0,8,89
2020-12-20,198,0,265,41,0,2,198
2020-12-20,15,0,25,3,0,0,15
2020-12-20,569,29,1555,104,5,18,598
2020-12-20,10,0,59,4,0,1,10
2020-12-20,0,0,17,0,0,2,0
2020-12-20,0,0,14,0,0,0,0
2020-12-20,10,0,95,3,0,5,10
2020-12-20,39,0,460,8,0,25,39
2020-12-20,2,0,51,2,0,3,2
2020-12-20,8,0,56,2,0,7,8
2020-12-20,11,0,84,1,0,4,11
2020-12-20,0,0,19,0,0,0,0
2020-12-20,6,0,48,0,0,5,6
2020-12-20,26,4,325,11,1,10,30
2020-12-20,8,1,51,1,0,2,9
2020-12-20,5866,358,20231,1202,31,354,6224
2020-12-20,0,0,25,0,0,0,0
2020-12-20,236,14,1505,55,2,37,250
2020-12-20,21,1,190,6,0,6,22
2020-12-20,21,2,120,5,0,1,23
2020-12-20,34,4,275,9,1,9,38
2020-12-20,8,0,77,2,0,2,8
2020-12-20,60,0,567,7,0,9,60
2020-12-20,10,0,29,0,0,4,10
2020-12-20,1248,46,6687,331,10,214,1294
2020-12-20,1239,94,3494,229,6,36,1333
2020-12-20,493,262,2602,97,10,71,755
2020-12-20,26,1,96,12,0,6,27
2020-12-20,7,3,270,1,0,12,10
2020-12-20,66,3,547,17,0,25,69
2020-12-20,58,0,261,10,0,0,58
2020-12-20,326,3,1132,73,0,19,329
2020-12-20,18,0,238,6,0,5,18
2020-12-20,599,24,3105,134,5,41,623
2020-12-20,196,8,627,22,0,15,204
2020-12-20,5,0,25,0,0,0,5
2020-12-20,60,0,372,15,0,2,60
2020-12-20,5,0,47,0,0,0,5
2020-12-20,4,0,35,0,0,0,4
2020-12-20,170,5,1831,42,1,67,175
2020-12-20,1709,72,5965,380,11,103,1781
2020-12-20,373,41,2531,97,8,90,414
2020-12-20,262,16,1216,70,3,19,278
2020-12-20,6,0,33,3,0,5,6
2020-12-20,166,2,717,30,0,11,168
2020-12-20,346,9,1302,60,0,11,355
2020-12-20,0,0,12,0,0,0,0
2020-12-20,181,9,747,29,0,27,190
2020-12-20,103,6,688,22,2,49,109
2020-12-20,110,12,559,31,1,12,122
2020-12-20,1545,125,4085,329,8,38,1670
2020-12-20,133,8,744,30,5,31,141
2020-12-20,67,0,271,15,0,4,67
2020-12-20,90,0,115,8,0,0,90
2020-12-21,1618,101,4116,326,5,40,1719
2020-12-21,130,7,738,29,2,33,137
2020-12-21,365,8,1308,58,1,12,373
2020-12-21,113,5,688,22,2,53,118
2020-12-21,1314,61,6700,341,6,197,1375
2020-12-21,273,8,1235,71,2,26,281
2020-12-21,373,38,2532,106,6,82,411
2020-12-21,12,0,48,0,0,5,12
2020-12-21,62,3,541,16,0,23,65
2020-12-21,500,262,2604,104,6,68,762
2020-12-21,10,0,29,0,0,4,10
2020-12-21,5,0,25,0,0,0,5
2020-12-21,599,25,3105,138,4,50,624
2020-12-21,23,0,190,5,0,11,23
2020-12-21,0,0,12,0,0,0,0
2020-12-21,20,0,247,6,0,5,20
2020-12-21,44,1,460,9,0,22,45
2020-12-21,587,28,1569,123,3,14,615
2020-12-21,194,1,265,40,0,2,195
2020-12-21,6155,305,20241,1234,34,373,6460
2020-12-21,6,0,33,3,0,4,6
2020-12-21,6,3,270,2,0,12,9
2020-12-21,0,0,17,0,0,2,0
2020-12-21,24,0,96,12,0,5,24
2020-12-21,8,0,51,1,0,0,8
2020-12-21,175,12,751,27,1,21,187
2020-12-21,238,17,1511,57,1,40,255
2020-12-21,62,0,261,9,0,6,62
2020-12-21,5,0,35,0,0,0,5
2020-12-21,198,8,627,24,2,7,206
2020-12-21,118,16,573,29,5,13,134
2020-12-21,57,0,567,7,0,10,57
2020-12-21,7,0,77,2,0,2,7
2020-12-21,2,0,51,1,0,2,2
2020-12-21,14,0,96,4,0,6,14
2020-12-21,5,0,47,0,0,0,5
2020-12-21,17,0,120,4,0,1,17
2020-12-21,60,0,372,15,0,3,60
2020-12-21,0,0,14,0,0,0,0
2020-12-21,37,6,304,9,1,8,43
2020-12-21,0,0,25,0,0,0,0
2020-12-21,348,7,1123,73,0,9,355
2020-12-21,10,0,59,4,0,1,10
2020-12-21,1278,102,3517,250,7,17,1380
2020-12-21,328,7,969,74,2,1,335
2020-12-21,162,9,1909,45,2,63,171
2020-12-21,15,0,25,3,0,0,15
2020-12-21,95,0,451,10,0,9,95
2020-12-21,1806,72,6019,390,14,96,1878
2020-12-21,87,0,129,10,0,0,87
2020-12-21,9,0,56,3,0,7,9
2020-12-21,10,0,84,3,0,2,10
2020-12-21,28,4,334,9,0,12,32
2020-12-21,165,2,717,32,0,16,167
2020-12-21,0,0,19,0,0,0,0
2020-12-21,66,0,271,15,0,4,66
2020-12-22,8,0,33,4,0,4,8
2020-12-22,6,0,77,2,0,2,6
2020-12-22,1322,69,3505,247,9,33,1391
2020-12-22,26,0,190,5,0,8,26
2020-12-22,560,30,1582,106,3,7,590
2020-12-22,237,16,1528,53,2,35,253
2020-12-22,1854,61,6051,394,11,102,1915
2020-12-22,43,4,288,11,0,13,47
2020-12-22,16,0,91,4,0,5,16
2020-12-22,312,7,1226,72,3,26,319
2020-12-22,0,0,14,0,0,0,0
2020-12-22,0,0,12,0,0,0,0
2020-12-22,349,11,1313,62,1,10,360
2020-12-22,6499,321,20234,1280,46,386,6820
2020-12-22,6,0,35,0,0,0,6
2020-12-22,2,0,51,1,0,3,2
2020-12-22,12,0,48,0,0,5,12
2020-12-22,388,40,2525,118,9,68,428
2020-12-22,157,9,2002,47,0,53,166
2020-12-22,14,0,25,3,0,0,14
2020-12-22,0,0,17,0,0,2,0
2020-12-22,6,0,56,3,0,8,6
2020-12-22,6,0,25,0,0,0,6
2020-12-22,202,10,627,26,1,7,212
2020-12-22,59,0,567,9,0,6,59
2020-12-22,67,0,271,15,0,3,67
2020-12-22,0,0,25,0,0,0,0
2020-12-22,165,1,717,33,0,15,166
2020-12-22,21,0,261,6,0,11,21
2020-12-22,145,11,746,34,0,29,156
2020-12-22,1340,70,6704,346,14,184,1410
2020-12-22,123,3,688,21,0,42,126
2020-12-22,25,2,342,10,0,11,27
2020-12-22,65,0,372,17,0,4,65
2020-12-22,77,1,583,18,0,19,78
2020-12-22,63,0,261,9,0,4,63
2020-12-22,205,0,265,42,0,3,205
2020-12-22,185,18,755,25,1,20,203
2020-12-22,618,28,3142,148,3,44,646
2020-12-22,323,15,954,71,3,3,338
2020-12-22,88,0,451,12,0,7,88
2020-12-22,518,21,2611,103,10,74,539
2020-12-22,0,0,19,0,0,0,0
2020-12-22,137,16,589,30,4,18,153
2020-12-22,1635,119,4092,327,8,37,1754
2020-12-22,49,1,460,9,0,23,50
2020-12-22,5,0,47,0,0,0,5
2020-12-22,13,0,59,2,0,1,13
2020-12-22,83,0,127,9,0,0,83
2020-12-22,10,0,29,0,0,4,10
2020-12-22,15,0,126,5,0,3,15
2020-12-22,342,3,1130,72,0,11,345
2020-12-22,25,18,96,11,0,5,43
2020-12-22,7,0,84,1,0,2,7
2020-12-22,9,0,52,2,0,0,9
2020-12-22,6,8,274,2,0,13,14
2020-12-23,124,5,668,26,0,22,129
2020-12-23,83,0,117,10,0,0,83
2020-12-23,10,0,84,1,0,3,10
2020-12-23,25,2,345,10,1,12,27
2020-12-23,0,0,25,0,0,0,0
2020-12-23,328,10,1121,66,1,17,338
2020-12-23,157,8,746,41,1,24,165
2020-12-23,1404,62,6699,369,11,190,1466
2020-12-23,5,5,270,2,0,14,10
2020-12-23,27,1,190,5,0,7,28
2020-12-23,4,0,56,2,0,8,4
2020-12-23,20,0,141,6,0,1,20
2020-12-23,15,0,25,4,0,0,15
2020-12-23,0,0,17,0,0,2,0
2020-12-23,2,0,51,1,0,2,2
2020-12-23,8,0,29,0,0,4,8
2020-12-23,52,0,567,10,0,4,52
2020-12-23,63,0,372,16,0,5,63
2020-12-23,0,0,14,0,0,0,0
2020-12-23,9,0,52,3,0,0,9
2020-12-23,333,13,926,77,7,5,346
2020-12-23,6,0,35,0,0,0,6
2020-12-23,14,0,92,5,0,3,14
2020-12-23,635,22,3150,152,2,37,657
2020-12-23,137,15,595,28,0,12,152
2020-12-23,6708,292,20196,1329,35,355,7000
2020-12-23,403,46,2521,124,8,67,449
2020-12-23,0,0,12,0,0,0,0
2020-12-23,193,17,756,27,1,21,210
2020-12-23,342,12,1303,62,2,15,354
2020-12-23,60,0,271,14,0,3,60
2020-12-23,1642,107,4093,331,5,38,1749
2020-12-23,1893,73,6082,405,12,101,1966
2020-12-23,48,2,460,9,0,21,50
2020-12-23,17,0,48,0,0,5,17
2020-12-23,8,0,33,3,0,4,8
2020-12-23,155,3,717,34,0,12,158
2020-12-23,58,0,261,7,0,4,58
2020-12-23,629,37,1587,126,1,4,666
2020-12-23,45,9,288,10,1,14,54
2020-12-23,1,0,19,0,0,0,1
2020-12-23,20,0,250,7,0,8,20
2020-12-23,6,0,77,3,0,4,6
2020-12-23,512,22,2626,101,4,75,534
2020-12-23,243,14,1537,54,2,24,257
2020-12-23,197,0,265,43,0,2,197
2020-12-23,74,3,572,20,0,19,77
2020-12-23,27,1,96,12,0,3,28
2020-12-23,5,0,25,0,0,0,5
2020-12-23,81,0,451,11,0,10,81
2020-12-23,14,0,47,0,0,0,14
2020-12-23,1327,86,3526,255,6,25,1413
2020-12-23,319,14,1232,68,6,34,333
2020-12-23,15,0,59,2,0,2,15
2020-12-23,164,11,1995,45,1,52,175
2020-12-23,208,4,627,26,0,8,212
2020-12-24,6770,286,20203,1335,27,364,7056
2020-12-24,1,0,12,0,0,0,1
2020-12-24,129,12,565,34,2,12,141
2020-12-24,120,23,668,26,1,22,143
2020-12-24,13,2,88,4,2,4,15
2020-12-24,45,4,288,10,0,13,49
2020-12-24,1405,64,6710,361,7,197,1469
2020-12-24,475,19,2615,98,5,72,494
2020-12-24,47,1,460,8,0,23,48
2020-12-24,84,0,451,14,0,5,84
2020-12-24,242,16,1532,49,3,37,258
2020-12-24,1641,90,4064,325,3,31,1731
2020-12-24,1,0,19,0,0,0,1
2020-12-24,621,29,1541,106,4,5,650
2020-12-24,83,0,125,11,0,0,83
2020-12-24,16,0,25,4,0,0,16
2020-12-24,176,3,717,33,1,16,179
2020-12-24,10,0,52,3,0,0,10
2020-12-24,171,11,1972,53,0,58,182
2020-12-24,323,5,940,77,2,5,328
2020-12-24,192,19,755,28,1,24,211
2020-12-24,14,0,47,0,0,0,14
2020-12-24,21,0,119,6,0,0,21
2020-12-24,0,0,25,0,0,0,0
2020-12-24,5,0,56,1,0,9,5
2020-12-24,21,0,241,5,0,8,21
2020-12-24,342,7,1294,57,2,17,349
2020-12-24,4,0,35,0,0,0,4
2020-12-24,1955,51,6003,417,8,94,2006
2020-12-24,17,0,48,0,0,5,17
2020-12-24,149,8,742,36,1,21,157
2020-12-24,78,3,577,22,0,22,81
2020-12-24,30,6,346,9,0,9,36
2020-12-24,25,0,190,7,0,6,25
2020-12-24,6,0,84,0,0,2,6
2020-12-24,9,0,29,1,0,4,9
2020-12-24,45,3,567,6,0,13,48
2020-12-24,0,0,17,0,0,3,0
2020-12-24,629,21,3137,156,0,35,650
2020-12-24,67,2,372,17,0,5,69
2020-12-24,6,4,265,2,0,16,10
2020-12-24,57,0,261,9,0,3,57
2020-12-24,6,0,25,0,0,0,6
2020-12-24,29,0,170,12,0,17,29
2020-12-24,6,0,77,3,0,3,6
2020-12-24,6,0,33,2,0,4,6
2020-12-24,2,0,51,1,0,2,2
2020-12-24,326,3,1109,69,0,22,329
2020-12-24,14,0,59,4,0,2,14
2020-12-24,0,0,14,0,0,0,0
2020-12-24,54,0,271,13,0,4,54
2020-12-24,198,7,627,21,1,12,205
2020-12-24,385,37,2507,117,4,76,422
2020-12-24,1336,85,3502,267,6,49,1421
2020-12-24,333,13,1217,67,6,36,346
2020-12-24,197,0,265,43,0,0,197
2020-12-25,6,4,274,2,0,15,10
2020-12-25,633,19,3083,158,2,40,652
2020-12-25,8,0,56,1,0,9,8
2020-12-25,12,0,81,3,0,2,12
2020-12-25,349,11,1301,59,1,14,360
2020-12-25,82,0,112,9,0,0,82
2020-12-25,1335,85,3477,266,4,36,1420
2020-12-25,142,6,729,31,2,26,148
2020-12-25,22,0,119,6,0,0,22
2020-12-25,26,0,190,8,0,6,26
2020-12-25,325,13,1209,67,4,35,338
2020-12-25,389,38,2493,113,2,81,427
2020-12-25,6815,309,20189,1368,41,363,7124
2020-12-25,168,2,717,35,0,15,170
2020-12-25,68,2,372,18,0,6,70
2020-12-25,333,5,1084,77,0,16,338
2020-12-25,0,0,17,0,0,1,0
2020-12-25,249,16,1518,53,4,33,265
2020-12-25,192,8,751,24,2,20,200
2020-12-25,199,3,627,22,0,10,202
2020-12-25,1625,95,4031,337,4,49,1720
2020-12-25,0,0,14,0,0,0,0
2020-12-25,7,0,29,0,0,4,7
2020-12-25,49,0,271,13,0,5,49
2020-12-25,46,3,460,8,0,27,49
2020-12-25,43,4,567,8,0,11,47
2020-12-25,1,0,12,0,0,0,1
2020-12-25,60,2,261,12,1,4,62
2020-12-25,0,0,25,0,0,0,0
2020-12-25,3,0,35,0,0,0,3
2020-12-25,3,0,51,0,0,4,3
2020-12-25,185,0,265,44,0,0,185
2020-12-25,1416,41,6700,365,5,170,1457
2020-12-25,7,1,52,3,0,0,8
2020-12-25,25,47,169,12,0,17,72
2020-12-25,1,0,19,0,0,0,1
2020-12-25,6,0,84,0,0,4,6
2020-12-25,16,0,25,4,0,0,16
2020-12-25,16,0,59,2,0,1,16
2020-12-25,16,1,47,0,0,0,17
2020-12-25,133,11,557,32,1,13,144
2020-12-25,5,0,33,2,0,4,5
2020-12-25,1957,54,5998,432,4,93,2011
2020-12-25,68,1,542,21,0,21,69
2020-12-25,22,0,234,8,0,8,22
2020-12-25,6,0,25,0,0,0,6
2020-12-25,47,5,288,9,0,13,52
2020-12-25,91,0,451,15,0,4,91
2020-12-25,617,23,1537,136,3,7,640
2020-12-25,30,6,341,10,0,12,36
2020-12-25,473,20,2596,98,5,83,493
2020-12-25,14,0,48,0,0,5,14
2020-12-25,316,11,906,75,1,11,327
2020-12-25,5,0,77,3,0,2,5
2020-12-25,164,5,1941,49,1,67,169
2020-12-25,117,3,668,25,1,25,120
2020-12-26,121,4,668,29,0,27,125
2020-12-26,25,0,190,10,0,2,25
2020-12-26,47,1,567,8,0,11,48
2020-12-26,65,2,261,13,1,2,67
2020-12-26,200,5,627,21,0,15,205
2020-12-26,70,0,534,20,0,23,70
2020-12-26,1,0,19,0,0,0,1
2020-12-26,19,0,59,2,0,0,19
2020-12-26,16,0,25,4,0,0,16
2020-12-26,348,17,1301,59,3,20,365
2020-12-26,6914,303,20201,1404,35,424,7217
2020-12-26,6,0,56,1,0,9,6
2020-12-26,336,20,1214,68,4,33,356
2020-12-26,88,0,129,9,0,0,88
2020-12-26,1440,41,6714,388,9,171,1481
2020-12-26,174,2,265,42,0,4,176
2020-12-26,3,0,35,0,0,0,3
2020-12-26,44,1,288,9,0,12,45
2020-12-26,29,0,169,4,0,24,29
2020-12-26,192,11,747,25,0,23,203
2020-12-26,1,0,17,0,0,1,1
2020-12-26,100,0,451,16,0,3,100
2020-12-26,9,0,29,0,0,4,9
2020-12-26,1,0,12,0,0,0,1
2020-12-26,64,0,372,18,0,5,64
2020-12-26,320,12,913,80,1,7,332
2020-12-26,620,32,1543,135,4,8,652
2020-12-26,5,2,274,2,0,14,7
2020-12-26,8,1,77,4,1,1,9
2020-12-26,242,24,1519,56,5,29,266
2020-12-26,1990,56,5929,443,7,99,2046
2020-12-26,4,0,33,2,0,4,4
2020-12-26,0,0,25,0,0,0,0
2020-12-26,51,0,271,12,0,7,51
2020-12-26,452,27,2584,99,4,84,479
2020-12-26,7,0,25,0,0,0,7
2020-12-26,141,9,573,36,1,11,150
2020-12-26,1617,82,4022,329,6,45,1699
2020-12-26,21,1,120,4,0,0,22
2020-12-26,146,2,723,33,1,28,148
2020-12-26,14,0,48,0,0,5,14
2020-12-26,23,3,241,10,0,5,26
2020-12-26,6,0,84,1,0,2,6
2020-12-26,0,0,14,0,0,0,0
2020-12-26,357,9,1074,71,0,33,366
2020-12-26,49,2,460,9,0,25,51
2020-12-26,412,37,2506,118,4,80,449
2020-12-26,14,0,80,4,0,2,14
2020-12-26,26,3,335,10,0,8,29
2020-12-26,172,3,1929,47,0,72,175
2020-12-26,3,0,51,1,0,1,3
2020-12-26,180,2,717,38,0,12,182
2020-12-26,1382,89,3468,277,1,31,1471
2020-12-26,9,0,52,2,0,1,9
2020-12-26,637,18,3081,150,4,48,655
2020-12-26,16,1,47,0,0,0,17
2020-12-27,0,0,14,0,0,0,0
2020-12-27,70,0,373,17,0,3,70
2020-12-27,0,0,25,0,0,0,0
2020-12-27,56,1,460,13,0,20,57
2020-12-27,9,0,52,3,0,0,9
2020-12-27,463,27,2590,94,6,95,490
2020-12-27,1481,45,6714,394,4,175,1526
2020-12-27,11,0,29,0,0,4,11
2020-12-27,24,4,335,8,1,10,28
2020-12-27,54,0,271,12,0,6,54
2020-12-27,201,14,747,26,2,20,215
2020-12-27,3,0,33,1,0,4,3
2020-12-27,375,9,1096,73,0,12,384
2020-12-27,6,3,274,1,0,13,9
2020-12-27,84,0,451,17,0,3,84
2020-12-27,327,11,930,76,1,9,338
2020-12-27,3,0,51,1,0,2,3
2020-12-27,16,1,47,0,0,0,17
2020-12-27,68,1,261,14,0,1,69
2020-12-27,2031,52,6001,453,8,92,2083
2020-12-27,24,1,241,9,0,5,25
2020-12-27,7,1,84,1,0,5,8
2020-12-27,1,0,12,0,0,0,1
2020-12-27,90,0,127,9,0,0,90
2020-12-27,152,8,727,34,3,28,160
2020-12-27,1,0,17,0,0,2,1
2020-12-27,625,41,1564,138,5,8,666
2020-12-27,341,17,1213,74,5,37,358
2020-12-27,136,9,572,36,2,11,145
2020-12-27,14,0,48,0,0,5,14
2020-12-27,22,0,59,2,0,1,22
2020-12-27,19,0,131,5,0,0,19
2020-12-27,2,0,35,0,0,0,2
2020-12-27,661,23,3102,155,5,39,684
2020-12-27,7181,332,20222,1449,65,384,7513
2020-12-27,16,0,25,4,0,0,16
2020-12-27,352,11,1300,62,1,21,363
2020-12-27,8,0,77,3,0,1,8
2020-12-27,418,35,2503,115,4,75,453
2020-12-27,45,5,288,8,0,13,50
2020-12-27,179,5,1919,46,0,65,184
2020-12-27,29,0,169,13,0,15,29
2020-12-27,1367,106,3476,282,7,29,1473
2020-12-27,12,1,83,4,1,4,13
2020-12-27,127,7,668,33,1,22,134
2020-12-27,179,0,717,37,0,9,179
2020-12-27,46,1,567,6,0,10,47
2020-12-27,5,0,56,1,0,9,5
2020-12-27,190,2,265,42,0,4,192
2020-12-27,28,0,190,9,0,4,28
2020-12-27,1655,72,4034,343,5,48,1727
2020-12-27,257,23,1528,63,4,27,280
2020-12-27,5,0,25,0,0,0,5
2020-12-27,215,5,627,22,1,12,220
2020-12-27,1,0,19,0,0,0,1
2020-12-27,74,3,570,20,1,23,77
2020-12-28,206,20,745,28,1,19,226
2020-12-28,186,6,1930,48,3,64,192
2020-12-28,7415,297,20266,1496,34,356,7712
2020-12-28,1,0,12,0,0,0,1
2020-12-28,218,12,633,21,1,13,230
2020-12-28,1738,83,4076,342,5,53,1821
2020-12-28,157,8,724,36,3,27,165
2020-12-28,1,0,33,0,0,5,1
2020-12-28,65,2,460,14,0,23,67
2020-12-28,5,0,56,1,0,7,5
2020-12-28,1448,93,3535,287,5,41,1541
2020-12-28,0,0,17,0,0,2,0
2020-12-28,15,0,25,3,0,0,15
2020-12-28,71,0,372,17,0,2,71
2020-12-28,249,11,1529,62,3,29,260
2020-12-28,18,0,134,3,0,2,18
2020-12-28,7,5,274,2,0,14,12
2020-12-28,67,0,261,14,0,1,67
2020-12-28,47,5,288,8,0,13,52
2020-12-28,10,0,88,3,0,7,10
2020-12-28,16,1,47,0,0,0,17
2020-12-28,28,4,342,9,0,12,32
2020-12-28,191,0,717,34,0,13,191
2020-12-28,23,2,250,11,0,47,25
2020-12-28,77,0,451,12,0,3,77
2020-12-28,637,40,1593,117,1,13,677
2020-12-28,1,0,19,0,0,0,1
2020-12-28,5,0,25,0,0,0,5
2020-12-28,14,0,48,0,0,5,14
2020-12-28,0,0,14,0,0,0,0
2020-12-28,42,0,567,4,0,7,42
2020-12-28,182,3,265,48,0,2,185
2020-12-28,137,9,568,34,1,11,146
2020-12-28,690,24,3117,167,4,27,714
2020-12-28,8,0,77,3,0,1,8
2020-12-28,484,23,2608,93,5,101,507
2020-12-28,76,2,569,23,0,20,78
2020-12-28,11,0,29,1,0,3,11
2020-12-28,352,15,1299,62,1,20,367
2020-12-28,129,7,668,35,1,21,136
2020-12-28,26,0,190,9,0,3,26
2020-12-28,441,32,2518,117,3,70,473
2020-12-28,2106,56,6003,473,1,107,2162
2020-12-28,55,0,271,16,0,3,55
2020-12-28,354,11,1218,76,5,36,365
2020-12-28,0,0,25,0,0,0,0
2020-12-28,9,0,52,3,0,1,9
2020-12-28,2,0,51,1,0,2,2
2020-12-28,331,10,908,81,2,9,341
2020-12-28,8,1,84,1,0,5,9
2020-12-28,2,0,35,0,0,0,2
2020-12-28,90,1,129,8,0,0,91
2020-12-28,23,0,59,2,0,0,23
2020-12-28,388,11,1123,80,0,10,399
2020-12-28,1504,56,6722,396,3,176,1560
2020-12-28,24,0,169,7,0,22,24
2020-12-29,5,0,25,0,0,0,5
2020-12-29,329,12,907,83,3,8,341
2020-12-29,10,0,53,3,0,1,10
2020-12-29,45,0,567,5,0,13,45
2020-12-29,73,0,451,11,0,4,73
2020-12-29,206,6,1984,54,3,60,212
2020-12-29,11,0,91,2,0,6,11
2020-12-29,81,3,607,23,1,20,84
2020-12-29,94,0,146,10,0,2,94
2020-12-29,29,0,190,10,0,4,29
2020-12-29,329,16,1299,68,1,18,345
2020-12-29,701,19,3126,162,1,28,720
2020-12-29,2145,44,6060,479,2,70,2189
2020-12-29,7546,279,20330,1528,42,330,7825
2020-12-29,15,0,47,0,0,0,15
2020-12-29,449,32,2557,123,3,72,481
2020-12-29,135,6,668,34,0,23,141
2020-12-29,72,0,261,18,0,1,72
2020-12-29,0,0,14,0,0,0,0
2020-12-29,216,15,753,22,2,18,231
2020-12-29,357,14,1237,73,4,36,371
2020-12-29,74,0,372,15,0,1,74
2020-12-29,3,0,33,1,0,2,3
2020-12-29,10,0,29,1,0,3,10
2020-12-29,223,7,622,23,0,12,230
2020-12-29,0,0,25,0,0,0,0
2020-12-29,22,0,169,6,0,21,22
2020-12-29,2,0,56,1,0,9,2
2020-12-29,142,13,578,33,2,13,155
2020-12-29,168,5,746,34,0,28,173
2020-12-29,202,2,717,36,0,14,204
2020-12-29,48,8,288,8,0,11,56
2020-12-29,2,0,35,0,0,0,2
2020-12-29,383,7,1171,79,1,14,390
2020-12-29,629,23,1582,136,0,7,652
2020-12-29,10,1,84,2,0,2,11
2020-12-29,7,0,77,3,0,1,7
2020-12-29,56,0,271,16,0,0,56
2020-12-29,7,3,267,3,0,11,10
2020-12-29,247,15,1543,60,2,26,262
2020-12-29,1770,88,4160,345,7,57,1858
2020-12-29,176,2,265,53,0,-1,178
2020-12-29,13,0,25,3,0,0,13
2020-12-29,26,1,262,12,0,1,27
2020-12-29,1,0,19,0,0,0,1
2020-12-29,22,0,59,2,0,0,22
2020-12-29,61,0,460,15,0,19,61
2020-12-29,6,1,48,0,0,5,7
2020-12-29,15,0,125,4,0,2,15
2020-12-29,1484,84,3533,297,7,24,1568
2020-12-29,1,0,12,0,0,0,1
2020-12-29,30,4,347,6,0,12,34
2020-12-29,3,0,51,2,0,3,3
2020-12-29,0,0,17,0,0,1,0
2020-12-29,1470,62,6733,393,5,172,1532
2020-12-29,451,49,2608,92,3,86,500
2020-12-30,76,0,372,17,0,2,76
2020-12-30,73,25,261,18,0,0,98
2020-12-30,141,6,668,35,0,18,147
2020-12-30,90,1,129,7,0,0,91
2020-12-30,4,0,56,1,0,8,4
2020-12-30,88,2,590,18,0,24,90
2020-12-30,83,0,451,15,0,4,83
2020-12-30,58,1,460,14,0,20,59
2020-12-30,2,0,35,0,0,0,2
2020-12-30,198,1,717,34,0,13,199
2020-12-30,328,15,1296,69,3,16,343
2020-12-30,4,0,33,0,0,4,4
2020-12-30,51,12,288,7,0,8,63
2020-12-30,0,0,14,0,0,0,0
2020-12-30,4,0,51,2,0,3,4
2020-12-30,212,3,1967,56,2,59,215
2020-12-30,602,19,1571,118,4,12,621
2020-12-30,5,2,274,2,1,15,7
2020-12-30,255,16,1565,67,2,25,271
2020-12-30,14,0,47,0,0,0,14
2020-12-30,31,4,346,5,0,12,35
2020-12-30,200,15,756,23,2,18,215
2020-12-30,9,1,52,3,0,0,10
2020-12-30,29,0,190,11,0,0,29
2020-12-30,172,6,737,41,0,26,178
2020-12-30,1464,82,3572,296,3,31,1546
2020-12-30,0,0,17,0,0,1,0
2020-12-30,7628,300,20515,1580,40,320,7928
2020-12-30,13,0,137,4,0,1,13
2020-12-30,1707,78,4135,339,6,41,1785
2020-12-30,56,0,272,16,0,0,56
2020-12-30,376,8,1174,78,1,10,384
2020-12-30,454,42,2526,115,5,71,496
2020-12-30,1499,50,6741,393,6,160,1549
2020-12-30,6,0,48,0,0,5,6
2020-12-30,176,2,265,50,0,4,178
2020-12-30,138,12,583,35,0,3,150
2020-12-30,1,0,19,0,0,0,1
2020-12-30,22,0,59,1,0,0,22
2020-12-30,491,20,2631,97,3,80,511
2020-12-30,30,1,260,14,0,1,31
2020-12-30,10,0,84,2,0,3,10
2020-12-30,25,0,169,6,0,22,25
2020-12-30,695,20,3156,156,1,39,715
2020-12-30,9,0,29,1,0,3,9
2020-12-30,323,10,905,80,2,6,333
2020-12-30,218,9,622,24,1,14,227
2020-12-30,8,0,77,3,0,3,8
2020-12-30,1,0,12,0,0,0,1
2020-12-30,5,0,25,0,0,0,5
2020-12-30,0,0,25,0,0,0,0
2020-12-30,14,0,25,3,0,0,14
2020-12-30,11,0,96,2,0,8,11
2020-12-30,2128,41,6064,495,1,84,2169
2020-12-30,39,0,567,6,0,9,39
2020-12-30,364,20,1239,73,3,31,384
2020-12-31,57,1,272,18,0,1,58
2020-12-31,1487,56,6743,381,12,175,1543
2020-12-31,14,0,25,3,0,0,14
2020-12-31,5,0,56,2,0,8,5
2020-12-31,10,0,125,5,0,0,10
2020-12-31,4,3,274,1,0,14,7
2020-12-31,454,43,2529,115,6,67,497
2020-12-31,225,13,627,25,1,13,238
2020-12-31,687,26,3123,165,2,33,713
2020-12-31,90,2,615,19,0,19,92
2020-12-31,78,0,372,17,0,1,78
2020-12-31,0,0,25,0,0,0,0
2020-12-31,28,0,247,16,0,2,28
2020-12-31,3,0,33,0,0,4,3
2020-12-31,5,0,48,0,0,5,5
2020-12-31,50,15,288,9,0,8,65
2020-12-31,137,11,668,36,0,21,148
2020-12-31,21,0,59,1,0,0,21
2020-12-31,189,1,717,35,0,21,190
2020-12-31,74,1,451,11,0,9,75
2020-12-31,6,0,25,0,0,0,6
2020-12-31,309,14,912,83,3,7,323
2020-12-31,7627,270,20438,1600,36,324,7897
2020-12-31,188,13,761,25,0,21,201
2020-12-31,149,11,591,38,1,6,160
2020-12-31,7,0,29,1,0,3,7
2020-12-31,0,0,19,0,0,0,0
2020-12-31,9,0,84,2,0,2,9
2020-12-31,1,0,12,0,0,0,1
2020-12-31,25,0,169,8,0,21,25
2020-12-31,33,0,190,14,0,1,33
2020-12-31,1516,123,3565,308,7,26,1639
2020-12-31,2,0,35,0,0,0,2
2020-12-31,254,15,1566,65,2,60,269
2020-12-31,359,15,1220,71,5,31,374
2020-12-31,35,0,567,6,0,13,35
2020-12-31,62,1,460,15,0,18,63
2020-12-31,467,27,2605,103,7,68,494
2020-12-31,0,0,17,0,0,2,0
2020-12-31,10,0,52,3,0,0,10
2020-12-31,11,0,47,0,0,0,11
2020-12-31,69,23,261,17,0,1,92
2020-12-31,79,1,140,9,0,0,80
2020-12-31,606,22,1548,148,0,10,628
2020-12-31,1705,97,4126,345,6,40,1802
2020-12-31,4,0,51,2,0,3,4
2020-12-31,207,8,1939,55,2,64,215
2020-12-31,2097,50,6085,501,0,96,2147
2020-12-31,0,0,14,0,0,0,0
2020-12-31,13,0,96,2,0,6,13
2020-12-31,167,1,265,52,0,6,168
2020-12-31,379,8,1176,78,1,13,387
2020-12-31,38,4,352,7,0,8,42
2020-12-31,162,5,730,40,0,27,167
2020-12-31,11,0,77,4,0,1,11
2020-12-31,315,13,1295,63,2,12,328
2021-01-01,37,3,339,9,0,9,40
2021-01-01,81,0,127,11,0,0,81
2021-01-01,94,4,618,20,0,10,98
2021-01-01,2,0,33,0,0,4,2
2021-01-01,33,0,190,9,0,2,33
2021-01-01,81,2,451,18,1,3,83
2021-01-01,359,16,1219,75,2,27,375
2021-01-01,5,0,48,0,0,5,5
2021-01-01,69,17,261,20,0,1,86
2021-01-01,77,0,372,18,0,2,77
2021-01-01,193,13,754,26,2,21,206
2021-01-01,24,0,169,12,0,16,24
2021-01-01,1497,63,6740,377,9,177,1560
2021-01-01,325,9,1297,69,1,15,334
2021-01-01,682,21,3108,158,4,35,703
2021-01-01,14,0,84,1,0,1,14
2021-01-01,22,0,59,5,0,0,22
2021-01-01,6,1,29,2,0,2,7
2021-01-01,3,0,51,1,0,0,3
2021-01-01,194,0,717,31,0,37,194
2021-01-01,49,3,288,8,1,9,52
2021-01-01,16,0,25,4,0,0,16
2021-01-01,0,0,19,0,0,0,0
2021-01-01,5,2,269,1,1,20,7
2021-01-01,12,0,121,3,0,4,12
2021-01-01,0,0,25,0,0,0,0
2021-01-01,0,0,17,0,0,1,0
2021-01-01,300,13,908,79,3,7,313
2021-01-01,364,10,1140,83,0,12,374
2021-01-01,597,20,1543,135,1,10,617
2021-01-01,10,4,129,4,0,0,14
2021-01-01,7544,280,20331,1587,27,325,7824
2021-01-01,430,38,2514,114,4,63,468
2021-01-01,469,29,2613,109,3,68,498
2021-01-01,176,0,265,59,0,4,176
2021-01-01,136,7,668,39,0,25,143
2021-01-01,53,0,272,18,0,3,53
2021-01-01,30,0,252,16,0,4,30
2021-01-01,10,0,52,4,0,0,10
2021-01-01,251,12,1549,67,0,26,263
2021-01-01,1676,86,4093,349,1,49,1762
2021-01-01,2,0,12,0,0,0,2
2021-01-01,0,0,14,0,0,0,0
2021-01-01,2057,55,6079,506,6,86,2112
2021-01-01,209,5,1949,55,1,58,214
2021-01-01,5,0,56,2,0,7,5
2021-01-01,5,0,25,0,0,0,5
2021-01-01,9,0,77,5,0,1,9
2021-01-01,171,6,733,40,1,23,177
2021-01-01,2,0,35,0,0,0,2
2021-01-01,40,1,567,8,0,12,41
2021-01-01,50,2,354,15,0,112,52
2021-01-01,11,0,47,0,0,0,11
2021-01-01,1486,117,3567,296,4,23,1603
2021-01-01,146,13,583,41,2,2,159
2021-01-01,225,7,626,22,1,14,232
2021-01-02,195,0,717,31,0,35,195
2021-01-02,35,2,190,10,1,2,37
2021-01-02,5,0,48,0,0,5,5
2021-01-02,7697,274,20244,1599,39,327,7971
2021-01-02,214,5,1946,57,1,63,219
2021-01-02,87,1,451,13,0,7,88
2021-01-02,331,8,1300,74,2,14,339
2021-01-02,0,0,18,0,0,2,0
2021-01-02,54,0,271,18,0,3,54
2021-01-02,251,15,1546,64,1,39,266
2021-01-02,36,3,335,6,0,11,39
2021-01-02,76,0,372,18,0,1,76
2021-01-02,601,27,1529,130,1,11,628
2021-01-02,689,20,3108,148,2,48,709
2021-01-02,6,1,29,2,0,2,7
2021-01-02,1,0,35,0,0,0,1
2021-01-02,2136,36,6015,487,5,83,2172
2021-01-02,1523,107,3537,299,3,34,1630
2021-01-02,6,3,269,1,0,21,9
2021-01-02,85,0,139,12,0,0,85
2021-01-02,11,0,84,0,0,2,11
2021-01-02,69,12,261,20,0,1,81
2021-01-02,170,12,746,41,1,23,182
2021-01-02,4,0,51,1,0,0,4
2021-01-02,8,3,129,4,0,1,11
2021-01-02,5,0,56,2,0,9,5
2021-01-02,0,0,25,0,0,0,0
2021-01-02,1715,65,4116,355,13,50,1780
2021-01-02,26,0,59,1,0,0,26
2021-01-02,0,0,14,0,0,0,0
2021-01-02,143,9,668,40,0,21,152
2021-01-02,428,48,2513,116,8,59,476
2021-01-02,39,2,567,9,0,13,41
2021-01-02,451,29,2623,106,4,82,480
2021-01-02,11,0,52,4,0,0,11
2021-01-02,2,0,12,0,0,0,2
2021-01-02,366,18,1230,79,5,23,384
2021-01-02,307,5,894,81,2,7,312
2021-01-02,1486,57,6737,369,6,186,1543
2021-01-02,50,9,288,8,1,9,59
2021-01-02,16,0,25,4,0,0,16
2021-01-02,0,0,19,0,0,0,0
2021-01-02,11,0,47,0,0,0,11
2021-01-02,375,8,1123,79,0,14,383
2021-01-02,3,0,33,0,0,4,3
2021-01-02,93,1,576,17,0,27,94
2021-01-02,223,4,626,25,2,14,227
2021-01-02,157,15,598,38,1,8,172
2021-01-02,9,0,77,4,0,2,9
2021-01-02,182,18,750,29,4,20,200
2021-01-02,5,0,25,0,0,0,5
2021-01-02,29,1,241,15,1,1,30
2021-01-02,24,0,169,13,0,17,24
2021-01-02,182,0,265,61,0,1,182
2021-01-02,13,0,121,4,0,3,13
2021-01-02,49,2,460,15,1,19,51
2021-01-03,29,0,170,15,0,26,29
2021-01-03,57,0,271,18,0,4,57
2021-01-03,2,0,12,0,0,0,2
2021-01-03,11,0,25,3,0,0,11
2021-01-03,298,5,886,88,1,23,303
2021-01-03,425,41,2473,116,6,62,466
2021-01-03,344,11,1299,71,1,15,355
2021-01-03,4,0,51,1,0,2,4
2021-01-03,179,9,742,44,2,24,188
2021-01-03,157,7,688,48,0,23,164
2021-01-03,5,0,56,1,0,10,5
2021-01-03,176,16,746,31,2,23,192
2021-01-03,71,7,261,18,0,1,78
2021-01-03,8,3,129,4,0,2,11
2021-01-03,5,0,25,0,0,0,5
2021-01-03,3,1,48,0,0,5,4
2021-01-03,1,0,35,0,0,0,1
2021-01-03,0,0,17,0,0,1,0
2021-01-03,1733,76,4129,343,7,55,1809
2021-01-03,1,0,19,0,0,0,1
2021-01-03,86,1,451,9,1,10,87
2021-01-03,12,0,121,3,0,2,12
2021-01-03,35,0,190,10,0,4,35
2021-01-03,206,5,1921,54,1,64,211
2021-01-03,0,0,14,0,0,0,0
2021-01-03,82,0,372,17,0,3,82
2021-01-03,620,43,1582,129,3,6,663
2021-01-03,42,0,567,9,0,10,42
2021-01-03,704,20,3120,147,3,44,724
2021-01-03,384,11,1139,82,1,14,395
2021-01-03,0,0,25,0,0,0,0
2021-01-03,259,13,1519,65,0,34,272
2021-01-03,39,2,339,6,0,10,41
2021-01-03,2178,40,6022,500,6,84,2218
2021-01-03,1543,117,3414,330,3,31,1660
2021-01-03,30,0,249,16,0,1,30
2021-01-03,1507,52,6740,373,4,189,1559
2021-01-03,377,23,1222,79,4,20,400
2021-01-03,11,0,52,4,0,0,11
2021-01-03,22,0,59,1,0,0,22
2021-01-03,84,0,134,12,0,0,84
2021-01-03,52,1,460,12,0,22,53
2021-01-03,98,0,568,17,0,21,98
2021-01-03,170,0,265,60,0,1,170
2021-01-03,53,7,288,10,0,6,60
2021-01-03,7,3,267,2,0,14,10
2021-01-03,7,0,29,2,0,2,7
2021-01-03,166,13,600,41,2,8,179
2021-01-03,488,36,2610,105,7,81,524
2021-01-03,7898,305,20328,1627,31,326,8203
2021-01-03,10,0,47,0,0,0,10
2021-01-03,224,7,627,26,2,11,231
2021-01-03,3,0,33,0,0,4,3
2021-01-03,11,0,84,1,0,2,11
2021-01-03,8,0,77,3,0,2,8
2021-01-03,203,0,717,31,0,35,203
2021-01-04,465,33,2629,102,9,87,498
2021-01-04,211,5,1965,54,2,64,216
2021-01-04,10,0,47,0,0,0,10
2021-01-04,96,0,137,14,0,4,96
2021-01-04,0,0,25,0,0,0,0
2021-01-04,2236,42,6031,504,5,88,2278
2021-01-04,2,0,12,0,0,0,2
2021-01-04,324,9,902,87,1,17,333
2021-01-04,11,0,25,3,0,0,11
2021-01-04,178,8,748,41,0,8,186
2021-01-04,0,0,17,0,0,2,0
2021-01-04,12,0,84,1,0,0,12
2021-01-04,8,0,29,2,0,2,8
2021-01-04,1,0,19,0,0,0,1
2021-01-04,6,0,25,0,0,0,6
2021-01-04,4,0,56,1,0,9,4
2021-01-04,1763,93,4126,346,5,58,1856
2021-01-04,53,9,288,11,0,2,62
2021-01-04,1,0,35,0,0,0,1
2021-01-04,170,16,595,36,3,11,186
2021-01-04,9,1,129,3,1,0,10
2021-01-04,198,1,717,32,0,36,199
2021-01-04,12,0,52,3,0,0,12
2021-01-04,231,5,632,27,0,10,236
2021-01-04,18,0,59,2,0,0,18
2021-01-04,178,15,744,29,7,19,193
2021-01-04,28,0,170,12,0,14,28
2021-01-04,7,3,268,2,1,14,10
2021-01-04,86,0,372,18,0,0,86
2021-01-04,172,8,598,55,2,15,180
2021-01-04,58,0,460,14,0,17,58
2021-01-04,181,0,265,67,0,0,181
2021-01-04,34,4,336,6,0,11,38
2021-01-04,4,0,48,0,0,5,4
2021-01-04,13,0,121,4,0,6,13
2021-01-04,60,0,271,17,0,4,60
2021-01-04,0,0,14,0,0,0,0
2021-01-04,4,0,51,1,0,1,4
2021-01-04,3,0,33,0,0,5,3
2021-01-04,38,0,190,12,0,5,38
2021-01-04,1615,122,3629,342,5,20,1737
2021-01-04,424,57,2492,109,6,64,481
2021-01-04,401,5,1158,90,0,9,406
2021-01-04,719,19,3105,146,6,40,738
2021-01-04,84,1,451,9,0,13,85
2021-01-04,1537,48,6742,382,5,202,1585
2021-01-04,102,0,566,20,0,21,102
2021-01-04,9,0,78,4,0,1,9
2021-01-04,45,0,567,10,0,10,45
2021-01-04,68,2,261,17,1,1,70
2021-01-04,269,19,1503,69,2,35,288
2021-01-04,8023,295,20371,1642,27,338,8318
2021-01-04,640,46,1610,126,3,11,686
2021-01-04,27,0,243,14,0,0,27
2021-01-04,355,7,1298,61,1,18,362
2021-01-04,394,15,1222,87,8,22,409
2021-01-05,8098,324,20495,1628,40,313,8422
2021-01-05,51,0,567,10,0,9,51
2021-01-05,36,4,336,6,0,11,40
2021-01-05,1,0,19,0,0,0,1
2021-01-05,96,0,451,8,0,12,96
2021-01-05,13,0,25,4,0,0,13
2021-01-05,11,0,84,2,0,0,11
2021-01-05,5,0,56,1,0,8,5
2021-01-05,12,0,118,4,0,4,12
2021-01-05,167,6,598,55,1,17,173
2021-01-05,58,0,271,16,0,3,58
2021-01-05,55,5,288,10,1,1,60
2021-01-05,6,0,47,0,0,0,6
2021-01-05,2250,42,6076,485,3,85,2292
2021-01-05,1585,61,6746,383,8,218,1646
2021-01-05,188,8,760,38,0,8,196
2021-01-05,101,1,595,23,0,18,102
2021-01-05,168,14,603,34,1,8,182
2021-01-05,91,0,145,16,0,0,91
2021-01-05,271,13,1530,62,3,36,284
2021-01-05,0,0,14,0,0,0,0
2021-01-05,2,0,17,0,0,2,2
2021-01-05,0,0,35,0,0,0,0
2021-01-05,17,0,59,3,0,2,17
2021-01-05,13,0,118,5,0,4,13
2021-01-05,416,6,1165,86,0,14,422
2021-01-05,6,2,274,2,2,11,8
2021-01-05,190,4,717,33,0,32,194
2021-01-05,180,22,742,27,5,20,202
2021-01-05,361,8,1296,68,1,11,369
2021-01-05,9,1,52,4,0,0,10
2021-01-05,5,0,48,0,0,5,5
2021-01-05,3,0,51,1,0,1,3
2021-01-05,221,8,1964,60,1,53,229
2021-01-05,5,0,25,0,0,0,5
2021-01-05,509,33,2646,118,9,78,542
2021-01-05,726,15,3142,163,4,37,741
2021-01-05,659,36,1619,122,0,6,695
2021-01-05,71,5,261,15,0,1,76
2021-01-05,1611,120,3657,343,2,23,1731
2021-01-05,172,1,265,64,0,4,173
2021-01-05,40,0,190,12,0,6,40
2021-01-05,0,0,25,0,0,0,0
2021-01-05,5,0,33,3,0,4,5
2021-01-05,2,0,12,0,0,0,2
2021-01-05,25,0,254,16,0,41,25
2021-01-05,1785,77,4107,352,3,53,1862
2021-01-05,340,8,905,87,1,8,348
2021-01-05,64,2,460,16,1,13,66
2021-01-05,84,0,372,16,0,5,84
2021-01-05,442,51,2512,109,7,71,493
2021-01-05,30,2,169,10,0,16,32
2021-01-05,12,0,77,4,0,1,12
2021-01-05,419,13,1220,85,2,22,432
2021-01-05,228,6,632,25,0,14,234
2021-01-05,8,0,29,2,0,2,8
2021-01-06,13,0,121,4,0,3,13
2021-01-06,14,0,25,5,0,0,14
2021-01-06,219,3,632,26,0,14,222
2021-01-06,0,0,25,0,0,0,0
2021-01-06,178,4,598,59,0,18,182
2021-01-06,12,0,121,4,0,4,12
2021-01-06,1,0,19,0,0,0,1
2021-01-06,8,3,274,3,2,10,11
2021-01-06,86,0,451,9,0,11,86
2021-01-06,0,0,35,0,0,0,0
2021-01-06,76,0,372,14,0,4,76
2021-01-06,180,7,776,39,1,12,187
2021-01-06,433,13,1164,92,2,13,446
2021-01-06,2,0,51,1,0,1,2
2021-01-06,233,10,2050,60,1,46,243
2021-01-06,1,0,12,0,0,0,1
2021-01-06,26,1,263,22,0,3,27
2021-01-06,334,9,912,87,0,7,343
2021-01-06,39,0,190,10,0,3,39
2021-01-06,1,0,17,0,0,2,1
2021-01-06,181,19,747,27,3,13,200
2021-01-06,431,50,2514,112,4,69,481
2021-01-06,6,0,33,3,0,4,6
2021-01-06,8,0,29,2,0,2,8
2021-01-06,8074,311,20435,1665,36,328,8385
2021-01-06,207,5,717,32,0,33,212
2021-01-06,17,0,59,4,0,1,17
2021-01-06,1634,119,3642,364,12,27,1753
2021-01-06,170,14,583,36,1,8,184
2021-01-06,626,29,1594,114,0,8,655
2021-01-06,723,28,3161,165,6,27,751
2021-01-06,2253,53,5993,502,4,80,2306
2021-01-06,499,32,2654,115,6,66,531
2021-01-06,70,1,460,17,0,13,71
2021-01-06,174,2,265,66,0,4,176
2021-01-06,10,0,84,1,0,1,10
2021-01-06,105,3,671,19,2,24,108
2021-01-06,38,3,340,8,0,14,41
2021-01-06,93,1,146,16,0,4,94
2021-01-06,418,8,1164,86,1,21,426
2021-01-06,65,5,261,13,0,4,70
2021-01-06,4,0,25,0,0,0,4
2021-01-06,57,0,271,16,0,3,57
2021-01-06,0,0,14,0,0,0,0
2021-01-06,57,4,282,11,0,2,61
2021-01-06,1762,81,4009,363,5,54,1843
2021-01-06,30,0,169,11,0,16,30
2021-01-06,6,0,47,0,0,0,6
2021-01-06,49,0,567,7,0,8,49
2021-01-06,349,9,1296,66,2,12,358
2021-01-06,1661,71,6755,391,9,169,1732
2021-01-06,9,0,52,4,0,1,9
2021-01-06,7,0,48,0,0,5,7
2021-01-06,273,17,1536,66,2,27,290
2021-01-06,5,0,56,1,0,9,5
2021-01-06,11,0,77,4,0,2,11
2021-01-07,37,0,190,11,0,6,37
2021-01-07,7,0,48,0,0,5,7
2021-01-07,2,0,51,1,0,1,2
2021-01-07,1685,71,6787,401,9,169,1756
2021-01-07,179,18,594,41,1,6,197
2021-01-07,6,0,47,0,0,0,6
2021-01-07,38,3,344,7,0,12,41
2021-01-07,713,36,3164,164,8,30,749
2021-01-07,1751,82,3954,362,5,48,1833
2021-01-07,58,0,272,16,0,4,58
2021-01-07,11,0,25,4,0,0,11
2021-01-07,7966,327,20437,1714,27,305,8293
2021-01-07,288,19,1552,66,4,33,307
2021-01-07,640,22,1556,102,0,6,662
2021-01-07,170,1,265,65,0,4,171
2021-01-07,69,3,261,14,0,3,72
2021-01-07,1,1,11,0,0,0,2
2021-01-07,437,16,1172,103,0,16,453
2021-01-07,31,0,169,10,0,17,31
2021-01-07,244,6,2064,61,0,37,250
2021-01-07,207,1,717,34,0,37,208
2021-01-07,11,0,84,2,0,1,11
2021-01-07,2259,49,6091,514,3,75,2308
2021-01-07,84,0,451,12,0,7,84
2021-01-07,1,0,19,0,0,0,1
2021-01-07,349,13,1296,66,1,15,362
2021-01-07,61,3,460,12,0,12,64
2021-01-07,8,2,274,2,0,8,10
2021-01-07,174,14,783,41,0,15,188
2021-01-07,497,40,2626,115,10,63,537
2021-01-07,4,0,56,1,0,9,4
2021-01-07,0,0,14,0,0,0,0
2021-01-07,0,0,17,0,0,1,0
2021-01-07,12,0,120,4,0,6,12
2021-01-07,14,1,121,4,0,3,15
2021-01-07,15,0,59,4,0,1,15
2021-01-07,48,0,567,5,0,9,48
2021-01-07,32,0,248,17,0,0,32
2021-01-07,95,1,136,15,0,2,96
2021-01-07,7,0,33,3,0,4,7
2021-01-07,53,4,282,13,0,1,57
2021-01-07,0,0,35,0,0,0,0
2021-01-07,1648,128,3656,370,11,10,1776
2021-01-07,10,1,77,3,0,3,11
2021-01-07,408,8,1160,79,1,22,416
2021-01-07,8,0,29,2,0,2,8
2021-01-07,174,25,745,29,6,12,199
2021-01-07,4,0,25,0,0,0,4
2021-01-07,432,61,2525,110,4,72,493
2021-01-07,183,3,598,60,0,19,186
2021-01-07,319,12,921,88,0,6,331
2021-01-07,77,0,372,13,0,1,77
2021-01-07,0,0,25,0,0,0,0
2021-01-07,210,5,632,27,1,10,215
2021-01-07,8,1,52,4,0,1,9
2021-01-07,110,4,651,21,2,18,114
2021-01-08,343,12,1297,68,2,13,355
2021-01-08,11,0,84,2,0,1,11
2021-01-08,628,22,1560,117,2,9,650
2021-01-08,1,0,10,0,0,0,1
2021-01-08,179,9,598,41,3,11,188
2021-01-08,180,6,598,57,1,20,186
2021-01-08,6,0,47,0,0,0,6
2021-01-08,31,0,256,18,0,0,31
2021-01-08,14,0,59,3,0,1,14
2021-01-08,210,4,677,25,1,8,214
2021-01-08,80,0,451,9,0,9,80
2021-01-08,56,0,460,11,0,13,56
2021-01-08,176,17,750,31,4,11,193
2021-01-08,3,0,25,0,0,0,3
2021-01-08,52,0,567,8,0,10,52
2021-01-08,11,0,130,4,0,2,11
2021-01-08,204,3,717,30,0,36,207
2021-01-08,2,0,51,0,0,3,2
2021-01-08,2,0,17,0,0,1,2
2021-01-08,410,11,1180,79,3,27,421
2021-01-08,8,0,102,4,0,1,8
2021-01-08,15,0,25,6,0,0,15
2021-01-08,5,0,29,1,0,3,5
2021-01-08,7964,289,19600,1731,25,306,8253
2021-01-08,180,10,771,32,1,16,190
2021-01-08,708,17,3151,173,2,37,725
2021-01-08,101,4,676,17,0,10,105
2021-01-08,0,0,35,0,0,0,0
2021-01-08,0,0,25,0,0,0,0
2021-01-08,0,0,19,0,0,0,0
2021-01-08,1671,119,3633,380,10,23,1790
2021-01-08,442,52,2525,112,5,67,494
2021-01-08,55,0,271,14,0,6,55
2021-01-08,8,1,52,3,0,0,9
2021-01-08,9,4,274,2,0,15,13
2021-01-08,8,0,33,3,0,4,8
2021-01-08,45,5,282,14,0,2,50
2021-01-08,6,0,48,0,0,5,6
2021-01-08,64,0,261,13,0,5,64
2021-01-08,6,0,56,1,0,9,6
2021-01-08,280,16,1549,75,1,34,296
2021-01-08,156,0,263,64,0,5,156
2021-01-08,78,0,372,20,0,3,78
2021-01-08,12,0,77,3,0,4,12
2021-01-08,36,0,190,10,0,4,36
2021-01-08,0,0,14,0,0,0,0
2021-01-08,314,7,871,86,0,4,321
2021-01-08,29,0,169,10,0,17,29
2021-01-08,1695,68,6546,410,11,162,1763
2021-01-08,2221,39,5988,528,3,78,2260
2021-01-08,422,14,1134,91,0,13,436
2021-01-08,249,5,2082,63,0,50,254
2021-01-08,94,0,135,12,0,5,94
2021-01-08,1758,79,3764,360,4,35,1837
2021-01-08,482,31,2636,105,7,63,513
2021-01-08,34,2,335,8,0,12,36
2021-01-09,13,0,59,6,0,1,13
2021-01-09,2,0,17,0,0,1,2
2021-01-09,42,0,190,10,0,8,42
2021-01-09,3,0,25,0,0,0,3
2021-01-09,0,0,35,0,0,0,0
2021-01-09,92,0,135,13,0,3,92
2021-01-09,56,0,261,12,0,5,56
2021-01-09,421,12,1175,87,2,23,433
2021-01-09,7910,280,19580,1712,39,319,8190
2021-01-09,10,0,33,3,0,4,10
2021-01-09,0,0,25,0,0,0,0
2021-01-09,6,0,47,0,0,0,6
2021-01-09,9,1,77,3,1,4,10
2021-01-09,44,8,288,12,0,2,52
2021-01-09,428,43,2526,115,6,66,471
2021-01-09,2,0,51,0,0,3,2
2021-01-09,16,0,25,6,0,0,16
2021-01-09,98,7,646,12,1,10,105
2021-01-09,480,29,2633,110,6,70,509
2021-01-09,50,1,567,7,0,4,51
2021-01-09,1650,146,3610,375,10,26,1796
2021-01-09,174,8,610,42,0,10,182
2021-01-09,50,0,460,11,0,16,50
2021-01-09,316,6,920,90,1,7,322
2021-01-09,165,0,264,64,0,0,165
2021-01-09,11,0,84,3,0,1,11
2021-01-09,178,26,746,30,5,6,204
2021-01-09,694,17,3153,172,4,37,711
2021-01-09,174,3,598,55,3,20,177
2021-01-09,185,12,765,32,0,16,197
2021-01-09,296,12,1612,77,1,26,308
2021-01-09,211,3,637,27,1,3,214
2021-01-09,15,0,121,2,0,5,15
2021-01-09,0,0,14,0,0,0,0
2021-01-09,5,0,48,0,0,5,5
2021-01-09,245,7,2121,61,0,54,252
2021-01-09,2216,34,5984,547,0,95,2250
2021-01-09,12,0,115,4,0,1,12
2021-01-09,208,4,717,30,0,32,212
2021-01-09,11,0,273,3,0,9,11
2021-01-09,33,0,170,13,0,16,33
2021-01-09,31,0,203,13,0,1,31
2021-01-09,83,0,451,12,0,7,83
2021-01-09,56,0,271,16,0,2,56
2021-01-09,4,0,56,2,0,9,4
2021-01-09,1716,75,3779,359,7,37,1791
2021-01-09,1691,60,6549,399,11,150,1751
2021-01-09,29,2,339,8,0,12,31
2021-01-09,6,0,29,1,0,3,6
2021-01-09,1,0,11,0,0,0,1
2021-01-09,635,38,1545,114,3,11,673
2021-01-09,7,0,52,3,0,1,7
2021-01-09,437,15,1167,102,1,11,452
2021-01-09,82,0,372,13,0,0,82
2021-01-09,338,17,1302,75,0,7,355
2021-01-09,0,0,19,0,0,0,0
2021-01-10,189,12,737,28,1,20,201
2021-01-10,12,0,279,2,0,16,12
2021-01-10,5,0,48,0,0,5,5
2021-01-10,261,13,1587,71,4,36,274
2021-01-10,10,0,59,4,0,2,10
2021-01-10,7,0,52,3,0,0,7
2021-01-10,207,14,717,26,0,41,221
2021-01-10,19,0,25,6,0,0,19
2021-01-10,43,9,288,11,0,2,52
2021-01-10,1,0,11,0,0,0,1
2021-01-10,3,0,25,0,0,0,3
2021-01-10,58,0,271,15,0,3,58
2021-01-10,97,11,644,13,2,10,108
2021-01-10,46,0,190,8,0,8,46
2021-01-10,0,0,25,0,0,0,0
2021-01-10,6,0,47,0,0,0,6
2021-01-10,485,27,2615,115,8,82,512
2021-01-10,2221,56,5936,544,3,84,2277
2021-01-10,1697,58,6549,417,13,150,1755
2021-01-10,320,9,921,91,1,6,329
2021-01-10,179,11,610,48,1,9,190
2021-01-10,69,1,372,13,0,0,70
2021-01-10,7926,344,19462,1724,35,340,8270
2021-01-10,1,0,17,0,0,2,1
2021-01-10,1720,75,3746,356,9,38,1795
2021-01-10,0,0,35,0,0,0,0
2021-01-10,2,0,51,0,0,3,2
2021-01-10,73,1,451,8,0,14,74
2021-01-10,56,0,261,14,0,2,56
2021-01-10,10,0,84,3,0,1,10
2021-01-10,5,0,56,3,0,9,5
2021-01-10,193,4,598,56,2,17,197
2021-01-10,257,10,2112,61,0,70,267
2021-01-10,449,14,1180,109,2,6,463
2021-01-10,424,37,2516,113,4,68,461
2021-01-10,410,14,1173,83,3,21,424
2021-01-10,5,0,29,1,0,3,5
2021-01-10,32,0,171,14,0,16,32
2021-01-10,215,5,638,29,1,2,220
2021-01-10,151,0,262,64,0,0,151
2021-01-10,90,0,133,14,0,0,90
2021-01-10,0,0,14,0,0,0,0
2021-01-10,48,2,460,8,0,20,50
2021-01-10,340,13,1305,79,0,14,353
2021-01-10,12,0,109,2,0,6,12
2021-01-10,12,0,33,4,0,3,12
2021-01-10,49,1,567,8,0,7,50
2021-01-10,28,0,207,16,0,1,28
2021-01-10,1671,134,3619,357,9,26,1805
2021-01-10,626,50,1554,116,1,13,676
2021-01-10,0,0,15,0,0,0,0
2021-01-10,688,16,3144,163,2,39,704
2021-01-10,30,4,341,8,0,13,34
2021-01-10,183,20,753,32,2,4,203
2021-01-10,10,0,77,3,0,2,10
2021-01-10,13,0,115,5,0,8,13
2021-01-11,0,0,15,0,0,0,0
2021-01-11,68,1,372,13,0,2,69
2021-01-11,54,0,261,14,0,2,54
2021-01-11,45,2,288,12,0,2,47
2021-01-11,195,10,767,37,1,21,205
2021-01-11,1660,131,3550,354,12,16,1791
2021-01-11,453,11,1178,110,0,11,464
2021-01-11,15,0,116,3,0,5,15
2021-01-11,687,15,3143,160,5,45,702
2021-01-11,1,0,17,0,0,2,1
2021-01-11,26,0,171,9,0,19,26
2021-01-11,437,11,1193,83,2,23,448
2021-01-11,0,0,25,0,0,0,0
2021-01-11,97,9,638,17,3,5,106
2021-01-11,202,2,717,24,0,26,204
2021-01-11,3,0,25,0,0,0,3
2021-01-11,18,0,25,6,0,0,18
2021-01-11,15,0,59,3,0,0,15
2021-01-11,647,37,1569,102,0,13,684
2021-01-11,6,0,47,0,0,0,6
2021-01-11,266,13,1596,70,2,31,279
2021-01-11,1692,87,3794,341,12,35,1779
2021-01-11,4,0,29,0,0,4,4
2021-01-11,7949,330,19573,1725,37,339,8279
2021-01-11,215,6,677,27,3,6,221
2021-01-11,32,3,339,7,0,13,35
2021-01-11,1,0,11,0,0,0,1
2021-01-11,12,0,33,4,0,4,12
2021-01-11,28,1,204,12,0,2,29
2021-01-11,492,26,2618,120,6,83,518
2021-01-11,52,2,567,6,0,4,54
2021-01-11,184,14,751,30,0,4,198
2021-01-11,1,0,51,0,0,2,1
2021-01-11,1,0,35,0,0,0,1
2021-01-11,428,50,2487,115,5,70,478
2021-01-11,252,4,2118,59,1,66,256
2021-01-11,180,16,605,47,5,10,196
2021-01-11,6,0,48,0,0,5,6
2021-01-11,46,0,190,9,0,7,46
2021-01-11,8,0,84,2,0,2,8
2021-01-11,88,1,132,12,0,1,89
2021-01-11,13,1,274,4,0,12,14
2021-01-11,72,1,451,12,0,11,73
2021-01-11,211,7,598,59,2,15,218
2021-01-11,327,9,924,91,1,5,336
2021-01-11,58,0,271,15,0,3,58
2021-01-11,12,1,138,4,0,1,13
2021-01-11,348,9,1305,80,1,10,357
2021-01-11,2200,47,5981,535,5,87,2247
2021-01-11,1725,61,6558,436,5,150,1786
2021-01-11,46,0,460,8,0,21,46
2021-01-11,8,0,52,3,0,0,8
2021-01-11,148,0,262,68,0,24,148
2021-01-11,4,0,56,3,0,8,4
2021-01-11,0,0,14,0,0,0,0
2021-01-11,9,0,77,3,0,2,9
2021-01-12,441,10,1164,108,0,18,451
2021-01-12,7906,295,19619,1699,28,376,8201
2021-01-12,96,1,137,14,0,0,97
2021-01-12,55,0,261,15,0,1,55
2021-01-12,1,0,51,0,0,1,1
2021-01-12,72,0,372,13,0,1,72
2021-01-12,199,10,598,54,3,16,209
2021-01-12,19,0,25,7,0,0,19
2021-01-12,102,8,666,17,3,9,110
2021-01-12,171,15,748,26,1,9,186
2021-01-12,206,9,677,26,2,6,215
2021-01-12,53,2,567,6,0,5,55
2021-01-12,15,6,274,4,0,4,21
2021-01-12,12,0,125,3,0,4,12
2021-01-12,0,0,25,0,0,0,0
2021-01-12,687,16,3168,157,2,33,703
2021-01-12,0,0,17,0,0,2,0
2021-01-12,448,14,1195,83,3,22,462
2021-01-12,645,30,1571,109,2,9,675
2021-01-12,4,0,29,0,0,4,4
2021-01-12,3,0,25,0,0,0,3
2021-01-12,7,1,77,3,0,2,8
2021-01-12,12,0,33,4,0,4,12
2021-01-12,67,1,451,8,0,9,68
2021-01-12,0,0,11,0,0,0,0
2021-01-12,12,0,59,4,0,0,12
2021-01-12,430,38,2505,107,5,61,468
2021-01-12,2180,42,5964,544,4,85,2222
2021-01-12,321,14,918,84,1,1,335
2021-01-12,259,14,2142,63,5,52,273
2021-01-12,1721,69,6552,434,8,135,1790
2021-01-12,6,0,47,0,0,0,6
2021-01-12,8,0,52,4,0,0,8
2021-01-12,142,2,262,61,0,24,144
2021-01-12,8,0,48,0,0,5,8
2021-01-12,359,10,1306,81,1,11,369
2021-01-12,263,7,1588,68,2,27,270
2021-01-12,0,0,15,0,0,0,0
2021-01-12,55,2,460,7,0,18,57
2021-01-12,5,2,56,3,0,7,7
2021-01-12,207,4,717,25,0,27,211
2021-01-12,30,0,169,9,0,18,30
2021-01-12,30,1,207,14,0,0,31
2021-01-12,8,0,84,2,0,3,8
2021-01-12,176,17,618,48,4,3,193
2021-01-12,17,0,113,4,0,2,17
2021-01-12,1,0,35,0,0,0,1
2021-01-12,42,0,190,9,0,6,42
2021-01-12,492,23,2652,115,3,71,515
2021-01-12,1703,91,3813,347,12,41,1794
2021-01-12,46,4,288,12,0,2,50
2021-01-12,0,0,14,0,0,0,0
2021-01-12,51,0,271,17,0,1,51
2021-01-12,1636,125,3569,363,10,15,1761
2021-01-12,31,2,346,6,0,15,33
2021-01-12,194,11,755,42,1,18,205
2021-01-13,1584,117,3509,367,9,11,1701
2021-01-13,7715,371,19629,1677,40,319,8086
2021-01-13,30,0,169,9,0,24,30
2021-01-13,448,13,1180,86,3,23,461
2021-01-13,1,0,14,0,0,0,1
2021-01-13,5,0,29,0,0,4,5
2021-01-13,193,9,753,42,0,16,202
2021-01-13,66,0,451,8,0,11,66
2021-01-13,46,0,271,14,0,3,46
2021-01-13,669,23,3160,157,5,30,692
2021-01-13,345,8,1300,78,0,11,353
2021-01-13,8,0,56,3,0,7,8
2021-01-13,2,0,51,1,0,0,2
2021-01-13,494,16,2638,114,3,58,510
2021-01-13,7,0,48,0,0,5,7
2021-01-13,5,0,25,0,0,0,5
2021-01-13,14,0,136,4,0,5,14
2021-01-13,95,1,135,12,1,1,96
2021-01-13,211,2,717,26,0,21,213
2021-01-13,57,2,460,7,0,16,59
2021-01-13,8,1,77,3,0,2,9
2021-01-13,31,2,343,6,0,16,33
2021-01-13,436,10,1166,98,0,16,446
2021-01-13,9,0,33,3,0,5,9
2021-01-13,437,55,2527,116,7,59,492
2021-01-13,0,0,11,0,0,0,0
2021-01-13,79,0,372,14,0,0,79
2021-01-13,1719,56,6557,428,7,138,1775
2021-01-13,309,12,924,77,2,0,321
2021-01-13,623,21,1567,92,2,11,644
2021-01-13,52,9,279,11,0,3,61
2021-01-13,173,11,622,49,2,2,184
2021-01-13,0,0,14,0,0,0,0
2021-01-13,250,10,1600,61,1,40,260
2021-01-13,13,4,274,3,0,8,17
2021-01-13,2169,55,5999,544,5,87,2224
2021-01-13,0,0,17,0,0,2,0
2021-01-13,0,0,25,0,0,0,0
2021-01-13,54,2,567,5,0,8,56
2021-01-13,100,0,682,20,0,8,100
2021-01-13,37,0,190,11,0,5,37
2021-01-13,29,2,206,14,1,0,31
2021-01-13,7,0,52,4,0,0,7
2021-01-13,13,0,59,3,0,0,13
2021-01-13,6,2,47,0,0,0,8
2021-01-13,197,6,598,53,2,17,203
2021-01-13,165,12,754,28,2,8,177
2021-01-13,1678,73,3849,344,9,29,1751
2021-01-13,7,0,84,3,0,3,7
2021-01-13,1,0,35,0,0,0,1
2021-01-13,257,9,2128,61,3,52,266
2021-01-13,200,11,677,26,4,8,211
2021-01-13,19,0,25,7,0,0,19
2021-01-13,53,0,261,15,0,0,53
2021-01-13,16,0,115,4,0,2,16
2021-01-13,140,3,263,62,0,0,143
2021-01-14,6,0,48,1,0,4,6
2021-01-14,192,4,598,52,1,24,196
2021-01-14,35,3,344,6,1,9,38
2021-01-14,163,5,751,26,1,7,168
2021-01-14,30,0,169,13,0,23,30
2021-01-14,26,2,211,13,1,2,28
2021-01-14,5,0,56,0,0,3,5
2021-01-14,1563,129,3492,353,8,13,1692
2021-01-14,434,12,1183,88,3,23,446
2021-01-14,647,21,3144,150,4,31,668
2021-01-14,70,0,451,8,0,12,70
2021-01-14,209,7,717,24,0,19,216
2021-01-14,34,0,190,9,0,6,34
2021-01-14,1660,63,3841,343,9,36,1723
2021-01-14,148,2,263,61,0,0,150
2021-01-14,0,0,14,0,0,0,0
2021-01-14,11,0,33,5,0,3,11
2021-01-14,57,1,460,9,0,18,58
2021-01-14,10,0,52,4,0,0,10
2021-01-14,47,0,271,17,0,2,47
2021-01-14,14,0,128,4,0,0,14
2021-01-14,0,0,11,0,0,0,0
2021-01-14,58,0,261,18,0,1,58
2021-01-14,199,8,677,26,0,6,207
2021-01-14,80,0,372,12,0,0,80
2021-01-14,1,0,14,0,0,0,1
2021-01-14,5,0,84,3,0,2,5
2021-01-14,614,34,1562,107,2,14,648
2021-01-14,4,0,25,0,0,0,4
2021-01-14,55,0,567,5,0,17,55
2021-01-14,469,17,2630,124,4,67,486
2021-01-14,94,6,657,18,0,8,100
2021-01-14,2,0,35,0,0,0,2
2021-01-14,435,10,1168,80,0,23,445
2021-01-14,6,1,47,0,0,0,7
2021-01-14,315,8,928,82,1,6,323
2021-01-14,16,0,121,4,0,2,16
2021-01-14,437,52,2528,119,7,59,489
2021-01-14,257,19,1588,62,2,35,276
2021-01-14,89,1,136,9,1,3,90
2021-01-14,2,0,51,1,0,2,2
2021-01-14,4,0,29,0,0,4,4
2021-01-14,170,16,641,47,4,6,186
2021-01-14,196,8,769,39,0,20,204
2021-01-14,1728,57,6553,427,5,141,1785
2021-01-14,0,0,25,0,0,0,0
2021-01-14,49,3,279,11,0,3,52
2021-01-14,0,0,17,0,0,2,0
2021-01-14,355,5,1306,77,0,10,360
2021-01-14,12,0,62,4,0,0,12
2021-01-14,11,1,274,3,0,6,12
2021-01-14,244,9,2120,63,2,50,253
2021-01-14,13,0,59,2,0,1,13
2021-01-14,2102,54,5950,532,7,91,2156
2021-01-14,7597,300,19626,1675,25,297,7897
2021-01-14,19,0,25,7,0,0,19
2021-01-15,36,2,190,9,0,6,38
2021-01-15,13,1,118,2,0,6,14
2021-01-15,14,0,52,7,0,0,14
2021-01-15,7498,328,19646,1709,38,286,7826
2021-01-15,54,0,460,9,0,16,54
2021-01-15,217,2,717,27,0,4,219
2021-01-15,1720,65,6509,425,10,148,1785
2021-01-15,203,9,673,27,0,5,212
2021-01-15,580,25,1561,85,5,27,605
2021-01-15,7,0,33,4,0,4,7
2021-01-15,0,0,25,0,0,0,0
2021-01-15,4,0,25,0,0,0,4
2021-01-15,53,1,261,18,0,1,54
2021-01-15,1567,121,3441,356,11,25,1688
2021-01-15,1602,64,3870,331,5,52,1666
2021-01-15,36,2,340,8,0,10,38
2021-01-15,52,0,567,5,0,15,52
2021-01-15,196,6,598,48,1,28,202
2021-01-15,54,0,271,15,0,3,54
2021-01-15,68,0,451,8,0,8,68
2021-01-15,14,0,59,2,0,0,14
2021-01-15,0,0,17,0,0,2,0
2021-01-15,240,4,2123,65,2,53,244
2021-01-15,12,0,129,4,0,1,12
2021-01-15,168,17,614,43,1,2,185
2021-01-15,7,1,47,0,0,0,8
2021-01-15,461,12,2624,122,3,67,473
2021-01-15,101,3,680,21,0,4,104
2021-01-15,10,1,274,3,0,6,11
2021-01-15,88,2,133,10,1,0,90
2021-01-15,2065,45,5922,542,3,97,2110
2021-01-15,159,11,751,26,0,11,170
2021-01-15,296,5,922,79,0,2,301
2021-01-15,13,0,62,3,0,1,13
2021-01-15,2,0,35,0,0,0,2
2021-01-15,17,0,25,5,0,0,17
2021-01-15,422,48,2521,119,6,59,470
2021-01-15,274,15,1600,57,2,45,289
2021-01-15,440,11,1181,87,2,24,451
2021-01-15,5,0,56,0,0,6,5
2021-01-15,0,0,11,0,0,0,0
2021-01-15,22,0,211,10,0,2,22
2021-01-15,81,0,372,12,0,0,81
2021-01-15,28,0,114,11,0,2,28
2021-01-15,2,0,29,0,0,2,2
2021-01-15,654,18,3135,148,4,37,672
2021-01-15,15,0,48,0,0,5,15
2021-01-15,135,4,264,62,0,0,139
2021-01-15,49,9,279,16,1,1,58
2021-01-15,1,0,51,0,0,3,1
2021-01-15,6,0,85,3,0,2,6
2021-01-15,352,10,1307,80,1,13,362
2021-01-15,418,9,1186,82,0,18,427
2021-01-15,190,6,759,45,0,19,196
2021-01-15,1,0,14,0,0,0,1
2021-01-15,0,0,14,0,0,0,0
2021-01-16,29,1,333,7,0,5,30
2021-01-16,1696,65,6472,416,8,147,1761
2021-01-16,204,8,651,28,0,6,212
2021-01-16,28,0,114,12,0,2,28
2021-01-16,166,13,601,45,1,3,179
2021-01-16,15,0,59,3,0,0,15
2021-01-16,15,1,121,3,0,6,16
2021-01-16,18,0,25,6,0,0,18
2021-01-16,407,4,1160,89,0,17,411
2021-01-16,71,0,451,9,0,7,71
2021-01-16,296,20,927,79,0,7,316
2021-01-16,3,0,29,0,0,2,3
2021-01-16,58,0,567,6,0,13,58
2021-01-16,154,7,751,28,1,10,161
2021-01-16,1560,107,3386,348,23,17,1667
2021-01-16,576,24,1555,88,0,13,600
2021-01-16,138,0,264,57,0,0,138
2021-01-16,10,0,140,3,0,0,10
2021-01-16,4,0,25,0,0,0,4
2021-01-16,87,1,135,10,0,2,88
2021-01-16,0,0,25,0,0,0,0
2021-01-16,195,7,598,48,1,20,202
2021-01-16,64,0,271,17,0,1,64
2021-01-16,47,8,281,17,0,0,55
2021-01-16,265,14,1349,58,2,24,279
2021-01-16,2,0,51,0,0,2,2
2021-01-16,331,8,1302,79,0,13,339
2021-01-16,6,0,33,4,0,4,6
2021-01-16,45,0,460,8,0,17,45
2021-01-16,0,0,14,0,0,0,0
2021-01-16,446,48,2516,121,7,64,494
2021-01-16,21,0,206,9,0,4,21
2021-01-16,14,1,52,6,0,0,15
2021-01-16,239,7,2131,55,2,57,246
2021-01-16,97,6,691,20,0,13,103
2021-01-16,1523,74,3589,325,7,40,1597
2021-01-16,7328,296,19425,1720,30,281,7624
2021-01-16,2026,52,5968,538,2,79,2078
2021-01-16,180,4,720,43,0,17,184
2021-01-16,434,5,1165,84,1,27,439
2021-01-16,5,0,56,0,0,6,5
2021-01-16,32,1,190,11,0,3,33
2021-01-16,16,0,62,6,0,2,16
2021-01-16,444,18,2636,120,5,68,462
2021-01-16,635,17,3139,138,5,41,652
2021-01-16,0,0,11,0,0,0,0
2021-01-16,10,1,274,3,0,6,11
2021-01-16,2,0,35,0,0,0,2
2021-01-16,0,0,17,0,0,2,0
2021-01-16,209,1,717,27,0,14,210
2021-01-16,84,0,372,12,0,0,84
2021-01-16,9,0,85,3,0,0,9
2021-01-16,16,0,48,0,0,5,16
2021-01-16,7,1,47,0,0,0,8
2021-01-16,2,0,14,0,0,0,2
2021-01-16,54,0,261,16,0,3,54
2021-01-17,1524,122,3400,339,12,13,1646
2021-01-17,186,4,730,47,0,14,190
2021-01-17,613,19,3131,148,6,38,632
2021-01-17,55,0,261,17,0,2,55
2021-01-17,152,13,754,23,0,18,165
2021-01-17,2,0,29,0,0,2,2
2021-01-17,28,0,329,8,0,9,28
2021-01-17,1,0,35,0,0,0,1
2021-01-17,27,0,196,11,0,2,27
2021-01-17,10,0,85,2,0,2,10
2021-01-17,0,0,25,0,0,0,0
2021-01-17,1511,51,3575,322,6,49,1562
2021-01-17,18,0,25,6,0,0,18
2021-01-17,33,0,190,10,0,6,33
2021-01-17,1,0,51,0,0,2,1
2021-01-17,441,19,2613,121,5,71,460
2021-01-17,83,1,372,12,0,0,84
2021-01-17,2,0,14,0,0,0,2
2021-01-17,64,0,451,7,0,11,64
2021-01-17,0,0,14,0,0,0,0
2021-01-17,14,0,59,3,0,1,14
2021-01-17,50,0,460,8,0,19,50
2021-01-17,2,0,56,1,1,3,2
2021-01-17,208,13,598,48,4,13,221
2021-01-17,1964,51,5913,538,3,86,2015
2021-01-17,65,0,271,20,0,0,65
2021-01-17,1664,69,6467,412,10,150,1733
2021-01-17,331,10,1305,79,0,14,341
2021-01-17,92,1,137,13,0,2,93
2021-01-17,16,0,63,5,0,3,16
2021-01-17,13,0,109,3,0,4,13
2021-01-17,242,5,2127,57,2,67,247
2021-01-17,266,18,1455,59,1,29,284
2021-01-17,53,11,281,15,1,0,64
2021-01-17,7322,302,19322,1728,39,263,7624
2021-01-17,430,5,1177,81,4,27,435
2021-01-17,10,1,140,3,0,2,11
2021-01-17,291,10,919,79,0,7,301
2021-01-17,101,6,662,17,1,15,107
2021-01-17,28,0,114,12,0,1,28
2021-01-17,5,3,47,0,0,0,8
2021-01-17,10,1,274,3,1,4,11
2021-01-17,0,0,17,0,0,2,0
2021-01-17,131,0,234,55,0,2,131
2021-01-17,6,0,33,3,0,5,6
2021-01-17,54,0,567,6,0,15,54
2021-01-17,172,13,616,42,1,6,185
2021-01-17,14,0,52,7,0,0,14
2021-01-17,562,23,1549,91,1,16,585
2021-01-17,202,7,651,27,0,14,209
2021-01-17,458,44,2503,115,9,70,502
2021-01-17,213,3,717,28,0,10,216
2021-01-17,14,0,48,0,0,5,14
2021-01-17,2,0,25,0,0,0,2
2021-01-17,0,0,11,0,0,0,0
2021-01-17,416,5,1154,88,0,19,421
2021-01-18,201,7,653,26,0,14,208
2021-01-18,201,4,717,29,0,10,205
2021-01-18,1487,40,3627,327,13,60,1527
2021-01-18,134,0,234,57,0,2,134
2021-01-18,27,0,204,8,0,2,27
2021-01-18,18,0,25,6,0,0,18
2021-01-18,1632,73,6483,414,7,168,1705
2021-01-18,2,0,14,0,0,0,2
2021-01-18,554,26,1560,99,4,9,580
2021-01-18,4,0,25,0,0,0,4
2021-01-18,2,0,56,0,0,4,2
2021-01-18,2,1,29,1,0,2,3
2021-01-18,16,0,63,4,0,2,16
2021-01-18,5,3,47,0,0,0,8
2021-01-18,611,18,3097,145,1,33,629
2021-01-18,62,0,271,21,0,0,62
2021-01-18,303,3,914,81,0,7,306
2021-01-18,0,0,17,0,0,0,0
2021-01-18,58,5,281,13,0,0,63
2021-01-18,12,1,98,3,0,5,13
2021-01-18,1,0,35,0,0,0,1
2021-01-18,452,20,2632,130,4,67,472
2021-01-18,6,0,33,2,0,5,6
2021-01-18,445,40,2480,119,5,72,485
2021-01-18,53,0,567,7,0,16,53
2021-01-18,1,0,51,0,0,3,1
2021-01-18,205,9,598,49,2,14,214
2021-01-18,15,0,48,0,0,5,15
2021-01-18,56,0,460,7,0,19,56
2021-01-18,12,3,274,4,0,6,15
2021-01-18,148,18,754,24,1,11,166
2021-01-18,14,0,52,6,0,0,14
2021-01-18,94,1,137,11,0,4,95
2021-01-18,54,0,261,20,0,1,54
2021-01-18,0,0,25,0,0,0,0
2021-01-18,9,0,85,1,0,2,9
2021-01-18,0,0,14,0,0,0,0
2021-01-18,241,2,2127,60,0,72,243
2021-01-18,30,0,117,10,0,0,30
2021-01-18,336,13,1300,77,0,17,349
2021-01-18,78,1,372,12,0,0,79
2021-01-18,418,7,1153,88,0,25,425
2021-01-18,268,13,1453,56,1,24,281
2021-01-18,1524,127,3425,344,12,23,1651
2021-01-18,8,0,132,3,0,4,8
2021-01-18,94,12,645,18,0,13,106
2021-01-18,187,7,738,43,0,19,194
2021-01-18,0,0,12,0,0,0,0
2021-01-18,29,1,332,9,0,8,30
2021-01-18,165,9,605,43,0,7,174
2021-01-18,2007,61,5914,523,5,76,2068
2021-01-18,7253,347,19317,1693,43,290,7600
2021-01-18,426,7,1179,80,2,33,433
2021-01-18,25,0,190,9,0,8,25
2021-01-18,63,1,451,8,0,12,64
2021-01-18,14,0,59,3,0,3,14
2021-01-19,604,16,3140,145,5,37,620
2021-01-19,325,17,1305,77,0,17,342
2021-01-19,99,4,648,19,1,18,103
2021-01-19,22,0,190,4,0,5,22
2021-01-19,443,47,2491,123,5,70,490
2021-01-19,305,9,923,78,0,4,314
2021-01-19,30,0,121,8,0,0,30
2021-01-19,4,0,33,2,0,5,4
2021-01-19,70,1,372,10,0,0,71
2021-01-19,2,0,56,0,0,5,2
2021-01-19,5,0,25,0,0,0,5
2021-01-19,12,0,52,5,0,0,12
2021-01-19,6,2,47,0,0,0,8
2021-01-19,1514,126,3429,335,8,34,1640
2021-01-19,10,0,119,3,0,2,10
2021-01-19,1,0,35,0,0,0,1
2021-01-19,9,0,84,1,0,2,9
2021-01-19,1,0,51,0,0,2,1
2021-01-19,420,14,1172,83,1,21,434
2021-01-19,1658,62,6496,438,3,164,1720
2021-01-19,62,0,271,19,0,2,62
2021-01-19,403,2,1170,86,0,29,405
2021-01-19,122,0,234,52,0,2,122
2021-01-19,11,3,274,4,0,7,14
2021-01-19,61,0,451,9,0,7,61
2021-01-19,158,10,587,38,0,6,168
2021-01-19,206,9,598,52,2,14,215
2021-01-19,17,0,62,5,0,1,17
2021-01-19,19,0,25,7,0,0,19
2021-01-19,243,4,2106,62,0,69,247
2021-01-19,31,2,330,10,0,9,33
2021-01-19,52,0,567,7,0,16,52
2021-01-19,192,6,746,42,1,16,198
2021-01-19,17,0,48,0,0,5,17
2021-01-19,61,0,460,7,0,19,61
2021-01-19,1,0,14,0,0,0,1
2021-01-19,28,0,202,8,0,1,28
2021-01-19,16,0,59,3,0,0,16
2021-01-19,16,1,115,4,0,5,17
2021-01-19,7263,308,19445,1692,29,296,7571
2021-01-19,57,7,281,15,0,0,64
2021-01-19,0,0,14,0,0,0,0
2021-01-19,50,0,261,16,0,3,50
2021-01-19,201,13,669,21,1,15,214
2021-01-19,149,13,757,26,2,8,162
2021-01-19,93,1,134,10,1,2,94
2021-01-19,183,5,717,30,0,12,188
2021-01-19,551,22,1579,84,2,9,573
2021-01-19,0,2,12,0,0,0,2
2021-01-19,1477,51,3555,325,2,56,1528
2021-01-19,0,0,25,0,0,0,0
2021-01-19,1,0,29,0,0,2,1
2021-01-19,447,25,2623,128,4,66,472
2021-01-19,276,10,1348,62,2,21,286
2021-01-19,1975,43,5969,527,7,74,2018
2021-01-19,0,0,17,0,0,1,0
2021-01-20,296,5,928,78,0,5,301
2021-01-20,416,41,2484,121,6,61,457
2021-01-20,118,0,234,59,0,1,118
2021-01-20,436,25,2618,126,1,64,461
2021-01-20,51,0,451,8,0,9,51
2021-01-20,1585,62,6511,447,4,154,1647
2021-01-20,17,0,48,0,0,5,17
2021-01-20,14,4,276,5,0,8,18
2021-01-20,26,0,205,7,0,1,26
2021-01-20,17,0,59,3,0,0,17
2021-01-20,0,0,12,0,0,0,0
2021-01-20,9,0,84,2,0,2,9
2021-01-20,5,0,25,0,0,0,5
2021-01-20,1434,50,3680,314,3,50,1484
2021-01-20,162,1,717,28,0,16,163
2021-01-20,560,29,1604,84,2,7,589
2021-01-20,14,1,113,3,0,6,15
2021-01-20,322,11,1302,73,0,16,333
2021-01-20,98,5,640,20,0,18,103
2021-01-20,4,0,33,2,0,5,4
2021-01-20,192,11,758,38,1,17,203
2021-01-20,186,11,673,24,2,9,197
2021-01-20,22,1,190,7,0,8,23
2021-01-20,87,0,137,9,0,4,87
2021-01-20,595,28,3150,146,5,25,623
2021-01-20,1,0,51,1,0,1,1
2021-01-20,50,0,567,5,0,17,50
2021-01-20,9,0,136,2,0,1,9
2021-01-20,434,12,1188,86,1,21,446
2021-01-20,204,8,603,52,1,14,212
2021-01-20,161,9,597,41,0,6,170
2021-01-20,4,0,56,1,0,5,4
2021-01-20,415,3,1182,87,0,25,418
2021-01-20,52,4,281,16,0,0,56
2021-01-20,0,0,35,0,0,0,0
2021-01-20,19,0,25,7,0,0,19
2021-01-20,44,0,261,16,0,2,44
2021-01-20,17,0,62,5,0,0,17
2021-01-20,30,0,126,12,0,0,30
2021-01-20,15,0,52,6,0,0,15
2021-01-20,7073,340,19392,1687,30,236,7413
2021-01-20,0,0,14,0,0,0,0
2021-01-20,0,0,14,0,0,0,0
2021-01-20,288,11,1357,60,1,22,299
2021-01-20,0,0,25,0,0,0,0
2021-01-20,1,0,17,0,0,2,1
2021-01-20,1935,45,5975,517,6,70,1980
2021-01-20,1,0,29,0,0,2,1
2021-01-20,69,3,372,9,0,0,72
2021-01-20,56,0,460,10,0,16,56
2021-01-20,28,1,320,9,0,10,29
2021-01-20,234,9,2122,58,0,55,243
2021-01-20,138,13,762,25,1,11,151
2021-01-20,1529,126,3433,335,12,22,1655
2021-01-20,6,2,47,0,0,0,8
2021-01-20,58,0,271,19,0,1,58
2021-01-21,47,2,278,15,1,2,49
2021-01-21,15,0,48,0,0,5,15
2021-01-21,1395,62,3671,313,4,44,1457
2021-01-21,58,0,451,8,0,7,58
2021-01-21,419,25,2609,122,7,57,444
2021-01-21,170,11,602,46,0,2,181
2021-01-21,187,8,603,50,1,13,195
2021-01-21,46,0,567,4,0,14,46
2021-01-21,7,0,84,2,0,0,7
2021-01-21,4,2,47,0,0,0,6
2021-01-21,3,0,56,1,0,4,3
2021-01-21,24,2,190,8,1,3,26
2021-01-21,0,0,25,0,0,0,0
2021-01-21,175,1,717,31,0,17,176
2021-01-21,29,2,322,8,0,9,31
2021-01-21,409,42,2513,122,5,66,451
2021-01-21,558,26,1591,89,2,8,584
2021-01-21,6881,345,19411,1654,26,274,7226
2021-01-21,5,0,33,2,0,5,5
2021-01-21,1,0,17,0,0,2,1
2021-01-21,112,3,234,59,0,0,115
2021-01-21,0,0,51,0,0,4,0
2021-01-21,55,0,271,14,0,2,55
2021-01-21,267,13,1319,57,2,26,280
2021-01-21,0,0,12,0,0,0,0
2021-01-21,1455,123,3415,330,12,26,1578
2021-01-21,26,1,213,6,1,1,27
2021-01-21,13,4,276,5,2,12,17
2021-01-21,42,2,261,13,0,2,44
2021-01-21,0,0,14,0,0,0,0
2021-01-21,5,0,25,0,0,0,5
2021-01-21,14,0,25,6,0,0,14
2021-01-21,0,0,14,0,0,0,0
2021-01-21,68,0,372,9,0,0,68
2021-01-21,175,7,743,40,1,10,182
2021-01-21,428,8,1174,91,0,25,436
2021-01-21,126,10,765,27,3,8,136
2021-01-21,8,0,123,2,0,3,8
2021-01-21,173,13,673,24,2,10,186
2021-01-21,289,11,919,88,0,6,300
2021-01-21,51,2,460,10,1,18,53
2021-01-21,82,0,137,11,0,2,82
2021-01-21,11,0,62,3,0,1,11
2021-01-21,2,0,29,0,0,2,2
2021-01-21,218,5,2118,56,0,52,223
2021-01-21,32,0,132,11,0,1,32
2021-01-21,15,0,59,2,0,1,15
2021-01-21,1536,69,6508,428,10,165,1605
2021-01-21,591,20,3152,143,1,26,611
2021-01-21,1896,29,5945,516,6,96,1925
2021-01-21,95,5,645,21,1,18,100
2021-01-21,12,0,52,5,0,0,12
2021-01-21,16,1,114,4,1,6,17
2021-01-21,412,3,1177,100,0,23,415
2021-01-21,327,13,1298,71,1,17,340
2021-01-21,0,0,35,0,0,0,0
2021-01-22,24,0,190,6,0,4,24
2021-01-22,32,0,136,11,0,0,32
2021-01-22,18,0,48,0,0,5,18
2021-01-22,0,0,17,0,0,2,0
2021-01-22,23,0,212,6,0,4,23
2021-01-22,258,14,1330,54,1,32,272
2021-01-22,406,38,2508,115,4,69,444
2021-01-22,9,0,84,2,0,2,9
2021-01-22,1818,31,5953,482,2,80,1849
2021-01-22,10,0,136,2,0,2,10
2021-01-22,1501,63,6503,415,15,147,1564
2021-01-22,386,5,1179,99,0,23,391
2021-01-22,0,0,35,0,0,0,0
2021-01-22,285,15,919,87,1,5,300
2021-01-22,4,0,33,2,0,6,4
2021-01-22,166,11,607,49,0,4,177
2021-01-22,14,0,25,6,0,0,14
2021-01-22,12,0,52,5,0,0,12
2021-01-22,32,4,326,8,0,8,36
2021-01-22,200,14,2122,52,30,52,214
2021-01-22,520,23,1567,86,5,7,543
2021-01-22,42,0,567,3,0,15,42
2021-01-22,16,2,110,3,1,2,18
2021-01-22,0,0,14,0,0,0,0
2021-01-22,0,0,14,0,0,0,0
2021-01-22,184,0,717,29,0,14,184
2021-01-22,0,0,51,0,0,3,0
2021-01-22,162,13,673,22,1,12,175
2021-01-22,18,0,59,1,0,1,18
2021-01-22,6697,317,19377,1619,25,281,7014
2021-01-22,1341,74,3661,313,4,57,1415
2021-01-22,4,2,47,0,0,0,6
2021-01-22,0,0,25,0,0,0,0
2021-01-22,45,0,271,13,0,4,45
2021-01-22,67,2,372,9,0,2,69
2021-01-22,9,0,62,3,0,2,9
2021-01-22,3,0,56,1,0,4,3
2021-01-22,104,1,234,52,0,0,105
2021-01-22,84,0,147,11,0,4,84
2021-01-22,100,5,649,22,0,16,105
2021-01-22,401,21,2609,119,5,52,422
2021-01-22,165,7,724,42,1,11,172
2021-01-22,50,0,451,7,0,14,50
2021-01-22,1422,117,3405,349,5,38,1539
2021-01-22,48,1,460,10,0,17,49
2021-01-22,16,7,276,6,1,12,23
2021-01-22,579,17,3145,147,1,34,596
2021-01-22,0,0,12,0,0,0,0
2021-01-22,45,0,261,12,0,2,45
2021-01-22,191,8,603,51,2,18,199
2021-01-22,116,10,770,28,0,12,126
2021-01-22,5,0,25,0,0,0,5
2021-01-22,312,12,1299,72,1,18,324
2021-01-22,3,0,29,0,0,1,3
2021-01-22,54,5,278,14,0,1,59
2021-01-22,441,12,1182,89,2,25,453
2021-01-23,160,12,726,43,1,16,172
2021-01-23,50,0,451,10,0,13,50
2021-01-23,382,11,1164,92,0,17,393
2021-01-23,419,12,1214,88,3,31,431
2021-01-23,1277,61,3683,289,5,59,1338
2021-01-23,63,2,372,5,0,1,65
2021-01-23,8,0,29,0,0,2,8
2021-01-23,4,2,47,0,0,0,6
2021-01-23,47,0,567,4,0,12,47
2021-01-23,15,0,25,6,0,0,15
2021-01-23,3,0,56,1,0,2,3
2021-01-23,49,0,261,12,0,3,49
2021-01-23,43,1,460,10,0,13,44
2021-01-23,185,5,603,46,2,18,190
2021-01-23,550,16,3145,151,1,33,566
2021-01-23,0,0,12,0,0,0,0
2021-01-23,6486,307,19334,1600,29,299,6793
2021-01-23,15,2,112,2,0,1,17
2021-01-23,1732,47,5902,467,3,73,1779
2021-01-23,1,0,25,0,0,3,1
2021-01-23,527,32,1554,90,6,9,559
2021-01-23,195,6,2133,55,0,49,201
2021-01-23,15,0,59,1,0,0,15
2021-01-23,19,0,205,7,0,3,19
2021-01-23,1342,106,3371,336,5,28,1448
2021-01-23,100,1,234,51,0,0,101
2021-01-23,118,11,772,28,0,7,129
2021-01-23,0,0,14,0,0,0,0
2021-01-23,0,0,51,0,0,3,0
2021-01-23,248,15,1347,54,2,29,263
2021-01-23,1467,55,6494,421,12,149,1522
2021-01-23,11,0,52,5,0,0,11
2021-01-23,20,0,190,7,0,3,20
2021-01-23,8,0,48,0,0,5,8
2021-01-23,12,0,84,2,0,1,12
2021-01-23,374,21,2609,115,5,53,395
2021-01-23,298,16,1299,66,1,18,314
2021-01-23,0,0,14,0,0,0,0
2021-01-23,166,8,625,51,1,1,174
2021-01-23,3,0,33,2,0,6,3
2021-01-23,404,40,2531,109,4,73,444
2021-01-23,13,3,276,4,1,14,16
2021-01-23,53,8,278,17,1,1,61
2021-01-23,157,9,677,25,0,3,166
2021-01-23,285,10,916,89,0,6,295
2021-01-23,94,0,137,11,0,3,94
2021-01-23,0,0,17,0,0,2,0
2021-01-23,44,0,271,13,0,3,44
2021-01-23,9,0,62,3,0,2,9
2021-01-23,0,0,25,0,0,0,0
2021-01-23,6,0,25,0,0,0,6
2021-01-23,34,3,329,6,1,10,37
2021-01-23,33,0,136,18,0,0,33
2021-01-23,0,0,35,0,0,0,0
2021-01-23,170,0,717,24,0,19,170
2021-01-23,96,6,645,23,0,20,102
2021-01-24,0,0,25,0,0,0,0
2021-01-24,55,1,451,9,0,12,56
2021-01-24,165,11,608,50,2,2,176
2021-01-24,159,9,720,41,1,17,168
2021-01-24,0,0,35,0,0,0,0
2021-01-24,21,0,200,7,0,2,21
2021-01-24,10,0,52,6,0,0,10
2021-01-24,29,2,136,17,0,1,31
2021-01-24,0,0,17,0,0,2,0
2021-01-24,13,0,84,1,0,2,13
2021-01-24,28,2,328,7,1,8,30
2021-01-24,48,0,460,12,0,10,48
2021-01-24,6,0,29,0,0,2,6
2021-01-24,0,0,14,0,0,0,0
2021-01-24,241,18,1334,59,3,25,259
2021-01-24,2,2,47,0,0,0,4
2021-01-24,15,3,276,5,0,14,18
2021-01-24,13,0,59,1,0,0,13
2021-01-24,23,1,190,9,1,2,24
2021-01-24,16,2,115,1,0,43,18
2021-01-24,60,1,372,5,0,2,61
2021-01-24,6307,299,19292,1565,22,295,6606
2021-01-24,1274,69,3616,297,6,61,1343
2021-01-24,291,11,1297,72,1,9,302
2021-01-24,12,0,124,3,0,3,12
2021-01-24,93,1,234,44,0,4,94
2021-01-24,4,0,33,2,0,5,4
2021-01-24,92,2,623,26,0,17,94
2021-01-24,554,17,3126,140,3,37,571
2021-01-24,536,39,1543,92,3,7,575
2021-01-24,14,0,25,6,0,0,14
2021-01-24,53,0,261,12,0,3,53
2021-01-24,0,0,14,0,0,0,0
2021-01-24,1703,45,5866,447,3,81,1748
2021-01-24,8,0,48,0,0,5,8
2021-01-24,7,0,25,0,0,0,7
2021-01-24,161,0,717,24,0,16,161
2021-01-24,377,24,2591,107,7,68,401
2021-01-24,367,12,1143,88,0,20,379
2021-01-24,112,84,603,49,1,18,196
2021-01-24,42,0,567,3,0,11,42
2021-01-24,0,0,12,0,0,0,0
2021-01-24,1440,51,6489,412,11,163,1491
2021-01-24,9,0,62,3,0,2,9
2021-01-24,51,0,271,14,0,2,51
2021-01-24,288,12,916,87,0,6,300
2021-01-24,54,5,278,20,0,1,59
2021-01-24,1304,108,3340,334,5,21,1412
2021-01-24,192,5,2103,54,1,57,197
2021-01-24,406,39,2514,115,4,70,445
2021-01-24,2,0,56,0,0,6,2
2021-01-24,96,0,133,11,0,0,96
2021-01-24,417,19,1200,88,4,17,436
2021-01-24,114,14,771,27,1,6,128
2021-01-24,148,7,649,23,0,10,155
2021-01-24,0,0,51,0,0,3,0
2021-01-25,190,9,2109,54,0,54,199
2021-01-25,46,1,460,13,0,12,47
2021-01-25,109,14,766,25,0,8,123
2021-01-25,6,0,29,0,0,2,6
2021-01-25,82,2,234,39,0,5,84
2021-01-25,7,0,25,0,0,0,7
2021-01-25,1677,37,5894,437,2,89,1714
2021-01-25,55,3,372,5,0,4,58
2021-01-25,151,10,672,21,2,12,161
2021-01-25,29,1,333,6,0,8,30
2021-01-25,56,8,278,21,0,0,64
2021-01-25,405,20,1224,86,3,25,425
2021-01-25,96,4,654,26,1,15,100
2021-01-25,396,40,2523,115,4,72,436
2021-01-25,371,21,2607,112,4,68,392
2021-01-25,12,0,138,3,0,1,12
2021-01-25,11,0,52,6,0,0,11
2021-01-25,49,0,451,9,0,9,49
2021-01-25,54,0,271,15,0,1,54
2021-01-25,302,14,1297,72,2,8,316
2021-01-25,12,2,276,5,0,14,14
2021-01-25,538,11,3102,132,2,42,549
2021-01-25,147,8,715,37,1,16,155
2021-01-25,192,8,603,51,2,16,200
2021-01-25,0,0,51,0,0,2,0
2021-01-25,553,16,1555,88,0,8,569
2021-01-25,1265,124,3380,319,4,26,1389
2021-01-25,1429,63,6486,405,11,168,1492
2021-01-25,2,0,56,0,0,6,2
2021-01-25,158,0,720,26,0,19,158
2021-01-25,16,2,112,3,0,7,18
2021-01-25,159,12,606,48,0,4,171
2021-01-25,10,0,84,2,0,2,10
2021-01-25,9,0,62,2,0,2,9
2021-01-25,224,17,1302,57,4,25,241
2021-01-25,4,0,48,0,0,5,4
2021-01-25,43,0,567,4,0,14,43
2021-01-25,14,0,25,5,0,0,14
2021-01-25,0,0,25,0,0,0,0
2021-01-25,54,0,256,11,0,2,54
2021-01-25,3,0,33,1,0,6,3
2021-01-25,0,0,14,0,0,0,0
2021-01-25,19,1,190,9,1,5,20
2021-01-25,6213,287,19309,1551,21,302,6500
2021-01-25,280,6,910,84,0,7,286
2021-01-25,0,0,12,0,0,0,0
2021-01-25,0,0,14,0,0,0,0
2021-01-25,95,0,136,10,0,2,95
2021-01-25,1,2,47,0,0,0,3
2021-01-25,28,0,134,12,0,1,28
2021-01-25,14,0,59,1,0,1,14
2021-01-25,0,0,35,0,0,0,0
2021-01-25,1248,51,3604,283,5,52,1299
2021-01-25,0,0,17,0,0,1,0
2021-01-25,24,0,196,8,0,0,24
2021-01-25,378,9,1150,96,0,18,387
2021-01-26,1,2,47,0,0,0,3
2021-01-26,13,11,276,5,0,13,24
2021-01-26,0,0,14,0,0,0,0
2021-01-26,21,1,190,5,1,5,22
2021-01-26,51,1,451,8,0,9,52
2021-01-26,503,15,3122,127,1,47,518
2021-01-26,203,9,603,58,2,13,212
2021-01-26,2,0,56,0,0,6,2
2021-01-26,1209,52,3604,279,9,66,1261
2021-01-26,181,6,2113,54,1,48,187
2021-01-26,382,22,2644,112,4,54,404
2021-01-26,293,10,1297,66,1,14,303
2021-01-26,0,0,17,0,0,0,0
2021-01-26,0,0,51,0,0,2,0
2021-01-26,11,0,52,6,0,0,11
2021-01-26,161,0,720,22,0,14,161
2021-01-26,6026,345,19292,1542,30,315,6371
2021-01-26,418,12,1224,90,3,25,430
2021-01-26,6,0,25,0,0,0,6
2021-01-26,89,1,137,8,0,5,90
2021-01-26,21,0,202,7,0,3,21
2021-01-26,12,0,25,5,0,2,12
2021-01-26,222,14,1309,57,3,27,236
2021-01-26,58,9,278,19,0,0,67
2021-01-26,0,0,35,0,0,0,0
2021-01-26,77,5,234,37,0,1,82
2021-01-26,97,1,679,26,0,13,98
2021-01-26,54,0,261,12,0,4,54
2021-01-26,0,0,14,0,0,0,0
2021-01-26,4,0,33,1,0,5,4
2021-01-26,58,3,373,6,0,1,61
2021-01-26,358,11,1136,89,0,29,369
2021-01-26,153,9,613,48,0,9,162
2021-01-26,4,0,48,0,0,5,4
2021-01-26,0,0,25,0,0,0,0
2021-01-26,12,0,129,3,0,4,12
2021-01-26,1410,62,6490,400,12,157,1472
2021-01-26,10,0,59,1,0,1,10
2021-01-26,0,0,12,0,0,0,0
2021-01-26,9,0,49,5,0,2,9
2021-01-26,16,2,116,3,0,5,18
2021-01-26,382,36,2504,115,5,71,418
2021-01-26,27,0,131,10,0,0,27
2021-01-26,543,29,1559,97,2,12,572
2021-01-26,47,2,460,14,0,13,49
2021-01-26,7,0,29,0,0,1,7
2021-01-26,152,8,676,21,2,15,160
2021-01-26,147,13,726,33,2,12,160
2021-01-26,54,0,271,16,0,1,54
2021-01-26,8,0,84,2,0,2,8
2021-01-26,1639,55,5890,448,6,90,1694
2021-01-26,1238,99,3411,315,6,29,1337
2021-01-26,113,13,775,24,1,6,126
2021-01-26,29,3,335,8,0,9,32
2021-01-26,269,10,931,76,0,8,279
2021-01-26,39,0,567,4,0,13,39
2021-01-27,6,0,29,0,0,2,6
2021-01-27,20,1,222,8,0,7,21
2021-01-27,0,0,35,0,0,0,0
2021-01-27,193,5,603,51,2,15,198
2021-01-27,338,8,1148,83,0,30,346
2021-01-27,255,16,916,72,0,6,271
2021-01-27,147,14,618,47,0,6,161
2021-01-27,75,1,234,37,0,1,76
2021-01-27,3,2,47,0,0,0,5
2021-01-27,8,0,59,1,0,3,8
2021-01-27,22,0,131,8,0,0,22
2021-01-27,51,1,373,6,0,2,52
2021-01-27,288,13,1297,62,2,15,301
2021-01-27,411,8,1233,91,2,22,419
2021-01-27,2,0,56,0,0,4,2
2021-01-27,3,0,25,0,0,0,3
2021-01-27,0,0,14,0,0,0,0
2021-01-27,0,0,12,0,0,0,0
2021-01-27,76,1,136,11,0,1,77
2021-01-27,1592,32,5985,439,3,97,1624
2021-01-27,18,2,190,6,0,4,20
2021-01-27,149,12,735,37,2,12,161
2021-01-27,0,0,25,0,0,0,0
2021-01-27,163,1,719,31,0,11,164
2021-01-27,0,0,17,0,0,2,0
2021-01-27,153,4,672,22,0,12,157
2021-01-27,94,6,657,22,0,14,100
2021-01-27,9,0,129,2,0,7,9
2021-01-27,359,41,2521,104,7,65,400
2021-01-27,6,0,84,2,0,3,6
2021-01-27,1164,68,3665,284,8,67,1232
2021-01-27,1191,122,3453,317,12,33,1313
2021-01-27,1343,61,6491,390,10,156,1404
2021-01-27,51,0,261,11,0,4,51
2021-01-27,46,1,451,7,0,9,47
2021-01-27,197,11,1324,53,3,36,208
2021-01-27,4,0,48,0,0,5,4
2021-01-27,10,0,52,6,0,0,10
2021-01-27,53,0,271,16,0,2,53
2021-01-27,5855,355,19289,1503,25,314,6210
2021-01-27,509,12,3143,134,1,47,521
2021-01-27,28,2,340,7,0,9,30
2021-01-27,11,0,25,5,0,0,11
2021-01-27,105,15,774,27,1,7,120
2021-01-27,9,1,62,5,1,1,10
2021-01-27,4,0,33,1,0,5,4
2021-01-27,0,0,14,0,0,0,0
2021-01-27,379,23,2669,108,4,61,402
2021-01-27,46,0,460,18,0,13,46
2021-01-27,15,2,117,3,0,2,17
2021-01-27,12,11,276,2,0,12,23
2021-01-27,500,33,1557,81,4,9,533
2021-01-27,0,0,51,0,0,2,0
2021-01-27,63,6,278,20,0,0,69
2021-01-27,37,0,567,2,0,15,37
2021-01-27,178,1,2109,54,0,49,179
2021-01-28,0,0,35,0,0,0,0
2021-01-28,0,0,25,0,0,0,0
2021-01-28,52,0,271,21,0,0,52
2021-01-28,487,9,3145,135,0,47,496
2021-01-28,32,0,567,2,0,15,32
2021-01-28,1521,33,5960,426,4,117,1554
2021-01-28,39,1,372,6,0,3,40
2021-01-28,15,3,190,3,0,9,18
2021-01-28,1128,51,3655,276,4,81,1179
2021-01-28,0,0,12,0,0,0,0
2021-01-28,5669,372,19275,1498,29,272,6041
2021-01-28,0,0,17,0,0,1,0
2021-01-28,0,0,14,0,0,0,0
2021-01-28,7,1,62,4,1,1,8
2021-01-28,180,7,603,48,2,17,187
2021-01-28,472,28,1543,92,0,12,500
2021-01-28,7,0,84,2,0,3,7
2021-01-28,13,0,126,2,0,3,13
2021-01-28,3,0,25,0,0,0,3
2021-01-28,147,11,614,42,0,8,158
2021-01-28,15,2,114,3,0,26,17
2021-01-28,11,0,59,2,0,1,11
2021-01-28,21,0,215,4,0,2,21
2021-01-28,75,0,234,36,0,1,75
2021-01-28,1128,124,3433,290,14,20,1252
2021-01-28,89,6,642,22,0,13,95
2021-01-28,176,2,2108,55,0,55,178
2021-01-28,41,1,451,8,0,7,42
2021-01-28,353,46,2524,107,8,63,399
2021-01-28,317,9,1153,92,0,24,326
2021-01-28,146,10,750,35,0,16,156
2021-01-28,27,2,350,6,0,9,29
2021-01-28,3,0,33,1,0,5,3
2021-01-28,1328,55,6487,388,9,159,1383
2021-01-28,7,0,48,0,0,5,7
2021-01-28,19,0,132,8,0,0,19
2021-01-28,386,7,1218,89,3,26,393
2021-01-28,4,0,29,0,0,2,4
2021-01-28,81,0,132,10,0,1,81
2021-01-28,12,0,25,5,0,0,12
2021-01-28,253,16,908,73,0,5,269
2021-01-28,2,1,56,0,0,4,3
2021-01-28,0,1,51,0,1,1,1
2021-01-28,49,0,261,12,0,2,49
2021-01-28,43,0,460,18,0,12,43
2021-01-28,67,6,272,19,1,0,73
2021-01-28,3,2,47,0,0,0,5
2021-01-28,149,2,719,30,0,11,151
2021-01-28,281,10,1303,61,0,18,291
2021-01-28,365,16,2659,111,4,48,381
2021-01-28,115,17,775,23,3,8,132
2021-01-28,0,0,14,0,0,0,0
2021-01-28,12,0,52,6,0,0,12
2021-01-28,153,7,672,22,1,14,160
2021-01-28,189,14,1313,50,3,33,203
2021-01-28,13,4,276,2,0,7,17
2021-01-29,3,0,33,1,0,5,3
2021-01-29,86,3,637,24,0,16,89
2021-01-29,1442,36,5922,394,7,108,1478
2021-01-29,182,10,603,41,1,18,192
2021-01-29,8,0,62,3,0,2,8
2021-01-29,487,8,3152,133,0,40,495
2021-01-29,1317,58,6486,379,8,155,1375
2021-01-29,149,9,594,39,1,7,158
2021-01-29,15,0,190,3,0,12,15
2021-01-29,376,14,1213,82,2,23,390
2021-01-29,12,2,52,5,0,0,14
2021-01-29,0,0,25,0,0,0,0
2021-01-29,223,12,920,71,0,4,235
2021-01-29,6,0,84,2,0,0,6
2021-01-29,347,39,2488,106,5,65,386
2021-01-29,12,0,25,5,0,0,12
2021-01-29,352,17,2651,107,3,49,369
2021-01-29,1103,122,3406,295,12,29,1225
2021-01-29,136,12,735,28,0,17,148
2021-01-29,298,10,1158,77,0,28,308
2021-01-29,1,0,12,0,0,0,1
2021-01-29,154,5,669,22,1,10,159
2021-01-29,0,0,56,0,0,4,0
2021-01-29,43,0,451,12,0,4,43
2021-01-29,475,27,1539,72,2,8,502
2021-01-29,0,1,51,0,1,1,1
2021-01-29,17,0,127,10,0,0,17
2021-01-29,45,2,372,11,0,1,47
2021-01-29,42,0,261,11,0,4,42
2021-01-29,2,0,25,0,0,0,2
2021-01-29,0,0,14,0,0,0,0
2021-01-29,46,2,460,18,0,12,48
2021-01-29,0,0,35,0,0,0,0
2021-01-29,5511,325,19325,1479,35,282,5836
2021-01-29,270,13,1301,60,0,13,283
2021-01-29,43,0,271,19,0,1,43
2021-01-29,3,2,47,0,0,0,5
2021-01-29,0,0,14,0,0,0,0
2021-01-29,9,0,48,0,0,5,9
2021-01-29,13,1,115,3,0,26,14
2021-01-29,190,6,2103,47,0,55,196
2021-01-29,151,1,718,30,0,13,152
2021-01-29,4,0,29,0,0,2,4
2021-01-29,59,9,267,17,0,0,68
2021-01-29,27,3,342,7,0,11,30
2021-01-29,10,0,59,2,0,1,10
2021-01-29,13,0,125,2,0,2,13
2021-01-29,118,17,786,23,0,12,135
2021-01-29,18,0,203,5,0,3,18
2021-01-29,8,3,276,0,0,8,11
2021-01-29,75,0,137,9,0,5,75
2021-01-29,80,0,234,34,0,0,80
2021-01-29,28,0,567,2,0,15,28
2021-01-29,0,0,17,0,0,2,0
2021-01-29,1100,41,3643,277,7,78,1141
2021-01-29,187,18,1327,49,2,28,205
2021-01-30,46,1,460,15,0,14,47
2021-01-30,207,18,905,66,1,4,225
2021-01-30,85,6,650,23,0,16,91
2021-01-30,43,8,261,13,0,2,51
2021-01-30,18,0,210,5,0,2,18
2021-01-30,51,6,267,15,0,0,57
2021-01-30,43,0,451,8,0,9,43
2021-01-30,1412,38,5959,392,4,98,1450
2021-01-30,76,2,234,30,0,4,78
2021-01-30,1,0,12,0,0,0,1
2021-01-30,330,38,2515,99,6,70,368
2021-01-30,5398,320,19244,1461,41,299,5718
2021-01-30,5,0,48,0,0,5,5
2021-01-30,9,0,53,5,0,0,9
2021-01-30,17,1,190,3,0,7,18
2021-01-30,16,0,125,9,0,0,16
2021-01-30,142,2,719,30,0,17,144
2021-01-30,8,7,276,1,3,4,15
2021-01-30,3,0,29,0,0,2,3
2021-01-30,134,9,604,38,0,6,143
2021-01-30,1,0,33,1,0,5,1
2021-01-30,0,0,35,0,0,0,0
2021-01-30,460,34,1511,75,2,5,494
2021-01-30,298,8,1186,79,1,28,306
2021-01-30,1028,109,3402,283,9,41,1137
2021-01-30,1310,42,6491,373,4,162,1352
2021-01-30,7,0,62,3,0,2,7
2021-01-30,41,0,271,8,10,1,41
2021-01-30,1060,52,3654,265,7,73,1112
2021-01-30,64,0,135,7,0,5,64
2021-01-30,362,14,1226,87,4,23,376
2021-01-30,262,15,1302,66,2,9,277
2021-01-30,475,7,3132,128,2,48,482
2021-01-30,177,4,2137,47,0,50,181
2021-01-30,9,0,59,2,0,4,9
2021-01-30,12,0,25,5,0,0,12
2021-01-30,0,0,17,0,0,2,0
2021-01-30,12,1,116,2,0,3,13
2021-01-30,26,0,567,2,0,17,26
2021-01-30,146,10,737,35,0,13,156
2021-01-30,0,0,56,0,0,4,0
2021-01-30,40,2,372,11,0,1,42
2021-01-30,179,7,603,48,2,14,186
2021-01-30,0,0,51,0,0,3,0
2021-01-30,5,1,84,0,0,2,6
2021-01-30,346,14,2641,104,2,54,360
2021-01-30,0,0,14,0,0,0,0
2021-01-30,121,16,786,20,0,23,137
2021-01-30,2,0,25,0,0,0,2
2021-01-30,0,0,25,0,0,0,0
2021-01-30,0,0,14,0,0,0,0
2021-01-30,182,18,1316,49,2,22,200
2021-01-30,27,4,348,7,0,13,31
2021-01-30,3,2,47,0,0,0,5
2021-01-30,146,4,649,23,1,7,150
2021-01-30,11,0,137,1,0,1,11
2021-01-31,107,11,787,24,1,13,118
2021-01-31,10,1,118,1,0,5,11
2021-01-31,246,11,1301,61,1,15,257
2021-01-31,126,4,608,36,0,10,130
2021-01-31,0,0,14,0,0,0,0
2021-01-31,78,2,634,21,0,17,80
2021-01-31,454,12,3153,129,3,41,466
2021-01-31,5,0,48,0,0,5,5
2021-01-31,172,16,1302,37,2,38,188
2021-01-31,452,29,1519,72,1,9,481
2021-01-31,212,15,909,69,1,7,227
2021-01-31,43,0,451,9,0,4,43
2021-01-31,51,10,267,14,2,0,61
2021-01-31,72,0,234,31,0,3,72
2021-01-31,979,129,3363,268,11,46,1108
2021-01-31,170,4,2135,49,0,61,174
2021-01-31,128,1,719,28,0,20,129
2021-01-31,0,0,14,0,0,0,0
2021-01-31,0,0,51,0,0,2,0
2021-01-31,39,0,271,19,0,4,39
2021-01-31,1,11,137,0,2,0,12
2021-01-31,10,0,25,4,0,0,10
2021-01-31,84,0,131,9,0,2,84
2021-01-31,1362,30,5884,384,3,120,1392
2021-01-31,4,0,25,0,0,0,4
2021-01-31,29,3,344,6,0,13,32
2021-01-31,43,7,261,13,0,4,50
2021-01-31,0,0,25,0,0,0,0
2021-01-31,7,0,63,2,0,2,7
2021-01-31,351,16,1205,90,4,20,367
2021-01-31,293,6,1167,75,0,27,299
2021-01-31,5259,300,19226,1415,36,327,5559
2021-01-31,11,0,59,2,0,1,11
2021-01-31,1036,39,3669,256,4,61,1075
2021-01-31,2,0,33,1,0,5,2
2021-01-31,42,2,372,12,0,4,44
2021-01-31,4,0,29,1,0,1,4
2021-01-31,318,31,2513,97,5,68,349
2021-01-31,15,0,210,4,0,6,15
2021-01-31,9,0,84,2,0,1,9
2021-01-31,25,0,567,1,0,15,25
2021-01-31,0,0,17,0,0,1,0
2021-01-31,3,2,47,0,0,0,5
2021-01-31,10,2,271,2,1,10,12
2021-01-31,170,8,603,47,2,17,178
2021-01-31,8,0,52,5,0,1,8
2021-01-31,0,0,35,0,0,0,0
2021-01-31,12,0,190,3,0,9,12
2021-01-31,1,0,12,0,0,0,1
2021-01-31,45,2,460,14,0,16,47
2021-01-31,149,5,647,24,1,8,154
2021-01-31,12,0,123,8,0,1,12
2021-01-31,0,0,56,0,0,4,0
2021-01-31,339,14,2631,102,4,67,353
2021-01-31,139,5,724,31,0,18,144
2021-01-31,1306,41,6495,379,8,161,1347
2021-02-01,0,0,14,0,0,0,0
2021-02-01,222,15,909,70,1,7,237
2021-02-01,16,0,210,3,0,2,16
2021-02-01,44,2,267,14,0,1,46
2021-02-01,161,8,603,48,3,18,169
2021-02-01,8,0,52,4,0,2,8
2021-02-01,9,1,94,1,0,3,10
2021-02-01,0,0,14,0,0,0,0
2021-02-01,14,0,126,7,0,2,14
2021-02-01,1017,46,3585,258,7,46,1063
2021-02-01,28,4,346,6,0,11,32
2021-02-01,325,19,2624,93,6,68,344
2021-02-01,0,0,25,0,0,0,0
2021-02-01,90,2,135,10,0,3,92
2021-02-01,7,3,276,3,1,5,10
2021-02-01,81,3,647,21,0,14,84
2021-02-01,287,5,1139,75,0,33,292
2021-02-01,174,1,2127,48,0,72,175
2021-02-01,0,0,47,0,0,0,0
2021-02-01,3,0,56,0,0,5,3
2021-02-01,0,0,35,0,0,0,0
2021-02-01,1,0,12,0,0,0,1
2021-02-01,21,0,567,1,0,14,21
2021-02-01,10,0,137,2,0,3,10
2021-02-01,142,7,667,22,2,13,149
2021-02-01,11,0,190,3,0,7,11
2021-02-01,5,0,63,3,0,1,5
2021-02-01,3,0,29,0,0,2,3
2021-02-01,314,39,2494,100,3,67,353
2021-02-01,5,0,25,0,0,0,5
2021-02-01,73,0,234,30,0,1,73
2021-02-01,10,0,59,2,0,2,10
2021-02-01,38,0,271,18,0,5,38
2021-02-01,466,12,3132,130,4,47,478
2021-02-01,1258,76,6491,373,13,154,1334
2021-02-01,480,28,1537,96,0,13,508
2021-02-01,41,1,372,8,0,4,42
2021-02-01,954,131,3335,254,9,41,1085
2021-02-01,0,0,17,0,0,2,0
2021-02-01,122,3,720,27,0,18,125
2021-02-01,8,1,84,0,0,0,9
2021-02-01,1330,22,5825,370,1,102,1352
2021-02-01,9,0,25,3,0,0,9
2021-02-01,139,7,588,40,0,10,146
2021-02-01,4,0,48,0,0,5,4
2021-02-01,47,1,460,11,1,18,48
2021-02-01,37,0,451,8,0,11,37
2021-02-01,5165,278,19190,1371,38,340,5443
2021-02-01,2,0,33,2,0,5,2
2021-02-01,330,10,1201,88,2,19,340
2021-02-01,132,3,720,32,0,20,135
2021-02-01,102,14,794,26,3,17,116
2021-02-01,181,18,1295,45,2,33,199
2021-02-01,0,0,51,0,0,1,0
2021-02-01,256,12,1302,60,1,15,268
2021-02-01,39,6,261,11,0,2,45
2021-02-02,128,10,568,36,3,10,138
2021-02-02,920,127,3346,256,12,49,1047
2021-02-02,135,7,670,23,2,5,142
2021-02-02,0,0,51,0,0,2,0
2021-02-02,167,7,603,47,2,19,174
2021-02-02,9,1,94,1,0,6,10
2021-02-02,66,0,234,27,0,2,66
2021-02-02,4,0,48,0,0,5,4
2021-02-02,3,0,84,0,0,1,3
2021-02-02,0,0,14,0,0,0,0
2021-02-02,11,3,276,4,0,8,14
2021-02-02,18,0,567,1,0,14,18
2021-02-02,316,35,2520,100,3,62,351
2021-02-02,38,0,460,10,0,16,38
2021-02-02,181,21,1303,45,2,39,202
2021-02-02,436,12,3144,127,3,47,448
2021-02-02,10,1,134,1,0,4,11
2021-02-02,305,14,2616,84,5,60,319
2021-02-02,9,0,25,3,0,0,9
2021-02-02,132,7,726,31,0,20,139
2021-02-02,256,21,1290,63,2,18,277
2021-02-02,1233,51,6501,358,6,160,1284
2021-02-02,969,43,3646,252,8,58,1012
2021-02-02,40,0,372,10,0,7,40
2021-02-02,1,0,12,0,0,0,1
2021-02-02,1298,33,5867,363,5,118,1331
2021-02-02,16,0,213,3,0,3,16
2021-02-02,448,39,1567,64,1,14,487
2021-02-02,3,0,56,0,0,4,3
2021-02-02,273,8,1145,67,0,24,281
2021-02-02,25,3,342,5,1,12,28
2021-02-02,3,0,29,0,0,1,3
2021-02-02,176,7,2118,44,1,67,183
2021-02-02,0,0,14,0,0,0,0
2021-02-02,8,0,52,5,0,1,8
2021-02-02,217,9,923,65,1,7,226
2021-02-02,39,4,267,14,0,0,43
2021-02-02,108,14,812,24,2,13,122
2021-02-02,0,0,17,0,0,2,0
2021-02-02,45,4,261,11,0,3,49
2021-02-02,36,0,271,17,0,3,36
2021-02-02,12,0,123,7,0,1,12
2021-02-02,2,0,33,2,0,3,2
2021-02-02,10,0,59,3,0,0,10
2021-02-02,85,0,133,10,0,0,85
2021-02-02,333,9,1214,77,3,27,342
2021-02-02,0,0,47,0,0,0,0
2021-02-02,34,0,451,6,0,10,34
2021-02-02,4990,314,19301,1354,43,319,5304
2021-02-02,118,2,720,25,0,16,120
2021-02-02,81,6,655,20,0,11,87
2021-02-02,5,0,25,0,0,0,5
2021-02-02,4,0,63,0,0,3,4
2021-02-02,0,0,35,0,0,0,0
2021-02-02,0,0,25,0,0,0,0
2021-02-02,10,0,190,2,0,4,10
2021-02-03,0,0,14,0,0,0,0
2021-02-03,5,0,84,1,0,1,5
2021-02-03,42,1,373,17,0,4,43
2021-02-03,209,6,909,71,1,7,215
2021-02-03,128,7,579,35,0,11,135
2021-02-03,945,49,3602,242,11,49,994
2021-02-03,1202,52,6497,348,9,162,1254
2021-02-03,4,0,48,0,0,5,4
2021-02-03,19,0,567,2,0,14,19
2021-02-03,48,3,261,11,0,0,51
2021-02-03,11,0,59,4,0,0,11
2021-02-03,435,33,1552,92,2,8,468
2021-02-03,5,0,29,0,0,2,5
2021-02-03,5,1,92,2,0,5,6
2021-02-03,12,0,25,3,0,0,12
2021-02-03,165,15,1306,42,4,47,180
2021-02-03,61,1,234,27,0,1,62
2021-02-03,418,9,3144,112,2,48,427
2021-02-03,11,3,273,5,0,7,14
2021-02-03,108,19,814,25,1,9,127
2021-02-03,1238,41,5902,365,5,98,1279
2021-02-03,72,9,673,20,0,16,81
2021-02-03,3,0,56,0,0,4,3
2021-02-03,118,2,720,27,0,16,120
2021-02-03,42,1,460,10,0,16,43
2021-02-03,3,0,62,0,0,2,3
2021-02-03,17,0,225,2,0,4,17
2021-02-03,0,0,14,0,0,0,0
2021-02-03,10,1,136,1,0,3,11
2021-02-03,12,0,133,6,0,3,12
2021-02-03,0,0,47,0,0,0,0
2021-02-03,125,6,718,32,0,18,131
2021-02-03,864,127,3359,243,16,52,991
2021-02-03,4796,346,19280,1333,53,313,5142
2021-02-03,166,9,2113,47,0,65,175
2021-02-03,0,0,17,0,0,2,0
2021-02-03,0,0,25,0,0,0,0
2021-02-03,76,1,137,12,0,3,77
2021-02-03,301,39,2523,98,3,71,340
2021-02-03,260,10,1149,66,0,27,270
2021-02-03,164,4,603,48,1,20,168
2021-02-03,137,13,672,20,2,7,150
2021-02-03,2,0,12,0,0,0,2
2021-02-03,340,8,1211,80,2,23,348
2021-02-03,32,0,451,7,0,6,32
2021-02-03,7,0,52,4,0,1,7
2021-02-03,23,2,332,4,1,16,25
2021-02-03,9,0,190,2,0,6,9
2021-02-03,2,0,25,0,0,0,2
2021-02-03,0,0,35,0,0,0,0
2021-02-03,250,22,1290,60,2,15,272
2021-02-03,0,0,51,0,0,0,0
2021-02-03,3,0,33,2,0,4,3
2021-02-03,32,7,278,12,0,1,39
2021-02-03,38,0,271,19,0,4,38
2021-02-03,302,14,2624,78,4,73,316
2021-02-04,245,21,1301,59,3,8,266
2021-02-04,119,5,721,27,0,21,124
2021-02-04,419,24,1535,62,3,2,443
2021-02-04,319,9,1232,76,1,27,328
2021-02-04,114,15,813,23,1,8,129
2021-02-04,4,0,29,1,0,1,4
2021-02-04,0,0,14,0,0,0,0
2021-02-04,55,1,234,26,0,1,56
2021-02-04,40,0,271,19,0,0,40
2021-02-04,2,0,12,0,0,0,2
2021-02-04,43,0,460,10,0,17,43
2021-02-04,45,0,372,16,0,4,45
2021-02-04,21,0,567,3,0,16,21
2021-02-04,381,14,3160,108,3,49,395
2021-02-04,4607,319,19299,1276,31,332,4926
2021-02-04,139,8,672,21,1,9,147
2021-02-04,0,0,17,0,0,2,0
2021-02-04,0,0,47,0,0,0,0
2021-02-04,25,4,338,5,1,13,29
2021-02-04,13,0,131,6,0,3,13
2021-02-04,847,117,3319,220,11,56,964
2021-02-04,302,42,2520,91,4,67,344
2021-02-04,4,0,33,1,0,5,4
2021-02-04,14,2,273,4,0,10,16
2021-02-04,196,8,903,62,1,6,204
2021-02-04,906,50,3613,234,8,47,956
2021-02-04,174,20,1332,42,3,50,194
2021-02-04,161,6,603,44,2,21,167
2021-02-04,12,0,25,2,0,0,12
2021-02-04,8,0,190,1,0,8,8
2021-02-04,2,0,62,0,0,1,2
2021-02-04,34,5,278,11,0,0,39
2021-02-04,72,1,135,12,0,3,73
2021-02-04,114,0,720,26,0,21,114
2021-02-04,32,0,451,7,0,7,32
2021-02-04,171,5,2145,47,1,65,176
2021-02-04,7,1,84,2,0,1,8
2021-02-04,14,2,128,2,0,2,16
2021-02-04,292,18,2625,78,5,65,310
2021-02-04,1233,36,5923,342,4,112,1269
2021-02-04,6,1,52,2,0,2,7
2021-02-04,0,0,14,0,0,0,0
2021-02-04,118,11,597,32,1,12,129
2021-02-04,14,0,218,3,0,7,14
2021-02-04,259,5,1142,60,0,31,264
2021-02-04,0,0,25,0,0,0,0
2021-02-04,43,3,261,11,0,1,46
2021-02-04,2,0,56,0,0,4,2
2021-02-04,69,8,643,19,0,16,77
2021-02-04,1142,47,6500,333,11,176,1189
2021-02-04,8,1,87,3,0,3,9
2021-02-04,5,0,48,0,0,5,5
2021-02-04,2,0,25,0,0,0,2
2021-02-04,0,0,35,0,0,0,0
2021-02-04,0,0,51,0,0,1,0
2021-02-04,9,0,59,3,0,0,9
2021-02-05,172,6,883,57,0,4,178
2021-02-05,11,0,59,2,0,0,11
2021-02-05,38,0,271,19,0,1,38
2021-02-05,0,0,14,0,0,0,0
2021-02-05,229,24,1296,52,5,15,253
2021-02-05,62,2,640,17,0,16,64
2021-02-05,5,0,33,1,0,5,5
2021-02-05,11,4,137,2,0,2,15
2021-02-05,1164,29,5864,347,2,101,1193
2021-02-05,115,9,708,23,0,20,124
2021-02-05,0,0,35,0,0,0,0
2021-02-05,154,6,603,43,1,22,160
2021-02-05,256,2,1141,59,0,28,258
2021-02-05,14,0,214,4,0,6,14
2021-02-05,2,0,62,0,0,2,2
2021-02-05,43,3,261,9,0,2,46
2021-02-05,39,8,278,15,0,0,47
2021-02-05,405,29,1525,97,1,7,434
2021-02-05,6,0,29,1,0,1,6
2021-02-05,0,0,14,0,0,0,0
2021-02-05,23,2,344,6,1,12,25
2021-02-05,905,45,3636,216,8,56,950
2021-02-05,2,0,12,0,0,0,2
2021-02-05,2,0,25,0,0,0,2
2021-02-05,294,34,2498,85,2,73,328
2021-02-05,0,0,47,0,0,0,0
2021-02-05,7,1,52,2,0,2,8
2021-02-05,4,0,48,0,0,5,4
2021-02-05,109,1,720,25,0,18,110
2021-02-05,172,4,2145,49,0,60,176
2021-02-05,166,21,1340,45,3,35,187
2021-02-05,260,17,2611,64,3,82,277
2021-02-05,6,0,190,1,0,8,6
2021-02-05,49,0,234,22,0,4,49
2021-02-05,31,0,451,8,0,9,31
2021-02-05,15,1,274,4,0,12,16
2021-02-05,36,1,460,10,0,20,37
2021-02-05,821,109,3314,214,9,27,930
2021-02-05,0,0,52,0,0,3,0
2021-02-05,1100,38,6498,328,11,182,1138
2021-02-05,2,0,56,0,0,4,2
2021-02-05,48,1,372,10,0,11,49
2021-02-05,20,0,567,2,0,26,20
2021-02-05,8,0,94,3,0,8,8
2021-02-05,110,9,592,29,0,13,119
2021-02-05,134,9,672,18,2,13,143
2021-02-05,12,0,25,4,0,0,12
2021-02-05,4421,338,19294,1275,36,287,4759
2021-02-05,305,11,1207,74,1,25,316
2021-02-05,109,10,780,22,0,13,119
2021-02-05,67,0,135,13,0,0,67
2021-02-05,12,0,129,5,0,5,12
2021-02-05,0,0,17,0,0,2,0
2021-02-05,9,1,84,2,0,1,10
2021-02-05,360,17,3141,107,3,38,377
2021-02-05,0,0,25,0,0,0,0
2021-02-06,1074,43,6478,325,11,179,1117
2021-02-06,1,0,12,0,0,0,1
2021-02-06,828,46,3613,203,4,73,874
2021-02-06,0,0,14,0,0,0,0
2021-02-06,23,1,327,6,0,11,24
2021-02-06,154,17,1325,44,1,37,171
2021-02-06,7,1,84,1,0,2,8
2021-02-06,105,0,720,22,0,17,105
2021-02-06,107,7,709,24,0,16,114
2021-02-06,1093,35,5898,335,1,103,1128
2021-02-06,126,6,652,15,0,10,132
2021-02-06,12,0,218,4,0,3,12
2021-02-06,0,0,17,0,0,2,0
2021-02-06,6,1,52,1,0,2,7
2021-02-06,69,2,137,12,0,3,71
2021-02-06,0,0,25,0,0,0,0
2021-02-06,0,0,14,0,0,0,0
2021-02-06,22,0,567,2,0,24,22
2021-02-06,4186,306,19328,1214,31,277,4492
2021-02-06,10,0,25,3,0,0,10
2021-02-06,15,2,274,3,0,9,17
2021-02-06,245,16,2587,66,3,71,261
2021-02-06,44,0,271,17,0,3,44
2021-02-06,94,14,780,21,0,13,108
2021-02-06,25,0,451,8,0,24,25
2021-02-06,12,0,131,6,0,2,12
2021-02-06,132,5,603,37,0,21,137
2021-02-06,4,0,33,1,0,5,4
2021-02-06,298,9,1210,70,2,24,307
2021-02-06,1,0,56,0,0,3,1
2021-02-06,12,0,59,3,0,1,12
2021-02-06,39,8,278,13,0,0,47
2021-02-06,98,12,584,32,0,10,110
2021-02-06,282,37,2483,93,7,68,319
2021-02-06,42,1,261,11,0,2,43
2021-02-06,341,24,3139,102,1,55,365
2021-02-06,0,0,47,0,0,0,0
2021-02-06,5,0,29,1,0,1,5
2021-02-06,0,1,52,0,0,1,1
2021-02-06,175,7,877,61,0,5,182
2021-02-06,0,0,35,0,0,0,0
2021-02-06,378,25,1499,94,2,6,403
2021-02-06,244,3,1140,58,0,32,247
2021-02-06,46,2,372,11,0,10,48
2021-02-06,43,0,246,23,0,2,43
2021-02-06,2,0,62,0,0,2,2
2021-02-06,32,0,460,8,0,19,32
2021-02-06,159,5,2130,43,0,62,164
2021-02-06,6,0,90,2,0,4,6
2021-02-06,7,0,48,0,0,5,7
2021-02-06,69,1,632,16,0,17,70
2021-02-06,218,31,1296,47,7,12,249
2021-02-06,3,0,25,0,0,0,3
2021-02-06,6,0,190,0,0,9,6
2021-02-06,9,2,129,1,0,4,11
2021-02-06,786,111,3320,201,9,39,897
2021-02-07,366,25,1505,98,2,10,391
2021-02-07,33,1,460,8,0,18,34
2021-02-07,137,18,1300,45,0,39,155
2021-02-07,1042,37,6493,318,10,173,1079
2021-02-07,67,1,135,11,0,2,68
2021-02-07,7,0,48,0,0,5,7
2021-02-07,5,0,29,1,0,1,5
2021-02-07,41,1,372,11,0,10,42
2021-02-07,0,0,35,0,0,0,0
2021-02-07,5,0,52,1,0,3,5
2021-02-07,12,0,213,2,0,5,12
2021-02-07,11,0,59,3,0,2,11
2021-02-07,0,0,25,0,0,0,0
2021-02-07,171,8,893,61,2,2,179
2021-02-07,270,2,1148,59,0,34,272
2021-02-07,768,103,3247,209,5,39,871
2021-02-07,124,11,652,18,0,11,135
2021-02-07,8,0,90,2,0,6,8
2021-02-07,92,8,583,31,0,16,100
2021-02-07,20,3,336,6,0,10,23
2021-02-07,822,48,3622,203,3,67,870
2021-02-07,279,32,2445,90,4,72,311
2021-02-07,42,7,276,16,0,0,49
2021-02-07,6,0,190,0,0,10,6
2021-02-07,38,2,246,21,0,2,40
2021-02-07,282,12,1182,65,4,39,294
2021-02-07,2,0,62,0,0,1,2
2021-02-07,1,0,14,0,0,0,1
2021-02-07,3,0,25,0,0,0,3
2021-02-07,24,0,451,8,0,24,24
2021-02-07,67,2,634,17,0,19,69
2021-02-07,141,6,603,39,0,18,147
2021-02-07,1,0,12,0,0,0,1
2021-02-07,10,0,131,6,0,3,10
2021-02-07,237,15,2580,68,3,73,252
2021-02-07,4,0,33,1,0,6,4
2021-02-07,106,1,720,18,0,19,107
2021-02-07,0,0,14,0,0,0,0
2021-02-07,84,17,777,21,0,8,101
2021-02-07,327,18,3128,100,2,61,345
2021-02-07,9,2,129,1,0,6,11
2021-02-07,101,9,703,27,1,18,110
2021-02-07,4079,255,19188,1193,27,318,4334
2021-02-07,11,0,25,4,0,0,11
2021-02-07,1046,24,5847,331,4,97,1070
2021-02-07,38,2,261,10,0,5,40
2021-02-07,0,0,17,0,0,2,0
2021-02-07,2,0,56,2,0,3,2
2021-02-07,210,22,1299,44,4,16,232
2021-02-07,151,3,2119,45,0,67,154
2021-02-07,0,0,47,0,0,0,0
2021-02-07,0,1,52,0,0,4,1
2021-02-07,7,0,84,1,0,1,7
2021-02-07,40,0,271,17,0,4,40
2021-02-07,22,0,567,5,0,23,22
2021-02-07,14,4,275,3,2,5,18
2021-02-08,13,0,223,2,0,5,13
2021-02-08,38,0,234,24,0,1,38
2021-02-08,86,11,775,20,0,9,97
2021-02-08,147,2,2126,45,0,71,149
2021-02-08,992,47,6483,314,7,184,1039
2021-02-08,257,3,1144,46,0,32,260
2021-02-08,8,0,190,0,0,7,8
2021-02-08,11,0,59,3,0,2,11
2021-02-08,36,2,261,11,0,5,38
2021-02-08,0,0,17,0,0,2,0
2021-02-08,22,0,567,5,0,24,22
2021-02-08,0,0,35,0,0,0,0
2021-02-08,23,0,451,9,0,8,23
2021-02-08,273,28,2455,86,6,68,301
2021-02-08,3973,267,19173,1159,45,307,4240
2021-02-08,60,2,625,17,0,21,62
2021-02-08,12,6,274,5,1,7,18
2021-02-08,131,18,1274,43,2,42,149
2021-02-08,7,0,48,0,0,5,7
2021-02-08,802,67,3610,205,12,71,869
2021-02-08,0,0,47,0,0,0,0
2021-02-08,5,0,56,2,0,4,5
2021-02-08,41,6,276,16,0,0,47
2021-02-08,18,3,326,6,0,14,21
2021-02-08,31,2,460,7,1,15,33
2021-02-08,4,0,29,1,0,1,4
2021-02-08,1,0,51,1,0,3,1
2021-02-08,755,98,3255,193,8,49,853
2021-02-08,10,0,84,1,0,1,10
2021-02-08,4,0,52,0,0,3,4
2021-02-08,99,8,584,30,1,15,107
2021-02-08,72,0,132,12,0,2,72
2021-02-08,1058,34,5787,324,4,101,1092
2021-02-08,1,0,12,0,0,0,1
2021-02-08,221,14,1302,46,2,16,235
2021-02-08,12,0,83,2,0,3,12
2021-02-08,0,0,25,0,0,0,0
2021-02-08,3,0,62,0,0,2,3
2021-02-08,1,0,14,0,0,0,1
2021-02-08,96,13,714,27,1,17,109
2021-02-08,165,5,916,61,0,1,170
2021-02-08,0,0,14,0,0,0,0
2021-02-08,3,0,25,0,0,0,3
2021-02-08,11,0,25,4,0,0,11
2021-02-08,149,3,603,41,0,18,152
2021-02-08,361,17,1512,95,1,10,378
2021-02-08,9,0,131,6,0,3,9
2021-02-08,4,0,33,1,0,6,4
2021-02-08,40,0,271,17,0,4,40
2021-02-08,128,11,672,17,0,14,139
2021-02-08,9,2,129,1,0,4,11
2021-02-08,40,0,373,10,0,11,40
2021-02-08,280,12,1183,63,3,35,292
2021-02-08,339,13,3120,98,2,64,352
2021-02-08,239,12,2570,71,4,77,251
2021-02-08,98,0,720,17,0,20,98
2021-02-09,951,50,6481,314,9,179,1001
2021-02-09,39,0,271,20,0,1,39
2021-02-09,101,17,732,25,3,11,118
2021-02-09,124,17,1310,37,0,46,141
2021-02-09,3772,312,19319,1105,41,331,4084
2021-02-09,3,0,48,0,0,5,3
2021-02-09,3,0,25,0,0,0,3
2021-02-09,18,3,330,6,0,15,21
2021-02-09,1,0,51,1,0,2,1
2021-02-09,38,1,373,10,0,5,39
2021-02-09,8,0,131,1,0,4,8
2021-02-09,82,9,781,16,2,9,91
2021-02-09,1,0,35,0,0,0,1
2021-02-09,738,57,3600,187,13,75,795
2021-02-09,15,2,275,4,0,6,17
2021-02-09,0,0,47,0,0,0,0
2021-02-09,145,4,603,35,0,25,149
2021-02-09,147,2,2136,44,1,70,149
2021-02-09,250,16,2568,73,4,79,266
2021-02-09,4,0,56,1,0,4,4
2021-02-09,36,1,234,23,0,1,37
2021-02-09,726,75,3312,193,6,38,801
2021-02-09,5,0,62,0,0,0,5
2021-02-09,0,0,25,0,0,0,0
2021-02-09,98,8,591,25,1,14,106
2021-02-09,65,2,649,20,0,22,67
2021-02-09,34,2,460,5,1,16,36
2021-02-09,12,0,25,3,0,0,12
2021-02-09,22,0,451,6,0,16,22
2021-02-09,353,16,1536,90,1,15,369
2021-02-09,4,0,190,0,0,5,4
2021-02-09,1,0,12,0,0,0,1
2021-02-09,1009,32,5853,310,1,114,1041
2021-02-09,20,0,567,4,0,22,20
2021-02-09,63,0,137,11,0,3,63
2021-02-09,45,10,278,11,0,0,55
2021-02-09,121,8,672,14,0,12,129
2021-02-09,342,17,3149,97,2,54,359
2021-02-09,5,0,33,1,0,6,5
2021-02-09,8,0,84,1,0,0,8
2021-02-09,268,6,1154,51,0,30,274
2021-02-09,0,0,17,0,0,2,0
2021-02-09,11,0,82,3,0,3,11
2021-02-09,274,17,1189,62,4,33,291
2021-02-09,98,0,720,12,0,18,98
2021-02-09,12,0,59,3,0,1,12
2021-02-09,1,0,14,0,0,0,1
2021-02-09,6,0,52,3,0,1,6
2021-02-09,11,0,125,6,0,2,11
2021-02-09,210,13,1304,46,2,12,223
2021-02-09,260,40,2471,79,5,72,300
2021-02-09,12,0,209,2,0,4,12
2021-02-09,3,0,29,1,0,1,3
2021-02-09,160,8,927,61,0,6,168
2021-02-09,0,0,14,0,0,0,0
2021-02-09,36,0,261,9,0,4,36
2021-02-10,18,0,451,5,0,17,18
2021-02-10,0,0,25,0,0,0,0
2021-02-10,153,12,914,58,1,9,165
2021-02-10,14,3,275,4,1,4,17
2021-02-10,0,0,47,0,0,0,0
2021-02-10,13,0,59,2,0,2,13
2021-02-10,0,0,14,0,0,0,0
2021-02-10,5,0,33,1,0,6,5
2021-02-10,242,41,2503,78,5,75,283
2021-02-10,79,5,780,18,0,13,84
2021-02-10,132,2,2128,40,1,70,134
2021-02-10,12,0,219,2,0,2,12
2021-02-10,97,13,730,24,2,16,110
2021-02-10,34,1,460,5,0,15,35
2021-02-10,1,0,51,0,0,2,1
2021-02-10,13,0,84,4,0,3,13
2021-02-10,706,61,3585,189,9,64,767
2021-02-10,916,41,6482,301,10,165,957
2021-02-10,266,7,1134,46,0,26,273
2021-02-10,11,0,128,5,0,0,11
2021-02-10,1,0,17,0,0,2,1
2021-02-10,124,14,1316,34,0,44,138
2021-02-10,38,0,271,19,0,2,38
2021-02-10,3614,256,19364,1067,27,337,3870
2021-02-10,20,0,567,4,0,18,20
2021-02-10,3,0,48,0,0,5,3
2021-02-10,33,4,234,22,0,1,37
2021-02-10,2,0,29,1,0,1,2
2021-02-10,34,0,261,10,0,2,34
2021-02-10,4,0,56,1,0,4,4
2021-02-10,44,7,278,13,0,1,51
2021-02-10,20,3,327,7,0,14,23
2021-02-10,154,8,603,38,0,19,162
2021-02-10,687,71,3318,194,8,32,758
2021-02-10,1,0,35,0,0,0,1
2021-02-10,1,0,12,0,0,0,1
2021-02-10,5,0,52,2,0,2,5
2021-02-10,1,0,25,0,0,0,1
2021-02-10,344,13,1558,87,1,15,357
2021-02-10,7,0,62,1,0,4,7
2021-02-10,4,0,190,0,0,13,4
2021-02-10,6,0,84,1,0,0,6
2021-02-10,117,7,672,16,0,4,124
2021-02-10,1,0,14,0,0,0,1
2021-02-10,203,14,1299,41,2,15,217
2021-02-10,245,18,2615,66,4,71,263
2021-02-10,12,0,25,3,0,0,12
2021-02-10,965,35,5867,298,3,120,1000
2021-02-10,319,11,3067,95,2,57,330
2021-02-10,96,11,605,25,1,12,107
2021-02-10,99,1,720,11,0,18,100
2021-02-10,60,0,133,10,0,0,60
2021-02-10,53,3,652,17,0,23,56
2021-02-10,38,0,373,9,0,0,38
2021-02-10,273,18,1182,58,4,38,291
2021-02-10,8,0,140,1,0,3,8
2021-02-11,19,4,317,6,0,15,23
2021-02-11,110,13,672,16,0,13,123
2021-02-11,237,18,2591,65,5,74,255
2021-02-11,9,0,59,2,0,0,9
2021-02-11,1,0,25,0,0,0,1
2021-02-11,1,0,51,1,0,1,1
2021-02-11,3415,223,19379,1032,22,349,3638
2021-02-11,230,40,2517,75,6,67,270
2021-02-11,8,0,127,1,0,2,8
2021-02-11,908,22,5873,290,4,130,930
2021-02-11,48,2,682,16,0,23,50
2021-02-11,0,0,47,0,0,0,0
2021-02-11,13,0,129,4,0,0,13
2021-02-11,4,0,56,1,0,4,4
2021-02-11,2,0,17,0,0,2,2
2021-02-11,1,0,12,0,0,0,1
2021-02-11,325,21,1566,87,1,10,346
2021-02-11,122,2,2123,33,1,73,124
2021-02-11,32,3,234,20,1,2,35
2021-02-11,7,0,62,0,0,3,7
2021-02-11,4,0,48,0,0,5,4
2021-02-11,6,0,84,1,0,0,6
2021-02-11,1,0,35,0,0,0,1
2021-02-11,197,11,1299,41,3,13,208
2021-02-11,114,15,1305,34,1,38,129
2021-02-11,11,3,275,4,1,5,14
2021-02-11,0,0,14,0,0,0,0
2021-02-11,262,10,1185,56,2,32,272
2021-02-11,170,4,915,60,1,11,174
2021-02-11,93,14,723,24,5,21,107
2021-02-11,857,37,6481,282,6,170,894
2021-02-11,674,43,3606,185,6,76,717
2021-02-11,42,7,281,12,1,2,49
2021-02-11,37,0,271,19,0,1,37
2021-02-11,15,0,25,4,0,0,15
2021-02-11,25,0,451,7,0,12,25
2021-02-11,0,0,25,0,0,0,0
2021-02-11,328,23,3080,93,2,48,351
2021-02-11,12,0,221,1,0,2,12
2021-02-11,139,11,603,28,1,29,150
2021-02-11,660,64,3307,185,9,34,724
2021-02-11,2,0,190,0,0,12,2
2021-02-11,99,0,720,11,0,15,99
2021-02-11,32,0,261,11,0,1,32
2021-02-11,96,15,618,28,2,16,111
2021-02-11,65,0,131,10,0,1,65
2021-02-11,30,0,460,6,0,16,30
2021-02-11,4,0,33,1,0,6,4
2021-02-11,3,1,52,3,0,2,4
2021-02-11,17,0,567,3,0,19,17
2021-02-11,0,0,14,0,0,0,0
2021-02-11,76,8,782,18,1,9,84
2021-02-11,13,0,84,5,0,4,13
2021-02-11,255,8,1164,55,0,30,263
2021-02-11,2,0,29,1,0,1,2
2021-02-11,39,0,372,12,0,0,39
2021-02-12,1,0,25,0,0,0,1
2021-02-12,129,5,603,28,0,32,134
2021-02-12,2,0,17,0,0,2,2
2021-02-12,626,43,3606,167,5,86,669
2021-02-12,5,0,48,0,0,5,5
2021-02-12,88,11,726,20,4,16,99
2021-02-12,50,1,658,18,0,21,51
2021-02-12,0,0,25,0,0,0,0
2021-02-12,850,40,6461,281,11,178,890
2021-02-12,242,9,1193,52,1,31,251
2021-02-12,18,0,451,4,0,16,18
2021-02-12,41,4,281,12,0,1,45
2021-02-12,0,0,14,0,0,0,0
2021-02-12,9,0,125,1,0,3,9
2021-02-12,4,0,84,0,0,2,4
2021-02-12,1,0,12,0,0,0,1
2021-02-12,314,20,3069,87,6,53,334
2021-02-12,92,0,720,10,0,16,92
2021-02-12,11,0,220,2,0,3,11
2021-02-12,16,0,25,4,0,0,16
2021-02-12,1,0,35,0,0,0,1
2021-02-12,37,0,271,17,0,2,37
2021-02-12,11,3,269,4,0,10,14
2021-02-12,839,30,5856,270,4,120,869
2021-02-12,2,0,51,1,0,2,2
2021-02-12,30,0,372,10,0,0,30
2021-02-12,17,0,567,3,0,19,17
2021-02-12,93,13,612,25,1,11,106
2021-02-12,64,1,133,7,0,4,65
2021-02-12,2,0,56,1,0,3,2
2021-02-12,0,0,47,0,0,0,0
2021-02-12,4,0,52,4,0,0,4
2021-02-12,240,3,1227,57,0,30,243
2021-02-12,12,0,131,5,0,2,12
2021-02-12,32,2,261,10,0,1,34
2021-02-12,222,19,2595,69,3,79,241
2021-02-12,32,1,234,20,1,1,33
2021-02-12,0,0,14,0,0,0,0
2021-02-12,626,58,3294,184,5,33,684
2021-02-12,319,30,1550,84,0,14,349
2021-02-12,99,12,1325,33,0,50,111
2021-02-12,196,14,1303,41,2,7,210
2021-02-12,20,3,321,7,0,15,23
2021-02-12,8,0,84,4,0,4,8
2021-02-12,4,0,190,1,0,6,4
2021-02-12,28,0,460,6,0,22,28
2021-02-12,158,8,895,52,1,10,166
2021-02-12,109,7,668,13,1,15,116
2021-02-12,3270,196,19282,990,25,333,3466
2021-02-12,219,39,2515,72,6,83,258
2021-02-12,4,0,33,1,0,6,4
2021-02-12,118,2,2125,34,0,77,120
2021-02-12,9,0,59,2,0,1,9
2021-02-12,6,0,62,1,0,2,6
2021-02-12,81,9,779,16,1,9,90
2021-02-12,3,1,29,1,0,1,4
2021-02-13,0,0,47,0,0,0,0
2021-02-13,3092,201,19286,930,33,379,3293
2021-02-13,124,5,2125,35,1,71,129
2021-02-13,3,0,84,0,0,3,3
2021-02-13,185,16,1305,38,1,13,201
2021-02-13,15,0,25,4,0,0,15
2021-02-13,4,0,33,1,0,4,4
2021-02-13,28,1,372,8,0,2,29
2021-02-13,168,11,908,55,1,7,179
2021-02-13,83,0,720,10,0,16,83
2021-02-13,229,3,1180,51,0,31,232
2021-02-13,2,0,51,0,0,1,2
2021-02-13,77,15,780,17,3,11,92
2021-02-13,586,65,3276,186,6,28,651
2021-02-13,86,12,723,22,3,15,98
2021-02-13,227,18,2584,67,3,82,245
2021-02-13,7,0,126,0,0,3,7
2021-02-13,6,0,59,1,0,0,6
2021-02-13,4,0,190,1,0,5,4
2021-02-13,0,0,14,0,0,0,0
2021-02-13,7,0,62,1,0,0,7
2021-02-13,5,0,48,0,0,5,5
2021-02-13,2,0,56,1,0,2,2
2021-02-13,15,0,451,0,1,18,15
2021-02-13,28,2,460,6,0,17,30
2021-02-13,2,1,29,0,0,2,3
2021-02-13,16,0,567,2,0,22,16
2021-02-13,11,0,130,6,0,1,11
2021-02-13,47,1,633,17,1,24,48
2021-02-13,97,18,1339,35,2,42,115
2021-02-13,1,0,17,0,0,2,1
2021-02-13,317,24,1518,87,4,15,341
2021-02-13,0,0,14,0,0,0,0
2021-02-13,12,7,268,4,1,7,19
2021-02-13,824,38,6466,288,10,161,862
2021-02-13,790,26,5878,257,7,112,816
2021-02-13,572,69,3579,153,5,80,641
2021-02-13,302,20,3076,81,4,54,322
2021-02-13,41,6,281,14,0,2,47
2021-02-13,0,0,25,0,0,0,0
2021-02-13,12,0,83,6,0,2,12
2021-02-13,1,0,35,0,0,0,1
2021-02-13,122,7,603,25,2,31,129
2021-02-13,12,1,212,2,1,2,13
2021-02-13,213,38,2522,70,4,73,251
2021-02-13,91,11,614,24,0,12,102
2021-02-13,104,6,647,13,2,17,110
2021-02-13,18,5,325,6,3,14,23
2021-02-13,2,0,25,0,0,0,2
2021-02-13,31,2,234,18,1,-3,33
2021-02-13,40,0,271,15,0,2,40
2021-02-13,232,11,1192,52,2,36,243
2021-02-13,35,0,261,10,0,1,35
2021-02-13,2,0,12,0,0,0,2
2021-02-13,5,0,52,3,0,0,5
2021-02-13,61,0,135,10,0,4,61
2021-02-14,0,0,29,0,0,2,0
2021-02-14,2964,200,19158,908,40,360,3164
2021-02-14,118,3,2098,38,0,88,121
2021-02-14,576,56,3247,181,6,38,632
2021-02-14,78,10,770,19,2,12,88
2021-02-14,30,0,372,7,0,5,30
2021-02-14,2,0,35,0,0,0,2
2021-02-14,2,0,51,0,0,1,2
2021-02-14,2,0,33,1,0,5,2
2021-02-14,0,0,14,0,0,0,0
2021-02-14,29,1,234,17,0,0,30
2021-02-14,92,14,608,22,1,13,106
2021-02-14,13,2,268,4,1,7,15
2021-02-14,806,36,6466,277,6,181,842
2021-02-14,178,17,1303,36,1,8,195
2021-02-14,221,7,897,52,0,26,228
2021-02-14,777,32,5829,242,4,127,809
2021-02-14,1,0,17,0,0,2,1
2021-02-14,6,0,190,2,0,6,6
2021-02-14,33,0,271,13,0,2,33
2021-02-14,13,0,80,5,0,3,13
2021-02-14,2,0,25,0,0,0,2
2021-02-14,2,0,12,0,0,0,2
2021-02-14,81,10,733,25,4,15,91
2021-02-14,16,0,567,2,0,23,16
2021-02-14,5,0,48,0,0,5,5
2021-02-14,79,0,720,10,0,19,79
2021-02-14,293,24,3075,89,4,64,317
2021-02-14,119,4,603,25,0,33,123
2021-02-14,0,0,14,0,0,0,0
2021-02-14,97,5,642,10,2,21,102
2021-02-14,201,49,2494,67,5,81,250
2021-02-14,13,0,25,4,0,0,13
2021-02-14,7,0,52,1,0,0,7
2021-02-14,4,0,84,1,0,2,4
2021-02-14,308,16,1509,84,3,17,324
2021-02-14,17,3,324,7,0,15,20
2021-02-14,6,0,126,0,0,6,6
2021-02-14,0,0,47,0,0,0,0
2021-02-14,42,7,277,13,0,0,49
2021-02-14,60,0,135,10,0,4,60
2021-02-14,99,17,1325,34,3,40,116
2021-02-14,159,11,898,56,1,5,170
2021-02-14,14,2,451,0,1,16,16
2021-02-14,4,0,62,1,0,1,4
2021-02-14,576,42,3619,145,6,90,618
2021-02-14,10,0,129,5,0,0,10
2021-02-14,30,0,261,9,0,3,30
2021-02-14,0,0,25,0,0,0,0
2021-02-14,30,0,460,8,0,21,30
2021-02-14,11,0,205,1,0,4,11
2021-02-14,3,0,56,1,0,2,3
2021-02-14,48,1,627,20,0,26,49
2021-02-14,223,25,2462,59,4,87,248
2021-02-14,6,0,59,1,0,1,6
2021-02-14,221,12,1177,50,4,43,233
2021-02-15,177,11,1293,35,2,16,188
2021-02-15,271,41,3062,93,6,69,312
2021-02-15,106,3,603,21,1,34,109
2021-02-15,10,0,25,4,0,0,10
2021-02-15,146,8,900,56,2,7,154
2021-02-15,80,7,728,24,1,18,87
2021-02-15,3,0,62,1,0,0,3
2021-02-15,50,1,624,20,0,22,51
2021-02-15,2,0,12,0,0,0,2
2021-02-15,0,0,14,0,0,0,0
2021-02-15,2,0,35,0,0,0,2
2021-02-15,748,21,5792,235,9,136,769
2021-02-15,85,13,585,21,2,14,98
2021-02-15,11,2,451,1,1,10,13
2021-02-15,227,27,2578,62,5,107,254
2021-02-15,11,0,81,4,0,5,11
2021-02-15,2,0,84,0,0,2,2
2021-02-15,28,0,372,8,0,1,28
2021-02-15,228,9,1159,53,0,34,237
2021-02-15,207,38,2495,64,3,84,245
2021-02-15,1,0,33,1,0,6,1
2021-02-15,15,4,268,4,1,6,19
2021-02-15,10,0,146,4,0,2,10
2021-02-15,46,9,275,13,0,3,55
2021-02-15,104,28,1321,31,3,43,132
2021-02-15,2855,189,19163,876,43,382,3044
2021-02-15,114,5,2105,36,0,94,119
2021-02-15,7,0,52,1,0,2,7
2021-02-15,4,0,125,0,0,5,4
2021-02-15,309,19,1513,85,2,17,328
2021-02-15,0,0,29,0,0,2,0
2021-02-15,9,0,220,2,0,13,9
2021-02-15,0,0,47,0,0,0,0
2021-02-15,60,0,135,11,0,4,60
2021-02-15,77,17,768,21,0,9,94
2021-02-15,17,4,331,5,0,15,21
2021-02-15,2,0,51,0,0,2,2
2021-02-15,1,0,25,0,0,0,1
2021-02-15,567,51,3210,178,5,39,618
2021-02-15,27,0,460,7,0,22,27
2021-02-15,3,0,59,0,0,3,3
2021-02-15,1,0,17,0,0,2,1
2021-02-15,3,0,56,1,0,3,3
2021-02-15,14,0,567,2,0,24,14
2021-02-15,0,0,25,0,0,0,0
2021-02-15,28,1,234,16,0,0,29
2021-02-15,72,0,720,9,0,16,72
2021-02-15,3,0,190,3,0,8,3
2021-02-15,34,0,271,12,0,2,34
2021-02-15,95,7,642,11,1,16,102
2021-02-15,0,0,14,0,0,0,0
2021-02-15,5,0,48,0,0,5,5
2021-02-15,216,10,1160,48,4,40,226
2021-02-15,29,0,261,9,0,1,29
2021-02-15,782,37,6454,259,10,192,819
2021-02-15,575,54,3500,140,16,92,629
2021-02-16,14,3,325,5,0,15,17
2021-02-16,5,0,116,0,0,7,5
2021-02-16,12,1,451,2,0,10,13
2021-02-16,2,1,12,0,0,0,3
2021-02-16,98,25,1314,32,2,45,123
2021-02-16,226,9,1164,48,0,29,235
2021-02-16,553,60,3228,177,11,40,613
2021-02-16,23,1,372,6,0,2,24
2021-02-16,5,0,212,1,0,5,5
2021-02-16,95,9,662,13,1,16,104
2021-02-16,3,0,48,0,0,5,3
2021-02-16,557,55,3542,147,8,74,612
2021-02-16,1,0,17,0,0,2,1
2021-02-16,11,0,125,6,0,1,11
2021-02-16,11,0,85,4,0,3,11
2021-02-16,56,0,133,11,0,3,56
2021-02-16,212,17,2578,61,4,103,229
2021-02-16,0,0,47,0,0,0,0
2021-02-16,118,7,2112,37,1,98,125
2021-02-16,202,9,1168,48,1,31,211
2021-02-16,67,12,769,17,1,14,79
2021-02-16,13,5,268,2,0,4,18
2021-02-16,1,0,62,0,0,2,1
2021-02-16,33,0,271,12,0,2,33
2021-02-16,7,0,52,1,0,1,7
2021-02-16,2757,223,19197,859,37,391,2980
2021-02-16,45,1,621,18,0,22,46
2021-02-16,12,0,567,2,0,23,12
2021-02-16,27,1,234,16,0,4,28
2021-02-16,39,4,277,13,0,0,43
2021-02-16,82,7,726,22,1,24,89
2021-02-16,5,0,190,3,0,8,5
2021-02-16,1,0,33,1,0,5,1
2021-02-16,303,21,1528,81,1,17,324
2021-02-16,200,37,2498,57,2,87,237
2021-02-16,719,24,5833,235,5,141,743
2021-02-16,0,0,14,0,0,0,0
2021-02-16,0,0,29,0,0,2,0
2021-02-16,144,14,899,58,4,6,158
2021-02-16,172,12,1304,34,2,22,184
2021-02-16,782,39,6472,249,6,217,821
2021-02-16,82,13,578,22,2,16,95
2021-02-16,10,0,25,4,0,0,10
2021-02-16,1,0,56,1,0,1,1
2021-02-16,1,0,35,0,0,0,1
2021-02-16,0,0,14,0,0,0,0
2021-02-16,104,3,603,22,1,30,107
2021-02-16,2,0,52,0,0,1,2
2021-02-16,28,0,460,6,0,23,28
2021-02-16,29,0,261,9,0,1,29
2021-02-16,267,27,3038,88,4,66,294
2021-02-16,0,0,25,0,0,0,0
2021-02-16,2,0,84,0,0,2,2
2021-02-16,4,0,59,0,0,3,4
2021-02-16,0,0,25,0,0,0,0
2021-02-16,72,0,720,9,0,19,72
2021-02-17,10,0,25,3,0,0,10
2021-02-17,85,12,590,23,1,19,97
2021-02-17,0,0,14,0,0,0,0
2021-02-17,3,0,48,0,0,5,3
2021-02-17,23,1,372,6,0,1,24
2021-02-17,12,0,567,2,0,22,12
2021-02-17,65,0,720,9,0,25,65
2021-02-17,2,0,12,0,0,0,2
2021-02-17,1,0,35,0,0,0,1
2021-02-17,0,0,25,0,0,0,0
2021-02-17,1,0,56,1,0,2,1
2021-02-17,15,3,317,4,0,17,18
2021-02-17,6,0,52,1,0,1,6
2021-02-17,1,0,17,0,0,1,1
2021-02-17,556,44,3557,143,4,104,600
2021-02-17,41,9,278,10,0,0,50
2021-02-17,12,3,274,3,2,3,15
2021-02-17,98,20,1333,33,1,41,118
2021-02-17,535,68,3238,172,7,36,603
2021-02-17,663,26,5847,230,7,128,689
2021-02-17,3,0,84,1,0,4,3
2021-02-17,96,10,662,12,1,15,106
2021-02-17,0,0,14,0,0,0,0
2021-02-17,1,0,33,1,0,6,1
2021-02-17,746,55,6476,236,11,210,801
2021-02-17,4,0,59,0,0,1,4
2021-02-17,2,0,62,1,0,1,2
2021-02-17,173,15,1304,37,1,18,188
2021-02-17,2640,230,19251,808,26,410,2870
2021-02-17,204,21,2629,60,6,95,225
2021-02-17,43,0,645,15,0,23,43
2021-02-17,63,13,766,19,2,17,76
2021-02-17,85,9,744,20,1,28,94
2021-02-17,4,0,129,0,0,3,4
2021-02-17,108,10,2109,34,2,85,118
2021-02-17,3,0,214,0,0,4,3
2021-02-17,11,0,83,2,0,4,11
2021-02-17,16,0,451,2,0,4,16
2021-02-17,11,0,129,6,0,1,11
2021-02-17,195,8,1143,46,1,30,203
2021-02-17,219,14,1182,53,0,29,233
2021-02-17,1,0,52,0,0,2,1
2021-02-17,1,0,29,0,0,2,1
2021-02-17,49,0,135,9,0,8,49
2021-02-17,134,9,907,51,5,3,143
2021-02-17,5,1,190,3,0,9,6
2021-02-17,194,33,2499,58,1,76,227
2021-02-17,29,1,261,9,0,2,30
2021-02-17,95,6,603,20,1,23,101
2021-02-17,295,16,1540,75,0,15,311
2021-02-17,32,0,272,15,0,2,32
2021-02-17,261,20,3055,87,5,52,281
2021-02-17,24,3,460,5,0,21,27
2021-02-17,28,2,234,16,1,2,30
2021-02-17,0,0,47,0,0,0,0
2021-02-17,0,0,25,0,0,0,0
2021-02-18,40,12,278,10,0,0,52
2021-02-18,1,2,52,0,0,1,3
2021-02-18,9,0,25,3,0,0,9
2021-02-18,201,17,2624,56,2,89,218
2021-02-18,9,0,86,2,0,5,9
2021-02-18,1,0,35,0,0,0,1
2021-02-18,97,9,603,21,3,23,106
2021-02-18,185,9,1177,53,0,31,194
2021-02-18,93,7,2110,31,1,82,100
2021-02-18,289,18,1540,66,2,17,307
2021-02-18,513,63,3228,152,7,43,576
2021-02-18,173,19,1303,31,1,30,192
2021-02-18,636,25,5828,215,2,117,661
2021-02-18,5,1,52,1,0,3,6
2021-02-18,21,2,460,5,0,20,23
2021-02-18,255,19,3060,82,4,50,274
2021-02-18,0,0,25,0,0,0,0
2021-02-18,0,0,17,0,0,1,0
2021-02-18,86,12,602,20,0,14,98
2021-02-18,12,0,567,2,0,19,12
2021-02-18,505,34,3565,136,2,96,539
2021-02-18,2498,247,19277,760,40,419,2745
2021-02-18,717,41,6481,224,8,203,758
2021-02-18,129,16,904,54,4,11,145
2021-02-18,96,11,1330,37,1,41,107
2021-02-18,6,0,129,0,0,2,6
2021-02-18,0,0,84,0,0,2,0
2021-02-18,2,0,62,1,0,1,2
2021-02-18,1,0,56,1,0,4,1
2021-02-18,33,0,272,15,0,2,33
2021-02-18,2,0,12,0,0,0,2
2021-02-18,10,2,274,1,0,8,12
2021-02-18,23,2,372,5,0,7,25
2021-02-18,59,15,768,18,2,17,74
2021-02-18,38,1,651,14,0,21,39
2021-02-18,42,0,137,10,0,10,42
2021-02-18,12,0,451,2,0,5,12
2021-02-18,0,0,14,0,0,0,0
2021-02-18,2,0,29,0,0,2,2
2021-02-18,26,0,261,8,0,2,26
2021-02-18,82,6,733,20,0,28,88
2021-02-18,93,6,667,12,0,15,99
2021-02-18,2,0,33,1,0,6,2
2021-02-18,29,1,234,14,1,6,30
2021-02-18,0,0,25,0,0,0,0
2021-02-18,6,0,190,1,0,12,6
2021-02-18,2,0,48,0,0,5,2
2021-02-18,0,0,47,0,0,0,0
2021-02-18,188,9,1142,46,0,34,197
2021-02-18,183,29,2501,58,4,77,212
2021-02-18,67,0,720,9,0,24,67
2021-02-18,18,4,325,4,0,17,22
2021-02-18,0,0,14,0,0,0,0
2021-02-18,2,3,213,0,0,4,5
2021-02-18,10,0,126,6,0,5,10
2021-02-18,5,0,59,0,0,0,5
2021-02-19,83,4,667,12,0,20,87
2021-02-19,5,1,202,2,0,0,6
2021-02-19,1,0,56,1,0,4,1
2021-02-19,14,0,567,2,0,20,14
2021-02-19,27,1,234,14,1,5,28
2021-02-19,2369,228,19312,712,32,442,2597
2021-02-19,0,0,14,0,0,0,0
2021-02-19,46,0,135,10,0,8,46
2021-02-19,670,35,6476,218,8,195,705
2021-02-19,1,0,25,0,0,0,1
2021-02-19,11,2,274,0,2,6,13
2021-02-19,0,0,25,0,0,0,0
2021-02-19,2,0,29,0,0,2,2
2021-02-19,32,0,272,11,0,3,32
2021-02-19,84,5,603,20,2,23,89
2021-02-19,6,0,48,0,0,5,6
2021-02-19,84,10,604,23,2,5,94
2021-02-19,84,13,1310,35,2,36,97
2021-02-19,26,0,261,5,0,2,26
2021-02-19,182,5,1184,49,0,30,187
2021-02-19,0,0,14,0,0,0,0
2021-02-19,591,31,5800,196,3,121,622
2021-02-19,1,4,52,0,0,1,5
2021-02-19,11,0,127,6,0,3,11
2021-02-19,493,40,3232,137,4,42,533
2021-02-19,12,0,451,2,0,6,12
2021-02-19,25,2,372,5,0,6,27
2021-02-19,99,5,2116,32,0,85,104
2021-02-19,0,0,12,0,0,0,0
2021-02-19,469,38,3540,133,6,79,507
2021-02-19,0,0,47,0,0,0,0
2021-02-19,80,5,719,19,0,24,85
2021-02-19,1,0,84,0,0,4,1
2021-02-19,3,0,127,1,0,2,3
2021-02-19,7,0,190,1,0,12,7
2021-02-19,127,24,895,52,4,12,151
2021-02-19,265,27,1527,63,2,23,292
2021-02-19,39,6,278,12,0,6,45
2021-02-19,41,1,670,14,0,23,42
2021-02-19,8,0,25,2,0,1,8
2021-02-19,0,0,17,0,0,1,0
2021-02-19,19,2,460,4,0,20,21
2021-02-19,190,29,2519,60,3,79,219
2021-02-19,7,1,52,1,1,2,8
2021-02-19,7,0,59,1,0,0,7
2021-02-19,243,17,3065,73,2,55,260
2021-02-19,186,19,2621,49,1,82,205
2021-02-19,178,6,1173,44,3,35,184
2021-02-19,1,0,35,0,0,0,1
2021-02-19,72,1,720,8,0,16,73
2021-02-19,1,0,62,1,0,3,1
2021-02-19,162,16,1304,30,1,20,178
2021-02-19,16,3,321,6,0,14,19
2021-02-19,8,0,88,2,0,4,8
2021-02-19,57,18,777,20,0,16,75
2021-02-19,2,0,33,1,0,7,2
2021-02-20,7,0,207,2,0,5,7
2021-02-20,0,0,29,0,0,1,0
2021-02-20,1,0,63,0,0,4,1
2021-02-20,177,13,2508,50,2,80,190
2021-02-20,6,1,84,2,0,3,7
2021-02-20,2,0,84,0,0,2,2
2021-02-20,14,4,327,6,0,14,18
2021-02-20,0,0,25,0,0,0,0
2021-02-20,0,0,35,0,0,0,0
2021-02-20,228,15,3053,71,1,59,243
2021-02-20,155,15,1305,34,1,23,170
2021-02-20,455,56,3196,138,5,36,511
2021-02-20,0,0,17,0,0,1,0
2021-02-20,433,37,3510,127,2,102,470
2021-02-20,1,0,25,0,0,0,1
2021-02-20,2,0,115,1,0,2,2
2021-02-20,83,2,603,19,0,32,85
2021-02-20,2213,212,19279,679,34,438,2425
2021-02-20,2,0,33,1,0,7,2
2021-02-20,171,11,1150,43,0,38,182
2021-02-20,176,26,2481,58,1,78,202
2021-02-20,28,1,234,11,0,3,29
2021-02-20,21,1,261,4,0,4,22
2021-02-20,1,0,56,1,0,5,1
2021-02-20,64,17,772,21,0,13,81
2021-02-20,126,25,906,45,5,14,151
2021-02-20,0,0,14,0,0,0,0
2021-02-20,38,1,656,13,0,22,39
2021-02-20,78,10,1303,30,0,36,88
2021-02-20,577,32,5839,190,1,122,609
2021-02-20,9,0,25,3,0,0,9
2021-02-20,25,2,372,5,0,6,27
2021-02-20,3,0,59,0,0,1,3
2021-02-20,167,7,1165,51,0,31,174
2021-02-20,32,1,272,12,0,4,33
2021-02-20,70,12,582,17,1,11,82
2021-02-20,59,0,720,8,0,18,59
2021-02-20,89,5,2112,28,0,87,94
2021-02-20,0,0,12,0,0,0,0
2021-02-20,6,2,52,1,1,0,8
2021-02-20,10,4,273,0,1,7,14
2021-02-20,0,0,47,0,0,0,0
2021-02-20,45,0,135,9,0,9,45
2021-02-20,75,8,647,11,0,26,83
2021-02-20,2,4,52,0,0,2,6
2021-02-20,35,8,278,10,0,5,43
2021-02-20,6,0,190,2,0,8,6
2021-02-20,64,6,720,19,2,24,70
2021-02-20,11,0,451,2,0,11,11
2021-02-20,7,0,48,0,0,5,7
2021-02-20,18,0,567,1,0,21,18
2021-02-20,22,3,460,4,0,22,25
2021-02-20,244,32,1512,63,4,19,276
2021-02-20,0,0,14,0,0,0,0
2021-02-20,10,0,125,6,0,2,10
2021-02-20,636,36,6462,205,9,219,672
2021-02-21,79,6,647,13,1,21,85
2021-02-21,37,1,632,13,0,24,38
2021-02-21,437,56,3485,122,6,106,493
2021-02-21,125,23,896,41,5,16,148
2021-02-21,2,0,59,0,0,3,2
2021-02-21,2,4,52,0,0,2,6
2021-02-21,7,0,25,3,0,0,7
2021-02-21,189,4,1155,38,0,39,193
2021-02-21,0,0,25,0,0,0,0
2021-02-21,556,33,5815,179,1,127,589
2021-02-21,1,0,33,0,0,8,1
2021-02-21,13,0,451,3,0,8,13
2021-02-21,27,1,234,11,0,1,28
2021-02-21,2146,191,19119,660,31,512,2337
2021-02-21,0,0,12,0,0,0,0
2021-02-21,33,7,278,11,1,7,40
2021-02-21,2,1,119,1,0,3,3
2021-02-21,9,0,116,6,0,1,9
2021-02-21,22,2,372,2,1,3,24
2021-02-21,93,5,2088,27,1,86,98
2021-02-21,174,26,2461,55,1,78,200
2021-02-21,221,21,3040,67,4,69,242
2021-02-21,185,25,2578,53,4,90,210
2021-02-21,19,0,567,1,0,21,19
2021-02-21,167,7,1160,50,0,33,174
2021-02-21,10,0,190,3,0,5,10
2021-02-21,2,0,84,0,0,4,2
2021-02-21,231,13,1493,58,1,28,244
2021-02-21,143,14,1305,31,2,22,157
2021-02-21,15,5,317,5,2,14,20
2021-02-21,19,1,460,4,0,25,20
2021-02-21,441,51,3161,132,5,43,492
2021-02-21,32,1,272,10,0,4,33
2021-02-21,0,0,17,0,0,1,0
2021-02-21,7,0,209,3,0,3,7
2021-02-21,41,0,137,6,0,13,41
2021-02-21,63,16,561,16,1,12,79
2021-02-21,0,0,14,0,0,0,0
2021-02-21,1,0,56,1,0,5,1
2021-02-21,0,0,35,0,0,0,0
2021-02-21,66,8,714,18,1,24,74
2021-02-21,82,2,603,17,0,36,84
2021-02-21,0,0,47,0,0,0,0
2021-02-21,6,2,52,1,1,0,8
2021-02-21,0,0,25,0,0,0,0
2021-02-21,0,0,14,0,0,0,0
2021-02-21,8,0,48,0,0,5,8
2021-02-21,46,1,720,9,0,19,47
2021-02-21,622,36,6454,198,7,223,658
2021-02-21,1,0,29,1,0,1,1
2021-02-21,5,1,72,2,0,5,6
2021-02-21,9,7,273,0,1,7,16
2021-02-21,1,0,63,0,0,4,1
2021-02-21,64,16,770,23,0,13,80
2021-02-21,24,0,261,6,0,3,24
2021-02-21,84,9,1299,33,0,39,93
2021-02-22,601,31,6454,188,7,241,632
2021-02-22,226,26,3027,71,4,78,252
2021-02-22,75,7,667,12,1,21,82
2021-02-22,22,0,261,6,0,1,22
2021-02-22,4,0,63,0,0,4,4
2021-02-22,0,0,12,0,0,0,0
2021-02-22,167,6,1156,32,2,43,173
2021-02-22,65,8,705,18,1,21,73
2021-02-22,39,2,639,12,0,22,41
2021-02-22,0,0,17,0,0,2,0
2021-02-22,2,0,56,3,0,4,2
2021-02-22,32,1,272,9,0,4,33
2021-02-22,122,6,901,40,0,14,128
2021-02-22,1,0,29,1,0,1,1
2021-02-22,0,0,25,0,0,0,0
2021-02-22,1,0,59,0,0,5,1
2021-02-22,539,28,5805,152,0,150,567
2021-02-22,40,1,720,8,0,18,41
2021-02-22,138,15,1304,29,1,17,153
2021-02-22,7,0,25,3,0,1,7
2021-02-22,96,5,2076,30,0,91,101
2021-02-22,40,0,133,6,0,9,40
2021-02-22,29,0,234,12,0,4,29
2021-02-22,170,9,1152,50,0,29,179
2021-02-22,81,10,1269,34,0,53,91
2021-02-22,414,44,3522,113,5,96,458
2021-02-22,239,19,1515,60,2,22,258
2021-02-22,18,3,372,2,1,3,21
2021-02-22,8,0,48,0,0,5,8
2021-02-22,0,0,35,0,0,0,0
2021-02-22,180,21,2580,50,2,96,201
2021-02-22,180,23,2420,54,1,80,203
2021-02-22,4,0,79,2,0,4,4
2021-02-22,0,0,14,0,0,0,0
2021-02-22,0,0,47,0,0,0,0
2021-02-22,9,5,274,0,0,7,14
2021-02-22,56,16,556,16,3,17,72
2021-02-22,2064,200,19089,619,34,487,2264
2021-02-22,15,1,567,2,0,19,16
2021-02-22,64,6,769,22,0,20,70
2021-02-22,0,0,33,0,0,8,0
2021-02-22,18,0,460,3,0,23,18
2021-02-22,9,2,205,4,0,5,11
2021-02-22,13,0,451,4,0,11,13
2021-02-22,13,5,314,5,1,15,18
2021-02-22,10,0,121,6,0,4,10
2021-02-22,407,49,3215,112,8,48,456
2021-02-22,5,1,52,1,1,2,6
2021-02-22,5,0,119,1,0,2,5
2021-02-22,9,0,190,2,0,6,9
2021-02-22,30,6,278,11,0,9,36
2021-02-22,2,1,52,0,1,0,3
2021-02-22,76,6,603,17,1,35,82
2021-02-22,0,0,14,0,0,0,0
2021-02-22,0,0,25,0,0,0,0
2021-02-22,0,0,84,0,0,4,0
2021-02-23,95,6,2097,28,0,87,101
2021-02-23,85,3,603,17,0,22,88
2021-02-23,1,0,52,0,0,1,1
2021-02-23,33,1,271,8,0,6,34
2021-02-23,1,0,59,0,0,5,1
2021-02-23,4,0,25,2,0,1,4
2021-02-23,12,6,319,4,0,16,18
2021-02-23,22,2,372,3,0,0,24
2021-02-23,35,3,278,10,0,7,38
2021-02-23,0,0,25,0,0,0,0
2021-02-23,89,17,1293,30,0,48,106
2021-02-23,597,34,6487,178,6,222,631
2021-02-23,0,0,35,0,0,0,0
2021-02-23,3,1,85,2,0,3,4
2021-02-23,241,14,1532,63,1,18,255
2021-02-23,4,0,52,1,0,2,4
2021-02-23,11,0,127,6,0,2,11
2021-02-23,1,0,84,0,0,5,1
2021-02-23,1,0,33,0,0,5,1
2021-02-23,20,0,261,7,0,1,20
2021-02-23,27,0,234,10,0,5,27
2021-02-23,3,0,48,0,0,5,3
2021-02-23,13,1,567,3,0,18,14
2021-02-23,16,0,451,1,0,5,16
2021-02-23,0,0,12,0,0,0,0
2021-02-23,0,0,14,0,0,0,0
2021-02-23,2,0,56,3,0,3,2
2021-02-23,6,0,190,1,0,8,6
2021-02-23,118,15,890,42,0,8,133
2021-02-23,4,0,63,0,0,5,4
2021-02-23,2,1,115,1,0,3,3
2021-02-23,0,0,17,0,0,2,0
2021-02-23,1,0,29,0,0,1,1
2021-02-23,0,0,47,0,0,0,0
2021-02-23,406,49,3264,116,6,50,455
2021-02-23,37,1,667,12,0,16,38
2021-02-23,52,13,557,14,2,18,65
2021-02-23,141,14,1307,30,1,19,155
2021-02-23,165,7,1117,49,0,26,172
2021-02-23,78,9,667,11,1,18,87
2021-02-23,9,2,276,0,0,4,11
2021-02-23,515,26,5828,151,3,144,541
2021-02-23,41,0,720,8,0,22,41
2021-02-23,17,1,460,3,0,18,18
2021-02-23,157,8,1188,36,3,41,165
2021-02-23,61,5,703,17,1,16,66
2021-02-23,396,36,3564,112,6,99,432
2021-02-23,1988,226,19276,600,28,470,2214
2021-02-23,215,24,3063,66,1,68,239
2021-02-23,54,11,775,23,0,19,65
2021-02-23,0,0,25,0,0,0,0
2021-02-23,183,18,2573,50,1,85,201
2021-02-23,0,0,14,0,0,0,0
2021-02-23,39,0,129,6,0,5,39
2021-02-23,175,25,2438,49,4,78,200
2021-02-23,9,0,210,5,0,4,9
2021-02-24,151,9,1142,33,2,29,160
2021-02-24,1,0,25,0,0,0,1
2021-02-24,14,3,317,4,0,16,17
2021-02-24,2,0,84,0,0,3,2
2021-02-24,172,22,2443,50,1,77,194
2021-02-24,22,0,261,4,0,0,22
2021-02-24,29,5,278,6,0,10,34
2021-02-24,227,15,1530,52,1,23,242
2021-02-24,91,7,2106,29,1,81,98
2021-02-24,14,1,567,1,1,16,15
2021-02-24,1,0,52,0,0,1,1
2021-02-24,0,0,14,0,0,0,0
2021-02-24,19,2,460,2,0,21,21
2021-02-24,35,1,271,8,0,2,36
2021-02-24,0,0,35,0,0,0,0
2021-02-24,371,37,3563,102,5,101,408
2021-02-24,182,11,2609,52,1,75,193
2021-02-24,43,0,133,6,0,9,43
2021-02-24,83,4,603,19,0,20,87
2021-02-24,117,13,894,42,3,9,130
2021-02-24,53,13,770,21,1,17,66
2021-02-24,1,2,132,1,0,1,3
2021-02-24,3,0,48,0,0,5,3
2021-02-24,0,0,14,0,0,0,0
2021-02-24,3,0,52,1,0,2,3
2021-02-24,560,35,6499,179,6,218,595
2021-02-24,74,6,667,10,1,20,80
2021-02-24,1,0,33,0,0,5,1
2021-02-24,0,0,17,0,0,2,0
2021-02-24,2,0,59,0,0,4,2
2021-02-24,4,1,190,1,1,4,5
2021-02-24,0,0,25,0,0,0,0
2021-02-24,39,0,720,9,0,16,39
2021-02-24,203,31,3088,62,3,60,234
2021-02-24,0,0,12,0,0,0,0
2021-02-24,2,0,88,2,0,2,2
2021-02-24,515,27,5887,160,2,222,542
2021-02-24,39,0,687,12,0,15,39
2021-02-24,19,2,372,2,0,6,21
2021-02-24,161,7,1158,49,0,19,168
2021-02-24,52,14,579,15,0,13,66
2021-02-24,26,0,234,8,0,3,26
2021-02-24,16,0,451,1,0,4,16
2021-02-24,1,0,29,0,0,1,1
2021-02-24,53,5,704,16,2,21,58
2021-02-24,1886,215,19281,573,32,466,2101
2021-02-24,10,0,219,4,0,57,10
2021-02-24,0,0,47,0,0,0,0
2021-02-24,90,18,1296,28,3,45,108
2021-02-24,381,57,3288,102,5,55,438
2021-02-24,4,0,25,3,0,0,4
2021-02-24,2,0,56,3,0,2,2
2021-02-24,137,21,1300,30,3,18,158
2021-02-24,12,0,132,6,0,0,12
2021-02-24,3,0,63,0,0,5,3
2021-02-24,8,2,276,0,1,6,10
2021-02-25,0,0,14,0,0,0,0
2021-02-25,5,0,190,2,0,6,5
2021-02-25,144,8,1183,35,1,44,152
2021-02-25,453,22,5866,137,5,234,475
2021-02-25,13,2,317,4,1,15,15
2021-02-25,177,16,2597,50,2,73,193
2021-02-25,33,5,279,8,0,8,38
2021-02-25,0,0,25,0,0,0,0
2021-02-25,192,27,3072,66,2,51,219
2021-02-25,0,0,17,0,0,2,0
2021-02-25,35,0,271,6,0,8,35
2021-02-25,218,17,1524,48,1,18,235
2021-02-25,0,0,14,0,0,0,0
2021-02-25,2,1,84,0,1,3,3
2021-02-25,535,26,6484,173,2,217,561
2021-02-25,10,0,132,5,0,2,10
2021-02-25,1,0,48,0,0,5,1
2021-02-25,0,0,35,0,0,0,0
2021-02-25,139,14,1309,30,2,20,153
2021-02-25,8,2,276,0,0,6,10
2021-02-25,6,0,25,4,0,0,6
2021-02-25,18,1,567,4,0,17,19
2021-02-25,39,0,131,7,0,7,39
2021-02-25,0,0,29,0,0,2,0
2021-02-25,21,0,261,6,0,2,21
2021-02-25,74,14,1298,30,0,45,88
2021-02-25,56,17,771,18,4,16,73
2021-02-25,72,6,667,10,2,19,78
2021-02-25,46,16,581,13,1,7,62
2021-02-25,35,0,663,12,0,18,35
2021-02-25,76,5,603,18,1,27,81
2021-02-25,168,19,2466,46,1,87,187
2021-02-25,25,0,234,8,0,4,25
2021-02-25,38,1,720,9,0,17,39
2021-02-25,1733,229,19286,550,39,474,1962
2021-02-25,2,0,56,3,0,4,2
2021-02-25,54,2,697,16,0,17,56
2021-02-25,162,1,1140,54,0,24,163
2021-02-25,4,1,63,1,0,5,5
2021-02-25,1,0,52,0,0,1,1
2021-02-25,5,0,87,3,0,2,5
2021-02-25,1,0,25,0,0,0,1
2021-02-25,3,1,52,0,1,2,4
2021-02-25,0,0,47,0,0,0,0
2021-02-25,17,1,372,2,0,10,18
2021-02-25,1,0,33,0,0,5,1
2021-02-25,94,1,2120,27,0,74,95
2021-02-25,352,26,3559,91,3,110,378
2021-02-25,0,0,12,0,0,0,0
2021-02-25,117,14,877,40,7,6,131
2021-02-25,8,1,216,3,0,1,9
2021-02-25,13,0,451,2,0,5,13
2021-02-25,361,63,3295,96,9,54,424
2021-02-25,18,1,460,2,0,21,19
2021-02-25,3,0,59,0,0,3,3
2021-02-25,2,2,122,1,0,2,4
2021-02-26,45,12,577,14,0,13,57
2021-02-26,7,3,210,2,0,47,10
2021-02-26,1661,194,19252,533,32,461,1855
2021-02-26,74,6,603,18,1,28,80
2021-02-26,52,10,773,18,2,15,62
2021-02-26,194,25,3084,62,0,68,219
2021-02-26,18,0,256,5,0,1,18
2021-02-26,0,0,14,0,0,0,0
2021-02-26,1,0,52,0,0,0,1
2021-02-26,11,0,132,4,0,4,11
2021-02-26,29,7,279,12,0,6,36
2021-02-26,40,1,720,9,0,12,41
2021-02-26,6,0,190,1,0,6,6
2021-02-26,0,0,12,0,0,0,0
2021-02-26,18,1,567,4,0,17,19
2021-02-26,83,5,2116,24,1,66,88
2021-02-26,33,0,271,6,0,8,33
2021-02-26,3,0,59,0,0,3,3
2021-02-26,35,1,650,12,0,14,36
2021-02-26,18,1,460,2,0,21,19
2021-02-26,207,20,1540,48,2,16,227
2021-02-26,338,57,3292,87,5,60,395
2021-02-26,6,2,276,0,1,9,8
2021-02-26,34,0,126,6,0,0,34
2021-02-26,2,2,122,1,0,3,4
2021-02-26,0,0,35,0,0,0,0
2021-02-26,0,0,48,0,0,5,0
2021-02-26,128,14,1305,31,1,19,142
2021-02-26,157,24,2475,42,2,101,181
2021-02-26,6,0,25,4,0,0,6
2021-02-26,523,39,6493,167,6,222,562
2021-02-26,109,7,879,39,2,6,116
2021-02-26,0,0,14,0,0,0,0
2021-02-26,2,0,84,0,0,0,2
2021-02-26,15,2,316,5,1,16,17
2021-02-26,3,0,63,1,0,5,3
2021-02-26,72,11,1299,29,2,47,83
2021-02-26,0,0,25,0,0,0,0
2021-02-26,327,23,3542,85,4,116,350
2021-02-26,1,0,33,1,0,4,1
2021-02-26,1,0,25,0,0,0,1
2021-02-26,5,0,87,3,0,4,5
2021-02-26,3,0,52,0,0,1,3
2021-02-26,16,2,372,1,0,7,18
2021-02-26,15,0,451,2,0,4,15
2021-02-26,158,4,1140,52,0,24,162
2021-02-26,54,3,682,16,3,12,57
2021-02-26,1,0,17,0,0,2,1
2021-02-26,444,15,5852,128,2,249,459
2021-02-26,144,9,1191,38,2,44,153
2021-02-26,69,8,667,9,0,21,77
2021-02-26,177,17,2626,49,4,71,194
2021-02-26,2,0,29,0,0,2,2
2021-02-26,0,0,47,0,0,0,0
2021-02-26,22,0,234,8,0,5,22
2021-02-26,3,0,56,0,0,3,3
2021-02-27,105,9,879,40,2,7,114
2021-02-27,0,0,84,0,0,2,0
2021-02-27,6,3,276,0,1,9,9
2021-02-27,6,0,90,3,0,3,6
2021-02-27,328,50,3262,90,4,60,378
2021-02-27,78,8,2114,24,3,75,86
2021-02-27,4,0,25,3,0,0,4
2021-02-27,56,3,675,17,0,17,59
2021-02-27,0,0,14,0,0,0,0
2021-02-27,201,22,1508,41,1,14,223
2021-02-27,1,0,52,0,0,0,1
2021-02-27,62,3,648,7,0,23,65
2021-02-27,0,0,47,0,0,0,0
2021-02-27,38,3,720,9,0,14,41
2021-02-27,163,26,2466,38,4,95,189
2021-02-27,61,9,770,16,0,21,70
2021-02-27,1578,183,19266,495,29,465,1761
2021-02-27,11,0,132,4,0,4,11
2021-02-27,33,0,271,6,0,8,33
2021-02-27,0,0,25,0,0,0,0
2021-02-27,187,33,3056,62,3,57,220
2021-02-27,3,0,59,0,0,3,3
2021-02-27,0,0,14,0,0,0,0
2021-02-27,485,34,6486,156,6,205,519
2021-02-27,1,0,17,0,0,2,1
2021-02-27,120,15,1304,31,2,23,135
2021-02-27,78,16,1327,26,1,47,94
2021-02-27,8,0,207,2,0,11,8
2021-02-27,0,0,48,0,0,5,0
2021-02-27,37,0,135,7,0,6,37
2021-02-27,141,5,1183,36,2,43,146
2021-02-27,16,1,460,1,0,24,17
2021-02-27,3,0,52,1,0,2,3
2021-02-27,23,0,451,4,0,10,23
2021-02-27,2,2,122,1,0,2,4
2021-02-27,13,3,317,4,1,18,16
2021-02-27,159,3,1140,53,0,28,162
2021-02-27,70,6,603,18,2,28,76
2021-02-27,0,0,25,0,0,0,0
2021-02-27,1,0,29,0,0,2,1
2021-02-27,0,0,12,0,0,0,0
2021-02-27,165,22,2598,49,6,68,187
2021-02-27,4,1,190,1,1,3,5
2021-02-27,0,0,35,0,0,0,0
2021-02-27,30,1,653,13,0,14,31
2021-02-27,3,0,56,0,0,3,3
2021-02-27,299,23,3569,78,4,116,322
2021-02-27,22,0,261,6,0,2,22
2021-02-27,18,1,567,4,0,20,19
2021-02-27,26,7,281,5,0,2,33
2021-02-27,21,2,234,9,0,1,23
2021-02-27,15,1,372,1,1,9,16
2021-02-27,421,22,5869,132,5,245,443
2021-02-27,1,0,33,1,0,5,1
2021-02-27,39,14,590,12,0,11,53
2021-02-27,1,0,63,1,0,5,1
2021-02-28,73,17,1327,25,0,68,90
2021-02-28,18,1,261,5,0,3,19
2021-02-28,285,23,3548,75,5,112,308
2021-02-28,152,26,2464,36,4,107,178
2021-02-28,94,11,885,36,3,7,105
2021-02-28,0,0,48,0,0,5,0
2021-02-28,1,0,63,1,0,26,1
2021-02-28,16,0,125,6,0,3,16
2021-02-28,61,11,770,16,0,19,72
2021-02-28,157,22,2594,47,4,86,179
2021-02-28,22,0,234,8,0,3,22
2021-02-28,29,1,632,16,0,14,30
2021-02-28,59,5,603,17,0,34,64
2021-02-28,5,0,202,2,0,3,5
2021-02-28,2,0,53,1,0,1,2
2021-02-28,3,0,59,0,0,4,3
2021-02-28,24,0,451,5,0,13,24
2021-02-28,0,0,35,0,0,0,0
2021-02-28,148,6,1121,46,0,35,154
2021-02-28,0,0,25,0,0,0,0
2021-02-28,4,0,190,1,0,5,4
2021-02-28,0,0,12,0,0,0,0
2021-02-28,0,0,47,0,0,0,0
2021-02-28,3,0,52,1,0,2,3
2021-02-28,0,0,14,0,0,0,0
2021-02-28,2,0,56,0,0,4,2
2021-02-28,0,0,29,0,0,2,0
2021-02-28,0,0,17,0,0,2,0
2021-02-28,7,3,276,0,1,7,10
2021-02-28,16,0,567,4,0,22,16
2021-02-28,31,0,271,6,0,7,31
2021-02-28,419,26,5816,119,4,251,445
2021-02-28,4,0,84,2,0,2,4
2021-02-28,15,1,372,1,1,10,16
2021-02-28,20,8,280,3,0,2,28
2021-02-28,1502,157,19137,475,28,518,1659
2021-02-28,484,20,6491,149,6,227,504
2021-02-28,17,1,460,2,0,28,18
2021-02-28,0,1,116,1,0,2,1
2021-02-28,111,15,1307,31,3,23,126
2021-02-28,79,6,2106,28,3,80,85
2021-02-28,307,57,3259,83,11,61,364
2021-02-28,33,0,129,7,0,2,33
2021-02-28,116,4,1138,30,0,39,120
2021-02-28,0,0,14,0,0,0,0
2021-02-28,0,0,33,0,0,6,0
2021-02-28,38,1,720,8,0,16,39
2021-02-28,191,14,1502,38,1,15,205
2021-02-28,0,0,25,0,0,0,0
2021-02-28,3,0,25,2,0,0,3
2021-02-28,54,3,680,17,0,24,57
2021-02-28,0,0,84,0,0,2,0
2021-02-28,62,8,647,9,0,22,70
2021-02-28,42,14,590,13,0,12,56
2021-02-28,14,3,317,3,1,17,17
2021-02-28,189,32,3059,64,4,63,221
2021-03-01,301,45,3208,73,1,66,346
2021-03-01,34,1,129,6,0,4,35
2021-03-01,74,3,2103,22,0,99,77
2021-03-01,280,29,3483,69,6,130,309
2021-03-01,12,2,460,1,0,30,14
2021-03-01,3,5,276,0,1,5,8
2021-03-01,0,0,47,0,0,0,0
2021-03-01,13,1,372,2,0,8,14
2021-03-01,2,0,52,1,0,1,2
2021-03-01,5,0,107,2,0,3,5
2021-03-01,182,23,3033,58,1,70,205
2021-03-01,5,0,209,0,0,6,5
2021-03-01,21,9,282,3,0,8,30
2021-03-01,2,0,52,1,0,1,2
2021-03-01,14,5,316,4,0,14,19
2021-03-01,44,8,569,16,0,13,52
2021-03-01,40,1,720,9,0,18,41
2021-03-01,3,0,56,1,1,4,3
2021-03-01,22,1,451,5,1,16,23
2021-03-01,4,0,132,1,0,6,4
2021-03-01,30,2,642,13,1,14,32
2021-03-01,0,0,12,0,0,0,0
2021-03-01,3,0,190,2,0,2,3
2021-03-01,1,0,29,0,0,2,1
2021-03-01,0,0,25,0,0,0,0
2021-03-01,0,0,14,0,0,0,0
2021-03-01,181,17,1523,39,0,16,198
2021-03-01,2,0,25,1,0,0,2
2021-03-01,16,0,567,4,0,26,16
2021-03-01,0,0,63,0,0,6,0
2021-03-01,0,0,33,0,0,8,0
2021-03-01,62,9,667,9,0,21,71
2021-03-01,102,7,1113,33,3,39,109
2021-03-01,19,0,261,5,0,2,19
2021-03-01,0,0,35,0,0,0,0
2021-03-01,136,24,2434,33,2,108,160
2021-03-01,1,0,48,0,0,5,1
2021-03-01,2,0,59,2,0,2,2
2021-03-01,0,0,84,0,0,6,0
2021-03-01,23,0,234,8,0,5,23
2021-03-01,1476,155,19111,460,25,563,1631
2021-03-01,425,21,5863,116,5,255,446
2021-03-01,479,35,6486,152,4,237,514
2021-03-01,75,19,1291,26,0,51,94
2021-03-01,0,0,17,0,0,1,0
2021-03-01,53,3,692,16,1,23,56
2021-03-01,0,0,25,0,0,0,0
2021-03-01,55,8,768,15,1,21,63
2021-03-01,98,9,882,36,4,10,107
2021-03-01,61,6,603,19,2,30,67
2021-03-01,14,1,132,6,0,2,15
2021-03-01,150,18,2554,46,0,88,168
2021-03-01,0,0,14,0,0,0,0
2021-03-01,143,8,1114,42,0,32,151
2021-03-01,33,0,271,5,0,6,33
2021-03-01,111,15,1297,28,3,25,126
2021-03-02,21,0,451,5,0,15,21
2021-03-02,14,3,279,3,1,9,17
2021-03-02,101,14,1149,33,1,42,115
2021-03-02,180,28,1536,36,2,25,208
2021-03-02,2,0,25,1,0,0,2
2021-03-02,62,12,672,10,0,22,74
2021-03-02,0,0,25,0,0,0,0
2021-03-02,97,7,881,36,1,11,104
2021-03-02,0,0,84,0,0,3,0
2021-03-02,443,29,6484,142,7,228,472
2021-03-02,11,3,460,1,0,29,14
2021-03-02,170,20,2989,57,5,58,190
2021-03-02,0,0,63,0,0,5,0
2021-03-02,46,10,774,16,1,19,56
2021-03-02,112,18,1307,28,4,14,130
2021-03-02,2,0,52,1,0,1,2
2021-03-02,0,0,12,0,0,0,0
2021-03-02,154,16,2590,43,0,84,170
2021-03-02,12,0,372,2,0,6,12
2021-03-02,11,0,132,5,0,1,11
2021-03-02,69,22,1288,23,1,54,91
2021-03-02,0,0,35,0,0,0,0
2021-03-02,3,0,190,2,0,2,3
2021-03-02,0,0,17,0,0,2,0
2021-03-02,0,0,47,0,0,0,0
2021-03-02,13,4,321,4,0,17,17
2021-03-02,57,2,603,19,1,23,59
2021-03-02,17,0,567,5,0,21,17
2021-03-02,267,17,3507,69,2,118,284
2021-03-02,0,0,14,0,0,0,0
2021-03-02,49,5,710,15,1,22,54
2021-03-02,3,0,56,2,0,2,3
2021-03-02,38,1,720,9,0,11,39
2021-03-02,45,8,581,14,0,17,53
2021-03-02,76,2,2113,22,0,92,78
2021-03-02,1,5,276,0,0,9,6
2021-03-02,0,0,14,0,0,0,0
2021-03-02,34,1,128,4,0,4,35
2021-03-02,2,0,29,0,0,2,2
2021-03-02,1,2,48,0,0,5,3
2021-03-02,127,14,1117,42,0,17,141
2021-03-02,303,44,3239,66,3,66,347
2021-03-02,4,1,118,2,0,4,5
2021-03-02,140,25,2464,31,1,106,165
2021-03-02,4,0,218,0,0,7,4
2021-03-02,29,0,271,4,0,8,29
2021-03-02,403,25,5830,107,7,256,428
2021-03-02,22,2,664,10,1,13,24
2021-03-02,0,0,25,0,0,0,0
2021-03-02,1,0,52,1,0,1,1
2021-03-02,3,0,59,1,0,4,3
2021-03-02,21,0,261,4,0,3,21
2021-03-02,0,0,33,0,0,8,0
2021-03-02,1401,173,19210,450,29,551,1574
2021-03-02,22,0,234,9,0,5,22
2021-03-02,4,0,111,1,0,2,4
2021-03-03,0,0,14,0,0,0,0
2021-03-03,13,6,278,3,0,13,19
2021-03-03,65,9,2116,19,0,94,74
2021-03-03,0,0,25,0,0,0,0
2021-03-03,145,29,2459,32,1,111,174
2021-03-03,3,1,132,2,0,3,4
2021-03-03,1,0,84,0,0,2,1
2021-03-03,3,0,59,1,0,1,3
2021-03-03,1,2,275,0,1,5,3
2021-03-03,3,0,56,1,0,4,3
2021-03-03,22,0,271,2,0,8,22
2021-03-03,2,0,25,0,0,0,2
2021-03-03,35,1,130,4,0,5,36
2021-03-03,16,3,322,4,0,14,19
2021-03-03,1,0,52,1,0,1,1
2021-03-03,429,24,6496,139,6,234,453
2021-03-03,102,4,1167,32,0,54,106
2021-03-03,303,43,3264,68,3,55,346
2021-03-03,21,0,451,3,0,15,21
2021-03-03,2,0,110,2,0,3,2
2021-03-03,4,0,190,3,0,4,4
2021-03-03,40,1,720,8,0,12,41
2021-03-03,2,0,52,2,0,0,2
2021-03-03,15,0,567,5,0,8,15
2021-03-03,0,0,14,0,0,0,0
2021-03-03,2,0,29,0,0,2,2
2021-03-03,12,1,460,2,0,27,13
2021-03-03,18,5,660,8,1,15,23
2021-03-03,7,0,134,4,0,1,7
2021-03-03,0,0,12,0,0,0,0
2021-03-03,0,0,25,0,0,0,0
2021-03-03,44,8,593,11,0,17,52
2021-03-03,22,0,261,1,0,1,22
2021-03-03,174,24,1525,35,1,24,198
2021-03-03,0,0,63,0,0,7,0
2021-03-03,127,9,1127,34,8,30,136
2021-03-03,4,0,218,1,0,6,4
2021-03-03,54,10,672,8,0,23,64
2021-03-03,176,28,3043,60,5,64,204
2021-03-03,0,0,33,0,0,6,0
2021-03-03,152,9,2593,43,0,74,161
2021-03-03,0,0,47,0,0,0,0
2021-03-03,64,24,1280,21,3,49,88
2021-03-03,52,1,603,18,0,23,53
2021-03-03,50,6,730,13,1,19,56
2021-03-03,0,0,17,0,0,2,0
2021-03-03,50,4,772,17,0,17,54
2021-03-03,379,26,5883,97,5,249,405
2021-03-03,20,0,234,8,0,6,20
2021-03-03,114,13,1306,26,3,16,127
2021-03-03,1341,182,19238,429,19,531,1523
2021-03-03,93,11,905,35,3,10,104
2021-03-03,1,2,48,0,0,5,3
2021-03-03,0,0,35,0,0,0,0
2021-03-03,11,1,372,2,0,5,12
2021-03-03,254,31,3544,63,0,120,285
2021-03-04,339,24,5901,91,5,273,363
2021-03-04,5,0,129,2,0,3,5
2021-03-04,53,12,2109,17,1,84,65
2021-03-04,11,1,372,2,0,8,12
2021-03-04,11,0,567,4,0,19,11
2021-03-04,121,10,1301,26,3,21,131
2021-03-04,0,0,25,0,0,0,0
2021-03-04,34,0,135,4,0,7,34
2021-03-04,279,43,3275,66,0,54,322
2021-03-04,140,27,2459,32,1,111,167
2021-03-04,2,0,52,2,0,0,2
2021-03-04,15,4,318,4,0,11,19
2021-03-04,46,5,721,15,2,20,51
2021-03-04,0,0,14,0,0,0,0
2021-03-04,6,0,130,3,0,2,6
2021-03-04,0,0,35,0,0,0,0
2021-03-04,210,30,3531,66,3,128,240
2021-03-04,39,1,720,8,0,15,40
2021-03-04,0,0,63,0,0,1,0
2021-03-04,89,16,884,30,2,12,105
2021-03-04,0,0,25,0,0,0,0
2021-03-04,0,0,17,0,0,2,0
2021-03-04,4,0,190,3,0,11,4
2021-03-04,20,0,271,1,0,9,20
2021-03-04,1264,191,19291,372,16,551,1455
2021-03-04,19,0,694,9,0,14,19
2021-03-04,54,9,673,7,0,15,63
2021-03-04,2,0,111,2,0,4,2
2021-03-04,1,0,84,0,0,2,1
2021-03-04,3,0,56,1,0,4,3
2021-03-04,401,23,6485,127,3,250,424
2021-03-04,1,0,52,1,0,0,1
2021-03-04,156,23,1513,34,2,23,179
2021-03-04,21,1,234,7,0,6,22
2021-03-04,23,0,451,2,0,14,23
2021-03-04,0,0,14,0,0,0,0
2021-03-04,143,19,2585,46,1,79,162
2021-03-04,51,9,777,16,0,21,60
2021-03-04,127,8,1134,40,0,35,135
2021-03-04,67,26,1307,20,3,40,93
2021-03-04,1,4,275,0,1,5,5
2021-03-04,2,0,25,0,0,0,2
2021-03-04,9,3,278,3,0,6,12
2021-03-04,0,0,47,0,0,0,0
2021-03-04,21,0,261,3,0,2,21
2021-03-04,2,0,29,0,0,1,2
2021-03-04,12,2,460,2,0,23,14
2021-03-04,171,23,3003,59,2,47,194
2021-03-04,1,3,48,0,0,5,4
2021-03-04,5,1,215,3,0,5,6
2021-03-04,0,0,33,0,0,6,0
2021-03-04,0,0,12,0,0,0,0
2021-03-04,3,0,59,1,0,3,3
2021-03-04,53,3,603,17,0,29,56
2021-03-04,103,8,1159,31,1,52,111
2021-03-04,39,6,585,11,0,16,45
2021-03-05,0,0,25,0,0,0,0
2021-03-05,0,0,84,0,0,0,0
2021-03-05,3,0,59,1,0,5,3
2021-03-05,44,8,734,14,2,21,52
2021-03-05,60,22,1302,23,2,42,82
2021-03-05,7,0,213,2,0,2,7
2021-03-05,19,0,261,3,0,2,19
2021-03-05,1,0,52,1,0,1,1
2021-03-05,0,0,35,0,0,0,0
2021-03-05,3,0,190,3,0,5,3
2021-03-05,50,1,603,16,0,25,51
2021-03-05,263,47,3256,66,2,67,310
2021-03-05,45,7,782,14,1,23,52
2021-03-05,144,16,2598,44,4,94,160
2021-03-05,110,6,1162,31,0,56,116
2021-03-05,35,0,131,5,0,5,35
2021-03-05,0,0,33,0,0,6,0
2021-03-05,7,6,278,3,0,10,13
2021-03-05,2,0,29,0,0,1,2
2021-03-05,51,9,667,8,1,17,60
2021-03-05,2,5,273,0,1,7,7
2021-03-05,8,1,372,1,0,8,9
2021-03-05,0,0,12,0,0,0,0
2021-03-05,2,0,111,0,0,2,2
2021-03-05,7,0,127,4,0,4,7
2021-03-05,55,12,2106,14,1,79,67
2021-03-05,89,6,887,31,3,9,95
2021-03-05,321,15,5887,87,3,247,336
2021-03-05,248,38,3513,63,6,125,286
2021-03-05,166,33,3025,52,6,48,199
2021-03-05,2,0,52,2,0,1,2
2021-03-05,0,0,25,0,0,0,0
2021-03-05,12,0,567,4,0,16,12
2021-03-05,0,0,17,0,0,2,0
2021-03-05,0,0,63,0,0,4,0
2021-03-05,2,0,56,1,0,4,2
2021-03-05,5,0,110,1,0,3,5
2021-03-05,36,8,566,12,1,9,44
2021-03-05,131,28,2456,36,2,104,159
2021-03-05,19,0,451,3,0,17,19
2021-03-05,39,1,720,9,0,16,40
2021-03-05,126,10,1125,38,1,29,136
2021-03-05,1176,164,19290,361,22,512,1340
2021-03-05,1,3,48,0,0,5,4
2021-03-05,0,0,14,0,0,0,0
2021-03-05,13,1,460,2,0,25,14
2021-03-05,1,0,25,0,0,0,1
2021-03-05,115,11,1306,22,2,30,126
2021-03-05,0,0,14,0,0,0,0
2021-03-05,17,4,326,4,0,8,21
2021-03-05,0,0,47,0,0,0,0
2021-03-05,16,0,271,1,0,11,16
2021-03-05,150,24,1497,37,5,24,174
2021-03-05,22,0,234,6,0,8,22
2021-03-05,20,0,681,7,0,18,20
2021-03-05,359,23,6467,120,4,246,382
2021-03-06,0,0,12,0,0,0,0
2021-03-06,1,0,25,0,0,0,1
2021-03-06,17,4,324,3,0,12,21
2021-03-06,242,20,3489,51,4,118,262
2021-03-06,18,1,451,3,0,14,19
2021-03-06,142,29,1478,35,3,28,171
2021-03-06,2,0,29,0,0,1,2
2021-03-06,19,0,651,10,0,15,19
2021-03-06,18,0,261,3,0,3,18
2021-03-06,51,5,2125,14,1,75,56
2021-03-06,0,0,25,0,0,0,0
2021-03-06,42,9,774,14,0,19,51
2021-03-06,2,0,110,1,0,3,2
2021-03-06,0,0,35,0,0,0,0
2021-03-06,0,0,84,0,0,0,0
2021-03-06,86,5,873,32,3,11,91
2021-03-06,357,27,6468,113,5,279,384
2021-03-06,105,13,1307,24,2,18,118
2021-03-06,130,19,2545,42,4,85,149
2021-03-06,1,0,52,1,0,3,1
2021-03-06,1,0,107,0,0,5,1
2021-03-06,34,5,562,9,0,13,39
2021-03-06,13,0,567,4,0,19,13
2021-03-06,159,23,3020,46,3,55,182
2021-03-06,2,0,56,1,0,2,2
2021-03-06,35,0,720,8,0,20,35
2021-03-06,0,0,63,0,0,2,0
2021-03-06,1,2,48,0,0,5,3
2021-03-06,7,0,122,4,0,1,7
2021-03-06,2,6,273,0,0,7,8
2021-03-06,9,11,278,3,1,8,20
2021-03-06,257,54,3237,63,4,62,311
2021-03-06,106,11,1173,31,0,51,117
2021-03-06,3,0,59,1,0,3,3
2021-03-06,0,0,14,0,0,0,0
2021-03-06,14,0,271,1,0,10,14
2021-03-06,2,0,190,2,0,5,2
2021-03-06,2,0,52,2,0,2,2
2021-03-06,1132,156,19192,356,17,538,1288
2021-03-06,61,13,1284,22,2,40,74
2021-03-06,0,0,47,0,0,0,0
2021-03-06,1,0,33,0,0,8,1
2021-03-06,113,8,1113,27,1,35,121
2021-03-06,10,0,372,2,0,6,10
2021-03-06,47,9,668,6,3,21,56
2021-03-06,0,0,25,0,0,0,0
2021-03-06,6,1,214,2,0,6,7
2021-03-06,48,2,603,15,0,30,50
2021-03-06,33,0,122,3,0,4,33
2021-03-06,11,0,460,3,0,21,11
2021-03-06,296,15,5860,89,1,254,311
2021-03-06,116,29,2464,34,3,99,145
2021-03-06,40,2,701,13,2,20,42
2021-03-06,0,0,14,0,0,0,0
2021-03-06,18,0,234,7,0,6,18
2021-03-06,0,0,17,0,0,1,0
2021-03-07,0,0,14,0,0,0,0
2021-03-07,20,1,637,8,1,16,21
2021-03-07,251,63,3239,64,10,78,314
2021-03-07,39,2,694,13,1,20,41
2021-03-07,112,6,1127,33,0,34,118
2021-03-07,35,4,549,8,0,15,39
2021-03-07,47,9,2103,15,0,90,56
2021-03-07,345,21,6450,114,3,255,366
2021-03-07,51,3,603,15,0,36,54
2021-03-07,154,21,2970,49,3,68,175
2021-03-07,99,8,1145,25,1,50,107
2021-03-07,1,0,25,1,0,1,1
2021-03-07,28,0,129,3,0,5,28
2021-03-07,8,6,278,2,0,6,14
2021-03-07,2,0,52,2,0,3,2
2021-03-07,118,27,2545,39,11,102,145
2021-03-07,65,10,1272,17,3,43,75
2021-03-07,16,0,271,3,0,14,16
2021-03-07,2,0,106,0,0,4,2
2021-03-07,11,0,567,4,0,20,11
2021-03-07,0,0,25,0,0,0,0
2021-03-07,288,19,5782,84,3,260,307
2021-03-07,3,0,99,1,0,2,3
2021-03-07,1,0,52,1,0,2,1
2021-03-07,249,35,3465,50,7,118,284
2021-03-07,90,5,880,30,3,9,95
2021-03-07,116,14,1306,24,3,24,130
2021-03-07,3,0,190,2,0,6,3
2021-03-07,6,0,123,3,0,3,6
2021-03-07,10,0,372,3,0,7,10
2021-03-07,0,0,35,0,0,0,0
2021-03-07,0,0,14,0,0,0,0
2021-03-07,0,0,47,0,0,0,0
2021-03-07,0,0,17,0,0,2,0
2021-03-07,1,2,56,1,0,2,3
2021-03-07,114,27,2434,33,2,112,141
2021-03-07,0,0,63,0,0,1,0
2021-03-07,2,0,29,0,0,1,2
2021-03-07,1,0,33,0,0,8,1
2021-03-07,3,0,59,1,0,0,3
2021-03-07,1,0,84,0,0,1,1
2021-03-07,46,8,648,3,2,31,54
2021-03-07,5,0,207,1,0,4,5
2021-03-07,4,4,268,0,1,7,8
2021-03-07,18,1,451,2,0,12,19
2021-03-07,15,0,234,7,0,5,15
2021-03-07,38,0,720,8,0,22,38
2021-03-07,17,3,320,2,0,8,20
2021-03-07,16,0,261,3,0,4,16
2021-03-07,44,8,774,12,0,27,52
2021-03-07,1119,128,19119,334,12,573,1247
2021-03-07,136,26,1479,41,5,19,162
2021-03-07,15,1,460,4,0,25,16
2021-03-07,0,0,25,0,0,0,0
2021-03-07,1,0,48,0,0,5,1
2021-03-07,0,0,12,0,0,0,0
2021-03-08,1,0,63,1,0,2,1
2021-03-08,17,0,271,3,0,13,17
2021-03-08,4,0,59,1,0,4,4
2021-03-08,0,0,14,0,0,0,0
2021-03-08,7,6,278,2,1,12,13
2021-03-08,0,0,25,0,0,0,0
2021-03-08,121,16,1306,25,2,21,137
2021-03-08,9,0,567,4,0,20,9
2021-03-08,0,0,35,0,0,0,0
2021-03-08,13,0,234,8,0,3,13
2021-03-08,2,0,29,0,0,2,2
2021-03-08,18,0,261,3,0,0,18
2021-03-08,30,1,123,4,0,1,31
2021-03-08,4,5,268,1,1,7,9
2021-03-08,33,4,495,7,0,18,37
2021-03-08,253,38,3502,49,11,125,291
2021-03-08,3,0,190,3,0,3,3
2021-03-08,20,0,451,1,0,13,20
2021-03-08,9,0,372,2,0,5,9
2021-03-08,0,0,14,0,0,0,0
2021-03-08,40,4,700,11,1,24,44
2021-03-08,0,0,12,0,0,0,0
2021-03-08,1079,139,19105,320,29,581,1218
2021-03-08,16,1,460,4,0,23,17
2021-03-08,38,0,720,8,0,20,38
2021-03-08,341,23,6456,110,4,261,364
2021-03-08,151,23,2972,43,4,72,174
2021-03-08,4,0,124,1,0,2,4
2021-03-08,89,9,1135,24,1,50,98
2021-03-08,118,22,2435,34,1,110,140
2021-03-08,283,19,5738,77,2,265,302
2021-03-08,49,8,2093,18,0,88,57
2021-03-08,42,13,668,4,3,27,55
2021-03-08,7,1,125,2,0,1,8
2021-03-08,68,13,1257,18,5,39,81
2021-03-08,91,4,886,30,1,12,95
2021-03-08,5,0,207,1,0,9,5
2021-03-08,2,0,84,1,0,1,2
2021-03-08,0,0,25,0,0,2,0
2021-03-08,47,3,603,15,0,40,50
2021-03-08,1,3,48,0,0,5,4
2021-03-08,17,5,325,3,0,7,22
2021-03-08,264,50,3245,59,6,66,314
2021-03-08,115,5,1125,32,0,42,120
2021-03-08,19,3,621,11,0,15,22
2021-03-08,46,8,779,11,0,21,54
2021-03-08,1,0,33,0,0,6,1
2021-03-08,0,0,17,0,0,2,0
2021-03-08,2,0,52,2,0,4,2
2021-03-08,142,17,1491,38,2,23,159
2021-03-08,0,0,25,0,0,0,0
2021-03-08,2,0,111,0,0,4,2
2021-03-08,0,0,47,0,0,0,0
2021-03-08,1,0,52,0,0,4,1
2021-03-08,4,0,56,2,0,6,4
2021-03-08,116,18,2535,35,5,93,134
2021-03-09,277,31,5781,73,4,243,308
2021-03-09,3,0,59,1,0,3,3
2021-03-09,2,0,190,0,0,1,2
2021-03-09,117,17,2553,36,4,86,134
2021-03-09,36,7,710,13,2,23,43
2021-03-09,2,0,25,0,0,2,2
2021-03-09,0,0,14,0,0,0,0
2021-03-09,91,9,888,32,2,14,100
2021-03-09,13,0,261,4,0,2,13
2021-03-09,110,18,2466,32,1,101,128
2021-03-09,14,1,234,8,0,3,15
2021-03-09,39,6,786,11,1,25,45
2021-03-09,90,17,1151,20,2,52,107
2021-03-09,14,0,460,3,0,21,14
2021-03-09,46,14,2118,17,2,92,60
2021-03-09,19,0,611,11,0,13,19
2021-03-09,21,0,451,1,0,18,21
2021-03-09,2,0,29,0,0,2,2
2021-03-09,0,3,48,0,0,5,3
2021-03-09,1,0,33,0,0,6,1
2021-03-09,0,0,12,0,0,0,0
2021-03-09,237,29,3520,48,9,131,266
2021-03-09,6,0,128,2,0,1,6
2021-03-09,8,0,567,3,0,24,8
2021-03-09,0,0,25,0,0,0,0
2021-03-09,1,0,52,0,0,3,1
2021-03-09,29,0,126,4,0,2,29
2021-03-09,0,0,14,0,0,0,0
2021-03-09,334,31,6467,100,6,271,365
2021-03-09,0,0,17,0,0,1,0
2021-03-09,1,0,111,1,0,2,1
2021-03-09,254,35,3339,54,2,75,289
2021-03-09,22,0,271,7,0,3,22
2021-03-09,0,0,25,0,0,0,0
2021-03-09,142,29,1513,36,3,18,171
2021-03-09,5,0,200,1,0,6,5
2021-03-09,104,8,1112,33,0,33,112
2021-03-09,136,27,2983,41,2,65,163
2021-03-09,1056,151,19297,309,22,557,1207
2021-03-09,62,16,1284,19,3,38,78
2021-03-09,18,2,320,4,0,5,20
2021-03-09,6,3,278,2,0,12,9
2021-03-09,9,1,372,2,0,4,10
2021-03-09,3,0,56,2,0,6,3
2021-03-09,0,0,35,0,0,0,0
2021-03-09,0,0,47,0,0,0,0
2021-03-09,123,19,1307,24,3,21,142
2021-03-09,4,3,273,1,1,8,7
2021-03-09,43,11,668,4,3,21,54
2021-03-09,0,0,64,0,0,1,0
2021-03-09,46,2,603,13,0,43,48
2021-03-09,29,4,518,7,0,19,33
2021-03-09,2,0,52,2,0,3,2
2021-03-09,41,0,720,8,0,21,41
2021-03-09,1,0,84,0,0,2,1
2021-03-09,6,0,121,3,0,0,6
2021-03-10,87,12,1138,22,2,48,99
2021-03-10,14,2,318,6,0,8,16
2021-03-10,85,10,902,28,2,14,95
2021-03-10,0,0,47,0,0,0,0
2021-03-10,0,0,35,0,0,0,0
2021-03-10,26,8,530,8,2,17,34
2021-03-10,5,0,127,2,0,1,5
2021-03-10,21,0,271,7,0,8,21
2021-03-10,0,3,48,0,0,5,3
2021-03-10,3,5,273,2,3,3,8
2021-03-10,2,1,190,0,1,4,3
2021-03-10,0,0,17,0,0,1,0
2021-03-10,126,15,1306,23,2,26,141
2021-03-10,6,0,128,3,0,0,6
2021-03-10,6,1,372,2,0,5,7
2021-03-10,252,24,5838,67,4,243,276
2021-03-10,3,0,218,1,0,6,3
2021-03-10,48,1,603,13,0,38,49
2021-03-10,32,8,784,9,1,31,40
2021-03-10,0,0,12,0,0,0,0
2021-03-10,0,0,25,0,0,0,0
2021-03-10,0,0,33,0,0,6,0
2021-03-10,12,1,261,4,0,1,13
2021-03-10,111,18,2492,31,2,90,129
2021-03-10,9,0,567,4,0,19,9
2021-03-10,319,30,6481,94,9,271,349
2021-03-10,1,0,111,1,0,5,1
2021-03-10,1,0,52,0,0,4,1
2021-03-10,3,0,56,2,0,5,3
2021-03-10,3,0,29,0,0,2,3
2021-03-10,54,12,1277,17,1,34,66
2021-03-10,143,26,3000,43,4,80,169
2021-03-10,2,0,52,1,0,3,2
2021-03-10,2,0,63,1,0,1,2
2021-03-10,98,10,1117,33,0,32,108
2021-03-10,42,4,672,7,0,26,46
2021-03-10,12,0,234,7,0,6,12
2021-03-10,36,0,720,8,0,22,36
2021-03-10,234,30,3294,56,2,96,264
2021-03-10,122,23,2576,37,5,84,145
2021-03-10,219,28,3563,48,2,131,247
2021-03-10,7,6,278,2,0,10,13
2021-03-10,0,0,14,0,0,0,0
2021-03-10,23,0,451,1,0,16,23
2021-03-10,34,8,714,15,2,23,42
2021-03-10,11,0,460,2,0,17,11
2021-03-10,24,0,130,4,0,5,24
2021-03-10,20,0,662,10,0,13,20
2021-03-10,1015,163,19266,287,23,574,1178
2021-03-10,1,0,84,0,0,1,1
2021-03-10,0,0,25,0,0,0,0
2021-03-10,5,0,59,1,0,4,5
2021-03-10,0,0,14,0,0,0,0
2021-03-10,2,0,25,0,0,1,2
2021-03-10,44,9,2139,18,0,79,53
2021-03-10,152,23,1524,34,3,15,175
2021-03-11,0,0,33,0,0,6,0
2021-03-11,6,0,121,2,0,2,6
2021-03-11,1,4,134,2,0,2,5
2021-03-11,75,8,895,25,2,10,83
2021-03-11,1,0,25,0,0,0,1
2021-03-11,107,30,2494,31,1,86,137
2021-03-11,41,10,2129,19,0,87,51
2021-03-11,0,0,25,0,0,0,0
2021-03-11,2,0,52,1,0,3,2
2021-03-11,6,0,59,1,0,4,6
2021-03-11,128,16,1303,26,2,19,144
2021-03-11,3,0,56,2,0,6,3
2021-03-11,35,0,720,8,0,22,35
2021-03-11,0,0,14,0,0,0,0
2021-03-11,21,7,527,6,1,22,28
2021-03-11,0,0,52,0,0,4,0
2021-03-11,8,10,278,2,0,12,18
2021-03-11,15,0,234,7,0,3,15
2021-03-11,0,0,47,0,0,0,0
2021-03-11,5,0,210,2,0,5,5
2021-03-11,9,1,460,1,0,20,10
2021-03-11,2,0,190,0,0,6,2
2021-03-11,43,0,603,15,0,32,43
2021-03-11,1,0,63,1,0,0,1
2021-03-11,2,0,110,1,0,4,2
2021-03-11,1,1,48,0,0,5,2
2021-03-11,23,0,271,7,0,6,23
2021-03-11,979,167,19316,285,20,578,1146
2021-03-11,21,0,451,4,0,11,21
2021-03-11,3,0,29,1,0,1,3
2021-03-11,2,0,84,0,0,2,2
2021-03-11,147,25,1522,37,1,16,172
2021-03-11,118,19,2603,30,6,76,137
2021-03-11,217,25,3278,52,4,85,242
2021-03-11,21,1,677,10,0,14,22
2021-03-11,0,0,14,0,0,0,0
2021-03-11,0,0,12,0,0,0,0
2021-03-11,9,0,567,3,0,18,9
2021-03-11,50,11,1290,18,4,37,61
2021-03-11,20,0,121,3,0,8,20
2021-03-11,217,34,3573,54,2,146,251
2021-03-11,0,0,35,0,0,0,0
2021-03-11,0,0,17,0,0,1,0
2021-03-11,4,3,273,2,0,2,7
2021-03-11,245,21,5842,74,5,237,266
2021-03-11,12,0,261,3,0,2,12
2021-03-11,293,23,6469,90,4,249,316
2021-03-11,88,6,1150,22,0,49,94
2021-03-11,36,7,667,7,0,30,43
2021-03-11,38,8,720,15,3,21,46
2021-03-11,30,12,778,9,3,26,42
2021-03-11,6,1,372,2,0,5,7
2021-03-11,98,8,1124,34,0,33,106
2021-03-11,15,3,318,7,0,8,18
2021-03-11,0,0,25,0,0,0,0
2021-03-11,131,16,3005,45,6,68,147
2021-03-12,4,0,131,3,0,2,4
2021-03-12,0,0,12,0,0,0,0
2021-03-12,237,30,5835,71,2,236,267
2021-03-12,204,23,3230,51,4,93,227
2021-03-12,0,0,47,0,0,0,0
2021-03-12,41,3,2143,18,0,82,44
2021-03-12,17,0,111,4,0,2,17
2021-03-12,4,3,273,2,0,4,7
2021-03-12,3,0,207,2,0,2,3
2021-03-12,31,9,783,9,0,24,40
2021-03-12,132,17,3019,48,6,59,149
2021-03-12,37,6,672,8,1,32,43
2021-03-12,1,0,52,1,0,4,1
2021-03-12,20,0,271,7,0,2,20
2021-03-12,143,20,1528,37,1,17,163
2021-03-12,118,27,2499,30,0,100,145
2021-03-12,0,0,14,0,0,0,0
2021-03-12,85,4,1163,21,0,48,89
2021-03-12,6,0,59,1,0,4,6
2021-03-12,1,0,63,1,0,1,1
2021-03-12,9,2,460,0,0,15,11
2021-03-12,22,0,652,11,0,16,22
2021-03-12,290,30,6468,95,4,277,320
2021-03-12,9,0,567,2,0,21,9
2021-03-12,0,0,35,0,0,0,0
2021-03-12,0,0,52,0,0,2,0
2021-03-12,0,0,25,0,0,0,0
2021-03-12,35,6,727,14,2,25,41
2021-03-12,25,9,529,4,1,21,34
2021-03-12,951,155,19274,281,21,572,1106
2021-03-12,49,11,1290,16,1,32,60
2021-03-12,95,4,1122,32,0,29,99
2021-03-12,3,0,105,0,0,6,3
2021-03-12,1,2,48,0,0,5,3
2021-03-12,10,1,261,2,0,4,11
2021-03-12,200,21,3552,50,4,126,221
2021-03-12,5,0,129,2,0,0,5
2021-03-12,2,0,29,0,0,2,2
2021-03-12,39,0,603,15,0,30,39
2021-03-12,116,17,2620,29,3,77,133
2021-03-12,39,0,720,6,0,25,39
2021-03-12,2,0,84,0,0,2,2
2021-03-12,17,3,327,7,0,8,20
2021-03-12,126,15,1306,27,3,26,141
2021-03-12,0,0,33,0,0,7,0
2021-03-12,2,0,56,1,0,6,2
2021-03-12,6,6,278,2,0,13,12
2021-03-12,3,1,190,0,1,4,4
2021-03-12,1,0,25,0,0,0,1
2021-03-12,0,0,17,0,0,1,0
2021-03-12,5,1,372,2,0,5,6
2021-03-12,0,0,25,0,0,0,0
2021-03-12,14,0,234,8,0,3,14
2021-03-12,73,13,892,20,3,4,86
2021-03-12,0,0,14,0,0,0,0
2021-03-12,17,0,451,2,0,16,17
2021-03-13,1,0,52,1,0,4,1
2021-03-13,9,2,460,0,0,23,11
2021-03-13,5,0,210,1,0,4,5
2021-03-13,118,14,1307,30,1,25,132
2021-03-13,15,0,109,5,0,4,15
2021-03-13,5,0,59,1,0,4,5
2021-03-13,92,5,1098,32,0,34,97
2021-03-13,2,0,63,1,0,3,2
2021-03-13,4,0,132,3,0,3,4
2021-03-13,0,0,25,0,0,0,0
2021-03-13,1,0,56,1,0,6,1
2021-03-13,39,6,784,11,0,24,45
2021-03-13,194,20,3546,48,2,143,214
2021-03-13,0,0,12,0,0,0,0
2021-03-13,23,1,649,10,0,17,24
2021-03-13,3,0,110,0,0,6,3
2021-03-13,0,0,17,0,0,2,0
2021-03-13,241,26,5863,76,3,260,267
2021-03-13,279,24,6470,92,5,297,303
2021-03-13,69,11,880,18,3,11,80
2021-03-13,4,6,268,2,1,6,10
2021-03-13,9,0,372,3,0,7,9
2021-03-13,6,0,132,2,0,0,6
2021-03-13,1,1,48,0,0,5,2
2021-03-13,77,6,1161,21,0,43,83
2021-03-13,0,0,47,0,0,0,0
2021-03-13,1,0,190,0,0,7,1
2021-03-13,0,0,35,0,0,0,0
2021-03-13,1,0,33,0,0,7,1
2021-03-13,9,14,278,3,2,5,23
2021-03-13,0,0,25,0,0,0,0
2021-03-13,893,156,19192,251,22,590,1049
2021-03-13,131,12,3019,45,4,70,143
2021-03-13,13,1,451,2,0,11,14
2021-03-13,37,0,720,6,0,24,37
2021-03-13,18,5,321,7,1,8,23
2021-03-13,0,0,52,0,0,2,0
2021-03-13,25,7,567,4,1,21,32
2021-03-13,1,0,25,0,0,2,1
2021-03-13,10,0,567,2,0,22,10
2021-03-13,35,7,715,16,2,19,42
2021-03-13,3,0,29,0,0,1,3
2021-03-13,13,0,234,6,0,3,13
2021-03-13,182,23,3219,43,3,88,205
2021-03-13,34,4,653,8,1,26,38
2021-03-13,119,14,2601,24,3,80,133
2021-03-13,128,20,1498,36,2,17,148
2021-03-13,0,0,14,0,0,0,0
2021-03-13,37,1,603,12,0,38,38
2021-03-13,20,0,271,7,0,3,20
2021-03-13,117,34,2517,34,4,99,151
2021-03-13,9,1,261,1,0,6,10
2021-03-13,3,0,84,0,0,2,3
2021-03-13,48,16,1297,13,3,35,64
2021-03-13,0,0,14,0,0,0,0
2021-03-13,46,8,2142,18,0,70,54
2021-03-14,1,0,84,0,0,0,1
2021-03-14,1,0,56,1,0,6,1
2021-03-14,29,7,566,4,1,24,36
2021-03-14,14,0,109,4,0,4,14
2021-03-14,131,22,1492,37,2,23,153
2021-03-14,37,6,784,11,0,22,43
2021-03-14,191,29,3514,43,5,150,220
2021-03-14,23,1,639,9,0,17,24
2021-03-14,45,9,2138,16,1,84,54
2021-03-14,233,24,5757,72,4,249,257
2021-03-14,35,3,652,5,1,25,38
2021-03-14,4,0,115,2,0,2,4
2021-03-14,2,0,190,0,0,6,2
2021-03-14,95,5,1103,26,0,45,100
2021-03-14,51,15,1297,16,4,37,66
2021-03-14,2,0,64,1,0,2,2
2021-03-14,21,0,271,8,0,8,21
2021-03-14,3,0,206,1,0,3,3
2021-03-14,39,0,720,6,0,19,39
2021-03-14,1,0,52,1,0,0,1
2021-03-14,12,7,278,3,0,12,19
2021-03-14,39,3,603,13,1,39,42
2021-03-14,114,32,2517,33,3,108,146
2021-03-14,865,145,19097,241,24,641,1010
2021-03-14,1,1,48,0,0,5,2
2021-03-14,0,0,14,0,0,0,0
2021-03-14,12,1,451,1,0,15,13
2021-03-14,0,0,25,0,0,0,0
2021-03-14,5,0,59,1,0,3,5
2021-03-14,0,0,14,0,0,0,0
2021-03-14,0,0,52,0,0,0,0
2021-03-14,34,8,717,13,1,24,42
2021-03-14,4,6,267,2,2,8,10
2021-03-14,9,0,567,2,0,15,9
2021-03-14,138,16,3009,44,5,61,154
2021-03-14,284,23,6451,91,8,283,307
2021-03-14,0,0,35,0,0,0,0
2021-03-14,16,5,321,7,1,7,21
2021-03-14,10,1,261,2,0,5,11
2021-03-14,5,0,125,1,0,2,5
2021-03-14,195,21,3173,45,6,103,216
2021-03-14,0,0,25,0,0,0,0
2021-03-14,122,15,1307,31,2,28,137
2021-03-14,121,16,2593,24,3,101,137
2021-03-14,0,0,17,0,0,2,0
2021-03-14,3,0,29,0,0,1,3
2021-03-14,61,11,879,18,3,12,72
2021-03-14,76,6,1128,19,0,44,82
2021-03-14,14,0,234,6,0,3,14
2021-03-14,9,0,372,2,0,9,9
2021-03-14,8,0,460,0,0,26,8
2021-03-14,2,0,105,0,0,3,2
2021-03-14,0,0,47,0,0,0,0
2021-03-14,1,0,33,0,0,7,1
2021-03-14,1,0,25,0,0,2,1
2021-03-14,0,0,12,0,0,0,0
2021-03-15,0,0,14,0,0,0,0
2021-03-15,5,0,133,1,0,2,5
2021-03-15,40,6,784,9,0,27,46
2021-03-15,108,27,2501,31,3,105,135
2021-03-15,2,0,106,1,0,2,2
2021-03-15,125,19,1477,31,1,15,144
2021-03-15,0,0,25,0,0,0,0
2021-03-15,8,1,567,2,0,16,9
2021-03-15,36,0,720,7,0,25,36
2021-03-15,0,0,17,0,0,2,0
2021-03-15,1,0,84,0,0,4,1
2021-03-15,2,0,29,0,0,2,2
2021-03-15,0,0,25,0,0,0,0
2021-03-15,44,17,1267,16,4,42,61
2021-03-15,26,1,669,8,0,17,27
2021-03-15,64,10,889,19,4,9,74
2021-03-15,2,0,219,1,0,4,2
2021-03-15,9,0,261,1,0,6,9
2021-03-15,286,20,6461,88,9,286,306
2021-03-15,857,137,19133,236,28,622,994
2021-03-15,98,10,1116,27,0,52,108
2021-03-15,1,1,48,0,0,5,2
2021-03-15,125,13,1309,29,1,20,138
2021-03-15,2,0,135,1,0,4,2
2021-03-15,0,0,35,0,0,0,0
2021-03-15,29,7,562,4,1,18,36
2021-03-15,7,0,460,0,0,26,7
2021-03-15,0,0,25,0,0,0,0
2021-03-15,185,17,3530,46,1,156,202
2021-03-15,1,0,190,0,0,4,1
2021-03-15,0,0,47,0,0,0,0
2021-03-15,37,7,647,7,0,26,44
2021-03-15,7,1,373,2,0,9,8
2021-03-15,26,6,686,11,1,21,32
2021-03-15,1,0,52,1,0,0,1
2021-03-15,119,14,2576,19,4,105,133
2021-03-15,5,0,59,0,0,1,5
2021-03-15,0,0,52,0,0,2,0
2021-03-15,15,0,125,2,0,0,15
2021-03-15,19,0,271,6,0,11,19
2021-03-15,1,0,33,0,0,5,1
2021-03-15,40,1,603,15,0,38,41
2021-03-15,0,0,12,0,0,0,0
2021-03-15,0,0,14,0,0,0,0
2021-03-15,14,0,234,7,0,4,14
2021-03-15,2,0,63,0,0,0,2
2021-03-15,73,9,1139,22,1,44,82
2021-03-15,12,1,451,1,0,10,13
2021-03-15,2,0,56,1,0,3,2
2021-03-15,9,4,278,3,0,13,13
2021-03-15,5,2,272,1,1,9,7
2021-03-15,15,3,319,7,0,9,18
2021-03-15,216,24,5709,62,5,262,240
2021-03-15,144,14,2965,44,1,66,158
2021-03-15,188,23,3136,42,5,98,211
2021-03-15,45,3,2115,16,0,93,48
