,county,date,confirmed_patients,suspected_patients,total_covid_patients
0,Madera,2020-03-29,1,6,7
1,Calaveras,2020-03-29,0,0,0
2,Sonoma,2020-03-29,7,20,27
3,Tulare,2020-03-29,6,13,19
4,San Bernardino,2020-03-29,33,123,156
5,Yuba,2020-03-29,2,12,14
6,Tehama,2020-03-29,0,0,0
7,San Mateo,2020-03-29,46,27,73
8,Shasta,2020-03-29,0,0,0
9,Tuolumne,2020-03-29,1,5,6
10,El Dorado,2020-03-29,0,6,6
11,Sutter,2020-03-29,0,0,0
12,San Diego,2020-03-29,121,211,332
13,Los Angeles,2020-03-29,489,1132,1621
14,Modoc,2020-03-29,0,0,0
15,Santa Cruz,2020-03-29,0,0,0
16,Merced,2020-03-29,1,7,8
17,San Luis Obispo,2020-03-29,7,12,19
18,Lassen,2020-03-29,0,2,2
19,Stanislaus,2020-03-29,20,48,68
20,Riverside,2020-03-29,44,78,122
21,Santa Clara,2020-03-29,141,72,213
22,Mendocino,2020-03-29,1,11,12
23,Trinity,2020-03-29,0,0,0
24,Del Norte,2020-03-29,1,2,3
25,Placer,2020-03-29,18,14,32
26,Siskiyou,2020-03-29,0,0,0
27,Alameda,2020-03-29,36,91,127
28,Orange,2020-03-29,74,167,241
29,San Joaquin,2020-03-29,34,35,69
30,Kings,2020-03-29,2,5,7
31,Mono,2020-03-29,0,1,1
32,Amador,2020-03-29,1,0,1
33,Sacramento,2020-03-29,36,27,63
34,Humboldt,2020-03-29,1,10,11
35,Monterey,2020-03-29,2,16,18
36,Imperial,2020-03-29,5,100,105
37,Fresno,2020-03-29,8,116,124
38,Solano,2020-03-29,7,27,34
39,Butte,2020-03-29,0,0,0
40,Marin,2020-03-29,7,13,20
41,San Benito,2020-03-29,1,1,2
42,Santa Barbara,2020-03-29,15,21,36
43,Napa,2020-03-29,0,26,26
44,Kern,2020-03-29,16,57,73
45,Nevada,2020-03-29,23,0,0
46,Inyo,2020-03-29,0,0,0
47,Plumas,2020-03-29,0,1,1
48,Contra Costa,2020-03-29,23,62,85
49,Yolo,2020-03-29,2,3,5
50,Ventura,2020-03-29,24,85,109
51,Glenn,2020-03-29,0,0,0
52,San Francisco,2020-03-29,50,73,123
53,Colusa,2020-03-29,0,0,0
54,Lake,2020-03-29,0,1,1
55,Lassen,2020-03-30,0,4,4
56,Modoc,2020-03-30,0,31,31
57,San Diego,2020-03-30,146,446,592
58,Yolo,2020-03-30,2,2,4
59,San Bernardino,2020-03-30,67,179,246
60,Shasta,2020-03-30,1,4,5
61,Orange,2020-03-30,98,251,349
62,Butte,2020-03-30,4,12,16
63,San Luis Obispo,2020-03-30,5,11,16
64,Trinity,2020-03-30,0,0,0
65,Placer,2020-03-30,19,19,38
66,Imperial,2020-03-30,19,109,128
67,Marin,2020-03-30,10,9,19
68,Nevada,2020-03-30,26,17,43
69,Sutter,2020-03-30,0,0,0
70,Merced,2020-03-30,1,9,10
71,Siskiyou,2020-03-30,0,0,0
72,Mono,2020-03-30,0,1,1
73,Tulare,2020-03-30,5,21,26
74,Monterey,2020-03-30,11,16,27
75,Santa Clara,2020-03-30,153,93,246
76,Kern,2020-03-30,18,123,141
77,Colusa,2020-03-30,0,1,1
78,Santa Cruz,2020-03-30,0,2,2
79,Alameda,2020-03-30,59,89,148
80,Kings,2020-03-30,2,12,14
81,San Francisco,2020-03-30,58,92,150
82,Riverside,2020-03-30,60,133,193
83,Stanislaus,2020-03-30,17,51,68
84,Los Angeles,2020-03-30,601,1277,1878
85,Napa,2020-03-30,3,8,11
86,Lake,2020-03-30,0,1,1
87,Yuba,2020-03-30,3,17,20
88,Mendocino,2020-03-30,2,11,13
89,Ventura,2020-03-30,25,82,107
90,San Joaquin,2020-03-30,28,30,58
91,Santa Barbara,2020-03-30,19,25,44
92,Sonoma,2020-03-30,7,22,29
93,Plumas,2020-03-30,0,1,1
94,Calaveras,2020-03-30,0,3,3
95,Humboldt,2020-03-30,1,8,9
96,Amador,2020-03-30,0,1,1
97,Madera,2020-03-30,1,5,6
98,Tuolumne,2020-03-30,1,2,3
99,Solano,2020-03-30,15,16,31
100,El Dorado,2020-03-30,0,9,9
101,Fresno,2020-03-30,10,88,98
102,Contra Costa,2020-03-30,25,54,79
103,Del Norte,2020-03-30,0,2,2
104,Glenn,2020-03-30,0,0,0
105,San Benito,2020-03-30,1,1,2
106,Sacramento,2020-03-30,45,86,131
107,Inyo,2020-03-30,0,0,0
108,San Mateo,2020-03-30,56,40,96
109,Tehama,2020-03-30,0,2,2
110,Kings,2020-03-31,1,3,4
111,Solano,2020-03-31,15,15,30
112,Sacramento,2020-03-31,53,110,163
113,Sonoma,2020-03-31,8,18,26
114,Kern,2020-03-31,14,63,77
115,Santa Barbara,2020-03-31,19,29,48
116,San Diego,2020-03-31,158,408,566
117,Stanislaus,2020-03-31,20,31,51
118,Fresno,2020-03-31,30,274,304
119,Plumas,2020-03-31,0,0,0
120,Sutter,2020-03-31,0,0,0
121,Nevada,2020-03-31,36,40,76
122,Contra Costa,2020-03-31,27,54,81
123,Mendocino,2020-03-31,0,1,1
124,Placer,2020-03-31,18,27,45
125,El Dorado,2020-03-31,10,9,19
126,Siskiyou,2020-03-31,0,0,0
127,Calaveras,2020-03-31,0,1,1
128,Colusa,2020-03-31,0,1,1
129,Imperial,2020-03-31,12,100,112
130,San Joaquin,2020-03-31,44,54,98
131,Amador,2020-03-31,0,0,0
132,San Francisco,2020-03-31,67,69,136
133,Los Angeles,2020-03-31,713,1239,1952
134,San Mateo,2020-03-31,60,23,83
135,Tulare,2020-03-31,6,14,20
136,Merced,2020-03-31,3,11,14
137,Butte,2020-03-31,4,20,24
138,Marin,2020-03-31,9,14,23
139,Santa Clara,2020-03-31,155,98,253
140,Glenn,2020-03-31,0,0,0
141,San Luis Obispo,2020-03-31,7,15,22
142,Shasta,2020-03-31,1,5,6
143,Trinity,2020-03-31,0,0,0
144,Lassen,2020-03-31,0,7,7
145,Napa,2020-03-31,1,5,6
146,Alameda,2020-03-31,56,94,150
147,San Bernardino,2020-03-31,82,231,313
148,Tuolumne,2020-03-31,0,37,37
149,Ventura,2020-03-31,21,90,111
150,Riverside,2020-03-31,80,155,235
151,Del Norte,2020-03-31,0,4,4
152,San Benito,2020-03-31,1,0,1
153,Inyo,2020-03-31,0,83,0
154,Mono,2020-03-31,0,1,1
155,Santa Cruz,2020-03-31,1,10,11
156,Humboldt,2020-03-31,1,11,12
157,Yolo,2020-03-31,3,2,5
158,Orange,2020-03-31,105,233,338
159,Monterey,2020-03-31,11,15,26
160,Tehama,2020-03-31,0,2,2
161,Madera,2020-03-31,1,3,4
162,Modoc,2020-03-31,0,19,19
163,Yuba,2020-03-31,2,21,23
164,Lake,2020-03-31,0,4,4
165,Tehama,2020-04-01,0,1,1
166,Placer,2020-04-01,25,28,53
167,Imperial,2020-04-01,4,15,19
168,Madera,2020-04-01,1,3,4
169,Lassen,2020-04-01,0,7,7
170,Napa,2020-04-01,2,2,4
171,Siskiyou,2020-04-01,0,5,5
172,San Benito,2020-04-01,2,0,2
173,Colusa,2020-04-01,0,1,1
174,San Bernardino,2020-04-01,95,196,291
175,Stanislaus,2020-04-01,25,39,64
176,Amador,2020-04-01,0,3,3
177,Kings,2020-04-01,2,6,8
178,Inyo,2020-04-01,7,89,96
179,Glenn,2020-04-01,0,0,0
180,Calaveras,2020-04-01,0,1,1
181,Mariposa,2020-04-01,0,0,0
182,Lake,2020-04-01,0,2,2
183,Shasta,2020-04-01,1,4,5
184,Del Norte,2020-04-01,0,5,5
185,Humboldt,2020-04-01,1,9,10
186,Tulare,2020-04-01,4,12,16
187,Los Angeles,2020-04-01,739,1332,2071
188,Plumas,2020-04-01,0,0,0
189,San Diego,2020-04-01,168,340,508
190,Orange,2020-04-01,117,221,338
191,Contra Costa,2020-04-01,31,42,73
192,Modoc,2020-04-01,0,1,1
193,Riverside,2020-04-01,85,182,267
194,El Dorado,2020-04-01,14,8,22
195,San Mateo,2020-04-01,57,35,92
196,Kern,2020-04-01,15,45,60
197,San Francisco,2020-04-01,67,66,133
198,Mono,2020-04-01,0,0,0
199,Trinity,2020-04-01,0,0,0
200,Marin,2020-04-01,9,19,28
201,Merced,2020-04-01,3,15,18
202,Butte,2020-04-01,5,33,38
203,San Luis Obispo,2020-04-01,8,10,18
204,Yolo,2020-04-01,3,3,6
205,Santa Barbara,2020-04-01,23,23,46
206,Ventura,2020-04-01,22,96,118
207,Sonoma,2020-04-01,5,18,23
208,Sutter,2020-04-01,0,0,0
209,Alameda,2020-04-01,52,76,128
210,Santa Cruz,2020-04-01,2,12,14
211,Monterey,2020-04-01,13,16,29
212,Yuba,2020-04-01,2,24,26
213,Santa Clara,2020-04-01,160,85,245
214,Nevada,2020-04-01,36,54,90
215,Solano,2020-04-01,14,18,32
216,Sacramento,2020-04-01,53,138,191
217,Tuolumne,2020-04-01,0,0,0
218,San Joaquin,2020-04-01,25,35,60
219,Mendocino,2020-04-01,0,2,2
220,Fresno,2020-04-01,19,101,120
221,Placer,2020-04-02,32,15,47
222,Solano,2020-04-02,15,8,23
223,Fresno,2020-04-02,17,74,91
224,Marin,2020-04-02,7,16,23
225,Riverside,2020-04-02,136,181,317
226,Santa Barbara,2020-04-02,26,44,70
227,Mariposa,2020-04-02,0,1,1
228,Tehama,2020-04-02,0,1,1
229,Trinity,2020-04-02,0,0,0
230,Lassen,2020-04-02,0,7,7
231,Napa,2020-04-02,1,4,5
232,Los Angeles,2020-04-02,818,1270,2088
233,Humboldt,2020-04-02,1,8,9
234,Santa Clara,2020-04-02,163,101,264
235,San Mateo,2020-04-02,62,40,102
236,Siskiyou,2020-04-02,0,3,3
237,Glenn,2020-04-02,0,0,0
238,Sacramento,2020-04-02,71,92,163
239,Mono,2020-04-02,18,2,20
240,Del Norte,2020-04-02,0,3,3
241,Madera,2020-04-02,1,7,8
242,Tuolumne,2020-04-02,0,0,0
243,San Francisco,2020-04-02,75,60,135
244,El Dorado,2020-04-02,15,12,27
245,Calaveras,2020-04-02,0,1,1
246,Tulare,2020-04-02,4,26,30
247,Plumas,2020-04-02,0,0,0
248,Alameda,2020-04-02,57,76,133
249,San Luis Obispo,2020-04-02,5,5,10
250,Lake,2020-04-02,0,1,1
251,Contra Costa,2020-04-02,32,38,70
252,Modoc,2020-04-02,0,1,1
253,Yolo,2020-04-02,3,2,5
254,Monterey,2020-04-02,14,14,28
255,Ventura,2020-04-02,27,111,138
256,Butte,2020-04-02,4,26,30
257,Imperial,2020-04-02,4,16,20
258,Sonoma,2020-04-02,8,18,26
259,Santa Cruz,2020-04-02,4,4,8
260,Inyo,2020-04-02,8,102,110
261,Amador,2020-04-02,0,3,3
262,Yuba,2020-04-02,2,25,27
263,San Diego,2020-04-02,144,343,487
264,Orange,2020-04-02,129,225,354
265,San Benito,2020-04-02,2,0,2
266,Shasta,2020-04-02,2,4,6
267,San Bernardino,2020-04-02,126,185,311
268,Merced,2020-04-02,4,5,9
269,Kings,2020-04-02,2,6,8
270,Sutter,2020-04-02,0,0,0
271,Kern,2020-04-02,27,77,104
272,Stanislaus,2020-04-02,30,43,73
273,Colusa,2020-04-02,0,1,1
274,Nevada,2020-04-02,38,58,96
275,Mendocino,2020-04-02,0,1,1
276,San Joaquin,2020-04-02,42,42,84
277,Tulare,2020-04-03,6,15,21
278,Plumas,2020-04-03,0,0,0
279,Kings,2020-04-03,0,3,3
280,Tuolumne,2020-04-03,0,0,0
281,Mendocino,2020-04-03,0,5,5
282,Santa Clara,2020-04-03,164,83,247
283,Contra Costa,2020-04-03,31,39,70
284,Madera,2020-04-03,0,5,5
285,Humboldt,2020-04-03,1,7,8
286,San Mateo,2020-04-03,65,39,104
287,Stanislaus,2020-04-03,28,45,73
288,Orange,2020-04-03,131,182,313
289,Ventura,2020-04-03,22,116,138
290,Fresno,2020-04-03,15,81,96
291,Mariposa,2020-04-03,0,2,2
292,Napa,2020-04-03,1,9,10
293,San Bernardino,2020-04-03,118,204,322
294,Yuba,2020-04-03,2,12,14
295,Tehama,2020-04-03,0,0,0
296,Los Angeles,2020-04-03,962,1239,2201
297,Butte,2020-04-03,3,19,22
298,Inyo,2020-04-03,8,102,110
299,Kern,2020-04-03,35,73,108
300,Glenn,2020-04-03,0,0,0
301,Solano,2020-04-03,16,21,37
302,Sacramento,2020-04-03,77,76,153
303,Santa Cruz,2020-04-03,4,8,12
304,Alameda,2020-04-03,64,74,138
305,Placer,2020-04-03,21,23,44
306,Lassen,2020-04-03,0,3,3
307,Imperial,2020-04-03,9,7,16
308,Del Norte,2020-04-03,0,2,2
309,Merced,2020-04-03,4,5,9
310,Trinity,2020-04-03,0,0,0
311,Riverside,2020-04-03,105,182,287
312,Colusa,2020-04-03,1,0,1
313,San Joaquin,2020-04-03,41,38,79
314,San Francisco,2020-04-03,80,71,151
315,Sonoma,2020-04-03,6,24,30
316,El Dorado,2020-04-03,15,9,24
317,Monterey,2020-04-03,16,18,34
318,Modoc,2020-04-03,0,0,0
319,Amador,2020-04-03,0,0,0
320,Santa Barbara,2020-04-03,27,29,56
321,Shasta,2020-04-03,2,9,11
322,Calaveras,2020-04-03,0,1,1
323,San Luis Obispo,2020-04-03,4,5,9
324,Yolo,2020-04-03,2,7,9
325,Lake,2020-04-03,0,2,2
326,Sutter,2020-04-03,0,0,0
327,San Diego,2020-04-03,171,308,479
328,Siskiyou,2020-04-03,0,3,3
329,Nevada,2020-04-03,2,4,6
330,Mono,2020-04-03,18,2,20
331,Marin,2020-04-03,6,16,22
332,San Benito,2020-04-03,2,0,2
333,Mariposa,2020-04-04,0,2,2
334,San Luis Obispo,2020-04-04,4,6,10
335,Napa,2020-04-04,1,8,9
336,Yuba,2020-04-04,2,16,18
337,Yolo,2020-04-04,4,5,9
338,Tehama,2020-04-04,0,1,1
339,Riverside,2020-04-04,126,186,312
340,Madera,2020-04-04,0,4,4
341,Calaveras,2020-04-04,0,1,1
342,Sutter,2020-04-04,0,0,0
343,Alameda,2020-04-04,60,95,155
344,San Benito,2020-04-04,2,3,5
345,Nevada,2020-04-04,2,6,8
346,Siskiyou,2020-04-04,0,2,2
347,Monterey,2020-04-04,16,25,41
348,Santa Clara,2020-04-04,159,79,238
349,Marin,2020-04-04,5,16,21
350,Amador,2020-04-04,0,0,0
351,Contra Costa,2020-04-04,30,47,77
352,Ventura,2020-04-04,21,127,148
353,Sonoma,2020-04-04,7,16,23
354,Mono,2020-04-04,20,2,22
355,Solano,2020-04-04,16,19,35
356,Mendocino,2020-04-04,0,3,3
357,Tuolumne,2020-04-04,0,1,1
358,Modoc,2020-04-04,0,0,0
359,San Joaquin,2020-04-04,43,30,73
360,Santa Cruz,2020-04-04,4,6,10
361,Lassen,2020-04-04,0,0,0
362,Butte,2020-04-04,3,14,17
363,Del Norte,2020-04-04,0,2,2
364,Sacramento,2020-04-04,69,76,145
365,San Mateo,2020-04-04,66,19,85
366,Santa Barbara,2020-04-04,28,34,62
367,Plumas,2020-04-04,0,0,0
368,Kings,2020-04-04,1,9,10
369,Trinity,2020-04-04,0,0,0
370,Stanislaus,2020-04-04,30,45,75
371,Colusa,2020-04-04,1,0,1
372,Imperial,2020-04-04,9,10,19
373,Inyo,2020-04-04,8,106,114
374,Merced,2020-04-04,5,14,19
375,San Diego,2020-04-04,177,218,395
376,El Dorado,2020-04-04,15,9,24
377,Tulare,2020-04-04,8,20,28
378,San Bernardino,2020-04-04,138,254,392
379,Orange,2020-04-04,143,213,356
380,Glenn,2020-04-04,0,0,0
381,Lake,2020-04-04,0,4,4
382,Placer,2020-04-04,23,14,37
383,Humboldt,2020-04-04,1,4,5
384,Fresno,2020-04-04,14,93,107
385,Shasta,2020-04-04,2,10,12
386,Kern,2020-04-04,33,54,87
387,San Francisco,2020-04-04,80,65,145
388,Los Angeles,2020-04-04,1007,1190,2197
389,Mono,2020-04-05,20,2,22
390,Tuolumne,2020-04-05,0,0,0
391,Sonoma,2020-04-05,6,21,27
392,San Mateo,2020-04-05,69,15,84
393,Solano,2020-04-05,15,17,32
394,Lassen,2020-04-05,0,0,0
395,Tulare,2020-04-05,4,20,24
396,Mendocino,2020-04-05,0,3,3
397,Riverside,2020-04-05,129,207,336
398,Alameda,2020-04-05,72,87,159
399,San Francisco,2020-04-05,79,68,147
400,Calaveras,2020-04-05,0,0,0
401,Kings,2020-04-05,3,1,4
402,Mariposa,2020-04-05,0,2,2
403,Nevada,2020-04-05,2,4,6
404,San Luis Obispo,2020-04-05,2,11,13
405,Inyo,2020-04-05,9,106,115
406,Yolo,2020-04-05,3,6,9
407,San Diego,2020-04-05,179,220,399
408,Contra Costa,2020-04-05,29,35,64
409,Glenn,2020-04-05,0,0,0
410,Orange,2020-04-05,144,221,365
411,Los Angeles,2020-04-05,1094,1082,2176
412,Marin,2020-04-05,5,15,20
413,Madera,2020-04-05,0,1,1
414,Butte,2020-04-05,2,16,18
415,Santa Cruz,2020-04-05,5,12,17
416,El Dorado,2020-04-05,16,6,22
417,Sutter,2020-04-05,0,0,0
418,Napa,2020-04-05,1,8,9
419,Imperial,2020-04-05,9,9,18
420,Plumas,2020-04-05,0,0,0
421,Siskiyou,2020-04-05,0,2,2
422,Modoc,2020-04-05,0,0,0
423,Monterey,2020-04-05,16,15,31
424,Del Norte,2020-04-05,0,1,1
425,San Bernardino,2020-04-05,146,240,386
426,Fresno,2020-04-05,16,81,97
427,Shasta,2020-04-05,8,11,19
428,Trinity,2020-04-05,0,0,0
429,Merced,2020-04-05,15,10,25
430,Lake,2020-04-05,0,4,4
431,San Joaquin,2020-04-05,46,24,70
432,Stanislaus,2020-04-05,30,25,55
433,Placer,2020-04-05,23,13,36
434,Amador,2020-04-05,0,0,0
435,Ventura,2020-04-05,21,128,149
436,Kern,2020-04-05,23,27,50
437,Tehama,2020-04-05,0,1,1
438,Sacramento,2020-04-05,64,78,142
439,Santa Clara,2020-04-05,166,69,235
440,Humboldt,2020-04-05,2,3,5
441,San Benito,2020-04-05,3,0,3
442,Santa Barbara,2020-04-05,31,26,57
443,Colusa,2020-04-05,1,0,1
444,Yuba,2020-04-05,1,14,15
445,Inyo,2020-04-06,9,114,123
446,San Joaquin,2020-04-06,31,32,63
447,Alameda,2020-04-06,79,70,149
448,Yuba,2020-04-06,1,19,20
449,Yolo,2020-04-06,4,0,4
450,Colusa,2020-04-06,0,0,0
451,Modoc,2020-04-06,0,0,0
452,San Mateo,2020-04-06,68,20,88
453,Fresno,2020-04-06,18,81,99
454,Plumas,2020-04-06,0,0,0
455,San Benito,2020-04-06,3,3,6
456,Santa Barbara,2020-04-06,34,26,60
457,Solano,2020-04-06,15,21,36
458,Riverside,2020-04-06,129,193,322
459,San Luis Obispo,2020-04-06,2,3,5
460,Tulare,2020-04-06,12,24,36
461,Del Norte,2020-04-06,0,3,3
462,Tuolumne,2020-04-06,0,0,0
463,Merced,2020-04-06,4,2,6
464,Stanislaus,2020-04-06,28,28,56
465,Los Angeles,2020-04-06,1166,1070,2236
466,Ventura,2020-04-06,22,106,128
467,Calaveras,2020-04-06,0,0,0
468,Kings,2020-04-06,3,3,6
469,Sutter,2020-04-06,0,0,0
470,Santa Cruz,2020-04-06,5,9,14
471,Shasta,2020-04-06,6,3,9
472,Sonoma,2020-04-06,6,18,24
473,Imperial,2020-04-06,9,14,23
474,Monterey,2020-04-06,16,15,31
475,Amador,2020-04-06,0,0,0
476,Lake,2020-04-06,0,8,8
477,Napa,2020-04-06,0,7,7
478,Sacramento,2020-04-06,77,78,155
479,Butte,2020-04-06,1,15,16
480,San Francisco,2020-04-06,80,71,151
481,Siskiyou,2020-04-06,0,0,0
482,Mendocino,2020-04-06,0,2,2
483,Lassen,2020-04-06,0,0,0
484,Mono,2020-04-06,20,2,22
485,Contra Costa,2020-04-06,30,28,58
486,San Bernardino,2020-04-06,148,185,333
487,Humboldt,2020-04-06,3,12,15
488,Santa Clara,2020-04-06,181,49,230
489,Placer,2020-04-06,20,12,32
490,Madera,2020-04-06,0,2,2
491,Trinity,2020-04-06,0,0,0
492,Tehama,2020-04-06,0,0,0
493,El Dorado,2020-04-06,16,1,17
494,Kern,2020-04-06,24,36,60
495,San Diego,2020-04-06,187,224,411
496,Mariposa,2020-04-06,0,3,3
497,Marin,2020-04-06,8,8,16
498,Glenn,2020-04-06,0,0,0
499,Orange,2020-04-06,145,171,316
500,Nevada,2020-04-06,1,5,6
501,San Luis Obispo,2020-04-07,2,5,7
502,Sacramento,2020-04-07,74,91,165
503,Santa Clara,2020-04-07,187,47,234
504,Mono,2020-04-07,20,2,22
505,Imperial,2020-04-07,9,14,23
506,Ventura,2020-04-07,22,68,90
507,Calaveras,2020-04-07,0,1,1
508,Madera,2020-04-07,0,3,3
509,Inyo,2020-04-07,9,121,130
510,Trinity,2020-04-07,0,0,0
511,Colusa,2020-04-07,0,0,0
512,Plumas,2020-04-07,0,1,1
513,Sutter,2020-04-07,0,0,0
514,Merced,2020-04-07,3,3,6
515,Napa,2020-04-07,0,5,5
516,Kern,2020-04-07,28,91,119
517,Tulare,2020-04-07,8,23,31
518,Riverside,2020-04-07,129,207,336
519,Glenn,2020-04-07,0,0,0
520,San Mateo,2020-04-07,63,13,76
521,Sonoma,2020-04-07,6,28,34
522,Marin,2020-04-07,6,5,11
523,Nevada,2020-04-07,1,4,5
524,Santa Barbara,2020-04-07,41,8,49
525,El Dorado,2020-04-07,16,2,18
526,San Diego,2020-04-07,203,124,327
527,Orange,2020-04-07,143,144,287
528,Mariposa,2020-04-07,0,3,3
529,Tuolumne,2020-04-07,0,0,0
530,Tehama,2020-04-07,0,1,1
531,Placer,2020-04-07,19,18,37
532,Alameda,2020-04-07,76,84,160
533,Shasta,2020-04-07,5,8,13
534,Monterey,2020-04-07,18,25,43
535,Lassen,2020-04-07,0,1,1
536,Mendocino,2020-04-07,0,2,2
537,Lake,2020-04-07,0,0,0
538,Fresno,2020-04-07,20,82,102
539,San Bernardino,2020-04-07,146,178,324
540,Del Norte,2020-04-07,0,3,3
541,Yolo,2020-04-07,2,3,5
542,San Benito,2020-04-07,3,3,6
543,Siskiyou,2020-04-07,0,1,1
544,Santa Cruz,2020-04-07,4,4,8
545,Butte,2020-04-07,1,14,15
546,Humboldt,2020-04-07,2,7,9
547,San Francisco,2020-04-07,88,116,204
548,Kings,2020-04-07,3,4,7
549,Contra Costa,2020-04-07,31,38,69
550,Modoc,2020-04-07,0,1,1
551,San Joaquin,2020-04-07,31,33,64
552,Solano,2020-04-07,14,24,38
553,Amador,2020-04-07,0,0,0
554,Los Angeles,2020-04-07,1251,1350,2601
555,Yuba,2020-04-07,2,25,27
556,Stanislaus,2020-04-07,28,40,68
557,San Benito,2020-04-08,2,0,2
558,San Diego,2020-04-08,225,103,328
559,Santa Cruz,2020-04-08,4,9,13
560,Calaveras,2020-04-08,0,2,2
561,Merced,2020-04-08,1,1,2
562,Los Angeles,2020-04-08,1331,1077,2408
563,Santa Clara,2020-04-08,156,34,190
564,Imperial,2020-04-08,16,7,23
565,Yolo,2020-04-08,2,7,9
566,Sutter,2020-04-08,0,0,0
567,Sonoma,2020-04-08,6,22,28
568,Marin,2020-04-08,5,3,8
569,San Joaquin,2020-04-08,32,19,51
570,Colusa,2020-04-08,0,0,0
571,Mariposa,2020-04-08,0,0,0
572,Sacramento,2020-04-08,76,81,157
573,Modoc,2020-04-08,0,0,0
574,Nevada,2020-04-08,2,7,9
575,Madera,2020-04-08,0,6,6
576,Monterey,2020-04-08,18,24,42
577,Stanislaus,2020-04-08,30,35,65
578,Contra Costa,2020-04-08,35,50,85
579,Tehama,2020-04-08,0,2,2
580,Santa Barbara,2020-04-08,42,18,60
581,San Mateo,2020-04-08,66,20,86
582,San Luis Obispo,2020-04-08,2,13,15
583,Tuolumne,2020-04-08,0,0,0
584,Kings,2020-04-08,2,8,10
585,Fresno,2020-04-08,22,63,85
586,Ventura,2020-04-08,18,73,91
587,Alameda,2020-04-08,84,69,153
588,Placer,2020-04-08,18,15,33
589,Shasta,2020-04-08,4,5,9
590,Inyo,2020-04-08,9,128,137
591,Trinity,2020-04-08,0,0,0
592,Yuba,2020-04-08,2,24,26
593,Amador,2020-04-08,0,0,0
594,Napa,2020-04-08,0,7,7
595,Orange,2020-04-08,153,181,334
596,Lassen,2020-04-08,0,1,1
597,San Bernardino,2020-04-08,132,301,433
598,Butte,2020-04-08,1,15,16
599,El Dorado,2020-04-08,16,3,19
600,Riverside,2020-04-08,149,145,294
601,Lake,2020-04-08,0,0,0
602,Humboldt,2020-04-08,2,3,5
603,Kern,2020-04-08,31,57,88
604,Mono,2020-04-08,19,8,27
605,Del Norte,2020-04-08,0,2,2
606,Plumas,2020-04-08,0,1,1
607,Mendocino,2020-04-08,0,0,0
608,Solano,2020-04-08,15,19,34
609,Tulare,2020-04-08,7,16,23
610,San Francisco,2020-04-08,90,116,206
611,Siskiyou,2020-04-08,0,3,3
612,Glenn,2020-04-08,0,0,0
613,Monterey,2020-04-09,17,26,43
614,Nevada,2020-04-09,2,4,6
615,Humboldt,2020-04-09,2,6,8
616,Solano,2020-04-09,14,9,23
617,Los Angeles,2020-04-09,1368,758,2126
618,Trinity,2020-04-09,0,0,0
619,Mariposa,2020-04-09,0,0,0
620,Colusa,2020-04-09,0,0,0
621,Kern,2020-04-09,27,35,62
622,Yolo,2020-04-09,2,4,6
623,Contra Costa,2020-04-09,37,64,101
624,Tuolumne,2020-04-09,0,0,0
625,Sonoma,2020-04-09,5,21,26
626,Sutter,2020-04-09,0,0,0
627,San Luis Obispo,2020-04-09,2,10,12
628,Napa,2020-04-09,0,7,7
629,Plumas,2020-04-09,0,1,1
630,Butte,2020-04-09,1,14,15
631,Mono,2020-04-09,18,15,33
632,Shasta,2020-04-09,5,7,12
633,Mendocino,2020-04-09,0,0,0
634,Fresno,2020-04-09,25,41,66
635,San Mateo,2020-04-09,58,14,72
636,Orange,2020-04-09,146,117,263
637,San Diego,2020-04-09,227,124,351
638,Santa Cruz,2020-04-09,4,14,18
639,Riverside,2020-04-09,201,159,360
640,San Joaquin,2020-04-09,29,18,47
641,Madera,2020-04-09,0,3,3
642,San Benito,2020-04-09,2,1,3
643,Modoc,2020-04-09,0,0,0
644,Glenn,2020-04-09,0,0,0
645,Stanislaus,2020-04-09,28,30,58
646,Imperial,2020-04-09,14,10,24
647,Merced,2020-04-09,1,7,8
648,Ventura,2020-04-09,18,69,87
649,Santa Clara,2020-04-09,158,65,223
650,San Bernardino,2020-04-09,136,269,405
651,Yuba,2020-04-09,3,18,21
652,Del Norte,2020-04-09,0,2,2
653,Marin,2020-04-09,5,7,12
654,Lake,2020-04-09,0,0,0
655,Tulare,2020-04-09,10,11,21
656,Kings,2020-04-09,6,6,12
657,Sacramento,2020-04-09,74,60,134
658,Lassen,2020-04-09,0,2,2
659,El Dorado,2020-04-09,17,3,20
660,Placer,2020-04-09,18,12,30
661,Amador,2020-04-09,0,0,0
662,Tehama,2020-04-09,0,1,1
663,Santa Barbara,2020-04-09,40,18,58
664,San Francisco,2020-04-09,88,64,152
665,Inyo,2020-04-09,9,135,144
666,Alameda,2020-04-09,80,76,156
667,Calaveras,2020-04-09,0,0,0
668,Siskiyou,2020-04-09,0,2,2
669,Solano,2020-04-10,18,9,27
670,Sutter,2020-04-10,0,0,0
671,Modoc,2020-04-10,0,0,0
672,Plumas,2020-04-10,0,0,0
673,Colusa,2020-04-10,0,0,0
674,Imperial,2020-04-10,14,12,26
675,San Joaquin,2020-04-10,26,17,43
676,Los Angeles,2020-04-10,1299,754,2053
677,Del Norte,2020-04-10,0,3,3
678,Sonoma,2020-04-10,4,18,22
679,San Luis Obispo,2020-04-10,2,3,5
680,Mendocino,2020-04-10,0,1,1
681,Lake,2020-04-10,0,1,1
682,Orange,2020-04-10,139,129,268
683,Humboldt,2020-04-10,2,10,12
684,Santa Cruz,2020-04-10,4,11,15
685,Santa Clara,2020-04-10,151,44,195
686,Yolo,2020-04-10,3,2,5
687,Fresno,2020-04-10,27,41,68
688,Contra Costa,2020-04-10,42,30,72
689,Monterey,2020-04-10,18,21,39
690,Trinity,2020-04-10,0,0,0
691,Calaveras,2020-04-10,0,0,0
692,El Dorado,2020-04-10,17,1,18
693,Marin,2020-04-10,6,26,32
694,Nevada,2020-04-10,3,3,6
695,San Mateo,2020-04-10,56,12,68
696,Kern,2020-04-10,33,38,71
697,Yuba,2020-04-10,2,8,10
698,Napa,2020-04-10,0,7,7
699,Tulare,2020-04-10,11,10,21
700,Alameda,2020-04-10,93,71,164
701,Mono,2020-04-10,0,3,3
702,Riverside,2020-04-10,206,141,347
703,Siskiyou,2020-04-10,0,0,0
704,Kings,2020-04-10,8,0,8
705,Tehama,2020-04-10,0,1,1
706,San Benito,2020-04-10,2,1,3
707,Inyo,2020-04-10,9,135,144
708,San Bernardino,2020-04-10,156,295,451
709,Ventura,2020-04-10,19,76,95
710,Merced,2020-04-10,0,2,2
711,Shasta,2020-04-10,5,7,12
712,Amador,2020-04-10,0,0,0
713,Tuolumne,2020-04-10,0,0,0
714,Lassen,2020-04-10,0,2,2
715,Butte,2020-04-10,1,15,16
716,Stanislaus,2020-04-10,27,17,44
717,Glenn,2020-04-10,0,0,0
718,Madera,2020-04-10,0,5,5
719,Placer,2020-04-10,16,11,27
720,San Francisco,2020-04-10,85,46,131
721,Mariposa,2020-04-10,0,0,0
722,Sacramento,2020-04-10,70,45,115
723,Santa Barbara,2020-04-10,42,13,55
724,San Diego,2020-04-10,230,124,354
725,Merced,2020-04-11,0,2,2
726,Mono,2020-04-11,0,3,3
727,Modoc,2020-04-11,0,0,0
728,Placer,2020-04-11,20,19,39
729,Tehama,2020-04-11,0,0,0
730,Mariposa,2020-04-11,0,0,0
731,Sonoma,2020-04-11,3,19,22
732,Siskiyou,2020-04-11,0,0,0
733,Amador,2020-04-11,0,0,0
734,Shasta,2020-04-11,5,3,8
735,Alameda,2020-04-11,87,91,178
736,San Bernardino,2020-04-11,153,213,366
737,Calaveras,2020-04-11,0,1,1
738,Plumas,2020-04-11,0,0,0
739,Sacramento,2020-04-11,67,46,113
740,Glenn,2020-04-11,0,0,0
741,Nevada,2020-04-11,3,3,6
742,Colusa,2020-04-11,0,0,0
743,Stanislaus,2020-04-11,23,19,42
744,Kings,2020-04-11,10,0,10
745,Tulare,2020-04-11,12,3,15
746,Santa Clara,2020-04-11,146,61,207
747,San Mateo,2020-04-11,54,15,69
748,Imperial,2020-04-11,14,11,25
749,Del Norte,2020-04-11,0,2,2
750,Yolo,2020-04-11,3,4,7
751,Trinity,2020-04-11,0,0,0
752,Butte,2020-04-11,2,4,6
753,Marin,2020-04-11,2,27,29
754,Napa,2020-04-11,0,0,0
755,Yuba,2020-04-11,2,2,4
756,Fresno,2020-04-11,28,63,91
757,San Benito,2020-04-11,2,2,4
758,Humboldt,2020-04-11,2,5,7
759,Solano,2020-04-11,13,16,29
760,Los Angeles,2020-04-11,1362,905,2267
761,Inyo,2020-04-11,10,140,150
762,San Luis Obispo,2020-04-11,2,10,12
763,Riverside,2020-04-11,232,127,359
764,Sutter,2020-04-11,0,0,0
765,Kern,2020-04-11,32,52,84
766,Madera,2020-04-11,0,5,5
767,Monterey,2020-04-11,18,17,35
768,Lassen,2020-04-11,0,4,4
769,Tuolumne,2020-04-11,0,2,2
770,Santa Barbara,2020-04-11,40,16,56
771,San Francisco,2020-04-11,82,51,133
772,San Diego,2020-04-11,239,118,357
773,Lake,2020-04-11,0,0,0
774,Mendocino,2020-04-11,0,1,1
775,San Joaquin,2020-04-11,23,14,37
776,El Dorado,2020-04-11,17,2,19
777,Orange,2020-04-11,144,109,253
778,Contra Costa,2020-04-11,39,38,77
779,Ventura,2020-04-11,22,58,80
780,Santa Cruz,2020-04-11,4,14,18
781,Orange,2020-04-12,138,108,246
782,Marin,2020-04-12,2,24,26
783,Riverside,2020-04-12,245,142,387
784,Sutter,2020-04-12,0,0,0
785,Tehama,2020-04-12,0,3,3
786,Butte,2020-04-12,2,0,2
787,Santa Cruz,2020-04-12,4,15,19
788,Sonoma,2020-04-12,3,11,14
789,Placer,2020-04-12,19,15,34
790,Yuba,2020-04-12,1,0,1
791,Del Norte,2020-04-12,0,2,2
792,Yolo,2020-04-12,4,4,8
793,Glenn,2020-04-12,0,0,0
794,Mariposa,2020-04-12,0,0,0
795,Napa,2020-04-12,0,0,0
796,Kings,2020-04-12,8,0,8
797,Lassen,2020-04-12,0,4,4
798,Siskiyou,2020-04-12,0,0,0
799,San Benito,2020-04-12,0,0,0
800,Inyo,2020-04-12,10,140,150
801,Colusa,2020-04-12,0,0,0
802,El Dorado,2020-04-12,19,1,20
803,Plumas,2020-04-12,0,0,0
804,Alameda,2020-04-12,91,101,192
805,Kern,2020-04-12,31,28,59
806,Madera,2020-04-12,0,5,5
807,San Diego,2020-04-12,244,108,352
808,Sacramento,2020-04-12,69,46,115
809,Fresno,2020-04-12,23,46,69
810,Mendocino,2020-04-12,0,0,0
811,San Joaquin,2020-04-12,25,21,46
812,Lake,2020-04-12,0,0,0
813,Nevada,2020-04-12,3,1,4
814,Tulare,2020-04-12,15,4,19
815,Merced,2020-04-12,0,3,3
816,Los Angeles,2020-04-12,1433,715,2148
817,Ventura,2020-04-12,21,65,86
818,Stanislaus,2020-04-12,19,19,38
819,San Bernardino,2020-04-12,157,172,329
820,Santa Clara,2020-04-12,145,51,196
821,San Francisco,2020-04-12,92,44,136
822,San Luis Obispo,2020-04-12,2,8,10
823,Shasta,2020-04-12,4,3,7
824,Santa Barbara,2020-04-12,42,7,49
825,Contra Costa,2020-04-12,46,32,78
826,Monterey,2020-04-12,19,13,32
827,San Mateo,2020-04-12,46,31,77
828,Tuolumne,2020-04-12,0,0,0
829,Amador,2020-04-12,0,0,0
830,Calaveras,2020-04-12,0,2,2
831,Humboldt,2020-04-12,2,4,6
832,Imperial,2020-04-12,18,13,31
833,Solano,2020-04-12,13,19,32
834,Trinity,2020-04-12,0,0,0
835,Modoc,2020-04-12,0,0,0
836,Mono,2020-04-12,0,3,3
837,Riverside,2020-04-13,247,122,369
838,San Diego,2020-04-13,243,107,350
839,Santa Clara,2020-04-13,151,66,217
840,Fresno,2020-04-13,22,57,79
841,Tehama,2020-04-13,0,0,0
842,El Dorado,2020-04-13,19,1,20
843,Sonoma,2020-04-13,3,14,17
844,Tulare,2020-04-13,14,3,17
845,Inyo,2020-04-13,10,150,160
846,Santa Barbara,2020-04-13,42,7,49
847,Calaveras,2020-04-13,0,1,1
848,Contra Costa,2020-04-13,44,44,88
849,Kings,2020-04-13,0,1,1
850,Monterey,2020-04-13,22,19,41
851,Kern,2020-04-13,39,32,71
852,Amador,2020-04-13,0,0,0
853,Alameda,2020-04-13,85,81,166
854,Placer,2020-04-13,18,9,27
855,Sacramento,2020-04-13,73,36,109
856,Lake,2020-04-13,0,2,2
857,Solano,2020-04-13,13,13,26
858,Orange,2020-04-13,149,81,230
859,San Luis Obispo,2020-04-13,2,5,7
860,Madera,2020-04-13,0,4,4
861,San Benito,2020-04-13,1,1,2
862,Tuolumne,2020-04-13,0,0,0
863,Los Angeles,2020-04-13,1501,793,2294
864,Modoc,2020-04-13,0,0,0
865,Ventura,2020-04-13,21,56,77
866,Lassen,2020-04-13,0,4,4
867,Siskiyou,2020-04-13,0,2,2
868,Humboldt,2020-04-13,2,8,10
869,San Francisco,2020-04-13,89,48,137
870,Mariposa,2020-04-13,0,3,3
871,Imperial,2020-04-13,19,8,27
872,San Mateo,2020-04-13,57,19,76
873,Butte,2020-04-13,1,8,9
874,Nevada,2020-04-13,2,2,4
875,Marin,2020-04-13,2,20,22
876,San Bernardino,2020-04-13,167,155,322
877,Yuba,2020-04-13,1,2,3
878,Glenn,2020-04-13,0,0,0
879,Mendocino,2020-04-13,7,1,8
880,Del Norte,2020-04-13,0,1,1
881,San Joaquin,2020-04-13,26,16,42
882,Sutter,2020-04-13,0,0,0
883,Colusa,2020-04-13,0,0,0
884,Yolo,2020-04-13,4,0,4
885,Shasta,2020-04-13,3,0,3
886,Napa,2020-04-13,0,1,1
887,Santa Cruz,2020-04-13,4,8,12
888,Merced,2020-04-13,0,4,4
889,Stanislaus,2020-04-13,21,22,43
890,Plumas,2020-04-13,0,1,1
891,Mono,2020-04-13,0,1,1
892,Trinity,2020-04-13,0,0,0
893,Sacramento,2020-04-14,70,46,116
894,Fresno,2020-04-14,24,45,69
895,Shasta,2020-04-14,1,4,5
896,Inyo,2020-04-14,10,156,166
897,Imperial,2020-04-14,19,14,33
898,Yuba,2020-04-14,1,1,2
899,Plumas,2020-04-14,0,1,1
900,Contra Costa,2020-04-14,37,51,88
901,Tuolumne,2020-04-14,0,0,0
902,Madera,2020-04-14,0,4,4
903,Lassen,2020-04-14,0,6,6
904,Yolo,2020-04-14,3,0,3
905,Santa Cruz,2020-04-14,4,4,8
906,Mariposa,2020-04-14,0,3,3
907,San Joaquin,2020-04-14,22,10,32
908,Siskiyou,2020-04-14,0,0,0
909,Marin,2020-04-14,2,23,25
910,Kern,2020-04-14,35,23,58
911,Glenn,2020-04-14,0,0,0
912,Nevada,2020-04-14,3,4,7
913,Santa Clara,2020-04-14,144,47,191
914,Amador,2020-04-14,0,0,0
915,Del Norte,2020-04-14,0,5,5
916,Calaveras,2020-04-14,0,1,1
917,San Luis Obispo,2020-04-14,3,15,18
918,Kings,2020-04-14,8,0,8
919,Sonoma,2020-04-14,3,9,12
920,Placer,2020-04-14,17,15,32
921,Sutter,2020-04-14,0,0,0
922,Ventura,2020-04-14,24,35,59
923,San Benito,2020-04-14,1,1,2
924,Mendocino,2020-04-14,0,0,0
925,San Bernardino,2020-04-14,166,149,315
926,Humboldt,2020-04-14,2,7,9
927,Merced,2020-04-14,0,4,4
928,Stanislaus,2020-04-14,18,25,43
929,Colusa,2020-04-14,0,0,0
930,Tulare,2020-04-14,15,5,20
931,Butte,2020-04-14,1,6,7
932,Mono,2020-04-14,0,1,1
933,San Mateo,2020-04-14,55,12,67
934,Lake,2020-04-14,0,3,3
935,Monterey,2020-04-14,18,13,31
936,Trinity,2020-04-14,0,0,0
937,Riverside,2020-04-14,235,117,352
938,Orange,2020-04-14,147,111,258
939,Los Angeles,2020-04-14,1587,613,2200
940,Santa Barbara,2020-04-14,42,8,50
941,Solano,2020-04-14,12,25,37
942,San Diego,2020-04-14,243,109,352
943,Alameda,2020-04-14,92,106,198
944,Napa,2020-04-14,0,0,0
945,El Dorado,2020-04-14,20,3,23
946,Modoc,2020-04-14,0,1,1
947,San Francisco,2020-04-14,87,53,140
948,Tehama,2020-04-14,0,0,0
949,Mendocino,2020-04-15,0,0,0
950,Los Angeles,2020-04-15,1624,632,2256
951,Kings,2020-04-15,8,0,8
952,San Diego,2020-04-15,236,112,348
953,San Mateo,2020-04-15,53,18,71
954,Tehama,2020-04-15,0,0,0
955,Contra Costa,2020-04-15,38,41,79
956,Mariposa,2020-04-15,0,4,4
957,Sutter,2020-04-15,0,0,0
958,San Joaquin,2020-04-15,21,21,42
959,Modoc,2020-04-15,0,0,0
960,San Bernardino,2020-04-15,149,109,258
961,Fresno,2020-04-15,25,33,58
962,Napa,2020-04-15,0,0,0
963,Riverside,2020-04-15,207,155,362
964,Marin,2020-04-15,4,10,14
965,Siskiyou,2020-04-15,2,0,2
966,Placer,2020-04-15,13,11,24
967,Solano,2020-04-15,9,14,23
968,Stanislaus,2020-04-15,19,17,36
969,El Dorado,2020-04-15,0,5,5
970,Shasta,2020-04-15,1,1,2
971,Calaveras,2020-04-15,0,0,0
972,Lake,2020-04-15,3,3,6
973,Humboldt,2020-04-15,2,5,7
974,Plumas,2020-04-15,0,0,0
975,Del Norte,2020-04-15,0,0,0
976,Glenn,2020-04-15,0,0,0
977,Sacramento,2020-04-15,66,60,126
978,Kern,2020-04-15,40,12,52
979,Santa Cruz,2020-04-15,4,2,6
980,Inyo,2020-04-15,15,163,178
981,San Francisco,2020-04-15,87,84,171
982,Monterey,2020-04-15,20,11,31
983,Alameda,2020-04-15,81,99,180
984,Sonoma,2020-04-15,3,13,16
985,Butte,2020-04-15,1,5,6
986,Mono,2020-04-15,0,0,0
987,San Luis Obispo,2020-04-15,2,6,8
988,Yuba,2020-04-15,0,2,2
989,San Benito,2020-04-15,1,0,1
990,Madera,2020-04-15,1,6,7
991,Lassen,2020-04-15,0,6,6
992,Imperial,2020-04-15,21,13,34
993,Colusa,2020-04-15,0,0,0
994,Ventura,2020-04-15,25,57,82
995,Tulare,2020-04-15,18,3,21
996,Santa Clara,2020-04-15,144,42,186
997,Trinity,2020-04-15,0,0,0
998,Nevada,2020-04-15,3,4,7
999,Merced,2020-04-15,0,0,0
1000,Amador,2020-04-15,0,0,0
1001,Yolo,2020-04-15,2,1,3
1002,Tuolumne,2020-04-15,0,0,0
1003,Orange,2020-04-15,156,103,259
1004,Santa Barbara,2020-04-15,37,7,44
1005,Sacramento,2020-04-16,64,54,118
1006,Siskiyou,2020-04-16,0,2,2
1007,Tehama,2020-04-16,0,1,1
1008,San Mateo,2020-04-16,54,18,72
1009,Monterey,2020-04-16,20,22,42
1010,Santa Cruz,2020-04-16,4,3,7
1011,Sonoma,2020-04-16,3,10,13
1012,Del Norte,2020-04-16,0,3,3
1013,Napa,2020-04-16,0,0,0
1014,Tuolumne,2020-04-16,0,0,0
1015,Humboldt,2020-04-16,1,5,6
1016,Nevada,2020-04-16,3,3,6
1017,Imperial,2020-04-16,21,7,28
1018,Lake,2020-04-16,1,0,1
1019,Colusa,2020-04-16,0,1,1
1020,Mariposa,2020-04-16,0,1,1
1021,Solano,2020-04-16,9,15,24
1022,Ventura,2020-04-16,24,52,76
1023,Butte,2020-04-16,1,10,11
1024,Glenn,2020-04-16,0,0,0
1025,Santa Clara,2020-04-16,134,48,182
1026,Marin,2020-04-16,5,7,12
1027,Amador,2020-04-16,0,0,0
1028,Mono,2020-04-16,0,0,0
1029,Sutter,2020-04-16,0,0,0
1030,Merced,2020-04-16,1,1,2
1031,Mendocino,2020-04-16,0,0,0
1032,Orange,2020-04-16,152,117,269
1033,Shasta,2020-04-16,1,0,1
1034,Riverside,2020-04-16,216,150,366
1035,Inyo,2020-04-16,0,3,3
1036,Tulare,2020-04-16,22,5,27
1037,San Benito,2020-04-16,1,0,1
1038,San Francisco,2020-04-16,84,35,119
1039,Stanislaus,2020-04-16,18,19,37
1040,Yuba,2020-04-16,0,2,2
1041,Fresno,2020-04-16,33,33,66
1042,Madera,2020-04-16,0,7,7
1043,Placer,2020-04-16,12,18,30
1044,Los Angeles,2020-04-16,1679,620,2299
1045,Contra Costa,2020-04-16,37,59,96
1046,Trinity,2020-04-16,0,0,0
1047,Calaveras,2020-04-16,0,1,1
1048,San Bernardino,2020-04-16,164,124,288
1049,Lassen,2020-04-16,0,5,5
1050,Plumas,2020-04-16,0,0,0
1051,Kings,2020-04-16,8,0,8
1052,San Luis Obispo,2020-04-16,3,11,14
1053,Yolo,2020-04-16,2,1,3
1054,Santa Barbara,2020-04-16,37,4,41
1055,Kern,2020-04-16,41,19,60
1056,Modoc,2020-04-16,0,2,2
1057,Alameda,2020-04-16,73,82,155
1058,El Dorado,2020-04-16,0,5,5
1059,San Diego,2020-04-16,231,111,342
1060,San Joaquin,2020-04-16,21,16,37
1061,Marin,2020-04-17,4,2,6
1062,San Bernardino,2020-04-17,165,123,288
1063,Kings,2020-04-17,7,0,7
1064,Butte,2020-04-17,1,9,10
1065,Lassen,2020-04-17,0,5,5
1066,Riverside,2020-04-17,215,144,359
1067,Alameda,2020-04-17,85,91,176
1068,Mariposa,2020-04-17,0,1,1
1069,Sonoma,2020-04-17,2,6,8
1070,Del Norte,2020-04-17,0,4,4
1071,Stanislaus,2020-04-17,15,17,32
1072,Kern,2020-04-17,36,16,52
1073,Yolo,2020-04-17,4,0,4
1074,Glenn,2020-04-17,0,0,0
1075,Siskiyou,2020-04-17,0,3,3
1076,Santa Clara,2020-04-17,140,60,200
1077,Modoc,2020-04-17,0,1,1
1078,Lake,2020-04-17,0,6,6
1079,Sutter,2020-04-17,0,0,0
1080,Mono,2020-04-17,0,0,0
1081,Madera,2020-04-17,0,5,5
1082,Sacramento,2020-04-17,63,46,109
1083,Nevada,2020-04-17,2,4,6
1084,San Diego,2020-04-17,232,111,343
1085,Napa,2020-04-17,0,1,1
1086,Humboldt,2020-04-17,0,4,4
1087,Trinity,2020-04-17,0,0,0
1088,San Benito,2020-04-17,1,0,1
1089,Shasta,2020-04-17,1,0,1
1090,Colusa,2020-04-17,0,1,1
1091,Fresno,2020-04-17,31,29,60
1092,Mendocino,2020-04-17,0,0,0
1093,Inyo,2020-04-17,0,3,3
1094,Imperial,2020-04-17,19,15,34
1095,Santa Barbara,2020-04-17,36,6,42
1096,San Luis Obispo,2020-04-17,3,11,14
1097,San Francisco,2020-04-17,79,36,115
1098,San Joaquin,2020-04-17,23,23,46
1099,Los Angeles,2020-04-17,1720,634,2354
1100,Monterey,2020-04-17,22,25,47
1101,San Mateo,2020-04-17,51,16,67
1102,Tehama,2020-04-17,0,0,0
1103,Orange,2020-04-17,160,124,284
1104,Amador,2020-04-17,0,0,0
1105,Tuolumne,2020-04-17,0,0,0
1106,Tulare,2020-04-17,23,5,28
1107,Placer,2020-04-17,12,17,29
1108,Santa Cruz,2020-04-17,2,3,5
1109,Solano,2020-04-17,10,11,21
1110,El Dorado,2020-04-17,0,6,6
1111,Calaveras,2020-04-17,0,2,2
1112,Contra Costa,2020-04-17,34,46,80
1113,Merced,2020-04-17,0,4,4
1114,Yuba,2020-04-17,0,5,5
1115,Ventura,2020-04-17,23,33,56
1116,Plumas,2020-04-17,0,1,1
1117,Contra Costa,2020-04-18,35,44,79
1118,Yuba,2020-04-18,0,3,3
1119,Humboldt,2020-04-18,0,4,4
1120,Solano,2020-04-18,9,11,20
1121,Kings,2020-04-18,8,0,8
1122,Tehama,2020-04-18,0,0,0
1123,San Joaquin,2020-04-18,23,27,50
1124,Marin,2020-04-18,3,1,4
1125,Yolo,2020-04-18,4,0,4
1126,Sutter,2020-04-18,0,0,0
1127,Glenn,2020-04-18,0,0,0
1128,Napa,2020-04-18,0,0,0
1129,Tuolumne,2020-04-18,0,0,0
1130,Placer,2020-04-18,11,17,28
1131,Fresno,2020-04-18,32,35,67
1132,Mono,2020-04-18,0,0,0
1133,El Dorado,2020-04-18,0,8,8
1134,Mariposa,2020-04-18,0,0,0
1135,Madera,2020-04-18,0,7,7
1136,Imperial,2020-04-18,21,12,33
1137,Del Norte,2020-04-18,0,2,2
1138,San Benito,2020-04-18,0,0,0
1139,Ventura,2020-04-18,25,28,53
1140,Riverside,2020-04-18,223,118,341
1141,Trinity,2020-04-18,0,0,0
1142,Inyo,2020-04-18,1,1,2
1143,Kern,2020-04-18,33,14,47
1144,Santa Barbara,2020-04-18,31,9,40
1145,Colusa,2020-04-18,0,0,0
1146,Modoc,2020-04-18,0,1,1
1147,Siskiyou,2020-04-18,0,1,1
1148,Shasta,2020-04-18,1,1,2
1149,Orange,2020-04-18,157,120,277
1150,Nevada,2020-04-18,4,5,9
1151,Stanislaus,2020-04-18,14,23,37
1152,Lassen,2020-04-18,0,1,1
1153,Alameda,2020-04-18,82,73,155
1154,Sonoma,2020-04-18,2,4,6
1155,Calaveras,2020-04-18,0,0,0
1156,Amador,2020-04-18,0,0,0
1157,Merced,2020-04-18,0,3,3
1158,Butte,2020-04-18,1,4,5
1159,Lake,2020-04-18,0,0,0
1160,Tulare,2020-04-18,27,0,27
1161,Santa Cruz,2020-04-18,2,2,4
1162,Plumas,2020-04-18,0,1,1
1163,San Mateo,2020-04-18,49,12,61
1164,San Bernardino,2020-04-18,161,108,269
1165,San Luis Obispo,2020-04-18,3,12,15
1166,Mendocino,2020-04-18,0,0,0
1167,Santa Clara,2020-04-18,137,52,189
1168,Los Angeles,2020-04-18,1709,578,2287
1169,Monterey,2020-04-18,26,21,47
1170,Sacramento,2020-04-18,65,46,111
1171,San Diego,2020-04-18,223,97,320
1172,San Francisco,2020-04-18,74,29,103
1173,Plumas,2020-04-19,0,0,0
1174,San Joaquin,2020-04-19,23,16,39
1175,Napa,2020-04-19,0,3,3
1176,Del Norte,2020-04-19,0,0,0
1177,Trinity,2020-04-19,0,0,0
1178,Mono,2020-04-19,0,0,0
1179,Shasta,2020-04-19,1,0,1
1180,Santa Barbara,2020-04-19,29,7,36
1181,Santa Clara,2020-04-19,143,32,175
1182,Contra Costa,2020-04-19,34,40,74
1183,San Luis Obispo,2020-04-19,2,7,9
1184,San Francisco,2020-04-19,73,34,107
1185,Ventura,2020-04-19,26,26,52
1186,San Mateo,2020-04-19,53,6,59
1187,Solano,2020-04-19,11,10,21
1188,El Dorado,2020-04-19,0,11,11
1189,Madera,2020-04-19,0,7,7
1190,Riverside,2020-04-19,236,113,349
1191,Stanislaus,2020-04-19,13,16,29
1192,Sonoma,2020-04-19,2,8,10
1193,Los Angeles,2020-04-19,1739,549,2288
1194,Glenn,2020-04-19,0,0,0
1195,Humboldt,2020-04-19,0,3,3
1196,Colusa,2020-04-19,1,0,1
1197,Lassen,2020-04-19,0,1,1
1198,San Diego,2020-04-19,226,94,320
1199,Inyo,2020-04-19,1,0,1
1200,Orange,2020-04-19,162,130,292
1201,Fresno,2020-04-19,32,35,67
1202,San Benito,2020-04-19,0,0,0
1203,Yuba,2020-04-19,0,2,2
1204,Sacramento,2020-04-19,65,39,104
1205,Placer,2020-04-19,11,12,23
1206,Monterey,2020-04-19,25,6,31
1207,Modoc,2020-04-19,0,0,0
1208,San Bernardino,2020-04-19,158,97,255
1209,Marin,2020-04-19,3,7,10
1210,Alameda,2020-04-19,84,63,147
1211,Kings,2020-04-19,8,0,8
1212,Nevada,2020-04-19,1,4,5
1213,Tehama,2020-04-19,0,0,0
1214,Siskiyou,2020-04-19,0,1,1
1215,Calaveras,2020-04-19,0,0,0
1216,Mendocino,2020-04-19,0,0,0
1217,Mariposa,2020-04-19,0,0,0
1218,Merced,2020-04-19,0,2,2
1219,Tuolumne,2020-04-19,0,0,0
1220,Lake,2020-04-19,0,2,2
1221,Tulare,2020-04-19,27,0,27
1222,Sutter,2020-04-19,0,0,0
1223,Imperial,2020-04-19,25,8,33
1224,Butte,2020-04-19,1,3,4
1225,Yolo,2020-04-19,6,0,6
1226,Amador,2020-04-19,0,0,0
1227,Santa Cruz,2020-04-19,2,3,5
1228,Kern,2020-04-19,34,20,54
1229,Shasta,2020-04-20,1,0,1
1230,Imperial,2020-04-20,25,9,34
1231,Glenn,2020-04-20,0,0,0
1232,Kern,2020-04-20,34,11,45
1233,Monterey,2020-04-20,24,7,31
1234,Marin,2020-04-20,6,4,10
1235,Yuba,2020-04-20,0,1,1
1236,Merced,2020-04-20,0,1,1
1237,Humboldt,2020-04-20,0,6,6
1238,Modoc,2020-04-20,0,0,0
1239,Inyo,2020-04-20,1,0,1
1240,Riverside,2020-04-20,240,145,385
1241,Sacramento,2020-04-20,69,32,101
1242,Lassen,2020-04-20,0,1,1
1243,Solano,2020-04-20,10,11,21
1244,Lake,2020-04-20,0,2,2
1245,Alameda,2020-04-20,85,52,137
1246,Nevada,2020-04-20,1,5,6
1247,Sutter,2020-04-20,0,0,0
1248,Yolo,2020-04-20,5,1,6
1249,Madera,2020-04-20,0,6,6
1250,Del Norte,2020-04-20,0,2,2
1251,Tulare,2020-04-20,27,0,27
1252,San Francisco,2020-04-20,79,27,106
1253,Plumas,2020-04-20,0,0,0
1254,Kings,2020-04-20,8,0,8
1255,Siskiyou,2020-04-20,0,1,1
1256,Santa Cruz,2020-04-20,3,1,4
1257,San Bernardino,2020-04-20,152,200,352
1258,Ventura,2020-04-20,29,18,47
1259,Trinity,2020-04-20,0,0,0
1260,Amador,2020-04-20,0,0,0
1261,San Joaquin,2020-04-20,30,23,53
1262,Calaveras,2020-04-20,0,1,1
1263,San Diego,2020-04-20,238,76,314
1264,Mendocino,2020-04-20,0,0,0
1265,Contra Costa,2020-04-20,37,28,65
1266,Butte,2020-04-20,1,2,3
1267,San Mateo,2020-04-20,56,16,72
1268,Santa Barbara,2020-04-20,30,9,39
1269,Placer,2020-04-20,8,7,15
1270,Orange,2020-04-20,172,102,274
1271,Sonoma,2020-04-20,2,12,14
1272,San Luis Obispo,2020-04-20,2,3,5
1273,Fresno,2020-04-20,35,30,65
1274,El Dorado,2020-04-20,0,4,4
1275,Mariposa,2020-04-20,0,1,1
1276,San Benito,2020-04-20,0,0,0
1277,Napa,2020-04-20,1,2,3
1278,Colusa,2020-04-20,1,0,1
1279,Los Angeles,2020-04-20,1791,602,2393
1280,Santa Clara,2020-04-20,149,42,191
1281,Stanislaus,2020-04-20,13,18,31
1282,Tuolumne,2020-04-20,0,0,0
1283,Mono,2020-04-20,0,0,0
1284,Tehama,2020-04-20,0,0,0
1285,San Bernardino,2020-04-21,153,204,357
1286,Santa Cruz,2020-04-21,3,2,5
1287,Kern,2020-04-21,31,12,43
1288,Del Norte,2020-04-21,0,1,1
1289,Napa,2020-04-21,1,1,2
1290,Sutter,2020-04-21,0,0,0
1291,Merced,2020-04-21,0,3,3
1292,Tulare,2020-04-21,27,0,27
1293,San Francisco,2020-04-21,76,45,121
1294,Glenn,2020-04-21,0,0,0
1295,Placer,2020-04-21,4,18,22
1296,Mono,2020-04-21,0,0,0
1297,Ventura,2020-04-21,28,28,56
1298,San Benito,2020-04-21,1,0,1
1299,Amador,2020-04-21,0,0,0
1300,Santa Barbara,2020-04-21,26,8,34
1301,Yuba,2020-04-21,0,0,0
1302,Shasta,2020-04-21,1,0,1
1303,Madera,2020-04-21,0,5,5
1304,Tuolumne,2020-04-21,0,0,0
1305,Imperial,2020-04-21,23,12,35
1306,Stanislaus,2020-04-21,11,20,31
1307,Modoc,2020-04-21,0,1,1
1308,Nevada,2020-04-21,1,4,5
1309,Tehama,2020-04-21,0,0,0
1310,Sonoma,2020-04-21,2,17,19
1311,Yolo,2020-04-21,5,2,7
1312,Inyo,2020-04-21,1,0,1
1313,Mariposa,2020-04-21,0,1,1
1314,Colusa,2020-04-21,1,0,1
1315,Santa Clara,2020-04-21,144,34,178
1316,Lassen,2020-04-21,0,1,1
1317,Lake,2020-04-21,0,2,2
1318,Humboldt,2020-04-21,0,5,5
1319,El Dorado,2020-04-21,0,3,3
1320,San Luis Obispo,2020-04-21,1,5,6
1321,Orange,2020-04-21,179,129,308
1322,Fresno,2020-04-21,35,35,70
1323,Contra Costa,2020-04-21,33,44,77
1324,Trinity,2020-04-21,0,0,0
1325,Mendocino,2020-04-21,0,1,1
1326,Calaveras,2020-04-21,0,0,0
1327,Marin,2020-04-21,5,4,9
1328,Siskiyou,2020-04-21,0,1,1
1329,Alameda,2020-04-21,85,59,144
1330,Plumas,2020-04-21,0,0,0
1331,Solano,2020-04-21,6,17,23
1332,San Joaquin,2020-04-21,27,24,51
1333,San Diego,2020-04-21,221,84,305
1334,Los Angeles,2020-04-21,1854,617,2471
1335,Kings,2020-04-21,8,0,8
1336,Riverside,2020-04-21,250,120,370
1337,Butte,2020-04-21,0,1,1
1338,San Mateo,2020-04-21,53,14,67
1339,Sacramento,2020-04-21,54,39,93
1340,Monterey,2020-04-21,7,4,11
1341,San Benito,2020-04-22,0,0,0
1342,Trinity,2020-04-22,0,0,0
1343,Mariposa,2020-04-22,0,0,0
1344,Colusa,2020-04-22,1,0,1
1345,Alameda,2020-04-22,84,61,145
1346,Glenn,2020-04-22,0,0,0
1347,Kern,2020-04-22,32,25,57
1348,Imperial,2020-04-22,26,8,34
1349,Solano,2020-04-22,10,18,28
1350,Fresno,2020-04-22,36,43,79
1351,Sutter,2020-04-22,0,0,0
1352,San Luis Obispo,2020-04-22,1,7,8
1353,Santa Clara,2020-04-22,137,39,176
1354,Kings,2020-04-22,9,0,9
1355,Yuba,2020-04-22,0,0,0
1356,Siskiyou,2020-04-22,0,1,1
1357,Merced,2020-04-22,3,3,6
1358,Nevada,2020-04-22,1,0,1
1359,San Joaquin,2020-04-22,29,28,57
1360,Lake,2020-04-22,0,3,3
1361,Amador,2020-04-22,0,1,1
1362,Butte,2020-04-22,0,0,0
1363,Del Norte,2020-04-22,0,2,2
1364,Tulare,2020-04-22,27,0,27
1365,San Mateo,2020-04-22,50,17,67
1366,Tehama,2020-04-22,0,0,0
1367,Orange,2020-04-22,172,111,283
1368,Shasta,2020-04-22,1,0,1
1369,Sonoma,2020-04-22,3,16,19
1370,Modoc,2020-04-22,0,0,0
1371,Mendocino,2020-04-22,0,0,0
1372,El Dorado,2020-04-22,0,5,5
1373,Mono,2020-04-22,0,0,0
1374,Lassen,2020-04-22,0,1,1
1375,Los Angeles,2020-04-22,1858,590,2448
1376,San Bernardino,2020-04-22,149,201,350
1377,Sacramento,2020-04-22,47,23,70
1378,Contra Costa,2020-04-22,32,52,84
1379,Stanislaus,2020-04-22,13,20,33
1380,Riverside,2020-04-22,229,127,356
1381,Marin,2020-04-22,5,10,15
1382,Madera,2020-04-22,0,3,3
1383,Napa,2020-04-22,1,2,3
1384,Placer,2020-04-22,5,20,25
1385,San Diego,2020-04-22,241,77,318
1386,Santa Barbara,2020-04-22,25,9,34
1387,Yolo,2020-04-22,4,0,4
1388,Humboldt,2020-04-22,0,8,8
1389,Ventura,2020-04-22,27,30,57
1390,Tuolumne,2020-04-22,0,1,1
1391,Monterey,2020-04-22,6,3,9
1392,Plumas,2020-04-22,0,0,0
1393,San Francisco,2020-04-22,75,17,92
1394,Santa Cruz,2020-04-22,3,4,7
1395,Inyo,2020-04-22,1,0,1
1396,Calaveras,2020-04-22,0,0,0
1397,Fresno,2020-04-23,39,39,78
1398,Kings,2020-04-23,9,0,9
1399,Amador,2020-04-23,0,1,1
1400,Sacramento,2020-04-23,48,40,88
1401,Siskiyou,2020-04-23,0,1,1
1402,Mono,2020-04-23,0,0,0
1403,San Mateo,2020-04-23,53,19,72
1404,Shasta,2020-04-23,1,0,1
1405,Del Norte,2020-04-23,0,6,6
1406,Lassen,2020-04-23,0,0,0
1407,Monterey,2020-04-23,6,6,12
1408,San Benito,2020-04-23,0,0,0
1409,Humboldt,2020-04-23,0,7,7
1410,Nevada,2020-04-23,1,3,4
1411,Tehama,2020-04-23,0,0,0
1412,San Luis Obispo,2020-04-23,1,4,5
1413,Colusa,2020-04-23,1,0,1
1414,Lake,2020-04-23,0,1,1
1415,Yuba,2020-04-23,0,2,2
1416,Napa,2020-04-23,1,1,2
1417,El Dorado,2020-04-23,0,8,8
1418,Santa Barbara,2020-04-23,24,16,40
1419,Madera,2020-04-23,0,3,3
1420,Plumas,2020-04-23,0,0,0
1421,San Diego,2020-04-23,253,65,318
1422,Kern,2020-04-23,30,11,41
1423,Marin,2020-04-23,3,14,17
1424,Trinity,2020-04-23,0,0,0
1425,Orange,2020-04-23,170,143,313
1426,Butte,2020-04-23,0,0,0
1427,Mendocino,2020-04-23,0,1,1
1428,Sonoma,2020-04-23,3,17,20
1429,Contra Costa,2020-04-23,31,51,82
1430,Calaveras,2020-04-23,0,1,1
1431,San Joaquin,2020-04-23,31,34,65
1432,Glenn,2020-04-23,0,0,0
1433,Mariposa,2020-04-23,0,1,1
1434,Santa Clara,2020-04-23,137,28,165
1435,Tulare,2020-04-23,30,1,31
1436,Santa Cruz,2020-04-23,3,3,6
1437,San Bernardino,2020-04-23,146,94,240
1438,Tuolumne,2020-04-23,0,0,0
1439,Los Angeles,2020-04-23,1863,595,2458
1440,Imperial,2020-04-23,23,4,27
1441,Solano,2020-04-23,11,15,26
1442,Merced,2020-04-23,0,2,2
1443,Inyo,2020-04-23,1,0,1
1444,Sutter,2020-04-23,0,0,0
1445,San Francisco,2020-04-23,75,29,104
1446,Yolo,2020-04-23,4,0,4
1447,Modoc,2020-04-23,0,0,0
1448,Placer,2020-04-23,4,21,25
1449,Riverside,2020-04-23,222,118,340
1450,Alameda,2020-04-23,81,90,171
1451,Stanislaus,2020-04-23,14,17,31
1452,Ventura,2020-04-23,25,24,49
1453,San Luis Obispo,2020-04-24,1,8,9
1454,Humboldt,2020-04-24,1,4,5
1455,Orange,2020-04-24,175,138,313
1456,Del Norte,2020-04-24,0,4,4
1457,Yuba,2020-04-24,0,2,2
1458,Kern,2020-04-24,30,17,47
1459,Santa Clara,2020-04-24,129,34,163
1460,San Mateo,2020-04-24,49,16,65
1461,San Bernardino,2020-04-24,152,101,253
1462,Modoc,2020-04-24,0,0,0
1463,Merced,2020-04-24,0,5,5
1464,Tulare,2020-04-24,33,0,33
1465,Placer,2020-04-24,4,18,22
1466,Santa Cruz,2020-04-24,4,1,5
1467,Alameda,2020-04-24,79,63,142
1468,Colusa,2020-04-24,1,0,1
1469,Sutter,2020-04-24,0,0,0
1470,Siskiyou,2020-04-24,0,0,0
1471,Mendocino,2020-04-24,0,1,1
1472,Los Angeles,2020-04-24,1860,546,2406
1473,Stanislaus,2020-04-24,12,15,27
1474,Napa,2020-04-24,1,0,1
1475,Trinity,2020-04-24,0,0,0
1476,Riverside,2020-04-24,223,120,343
1477,Amador,2020-04-24,0,1,1
1478,El Dorado,2020-04-24,0,7,7
1479,Inyo,2020-04-24,1,3,4
1480,San Benito,2020-04-24,0,0,0
1481,Fresno,2020-04-24,41,37,78
1482,Santa Barbara,2020-04-24,21,11,32
1483,Yolo,2020-04-24,4,0,4
1484,Monterey,2020-04-24,5,8,13
1485,Plumas,2020-04-24,0,0,0
1486,Glenn,2020-04-24,0,0,0
1487,Nevada,2020-04-24,1,4,5
1488,Kings,2020-04-24,9,0,9
1489,Shasta,2020-04-24,1,0,1
1490,Mono,2020-04-24,0,0,0
1491,Imperial,2020-04-24,24,10,34
1492,Lake,2020-04-24,0,1,1
1493,Tuolumne,2020-04-24,0,0,0
1494,Lassen,2020-04-24,0,0,0
1495,Calaveras,2020-04-24,0,2,2
1496,San Diego,2020-04-24,257,78,335
1497,Tehama,2020-04-24,0,1,1
1498,Mariposa,2020-04-24,0,0,0
1499,Sonoma,2020-04-24,3,20,23
1500,Sacramento,2020-04-24,53,37,90
1501,Contra Costa,2020-04-24,29,54,83
1502,San Joaquin,2020-04-24,29,20,49
1503,Butte,2020-04-24,0,4,4
1504,Madera,2020-04-24,0,4,4
1505,Solano,2020-04-24,10,16,26
1506,San Francisco,2020-04-24,75,19,94
1507,Marin,2020-04-24,2,11,13
1508,Ventura,2020-04-24,24,63,87
1509,Merced,2020-04-25,0,3,3
1510,Placer,2020-04-25,4,30,34
1511,Riverside,2020-04-25,218,138,356
1512,Shasta,2020-04-25,1,0,1
1513,Mariposa,2020-04-25,0,0,0
1514,Trinity,2020-04-25,0,0,0
1515,Santa Clara,2020-04-25,125,47,172
1516,Siskiyou,2020-04-25,0,1,1
1517,Glenn,2020-04-25,0,0,0
1518,Tulare,2020-04-25,26,0,26
1519,San Mateo,2020-04-25,47,27,74
1520,Ventura,2020-04-25,27,71,98
1521,Kings,2020-04-25,6,0,6
1522,Sonoma,2020-04-25,3,9,12
1523,Santa Cruz,2020-04-25,4,4,8
1524,Mendocino,2020-04-25,0,0,0
1525,San Diego,2020-04-25,268,96,364
1526,El Dorado,2020-04-25,1,7,8
1527,Madera,2020-04-25,0,2,2
1528,San Luis Obispo,2020-04-25,1,4,5
1529,Monterey,2020-04-25,5,9,14
1530,Nevada,2020-04-25,1,3,4
1531,Orange,2020-04-25,177,133,310
1532,Santa Barbara,2020-04-25,23,12,35
1533,Sutter,2020-04-25,0,0,0
1534,San Benito,2020-04-25,0,0,0
1535,Marin,2020-04-25,2,13,15
1536,Colusa,2020-04-25,1,1,2
1537,Contra Costa,2020-04-25,25,53,78
1538,Mono,2020-04-25,0,0,0
1539,Humboldt,2020-04-25,0,3,3
1540,Kern,2020-04-25,29,18,47
1541,Solano,2020-04-25,10,16,26
1542,Fresno,2020-04-25,41,45,86
1543,Napa,2020-04-25,1,1,2
1544,Inyo,2020-04-25,0,3,3
1545,Tehama,2020-04-25,0,1,1
1546,Sacramento,2020-04-25,53,46,99
1547,Yolo,2020-04-25,5,0,5
1548,Lassen,2020-04-25,0,0,0
1549,Amador,2020-04-25,0,1,1
1550,San Francisco,2020-04-25,73,18,91
1551,San Bernardino,2020-04-25,147,101,248
1552,Tuolumne,2020-04-25,0,0,0
1553,Plumas,2020-04-25,0,0,0
1554,Del Norte,2020-04-25,0,4,4
1555,Alameda,2020-04-25,83,53,136
1556,Butte,2020-04-25,0,3,3
1557,Calaveras,2020-04-25,0,1,1
1558,San Joaquin,2020-04-25,27,20,47
1559,Stanislaus,2020-04-25,21,23,44
1560,Lake,2020-04-25,0,2,2
1561,Yuba,2020-04-25,0,2,2
1562,Imperial,2020-04-25,24,8,32
1563,Modoc,2020-04-25,0,0,0
1564,Los Angeles,2020-04-25,1845,572,2417
1565,Orange,2020-04-26,180,109,289
1566,Amador,2020-04-26,0,0,0
1567,Santa Barbara,2020-04-26,24,13,37
1568,Yuba,2020-04-26,0,2,2
1569,Lake,2020-04-26,0,1,1
1570,Contra Costa,2020-04-26,27,42,69
1571,Sonoma,2020-04-26,1,9,10
1572,Santa Cruz,2020-04-26,4,1,5
1573,Mono,2020-04-26,0,0,0
1574,Sutter,2020-04-26,0,0,0
1575,Monterey,2020-04-26,5,5,10
1576,San Francisco,2020-04-26,79,21,100
1577,Nevada,2020-04-26,1,2,3
1578,Butte,2020-04-26,0,0,0
1579,San Benito,2020-04-26,0,0,0
1580,Lassen,2020-04-26,0,0,0
1581,Fresno,2020-04-26,37,44,81
1582,San Mateo,2020-04-26,53,10,63
1583,San Luis Obispo,2020-04-26,1,3,4
1584,Merced,2020-04-26,0,4,4
1585,Humboldt,2020-04-26,0,0,0
1586,San Bernardino,2020-04-26,146,83,229
1587,Del Norte,2020-04-26,0,2,2
1588,Modoc,2020-04-26,0,0,0
1589,Yolo,2020-04-26,1,1,2
1590,Shasta,2020-04-26,1,0,1
1591,San Joaquin,2020-04-26,24,19,43
1592,Solano,2020-04-26,8,14,22
1593,Siskiyou,2020-04-26,0,0,0
1594,Glenn,2020-04-26,0,0,0
1595,Kern,2020-04-26,29,15,44
1596,Stanislaus,2020-04-26,28,19,47
1597,Tulare,2020-04-26,26,0,26
1598,Mendocino,2020-04-26,0,0,0
1599,Alameda,2020-04-26,84,43,127
1600,Mariposa,2020-04-26,0,0,0
1601,Sacramento,2020-04-26,48,40,88
1602,Marin,2020-04-26,3,7,10
1603,Plumas,2020-04-26,0,0,0
1604,San Diego,2020-04-26,273,90,363
1605,El Dorado,2020-04-26,1,8,9
1606,Calaveras,2020-04-26,0,0,0
1607,Los Angeles,2020-04-26,1887,575,2462
1608,Colusa,2020-04-26,1,1,2
1609,Placer,2020-04-26,4,21,25
1610,Napa,2020-04-26,1,0,1
1611,Inyo,2020-04-26,0,0,0
1612,Madera,2020-04-26,0,1,1
1613,Tehama,2020-04-26,0,0,0
1614,Trinity,2020-04-26,0,0,0
1615,Ventura,2020-04-26,27,73,100
1616,Tuolumne,2020-04-26,0,0,0
1617,Kings,2020-04-26,9,0,9
1618,Santa Clara,2020-04-26,118,64,182
1619,Imperial,2020-04-26,26,12,38
1620,Riverside,2020-04-26,215,152,367
1621,Mono,2020-04-27,0,0,0
1622,Kings,2020-04-27,9,2,11
1623,Yuba,2020-04-27,0,3,3
1624,Imperial,2020-04-27,27,7,34
1625,San Joaquin,2020-04-27,24,23,47
1626,Lake,2020-04-27,0,1,1
1627,Inyo,2020-04-27,0,0,0
1628,Riverside,2020-04-27,220,118,338
1629,San Luis Obispo,2020-04-27,3,6,9
1630,Calaveras,2020-04-27,0,1,1
1631,San Diego,2020-04-27,277,59,336
1632,El Dorado,2020-04-27,1,7,8
1633,Fresno,2020-04-27,39,52,91
1634,Solano,2020-04-27,8,16,24
1635,San Mateo,2020-04-27,52,28,80
1636,Glenn,2020-04-27,0,0,0
1637,Nevada,2020-04-27,1,1,2
1638,Lassen,2020-04-27,0,0,0
1639,Modoc,2020-04-27,0,0,0
1640,Stanislaus,2020-04-27,30,36,66
1641,Ventura,2020-04-27,28,75,103
1642,Napa,2020-04-27,1,0,1
1643,Marin,2020-04-27,2,6,8
1644,San Bernardino,2020-04-27,154,83,237
1645,Colusa,2020-04-27,1,1,2
1646,Kern,2020-04-27,31,19,50
1647,Orange,2020-04-27,189,113,302
1648,Plumas,2020-04-27,0,0,0
1649,Amador,2020-04-27,0,0,0
1650,Santa Barbara,2020-04-27,26,13,39
1651,Alameda,2020-04-27,81,47,128
1652,San Francisco,2020-04-27,82,19,101
1653,Del Norte,2020-04-27,0,5,5
1654,Humboldt,2020-04-27,0,3,3
1655,Mendocino,2020-04-27,0,1,1
1656,Sonoma,2020-04-27,2,11,13
1657,Santa Cruz,2020-04-27,2,1,3
1658,Mariposa,2020-04-27,0,1,1
1659,Santa Clara,2020-04-27,115,49,164
1660,Butte,2020-04-27,0,0,0
1661,Sutter,2020-04-27,0,0,0
1662,Madera,2020-04-27,0,0,0
1663,Yolo,2020-04-27,0,1,1
1664,San Benito,2020-04-27,0,0,0
1665,Monterey,2020-04-27,4,2,6
1666,Tehama,2020-04-27,0,0,0
1667,Sacramento,2020-04-27,46,42,88
1668,Los Angeles,2020-04-27,1940,609,2549
1669,Merced,2020-04-27,1,3,4
1670,Contra Costa,2020-04-27,24,44,68
1671,Siskiyou,2020-04-27,0,1,1
1672,Tulare,2020-04-27,29,0,29
1673,Tuolumne,2020-04-27,0,1,1
1674,Placer,2020-04-27,5,17,22
1675,Trinity,2020-04-27,0,0,0
1676,Shasta,2020-04-27,1,1,2
1677,Fresno,2020-04-28,39,44,83
1678,Stanislaus,2020-04-28,31,30,61
1679,Sutter,2020-04-28,0,0,0
1680,Humboldt,2020-04-28,0,6,6
1681,Sonoma,2020-04-28,3,11,14
1682,Lassen,2020-04-28,0,0,0
1683,Solano,2020-04-28,12,16,28
1684,Mariposa,2020-04-28,0,1,1
1685,Siskiyou,2020-04-28,0,2,2
1686,Placer,2020-04-28,5,21,26
1687,Santa Clara,2020-04-28,116,34,150
1688,Trinity,2020-04-28,0,0,0
1689,Tuolumne,2020-04-28,0,0,0
1690,Santa Barbara,2020-04-28,27,16,43
1691,Yolo,2020-04-28,0,0,0
1692,Del Norte,2020-04-28,0,5,5
1693,Marin,2020-04-28,1,7,8
1694,Shasta,2020-04-28,2,1,3
1695,Riverside,2020-04-28,215,112,327
1696,Imperial,2020-04-28,29,4,33
1697,Santa Cruz,2020-04-28,2,0,2
1698,San Joaquin,2020-04-28,24,16,40
1699,Ventura,2020-04-28,31,71,102
1700,San Benito,2020-04-28,0,0,0
1701,Napa,2020-04-28,1,0,1
1702,Orange,2020-04-28,203,84,287
1703,Mendocino,2020-04-28,0,0,0
1704,San Bernardino,2020-04-28,156,123,279
1705,Colusa,2020-04-28,1,0,1
1706,Alameda,2020-04-28,76,64,140
1707,Los Angeles,2020-04-28,1962,581,2543
1708,Monterey,2020-04-28,2,7,9
1709,Glenn,2020-04-28,0,0,0
1710,San Francisco,2020-04-28,81,23,104
1711,Sacramento,2020-04-28,43,33,76
1712,Mono,2020-04-28,0,0,0
1713,Tulare,2020-04-28,32,2,34
1714,San Luis Obispo,2020-04-28,3,3,6
1715,El Dorado,2020-04-28,1,7,8
1716,Calaveras,2020-04-28,0,1,1
1717,Nevada,2020-04-28,1,2,3
1718,Contra Costa,2020-04-28,27,43,70
1719,Plumas,2020-04-28,0,0,0
1720,Butte,2020-04-28,0,1,1
1721,Lake,2020-04-28,0,2,2
1722,San Diego,2020-04-28,276,105,381
1723,Yuba,2020-04-28,0,2,2
1724,Tehama,2020-04-28,0,0,0
1725,Madera,2020-04-28,0,1,1
1726,Merced,2020-04-28,2,6,8
1727,Kern,2020-04-28,32,13,45
1728,Amador,2020-04-28,0,0,0
1729,Kings,2020-04-28,9,2,11
1730,Inyo,2020-04-28,0,0,0
1731,Modoc,2020-04-28,0,1,1
1732,San Mateo,2020-04-28,50,13,63
1733,San Benito,2020-04-29,0,0,0
1734,Tehama,2020-04-29,0,0,0
1735,Tulare,2020-04-29,30,0,30
1736,Lassen,2020-04-29,0,0,0
1737,Merced,2020-04-29,2,7,9
1738,San Luis Obispo,2020-04-29,3,2,5
1739,Del Norte,2020-04-29,0,3,3
1740,San Bernardino,2020-04-29,156,124,280
1741,Solano,2020-04-29,10,18,28
1742,El Dorado,2020-04-29,0,4,4
1743,Madera,2020-04-29,0,1,1
1744,Marin,2020-04-29,0,6,6
1745,Humboldt,2020-04-29,1,5,6
1746,Stanislaus,2020-04-29,35,26,61
1747,Sacramento,2020-04-29,42,36,78
1748,Trinity,2020-04-29,0,0,0
1749,Inyo,2020-04-29,0,0,0
1750,Kings,2020-04-29,9,2,11
1751,Imperial,2020-04-29,29,5,34
1752,Ventura,2020-04-29,31,26,57
1753,Mono,2020-04-29,0,0,0
1754,Los Angeles,2020-04-29,1959,591,2550
1755,Riverside,2020-04-29,212,124,336
1756,Orange,2020-04-29,211,91,302
1757,San Joaquin,2020-04-29,21,20,41
1758,Yolo,2020-04-29,0,0,0
1759,Lake,2020-04-29,0,2,2
1760,Modoc,2020-04-29,0,0,0
1761,Santa Barbara,2020-04-29,28,14,42
1762,Nevada,2020-04-29,1,2,3
1763,Yuba,2020-04-29,0,0,0
1764,Monterey,2020-04-29,4,3,7
1765,Alameda,2020-04-29,76,63,139
1766,Mariposa,2020-04-29,0,1,1
1767,Shasta,2020-04-29,2,0,2
1768,Calaveras,2020-04-29,0,0,0
1769,Tuolumne,2020-04-29,0,0,0
1770,Sonoma,2020-04-29,5,14,19
1771,Placer,2020-04-29,5,28,33
1772,Amador,2020-04-29,0,0,0
1773,Santa Clara,2020-04-29,110,34,144
1774,Fresno,2020-04-29,38,48,86
1775,Mendocino,2020-04-29,0,0,0
1776,Plumas,2020-04-29,0,0,0
1777,Sutter,2020-04-29,0,0,0
1778,Glenn,2020-04-29,0,0,0
1779,Contra Costa,2020-04-29,24,50,74
1780,Napa,2020-04-29,1,0,1
1781,Santa Cruz,2020-04-29,2,0,2
1782,San Francisco,2020-04-29,80,24,104
1783,San Diego,2020-04-29,282,73,355
1784,Kern,2020-04-29,36,13,49
1785,San Mateo,2020-04-29,51,19,70
1786,Butte,2020-04-29,0,2,2
1787,Siskiyou,2020-04-29,0,3,3
1788,Colusa,2020-04-29,1,0,1
1789,Monterey,2020-04-30,6,6,12
1790,Plumas,2020-04-30,0,0,0
1791,Contra Costa,2020-04-30,24,43,67
1792,Del Norte,2020-04-30,0,4,4
1793,Lake,2020-04-30,0,2,2
1794,Los Angeles,2020-04-30,1894,470,2364
1795,Alameda,2020-04-30,74,52,126
1796,Napa,2020-04-30,1,0,1
1797,Calaveras,2020-04-30,0,0,0
1798,Yolo,2020-04-30,0,0,0
1799,Tuolumne,2020-04-30,0,0,0
1800,Lassen,2020-04-30,0,0,0
1801,Glenn,2020-04-30,0,0,0
1802,Shasta,2020-04-30,2,0,2
1803,Yuba,2020-04-30,0,0,0
1804,Nevada,2020-04-30,0,1,1
1805,Imperial,2020-04-30,29,3,32
1806,El Dorado,2020-04-30,0,6,6
1807,Sutter,2020-04-30,0,0,0
1808,Placer,2020-04-30,4,28,32
1809,Amador,2020-04-30,0,0,0
1810,Merced,2020-04-30,3,2,5
1811,Siskiyou,2020-04-30,0,2,2
1812,Colusa,2020-04-30,1,0,1
1813,San Luis Obispo,2020-04-30,3,3,6
1814,Modoc,2020-04-30,0,0,0
1815,Butte,2020-04-30,0,0,0
1816,San Francisco,2020-04-30,85,11,96
1817,Santa Clara,2020-04-30,104,37,141
1818,Humboldt,2020-04-30,0,7,7
1819,Tulare,2020-04-30,28,2,30
1820,Sonoma,2020-04-30,5,7,12
1821,Santa Cruz,2020-04-30,3,0,3
1822,Tehama,2020-04-30,0,0,0
1823,San Joaquin,2020-04-30,17,24,41
1824,San Benito,2020-04-30,1,0,1
1825,Stanislaus,2020-04-30,35,27,62
1826,Orange,2020-04-30,214,68,282
1827,San Bernardino,2020-04-30,158,100,258
1828,Inyo,2020-04-30,0,0,0
1829,Mendocino,2020-04-30,0,0,0
1830,Kings,2020-04-30,10,0,10
1831,Sacramento,2020-04-30,37,35,72
1832,Fresno,2020-04-30,41,37,78
1833,Ventura,2020-04-30,33,18,51
1834,Riverside,2020-04-30,214,138,352
1835,Trinity,2020-04-30,0,0,0
1836,Santa Barbara,2020-04-30,26,9,35
1837,Madera,2020-04-30,0,3,3
1838,Solano,2020-04-30,11,12,23
1839,Mono,2020-04-30,0,0,0
1840,Kern,2020-04-30,29,25,54
1841,Marin,2020-04-30,0,3,3
1842,San Diego,2020-04-30,283,81,364
1843,Mariposa,2020-04-30,0,2,2
1844,San Mateo,2020-04-30,53,10,63
1845,Humboldt,2020-05-01,0,5,5
1846,Los Angeles,2020-05-01,1884,511,2395
1847,Sonoma,2020-05-01,4,15,19
1848,Modoc,2020-05-01,0,0,0
1849,Calaveras,2020-05-01,0,1,1
1850,Yuba,2020-05-01,0,0,0
1851,Tuolumne,2020-05-01,0,0,0
1852,Lassen,2020-05-01,0,0,0
1853,Stanislaus,2020-05-01,35,19,54
1854,Tehama,2020-05-01,0,0,0
1855,Butte,2020-05-01,0,1,1
1856,Trinity,2020-05-01,0,0,0
1857,Contra Costa,2020-05-01,21,37,58
1858,Placer,2020-05-01,5,15,20
1859,Shasta,2020-05-01,1,0,1
1860,Colusa,2020-05-01,1,0,1
1861,Imperial,2020-05-01,36,3,39
1862,San Diego,2020-05-01,290,60,350
1863,Mendocino,2020-05-01,0,0,0
1864,Mariposa,2020-05-01,0,2,2
1865,San Benito,2020-05-01,1,0,1
1866,Yolo,2020-05-01,0,0,0
1867,Amador,2020-05-01,0,0,0
1868,Marin,2020-05-01,0,5,5
1869,Alameda,2020-05-01,75,60,135
1870,Sacramento,2020-05-01,35,29,64
1871,Nevada,2020-05-01,0,1,1
1872,Tulare,2020-05-01,28,2,30
1873,Lake,2020-05-01,0,2,2
1874,Del Norte,2020-05-01,0,0,0
1875,Kern,2020-05-01,35,13,48
1876,Siskiyou,2020-05-01,0,2,2
1877,Riverside,2020-05-01,210,152,362
1878,San Bernardino,2020-05-01,157,106,263
1879,Glenn,2020-05-01,0,0,0
1880,San Luis Obispo,2020-05-01,3,4,7
1881,Kings,2020-05-01,11,0,11
1882,Plumas,2020-05-01,0,0,0
1883,Merced,2020-05-01,4,1,5
1884,Orange,2020-05-01,218,101,319
1885,Santa Cruz,2020-05-01,3,1,4
1886,Santa Clara,2020-05-01,97,43,140
1887,San Mateo,2020-05-01,48,12,60
1888,Napa,2020-05-01,0,2,2
1889,Santa Barbara,2020-05-01,28,10,38
1890,Ventura,2020-05-01,29,12,41
1891,Mono,2020-05-01,0,0,0
1892,Madera,2020-05-01,0,0,0
1893,Sutter,2020-05-01,0,0,0
1894,Inyo,2020-05-01,0,0,0
1895,Solano,2020-05-01,10,11,21
1896,San Joaquin,2020-05-01,17,16,33
1897,Monterey,2020-05-01,7,1,8
1898,San Francisco,2020-05-01,86,14,100
1899,Fresno,2020-05-01,44,28,72
1900,El Dorado,2020-05-01,0,2,2
1901,San Francisco,2020-05-02,81,27,108
1902,Mendocino,2020-05-02,0,0,0
1903,Santa Cruz,2020-05-02,3,0,3
1904,El Dorado,2020-05-02,0,2,2
1905,Kern,2020-05-02,36,7,43
1906,San Mateo,2020-05-02,48,13,61
1907,Colusa,2020-05-02,1,0,1
1908,Fresno,2020-05-02,45,36,81
1909,Napa,2020-05-02,0,1,1
1910,Glenn,2020-05-02,0,0,0
1911,Mono,2020-05-02,0,0,0
1912,Solano,2020-05-02,14,15,29
1913,Humboldt,2020-05-02,0,5,5
1914,Placer,2020-05-02,5,23,28
1915,Sacramento,2020-05-02,23,35,58
1916,San Diego,2020-05-02,289,68,357
1917,Shasta,2020-05-02,0,0,0
1918,Amador,2020-05-02,0,0,0
1919,Tulare,2020-05-02,28,2,30
1920,Yuba,2020-05-02,0,0,0
1921,Lassen,2020-05-02,0,0,0
1922,Trinity,2020-05-02,0,0,0
1923,Sonoma,2020-05-02,3,14,17
1924,San Benito,2020-05-02,1,0,1
1925,Monterey,2020-05-02,8,3,11
1926,Siskiyou,2020-05-02,0,0,0
1927,San Luis Obispo,2020-05-02,3,10,13
1928,Modoc,2020-05-02,0,0,0
1929,Alameda,2020-05-02,73,59,132
1930,Tuolumne,2020-05-02,0,0,0
1931,Calaveras,2020-05-02,0,1,1
1932,Merced,2020-05-02,4,4,8
1933,Los Angeles,2020-05-02,1819,561,2380
1934,Santa Barbara,2020-05-02,25,11,36
1935,Mariposa,2020-05-02,0,0,0
1936,Butte,2020-05-02,0,0,0
1937,Ventura,2020-05-02,26,26,52
1938,Stanislaus,2020-05-02,36,30,66
1939,Marin,2020-05-02,0,11,11
1940,San Bernardino,2020-05-02,144,116,260
1941,Riverside,2020-05-02,211,126,337
1942,Contra Costa,2020-05-02,20,45,65
1943,Plumas,2020-05-02,0,0,0
1944,Inyo,2020-05-02,0,0,0
1945,Del Norte,2020-05-02,0,0,0
1946,Madera,2020-05-02,0,0,0
1947,Sutter,2020-05-02,0,0,0
1948,Yolo,2020-05-02,0,0,0
1949,Orange,2020-05-02,215,107,322
1950,San Joaquin,2020-05-02,17,16,33
1951,Santa Clara,2020-05-02,95,36,131
1952,Imperial,2020-05-02,36,3,39
1953,Nevada,2020-05-02,0,2,2
1954,Kings,2020-05-02,9,1,10
1955,Lake,2020-05-02,0,0,0
1956,Tehama,2020-05-02,0,0,0
1957,Napa,2020-05-03,0,0,0
1958,Kings,2020-05-03,9,1,10
1959,Alameda,2020-05-03,73,62,135
1960,Shasta,2020-05-03,0,0,0
1961,Siskiyou,2020-05-03,0,0,0
1962,Placer,2020-05-03,7,12,19
1963,Merced,2020-05-03,6,3,9
1964,San Bernardino,2020-05-03,154,100,254
1965,San Luis Obispo,2020-05-03,4,5,9
1966,Santa Barbara,2020-05-03,28,6,34
1967,Nevada,2020-05-03,0,1,1
1968,Inyo,2020-05-03,0,1,1
1969,Mono,2020-05-03,0,0,0
1970,San Diego,2020-05-03,276,76,352
1971,Santa Cruz,2020-05-03,3,0,3
1972,Marin,2020-05-03,0,6,6
1973,Madera,2020-05-03,0,0,0
1974,Tehama,2020-05-03,0,0,0
1975,San Joaquin,2020-05-03,17,18,35
1976,Mariposa,2020-05-03,0,0,0
1977,San Mateo,2020-05-03,47,14,61
1978,Plumas,2020-05-03,0,2,2
1979,Stanislaus,2020-05-03,33,15,48
1980,Trinity,2020-05-03,0,0,0
1981,El Dorado,2020-05-03,0,2,2
1982,Humboldt,2020-05-03,1,2,3
1983,Sacramento,2020-05-03,26,31,57
1984,Mendocino,2020-05-03,0,0,0
1985,Riverside,2020-05-03,217,132,349
1986,Orange,2020-05-03,218,90,308
1987,Contra Costa,2020-05-03,20,44,64
1988,Sonoma,2020-05-03,2,14,16
1989,Santa Clara,2020-05-03,93,39,132
1990,Los Angeles,2020-05-03,1779,520,2299
1991,Yuba,2020-05-03,0,1,1
1992,Del Norte,2020-05-03,0,0,0
1993,Fresno,2020-05-03,45,43,88
1994,Monterey,2020-05-03,7,1,8
1995,San Francisco,2020-05-03,83,18,101
1996,Glenn,2020-05-03,0,0,0
1997,Calaveras,2020-05-03,0,1,1
1998,Kern,2020-05-03,30,12,42
1999,Imperial,2020-05-03,39,5,44
2000,Lassen,2020-05-03,0,0,0
2001,San Benito,2020-05-03,0,0,0
2002,Butte,2020-05-03,0,2,2
2003,Amador,2020-05-03,0,0,0
2004,Ventura,2020-05-03,29,34,63
2005,Solano,2020-05-03,14,11,25
2006,Colusa,2020-05-03,1,0,1
2007,Lake,2020-05-03,0,3,3
2008,Yolo,2020-05-03,0,0,0
2009,Tuolumne,2020-05-03,0,0,0
2010,Tulare,2020-05-03,23,5,28
2011,Modoc,2020-05-03,0,0,0
2012,Sutter,2020-05-03,0,0,0
2013,San Bernardino,2020-05-04,156,103,259
2014,Yolo,2020-05-04,0,0,0
2015,Colusa,2020-05-04,0,0,0
2016,Mariposa,2020-05-04,0,0,0
2017,Tehama,2020-05-04,0,0,0
2018,Sonoma,2020-05-04,3,13,16
2019,Calaveras,2020-05-04,0,1,1
2020,Humboldt,2020-05-04,1,2,3
2021,Napa,2020-05-04,0,0,0
2022,Riverside,2020-05-04,216,107,323
2023,Shasta,2020-05-04,0,0,0
2024,Kings,2020-05-04,9,1,10
2025,Amador,2020-05-04,0,0,0
2026,Madera,2020-05-04,1,0,1
2027,Trinity,2020-05-04,0,0,0
2028,Lassen,2020-05-04,0,0,0
2029,Butte,2020-05-04,0,1,1
2030,Marin,2020-05-04,1,7,8
2031,San Francisco,2020-05-04,84,10,94
2032,Sutter,2020-05-04,0,0,0
2033,Solano,2020-05-04,15,22,37
2034,San Diego,2020-05-04,300,54,354
2035,Stanislaus,2020-05-04,34,11,45
2036,Merced,2020-05-04,6,6,12
2037,Ventura,2020-05-04,26,17,43
2038,San Mateo,2020-05-04,45,14,59
2039,Plumas,2020-05-04,0,2,2
2040,Imperial,2020-05-04,47,9,56
2041,Lake,2020-05-04,0,4,4
2042,Glenn,2020-05-04,0,0,0
2043,San Luis Obispo,2020-05-04,3,8,11
2044,Modoc,2020-05-04,0,0,0
2045,Santa Clara,2020-05-04,90,33,123
2046,Tulare,2020-05-04,21,1,22
2047,Monterey,2020-05-04,5,0,5
2048,Yuba,2020-05-04,0,1,1
2049,Sacramento,2020-05-04,27,23,50
2050,Inyo,2020-05-04,0,1,1
2051,Placer,2020-05-04,11,6,17
2052,Fresno,2020-05-04,47,39,86
2053,Los Angeles,2020-05-04,1828,543,2371
2054,Santa Cruz,2020-05-04,3,0,3
2055,Kern,2020-05-04,36,12,48
2056,Contra Costa,2020-05-04,19,32,51
2057,San Benito,2020-05-04,0,0,0
2058,Del Norte,2020-05-04,0,0,0
2059,Mono,2020-05-04,0,0,0
2060,Alameda,2020-05-04,73,62,135
2061,Mendocino,2020-05-04,0,0,0
2062,El Dorado,2020-05-04,0,3,3
2063,Santa Barbara,2020-05-04,29,10,39
2064,Nevada,2020-05-04,0,1,1
2065,Siskiyou,2020-05-04,0,0,0
2066,San Joaquin,2020-05-04,19,14,33
2067,Tuolumne,2020-05-04,0,0,0
2068,Orange,2020-05-04,214,80,294
2069,Tuolumne,2020-05-05,0,0,0
2070,Yolo,2020-05-05,0,0,0
2071,Monterey,2020-05-05,4,1,5
2072,Marin,2020-05-05,1,13,14
2073,Tulare,2020-05-05,23,1,24
2074,Lake,2020-05-05,0,2,2
2075,San Luis Obispo,2020-05-05,3,2,5
2076,Napa,2020-05-05,0,2,2
2077,Siskiyou,2020-05-05,0,0,0
2078,Stanislaus,2020-05-05,29,11,40
2079,Riverside,2020-05-05,208,125,333
2080,Santa Clara,2020-05-05,79,34,113
2081,Madera,2020-05-05,0,0,0
2082,Inyo,2020-05-05,0,0,0
2083,Yuba,2020-05-05,0,1,1
2084,Trinity,2020-05-05,0,0,0
2085,Santa Barbara,2020-05-05,31,4,35
2086,Solano,2020-05-05,13,16,29
2087,Amador,2020-05-05,0,0,0
2088,El Dorado,2020-05-05,0,4,4
2089,Sacramento,2020-05-05,25,25,50
2090,Calaveras,2020-05-05,0,0,0
2091,Plumas,2020-05-05,0,2,2
2092,San Francisco,2020-05-05,79,24,103
2093,Mendocino,2020-05-05,0,0,0
2094,San Joaquin,2020-05-05,18,29,47
2095,Butte,2020-05-05,0,0,0
2096,Contra Costa,2020-05-05,21,48,69
2097,Lassen,2020-05-05,0,0,0
2098,Tehama,2020-05-05,0,0,0
2099,Modoc,2020-05-05,0,0,0
2100,San Mateo,2020-05-05,44,14,58
2101,Placer,2020-05-05,11,13,24
2102,Imperial,2020-05-05,57,1,58
2103,Santa Cruz,2020-05-05,2,1,3
2104,San Diego,2020-05-05,294,69,363
2105,Alameda,2020-05-05,76,71,147
2106,San Benito,2020-05-05,0,0,0
2107,Humboldt,2020-05-05,0,13,13
2108,Mariposa,2020-05-05,0,1,1
2109,Del Norte,2020-05-05,0,0,0
2110,Sutter,2020-05-05,0,0,0
2111,Los Angeles,2020-05-05,1826,544,2370
2112,Nevada,2020-05-05,0,0,0
2113,Orange,2020-05-05,210,69,279
2114,Kern,2020-05-05,32,10,42
2115,Glenn,2020-05-05,0,0,0
2116,Merced,2020-05-05,5,5,10
2117,Shasta,2020-05-05,0,0,0
2118,Fresno,2020-05-05,49,50,99
2119,Kings,2020-05-05,12,0,12
2120,Sonoma,2020-05-05,3,13,16
2121,Ventura,2020-05-05,24,24,48
2122,Colusa,2020-05-05,0,0,0
2123,San Bernardino,2020-05-05,155,105,260
2124,Mono,2020-05-05,0,0,0
2125,Yolo,2020-05-06,0,1,1
2126,San Benito,2020-05-06,0,0,0
2127,Shasta,2020-05-06,0,0,0
2128,Monterey,2020-05-06,4,2,6
2129,Siskiyou,2020-05-06,0,0,0
2130,Napa,2020-05-06,1,1,2
2131,San Luis Obispo,2020-05-06,2,2,4
2132,Trinity,2020-05-06,0,0,0
2133,Modoc,2020-05-06,0,0,0
2134,San Diego,2020-05-06,308,71,379
2135,Tuolumne,2020-05-06,0,0,0
2136,Amador,2020-05-06,0,0,0
2137,Kern,2020-05-06,34,7,41
2138,Orange,2020-05-06,216,63,279
2139,El Dorado,2020-05-06,0,4,4
2140,Santa Clara,2020-05-06,73,38,111
2141,Glenn,2020-05-06,0,0,0
2142,San Mateo,2020-05-06,43,18,61
2143,San Francisco,2020-05-06,76,12,88
2144,Mendocino,2020-05-06,0,0,0
2145,Madera,2020-05-06,0,0,0
2146,Lake,2020-05-06,0,3,3
2147,Lassen,2020-05-06,0,1,1
2148,Tehama,2020-05-06,0,0,0
2149,Sonoma,2020-05-06,4,13,17
2150,Colusa,2020-05-06,0,0,0
2151,Nevada,2020-05-06,0,0,0
2152,Contra Costa,2020-05-06,16,51,67
2153,Plumas,2020-05-06,0,2,2
2154,Placer,2020-05-06,9,21,30
2155,San Bernardino,2020-05-06,167,69,236
2156,Butte,2020-05-06,0,0,0
2157,Marin,2020-05-06,3,14,17
2158,Yuba,2020-05-06,0,0,0
2159,Sacramento,2020-05-06,27,40,67
2160,Imperial,2020-05-06,62,1,63
2161,Mono,2020-05-06,1,0,1
2162,Los Angeles,2020-05-06,1790,502,2292
2163,Stanislaus,2020-05-06,27,11,38
2164,Calaveras,2020-05-06,0,0,0
2165,Inyo,2020-05-06,0,0,0
2166,Santa Barbara,2020-05-06,30,6,36
2167,Merced,2020-05-06,6,3,9
2168,Del Norte,2020-05-06,0,0,0
2169,Sutter,2020-05-06,0,0,0
2170,Solano,2020-05-06,12,18,30
2171,Alameda,2020-05-06,78,58,136
2172,Kings,2020-05-06,13,0,13
2173,Mariposa,2020-05-06,0,1,1
2174,Ventura,2020-05-06,28,23,51
2175,Tulare,2020-05-06,25,3,28
2176,San Joaquin,2020-05-06,17,29,46
2177,Santa Cruz,2020-05-06,2,1,3
2178,Humboldt,2020-05-06,1,6,7
2179,Riverside,2020-05-06,197,99,296
2180,Fresno,2020-05-06,47,47,94
2181,Sacramento,2020-05-07,19,32,51
2182,Tehama,2020-05-07,0,0,0
2183,Marin,2020-05-07,3,10,13
2184,Amador,2020-05-07,0,0,0
2185,Tulare,2020-05-07,11,0,11
2186,Del Norte,2020-05-07,0,1,1
2187,Madera,2020-05-07,1,0,1
2188,Mariposa,2020-05-07,0,1,1
2189,San Luis Obispo,2020-05-07,2,4,6
2190,Inyo,2020-05-07,0,0,0
2191,Imperial,2020-05-07,58,1,59
2192,El Dorado,2020-05-07,0,2,2
2193,Trinity,2020-05-07,0,0,0
2194,Los Angeles,2020-05-07,1771,552,2323
2195,Colusa,2020-05-07,1,0,1
2196,San Joaquin,2020-05-07,13,25,38
2197,Orange,2020-05-07,222,77,299
2198,Butte,2020-05-07,1,1,2
2199,Santa Cruz,2020-05-07,3,1,4
2200,Alameda,2020-05-07,75,61,136
2201,Napa,2020-05-07,1,1,2
2202,Contra Costa,2020-05-07,20,45,65
2203,Placer,2020-05-07,8,23,31
2204,Merced,2020-05-07,5,3,8
2205,Glenn,2020-05-07,0,0,0
2206,Ventura,2020-05-07,33,25,58
2207,Lake,2020-05-07,0,0,0
2208,Yuba,2020-05-07,0,0,0
2209,Mono,2020-05-07,0,0,0
2210,San Francisco,2020-05-07,72,21,93
2211,Solano,2020-05-07,10,15,25
2212,Stanislaus,2020-05-07,25,14,39
2213,Kern,2020-05-07,33,3,36
2214,San Diego,2020-05-07,312,75,387
2215,Fresno,2020-05-07,49,39,88
2216,Mendocino,2020-05-07,0,0,0
2217,Santa Barbara,2020-05-07,27,12,39
2218,Nevada,2020-05-07,0,0,0
2219,Calaveras,2020-05-07,0,0,0
2220,San Mateo,2020-05-07,37,14,51
2221,Tuolumne,2020-05-07,0,0,0
2222,Monterey,2020-05-07,4,1,5
2223,Riverside,2020-05-07,194,76,270
2224,San Benito,2020-05-07,0,0,0
2225,San Bernardino,2020-05-07,153,73,226
2226,Humboldt,2020-05-07,1,5,6
2227,Lassen,2020-05-07,0,0,0
2228,Sutter,2020-05-07,0,0,0
2229,Kings,2020-05-07,14,0,14
2230,Yolo,2020-05-07,0,0,0
2231,Modoc,2020-05-07,0,0,0
2232,Siskiyou,2020-05-07,0,3,3
2233,Shasta,2020-05-07,0,0,0
2234,Santa Clara,2020-05-07,70,37,107
2235,Plumas,2020-05-07,0,0,0
2236,Sonoma,2020-05-07,2,11,13
2237,Marin,2020-05-08,3,4,7
2238,Solano,2020-05-08,10,23,33
2239,Alameda,2020-05-08,80,56,136
2240,Sacramento,2020-05-08,17,34,51
2241,San Mateo,2020-05-08,33,23,56
2242,San Joaquin,2020-05-08,15,32,47
2243,Shasta,2020-05-08,0,0,0
2244,Riverside,2020-05-08,189,88,277
2245,Kings,2020-05-08,14,1,15
2246,San Benito,2020-05-08,0,0,0
2247,Inyo,2020-05-08,1,0,1
2248,Madera,2020-05-08,1,0,1
2249,San Francisco,2020-05-08,71,32,103
2250,Glenn,2020-05-08,0,0,0
2251,Ventura,2020-05-08,33,21,54
2252,Santa Barbara,2020-05-08,32,4,36
2253,Imperial,2020-05-08,66,4,70
2254,Trinity,2020-05-08,0,0,0
2255,Plumas,2020-05-08,0,0,0
2256,Yuba,2020-05-08,0,0,0
2257,Mono,2020-05-08,0,0,0
2258,Contra Costa,2020-05-08,21,61,82
2259,San Diego,2020-05-08,334,73,407
2260,Santa Cruz,2020-05-08,4,0,4
2261,Amador,2020-05-08,0,0,0
2262,Tehama,2020-05-08,0,0,0
2263,Kern,2020-05-08,32,7,39
2264,Napa,2020-05-08,1,0,1
2265,Stanislaus,2020-05-08,21,15,36
2266,Los Angeles,2020-05-08,1766,510,2276
2267,Mendocino,2020-05-08,0,0,0
2268,El Dorado,2020-05-08,0,4,4
2269,Mariposa,2020-05-08,0,1,1
2270,San Luis Obispo,2020-05-08,1,3,4
2271,Butte,2020-05-08,1,1,2
2272,Tulare,2020-05-08,26,0,26
2273,Modoc,2020-05-08,0,0,0
2274,Siskiyou,2020-05-08,0,3,3
2275,Sutter,2020-05-08,0,0,0
2276,Lake,2020-05-08,0,1,1
2277,Del Norte,2020-05-08,0,1,1
2278,Calaveras,2020-05-08,0,0,0
2279,Nevada,2020-05-08,0,0,0
2280,Lassen,2020-05-08,0,1,1
2281,Humboldt,2020-05-08,1,5,6
2282,Monterey,2020-05-08,7,2,9
2283,Tuolumne,2020-05-08,0,0,0
2284,Yolo,2020-05-08,0,0,0
2285,Merced,2020-05-08,7,1,8
2286,Colusa,2020-05-08,1,1,2
2287,San Bernardino,2020-05-08,142,78,220
2288,Sonoma,2020-05-08,2,15,17
2289,Santa Clara,2020-05-08,69,26,95
2290,Fresno,2020-05-08,50,31,81
2291,Orange,2020-05-08,222,77,299
2292,Placer,2020-05-08,9,17,26
2293,San Luis Obispo,2020-05-09,3,3,6
2294,Calaveras,2020-05-09,0,2,2
2295,Santa Cruz,2020-05-09,3,0,3
2296,Imperial,2020-05-09,66,4,70
2297,Stanislaus,2020-05-09,18,11,29
2298,Del Norte,2020-05-09,0,0,0
2299,Marin,2020-05-09,4,9,13
2300,Madera,2020-05-09,1,0,1
2301,Riverside,2020-05-09,190,120,310
2302,Glenn,2020-05-09,0,0,0
2303,San Mateo,2020-05-09,32,26,58
2304,Tuolumne,2020-05-09,0,0,0
2305,Nevada,2020-05-09,0,0,0
2306,Plumas,2020-05-09,0,1,1
2307,El Dorado,2020-05-09,0,4,4
2308,San Francisco,2020-05-09,68,29,97
2309,Mendocino,2020-05-09,0,0,0
2310,Kern,2020-05-09,36,15,51
2311,Monterey,2020-05-09,9,1,10
2312,San Benito,2020-05-09,0,0,0
2313,Lassen,2020-05-09,0,1,1
2314,Los Angeles,2020-05-09,1690,531,2221
2315,Sutter,2020-05-09,0,0,0
2316,Placer,2020-05-09,8,29,37
2317,Alameda,2020-05-09,81,58,139
2318,Ventura,2020-05-09,33,24,57
2319,Yolo,2020-05-09,0,0,0
2320,Yuba,2020-05-09,0,0,0
2321,Humboldt,2020-05-09,1,5,6
2322,Shasta,2020-05-09,0,0,0
2323,Butte,2020-05-09,1,2,3
2324,Solano,2020-05-09,11,24,35
2325,Mariposa,2020-05-09,0,1,1
2326,Santa Clara,2020-05-09,66,36,102
2327,Trinity,2020-05-09,0,0,0
2328,Tulare,2020-05-09,28,2,30
2329,Fresno,2020-05-09,55,43,98
2330,San Bernardino,2020-05-09,145,86,231
2331,Contra Costa,2020-05-09,20,48,68
2332,Colusa,2020-05-09,0,0,0
2333,Inyo,2020-05-09,0,0,0
2334,Siskiyou,2020-05-09,0,0,0
2335,Sacramento,2020-05-09,18,35,53
2336,San Joaquin,2020-05-09,16,28,44
2337,Amador,2020-05-09,0,0,0
2338,Santa Barbara,2020-05-09,28,4,32
2339,Tehama,2020-05-09,0,0,0
2340,Modoc,2020-05-09,0,0,0
2341,Kings,2020-05-09,12,6,18
2342,Sonoma,2020-05-09,3,12,15
2343,Napa,2020-05-09,1,1,2
2344,Merced,2020-05-09,5,6,11
2345,San Diego,2020-05-09,338,58,396
2346,Mono,2020-05-09,0,0,0
2347,Lake,2020-05-09,0,0,0
2348,Orange,2020-05-09,228,72,300
2349,Glenn,2020-05-10,0,0,0
2350,Yolo,2020-05-10,0,0,0
2351,Los Angeles,2020-05-10,1731,539,2270
2352,Humboldt,2020-05-10,2,4,6
2353,Kings,2020-05-10,12,5,17
2354,Mono,2020-05-10,0,0,0
2355,Placer,2020-05-10,8,19,27
2356,Lassen,2020-05-10,0,1,1
2357,Colusa,2020-05-10,0,0,0
2358,Imperial,2020-05-10,63,1,64
2359,Mariposa,2020-05-10,0,0,0
2360,Ventura,2020-05-10,28,24,52
2361,Calaveras,2020-05-10,0,0,0
2362,Siskiyou,2020-05-10,0,0,0
2363,San Diego,2020-05-10,334,56,390
2364,Napa,2020-05-10,2,0,2
2365,Del Norte,2020-05-10,0,0,0
2366,San Bernardino,2020-05-10,144,83,227
2367,Amador,2020-05-10,0,0,0
2368,Mendocino,2020-05-10,0,0,0
2369,Sacramento,2020-05-10,18,37,55
2370,Butte,2020-05-10,1,2,3
2371,Modoc,2020-05-10,0,0,0
2372,Marin,2020-05-10,4,13,17
2373,Plumas,2020-05-10,0,1,1
2374,El Dorado,2020-05-10,0,2,2
2375,Santa Cruz,2020-05-10,3,0,3
2376,Riverside,2020-05-10,199,117,316
2377,Lake,2020-05-10,0,1,1
2378,San Francisco,2020-05-10,66,25,91
2379,Trinity,2020-05-10,0,0,0
2380,Tulare,2020-05-10,27,2,29
2381,Tuolumne,2020-05-10,0,0,0
2382,Contra Costa,2020-05-10,18,43,61
2383,Tehama,2020-05-10,0,0,0
2384,Stanislaus,2020-05-10,17,10,27
2385,Monterey,2020-05-10,9,0,9
2386,Sutter,2020-05-10,0,0,0
2387,Madera,2020-05-10,1,1,2
2388,Solano,2020-05-10,14,22,36
2389,Merced,2020-05-10,6,0,6
2390,San Benito,2020-05-10,0,0,0
2391,San Joaquin,2020-05-10,15,28,43
2392,Shasta,2020-05-10,0,0,0
2393,Santa Clara,2020-05-10,66,45,111
2394,San Luis Obispo,2020-05-10,3,2,5
2395,Nevada,2020-05-10,0,1,1
2396,Yuba,2020-05-10,0,0,0
2397,Santa Barbara,2020-05-10,26,4,30
2398,Fresno,2020-05-10,53,45,98
2399,Orange,2020-05-10,230,78,308
2400,Inyo,2020-05-10,0,0,0
2401,San Mateo,2020-05-10,29,23,52
2402,Sonoma,2020-05-10,5,7,12
2403,Kern,2020-05-10,37,14,51
2404,Alameda,2020-05-10,77,46,123
2405,San Luis Obispo,2020-05-11,3,2,5
2406,Stanislaus,2020-05-11,21,14,35
2407,Calaveras,2020-05-11,0,1,1
2408,Monterey,2020-05-11,9,0,9
2409,Kings,2020-05-11,13,4,17
2410,Colusa,2020-05-11,0,0,0
2411,Trinity,2020-05-11,0,0,0
2412,Del Norte,2020-05-11,0,0,0
2413,Amador,2020-05-11,0,0,0
2414,Yuba,2020-05-11,0,1,1
2415,Alameda,2020-05-11,78,53,131
2416,Tuolumne,2020-05-11,0,1,1
2417,Marin,2020-05-11,3,12,15
2418,Tulare,2020-05-11,35,0,35
2419,Sutter,2020-05-11,0,0,0
2420,El Dorado,2020-05-11,0,3,3
2421,Santa Cruz,2020-05-11,1,0,1
2422,Placer,2020-05-11,8,16,24
2423,Mendocino,2020-05-11,0,0,0
2424,Lake,2020-05-11,0,0,0
2425,Orange,2020-05-11,232,88,320
2426,Contra Costa,2020-05-11,16,38,54
2427,Tehama,2020-05-11,0,0,0
2428,Napa,2020-05-11,1,0,1
2429,Nevada,2020-05-11,0,1,1
2430,Inyo,2020-05-11,1,0,1
2431,Mariposa,2020-05-11,0,0,0
2432,San Benito,2020-05-11,1,0,1
2433,Sonoma,2020-05-11,5,9,14
2434,Los Angeles,2020-05-11,1763,547,2310
2435,Butte,2020-05-11,2,1,3
2436,Solano,2020-05-11,13,15,28
2437,Siskiyou,2020-05-11,0,0,0
2438,Modoc,2020-05-11,0,0,0
2439,Humboldt,2020-05-11,2,6,8
2440,Kern,2020-05-11,39,4,43
2441,Lassen,2020-05-11,0,1,1
2442,Santa Barbara,2020-05-11,22,10,32
2443,San Francisco,2020-05-11,63,28,91
2444,San Bernardino,2020-05-11,152,66,218
2445,San Joaquin,2020-05-11,15,15,30
2446,Glenn,2020-05-11,0,0,0
2447,San Diego,2020-05-11,339,61,400
2448,Fresno,2020-05-11,56,37,93
2449,Sacramento,2020-05-11,16,35,51
2450,Mono,2020-05-11,0,0,0
2451,San Mateo,2020-05-11,31,18,49
2452,Yolo,2020-05-11,0,0,0
2453,Santa Clara,2020-05-11,59,41,100
2454,Plumas,2020-05-11,0,1,1
2455,Ventura,2020-05-11,31,23,54
2456,Riverside,2020-05-11,186,104,290
2457,Shasta,2020-05-11,0,0,0
2458,Merced,2020-05-11,7,2,9
2459,Imperial,2020-05-11,60,2,62
2460,Madera,2020-05-11,1,0,1
2461,Yolo,2020-05-12,0,0,0
2462,Mendocino,2020-05-12,0,0,0
2463,Tulare,2020-05-12,34,0,34
2464,San Diego,2020-05-12,334,51,385
2465,Riverside,2020-05-12,206,100,306
2466,Tuolumne,2020-05-12,0,0,0
2467,Placer,2020-05-12,9,18,27
2468,Sutter,2020-05-12,0,0,0
2469,San Luis Obispo,2020-05-12,4,4,8
2470,Inyo,2020-05-12,0,0,0
2471,Mariposa,2020-05-12,0,1,1
2472,Orange,2020-05-12,263,85,348
2473,San Bernardino,2020-05-12,148,49,197
2474,Yuba,2020-05-12,0,1,1
2475,Shasta,2020-05-12,0,0,0
2476,Napa,2020-05-12,1,0,1
2477,Kern,2020-05-12,38,14,52
2478,Madera,2020-05-12,0,0,0
2479,Humboldt,2020-05-12,3,5,8
2480,Calaveras,2020-05-12,0,0,0
2481,San Benito,2020-05-12,1,0,1
2482,Merced,2020-05-12,6,5,11
2483,Amador,2020-05-12,0,0,0
2484,Lassen,2020-05-12,0,0,0
2485,Ventura,2020-05-12,26,25,51
2486,El Dorado,2020-05-12,0,2,2
2487,Los Angeles,2020-05-12,1742,506,2248
2488,Plumas,2020-05-12,0,0,0
2489,Trinity,2020-05-12,0,0,0
2490,Santa Cruz,2020-05-12,1,0,1
2491,San Mateo,2020-05-12,30,33,63
2492,Modoc,2020-05-12,0,0,0
2493,San Joaquin,2020-05-12,14,20,34
2494,Tehama,2020-05-12,0,0,0
2495,Nevada,2020-05-12,0,0,0
2496,Butte,2020-05-12,2,3,5
2497,Contra Costa,2020-05-12,17,49,66
2498,Mono,2020-05-12,0,0,0
2499,Monterey,2020-05-12,6,1,7
2500,Imperial,2020-05-12,60,3,63
2501,Santa Barbara,2020-05-12,24,5,29
2502,Solano,2020-05-12,15,14,29
2503,Lake,2020-05-12,0,1,1
2504,Alameda,2020-05-12,79,51,130
2505,Kings,2020-05-12,16,4,20
2506,Siskiyou,2020-05-12,0,0,0
2507,San Francisco,2020-05-12,63,27,90
2508,Marin,2020-05-12,3,18,21
2509,Stanislaus,2020-05-12,19,15,34
2510,Fresno,2020-05-12,62,48,110
2511,Sacramento,2020-05-12,14,34,48
2512,Del Norte,2020-05-12,0,0,0
2513,Colusa,2020-05-12,0,1,1
2514,Sonoma,2020-05-12,6,22,28
2515,Glenn,2020-05-12,0,0,0
2516,Santa Clara,2020-05-12,55,29,84
2517,Los Angeles,2020-05-13,1733,618,2351
2518,Del Norte,2020-05-13,0,0,0
2519,Tuolumne,2020-05-13,0,0,0
2520,Alameda,2020-05-13,81,59,140
2521,Contra Costa,2020-05-13,20,40,60
2522,Placer,2020-05-13,3,27,30
2523,San Francisco,2020-05-13,57,32,89
2524,Sacramento,2020-05-13,15,35,50
2525,Napa,2020-05-13,1,0,1
2526,Yolo,2020-05-13,0,1,1
2527,Stanislaus,2020-05-13,20,11,31
2528,Humboldt,2020-05-13,4,4,8
2529,Solano,2020-05-13,16,18,34
2530,Santa Clara,2020-05-13,58,33,91
2531,Monterey,2020-05-13,7,2,9
2532,Amador,2020-05-13,0,0,0
2533,Lake,2020-05-13,0,0,0
2534,Yuba,2020-05-13,0,0,0
2535,San Luis Obispo,2020-05-13,3,7,10
2536,Sutter,2020-05-13,0,0,0
2537,Fresno,2020-05-13,69,60,129
2538,Merced,2020-05-13,8,3,11
2539,Kings,2020-05-13,16,4,20
2540,Nevada,2020-05-13,0,0,0
2541,Tulare,2020-05-13,40,0,40
2542,Trinity,2020-05-13,0,0,0
2543,Imperial,2020-05-13,61,4,65
2544,El Dorado,2020-05-13,0,2,2
2545,Calaveras,2020-05-13,0,0,0
2546,San Benito,2020-05-13,1,0,1
2547,Glenn,2020-05-13,0,0,0
2548,San Joaquin,2020-05-13,11,16,27
2549,Marin,2020-05-13,3,16,19
2550,Plumas,2020-05-13,0,0,0
2551,Santa Cruz,2020-05-13,1,0,1
2552,Modoc,2020-05-13,0,0,0
2553,San Diego,2020-05-13,329,51,380
2554,Mendocino,2020-05-13,0,0,0
2555,Lassen,2020-05-13,0,0,0
2556,Siskiyou,2020-05-13,0,1,1
2557,Butte,2020-05-13,2,3,5
2558,San Mateo,2020-05-13,34,35,69
2559,Sonoma,2020-05-13,5,20,25
2560,Riverside,2020-05-13,188,77,265
2561,Shasta,2020-05-13,0,0,0
2562,Orange,2020-05-13,257,85,342
2563,Mariposa,2020-05-13,0,1,1
2564,Madera,2020-05-13,0,0,0
2565,Tehama,2020-05-13,0,0,0
2566,Inyo,2020-05-13,0,0,0
2567,Mono,2020-05-13,0,0,0
2568,Santa Barbara,2020-05-13,26,3,29
2569,Ventura,2020-05-13,25,29,54
2570,Kern,2020-05-13,34,6,40
2571,San Bernardino,2020-05-13,133,90,223
2572,Colusa,2020-05-13,0,1,1
2573,Orange,2020-05-14,259,68,327
2574,Sonoma,2020-05-14,5,23,28
2575,Riverside,2020-05-14,184,91,275
2576,Mono,2020-05-14,0,0,0
2577,Los Angeles,2020-05-14,1648,559,2207
2578,San Diego,2020-05-14,329,70,399
2579,Madera,2020-05-14,0,0,0
2580,Amador,2020-05-14,0,0,0
2581,San Mateo,2020-05-14,32,12,44
2582,Plumas,2020-05-14,0,0,0
2583,San Bernardino,2020-05-14,132,97,229
2584,Butte,2020-05-14,2,1,3
2585,Shasta,2020-05-14,0,0,0
2586,Modoc,2020-05-14,0,0,0
2587,Santa Cruz,2020-05-14,1,0,1
2588,Trinity,2020-05-14,0,0,0
2589,Ventura,2020-05-14,28,30,58
2590,Fresno,2020-05-14,64,52,116
2591,San Francisco,2020-05-14,56,38,94
2592,Mendocino,2020-05-14,0,0,0
2593,San Luis Obispo,2020-05-14,2,3,5
2594,Stanislaus,2020-05-14,19,19,38
2595,Marin,2020-05-14,3,9,12
2596,Sacramento,2020-05-14,12,40,52
2597,Colusa,2020-05-14,0,0,0
2598,Tulare,2020-05-14,37,0,37
2599,Sutter,2020-05-14,0,0,0
2600,Nevada,2020-05-14,0,0,0
2601,Lassen,2020-05-14,0,0,0
2602,Tuolumne,2020-05-14,0,0,0
2603,Santa Clara,2020-05-14,51,40,91
2604,Mariposa,2020-05-14,0,1,1
2605,Kern,2020-05-14,39,5,44
2606,Monterey,2020-05-14,6,1,7
2607,Merced,2020-05-14,8,1,9
2608,Humboldt,2020-05-14,5,7,12
2609,Calaveras,2020-05-14,0,0,0
2610,Solano,2020-05-14,15,25,40
2611,Del Norte,2020-05-14,0,0,0
2612,Lake,2020-05-14,0,0,0
2613,Glenn,2020-05-14,0,0,0
2614,Alameda,2020-05-14,82,56,138
2615,Placer,2020-05-14,2,21,23
2616,Inyo,2020-05-14,0,0,0
2617,Napa,2020-05-14,1,0,1
2618,Santa Barbara,2020-05-14,26,4,30
2619,Imperial,2020-05-14,62,9,71
2620,San Benito,2020-05-14,1,0,1
2621,Tehama,2020-05-14,0,1,1
2622,El Dorado,2020-05-14,0,3,3
2623,Kings,2020-05-14,16,2,18
2624,San Joaquin,2020-05-14,10,26,36
2625,Contra Costa,2020-05-14,20,47,67
2626,Siskiyou,2020-05-14,0,1,1
2627,Yuba,2020-05-14,0,0,0
2628,Yolo,2020-05-14,0,0,0
2629,Sonoma,2020-05-15,5,34,39
2630,Butte,2020-05-15,2,2,4
2631,Mono,2020-05-15,0,0,0
2632,Calaveras,2020-05-15,0,1,1
2633,Tuolumne,2020-05-15,0,0,0
2634,Lassen,2020-05-15,0,0,0
2635,Riverside,2020-05-15,184,72,256
2636,Sutter,2020-05-15,0,0,0
2637,Los Angeles,2020-05-15,1648,553,2201
2638,San Luis Obispo,2020-05-15,1,4,5
2639,Santa Clara,2020-05-15,48,27,75
2640,Monterey,2020-05-15,6,1,7
2641,San Benito,2020-05-15,1,0,1
2642,Tulare,2020-05-15,38,1,39
2643,Placer,2020-05-15,3,26,29
2644,Contra Costa,2020-05-15,19,37,56
2645,Lake,2020-05-15,0,0,0
2646,Merced,2020-05-15,6,2,8
2647,San Francisco,2020-05-15,56,33,89
2648,Glenn,2020-05-15,0,0,0
2649,Napa,2020-05-15,1,0,1
2650,Modoc,2020-05-15,0,0,0
2651,Alameda,2020-05-15,76,72,148
2652,Solano,2020-05-15,14,26,40
2653,Kings,2020-05-15,20,2,22
2654,Yuba,2020-05-15,0,0,0
2655,Tehama,2020-05-15,0,1,1
2656,Stanislaus,2020-05-15,19,19,38
2657,Marin,2020-05-15,2,8,10
2658,Kern,2020-05-15,40,12,52
2659,Del Norte,2020-05-15,0,0,0
2660,San Diego,2020-05-15,326,66,392
2661,Shasta,2020-05-15,0,0,0
2662,Colusa,2020-05-15,0,0,0
2663,San Bernardino,2020-05-15,125,69,194
2664,Inyo,2020-05-15,0,0,0
2665,Plumas,2020-05-15,0,0,0
2666,Humboldt,2020-05-15,3,6,9
2667,Orange,2020-05-15,250,60,310
2668,El Dorado,2020-05-15,0,0,0
2669,Fresno,2020-05-15,59,32,91
2670,Nevada,2020-05-15,0,0,0
2671,Trinity,2020-05-15,0,0,0
2672,Amador,2020-05-15,0,0,0
2673,Madera,2020-05-15,1,0,1
2674,San Joaquin,2020-05-15,11,34,45
2675,Yolo,2020-05-15,0,0,0
2676,Ventura,2020-05-15,27,20,47
2677,Siskiyou,2020-05-15,0,0,0
2678,San Mateo,2020-05-15,30,24,54
2679,Santa Cruz,2020-05-15,1,0,1
2680,Sacramento,2020-05-15,11,44,55
2681,Imperial,2020-05-15,67,4,71
2682,Santa Barbara,2020-05-15,26,6,32
2683,Mariposa,2020-05-15,0,0,0
2684,Mendocino,2020-05-15,0,0,0
2685,Solano,2020-05-16,14,26,40
2686,Plumas,2020-05-16,0,0,0
2687,Stanislaus,2020-05-16,19,20,39
2688,Butte,2020-05-16,2,1,3
2689,Placer,2020-05-16,3,25,28
2690,Kern,2020-05-16,36,15,51
2691,Tehama,2020-05-16,0,0,0
2692,Alameda,2020-05-16,81,64,145
2693,Marin,2020-05-16,1,10,11
2694,El Dorado,2020-05-16,1,3,4
2695,Riverside,2020-05-16,183,83,266
2696,Yuba,2020-05-16,0,0,0
2697,Kings,2020-05-16,20,2,22
2698,Lake,2020-05-16,0,0,0
2699,Mendocino,2020-05-16,0,0,0
2700,Los Angeles,2020-05-16,1570,516,2086
2701,Ventura,2020-05-16,27,23,50
2702,Monterey,2020-05-16,8,1,9
2703,Santa Clara,2020-05-16,51,39,90
2704,San Joaquin,2020-05-16,11,19,30
2705,Sacramento,2020-05-16,12,34,46
2706,Siskiyou,2020-05-16,0,1,1
2707,Santa Barbara,2020-05-16,27,7,34
2708,Inyo,2020-05-16,0,0,0
2709,San Mateo,2020-05-16,31,23,54
2710,San Luis Obispo,2020-05-16,1,5,6
2711,Lassen,2020-05-16,0,0,0
2712,Amador,2020-05-16,0,0,0
2713,San Benito,2020-05-16,1,0,1
2714,Mariposa,2020-05-16,0,0,0
2715,Tuolumne,2020-05-16,0,0,0
2716,Imperial,2020-05-16,60,1,61
2717,Colusa,2020-05-16,0,0,0
2718,Humboldt,2020-05-16,3,4,7
2719,Modoc,2020-05-16,0,0,0
2720,Napa,2020-05-16,1,3,4
2721,Santa Cruz,2020-05-16,1,0,1
2722,Tulare,2020-05-16,40,1,41
2723,Nevada,2020-05-16,0,0,0
2724,Merced,2020-05-16,6,1,7
2725,Madera,2020-05-16,0,0,0
2726,Yolo,2020-05-16,0,1,1
2727,San Diego,2020-05-16,319,51,370
2728,Calaveras,2020-05-16,0,0,0
2729,Del Norte,2020-05-16,0,0,0
2730,Orange,2020-05-16,251,74,325
2731,Glenn,2020-05-16,0,0,0
2732,Mono,2020-05-16,0,0,0
2733,Contra Costa,2020-05-16,16,34,50
2734,Shasta,2020-05-16,0,0,0
2735,Fresno,2020-05-16,58,39,97
2736,San Bernardino,2020-05-16,122,79,201
2737,San Francisco,2020-05-16,44,30,74
2738,Trinity,2020-05-16,0,0,0
2739,Sutter,2020-05-16,0,0,0
2740,Sonoma,2020-05-16,5,31,36
2741,Siskiyou,2020-05-17,0,1,1
2742,San Benito,2020-05-17,1,0,1
2743,Merced,2020-05-17,6,3,9
2744,Trinity,2020-05-17,0,0,0
2745,Stanislaus,2020-05-17,20,21,41
2746,Tuolumne,2020-05-17,0,0,0
2747,Tehama,2020-05-17,0,0,0
2748,Mono,2020-05-17,0,0,0
2749,Tulare,2020-05-17,40,1,41
2750,Ventura,2020-05-17,31,13,44
2751,Colusa,2020-05-17,0,0,0
2752,San Francisco,2020-05-17,40,31,71
2753,Imperial,2020-05-17,68,3,71
2754,Calaveras,2020-05-17,0,0,0
2755,Mariposa,2020-05-17,0,1,1
2756,Lake,2020-05-17,0,0,0
2757,Alameda,2020-05-17,74,72,146
2758,Orange,2020-05-17,267,88,355
2759,Yolo,2020-05-17,0,0,0
2760,Yuba,2020-05-17,1,0,1
2761,Santa Clara,2020-05-17,44,38,82
2762,Kings,2020-05-17,21,4,25
2763,Plumas,2020-05-17,0,0,0
2764,Santa Cruz,2020-05-17,1,0,1
2765,Glenn,2020-05-17,0,0,0
2766,Inyo,2020-05-17,0,0,0
2767,Solano,2020-05-17,17,30,47
2768,Madera,2020-05-17,0,0,0
2769,Lassen,2020-05-17,0,0,0
2770,Placer,2020-05-17,2,25,27
2771,San Luis Obispo,2020-05-17,1,4,5
2772,Contra Costa,2020-05-17,16,39,55
2773,Del Norte,2020-05-17,0,0,0
2774,Fresno,2020-05-17,60,46,106
2775,Napa,2020-05-17,1,2,3
2776,Sonoma,2020-05-17,5,26,31
2777,Santa Barbara,2020-05-17,25,6,31
2778,Monterey,2020-05-17,8,2,10
2779,Sutter,2020-05-17,0,0,0
2780,Sacramento,2020-05-17,15,41,56
2781,San Diego,2020-05-17,321,59,380
2782,Los Angeles,2020-05-17,1549,558,2107
2783,Humboldt,2020-05-17,4,1,5
2784,Kern,2020-05-17,36,12,48
2785,Marin,2020-05-17,1,11,12
2786,San Mateo,2020-05-17,32,23,55
2787,Mendocino,2020-05-17,1,0,1
2788,Shasta,2020-05-17,0,0,0
2789,San Bernardino,2020-05-17,129,81,210
2790,Amador,2020-05-17,0,0,0
2791,El Dorado,2020-05-17,1,3,4
2792,Nevada,2020-05-17,0,0,0
2793,San Joaquin,2020-05-17,10,18,28
2794,Modoc,2020-05-17,1,0,1
2795,Butte,2020-05-17,2,0,2
2796,Riverside,2020-05-17,186,91,277
2797,Marin,2020-05-18,4,8,12
2798,Monterey,2020-05-18,8,1,9
2799,Calaveras,2020-05-18,0,0,0
2800,Sacramento,2020-05-18,13,58,71
2801,Glenn,2020-05-18,0,0,0
2802,Humboldt,2020-05-18,4,1,5
2803,Mono,2020-05-18,0,0,0
2804,Lake,2020-05-18,0,2,2
2805,Napa,2020-05-18,1,0,1
2806,San Joaquin,2020-05-18,9,23,32
2807,Sutter,2020-05-18,0,0,0
2808,San Mateo,2020-05-18,41,19,60
2809,San Benito,2020-05-18,1,0,1
2810,Imperial,2020-05-18,73,1,74
2811,El Dorado,2020-05-18,1,3,4
2812,Stanislaus,2020-05-18,18,20,38
2813,Kern,2020-05-18,36,12,48
2814,Santa Cruz,2020-05-18,2,0,2
2815,Modoc,2020-05-18,0,1,1
2816,Solano,2020-05-18,16,27,43
2817,Amador,2020-05-18,0,1,1
2818,San Luis Obispo,2020-05-18,1,2,3
2819,Ventura,2020-05-18,33,16,49
2820,Inyo,2020-05-18,0,0,0
2821,Contra Costa,2020-05-18,19,51,70
2822,Lassen,2020-05-18,0,1,1
2823,Santa Barbara,2020-05-18,25,2,27
2824,San Bernardino,2020-05-18,140,81,221
2825,Riverside,2020-05-18,195,86,281
2826,Plumas,2020-05-18,0,0,0
2827,Colusa,2020-05-18,0,1,1
2828,Tulare,2020-05-18,35,1,36
2829,San Francisco,2020-05-18,46,33,79
2830,Alameda,2020-05-18,87,51,138
2831,Sonoma,2020-05-18,3,20,23
2832,Fresno,2020-05-18,61,44,105
2833,Tuolumne,2020-05-18,0,0,0
2834,Nevada,2020-05-18,0,0,0
2835,Del Norte,2020-05-18,0,0,0
2836,Tehama,2020-05-18,0,1,1
2837,Orange,2020-05-18,263,78,341
2838,Trinity,2020-05-18,0,0,0
2839,Kings,2020-05-18,21,4,25
2840,San Diego,2020-05-18,329,49,378
2841,Los Angeles,2020-05-18,1531,520,2051
2842,Santa Clara,2020-05-18,46,33,79
2843,Mendocino,2020-05-18,1,0,1
2844,Merced,2020-05-18,6,0,6
2845,Yuba,2020-05-18,1,0,1
2846,Siskiyou,2020-05-18,0,0,0
2847,Mariposa,2020-05-18,0,2,2
2848,Shasta,2020-05-18,0,0,0
2849,Butte,2020-05-18,2,1,3
2850,Placer,2020-05-18,1,34,35
2851,Yolo,2020-05-18,0,0,0
2852,Madera,2020-05-18,0,2,2
2853,Solano,2020-05-19,18,29,47
2854,Humboldt,2020-05-19,4,3,7
2855,Colusa,2020-05-19,0,1,1
2856,San Francisco,2020-05-19,48,26,74
2857,Tulare,2020-05-19,37,5,42
2858,Kern,2020-05-19,42,11,53
2859,Ventura,2020-05-19,33,27,60
2860,San Joaquin,2020-05-19,7,26,33
2861,Shasta,2020-05-19,0,0,0
2862,Riverside,2020-05-19,189,103,292
2863,Sonoma,2020-05-19,4,24,28
2864,Lake,2020-05-19,0,1,1
2865,El Dorado,2020-05-19,0,2,2
2866,Calaveras,2020-05-19,0,0,0
2867,Imperial,2020-05-19,74,4,78
2868,Mariposa,2020-05-19,0,3,3
2869,Mono,2020-05-19,0,0,0
2870,Yuba,2020-05-19,1,0,1
2871,Los Angeles,2020-05-19,1517,619,2136
2872,Orange,2020-05-19,269,97,366
2873,Marin,2020-05-19,4,20,24
2874,Madera,2020-05-19,0,1,1
2875,Fresno,2020-05-19,64,43,107
2876,Contra Costa,2020-05-19,14,74,88
2877,Santa Cruz,2020-05-19,1,0,1
2878,Trinity,2020-05-19,0,0,0
2879,Tuolumne,2020-05-19,0,0,0
2880,Lassen,2020-05-19,0,1,1
2881,Siskiyou,2020-05-19,0,0,0
2882,Placer,2020-05-19,3,45,48
2883,Tehama,2020-05-19,0,0,0
2884,Stanislaus,2020-05-19,17,31,48
2885,Napa,2020-05-19,1,0,1
2886,Mendocino,2020-05-19,1,0,1
2887,Nevada,2020-05-19,0,0,0
2888,San Bernardino,2020-05-19,134,76,210
2889,Alameda,2020-05-19,83,108,191
2890,San Mateo,2020-05-19,41,30,71
2891,Plumas,2020-05-19,0,0,0
2892,Amador,2020-05-19,0,0,0
2893,Santa Barbara,2020-05-19,23,5,28
2894,Del Norte,2020-05-19,0,0,0
2895,San Benito,2020-05-19,1,0,1
2896,San Diego,2020-05-19,319,68,387
2897,Merced,2020-05-19,7,1,8
2898,Inyo,2020-05-19,0,0,0
2899,Sutter,2020-05-19,0,0,0
2900,Monterey,2020-05-19,11,0,11
2901,Kings,2020-05-19,23,1,24
2902,Santa Clara,2020-05-19,43,57,100
2903,Yolo,2020-05-19,0,0,0
2904,Butte,2020-05-19,1,0,1
2905,Sacramento,2020-05-19,11,90,101
2906,San Luis Obispo,2020-05-19,2,1,3
2907,Glenn,2020-05-19,0,0,0
2908,Modoc,2020-05-19,0,1,1
2909,Santa Clara,2020-05-20,40,56,96
2910,Solano,2020-05-20,18,37,55
2911,San Benito,2020-05-20,1,0,1
2912,Merced,2020-05-20,8,1,9
2913,San Francisco,2020-05-20,47,32,79
2914,Fresno,2020-05-20,56,41,97
2915,Mariposa,2020-05-20,0,2,2
2916,Stanislaus,2020-05-20,18,30,48
2917,Yolo,2020-05-20,0,0,0
2918,Alameda,2020-05-20,81,134,215
2919,Plumas,2020-05-20,0,0,0
2920,Tehama,2020-05-20,0,0,0
2921,Tuolumne,2020-05-20,0,0,0
2922,Kings,2020-05-20,22,4,26
2923,Siskiyou,2020-05-20,0,0,0
2924,Santa Barbara,2020-05-20,23,4,27
2925,Del Norte,2020-05-20,0,0,0
2926,Trinity,2020-05-20,0,0,0
2927,Tulare,2020-05-20,42,3,45
2928,Napa,2020-05-20,1,0,1
2929,Glenn,2020-05-20,0,0,0
2930,Kern,2020-05-20,48,8,56
2931,Marin,2020-05-20,4,25,29
2932,Modoc,2020-05-20,0,1,1
2933,Mono,2020-05-20,0,0,0
2934,San Diego,2020-05-20,335,69,404
2935,Sonoma,2020-05-20,2,34,36
2936,Sacramento,2020-05-20,11,92,103
2937,Humboldt,2020-05-20,4,8,12
2938,Butte,2020-05-20,4,1,5
2939,Los Angeles,2020-05-20,1506,561,2067
2940,Inyo,2020-05-20,0,0,0
2941,Colusa,2020-05-20,0,0,0
2942,Shasta,2020-05-20,0,0,0
2943,Mendocino,2020-05-20,1,0,1
2944,Riverside,2020-05-20,183,107,290
2945,Contra Costa,2020-05-20,9,73,82
2946,Lake,2020-05-20,0,2,2
2947,Placer,2020-05-20,4,52,56
2948,San Bernardino,2020-05-20,127,89,216
2949,Imperial,2020-05-20,80,3,83
2950,Nevada,2020-05-20,0,0,0
2951,San Luis Obispo,2020-05-20,2,6,8
2952,Sutter,2020-05-20,0,0,0
2953,Yuba,2020-05-20,1,0,1
2954,Monterey,2020-05-20,10,0,10
2955,Amador,2020-05-20,0,0,0
2956,San Joaquin,2020-05-20,9,29,38
2957,El Dorado,2020-05-20,0,2,2
2958,Calaveras,2020-05-20,0,0,0
2959,Lassen,2020-05-20,0,1,1
2960,Ventura,2020-05-20,36,26,62
2961,San Mateo,2020-05-20,37,37,74
2962,Madera,2020-05-20,0,4,4
2963,Santa Cruz,2020-05-20,3,0,3
2964,Orange,2020-05-20,275,113,388
2965,Ventura,2020-05-21,30,19,49
2966,San Mateo,2020-05-21,37,33,70
2967,Humboldt,2020-05-21,4,12,16
2968,Sonoma,2020-05-21,4,31,35
2969,Orange,2020-05-21,262,102,364
2970,El Dorado,2020-05-21,0,2,2
2971,Trinity,2020-05-21,0,0,0
2972,San Bernardino,2020-05-21,131,93,224
2973,Placer,2020-05-21,7,59,66
2974,Kings,2020-05-21,21,4,25
2975,Tuolumne,2020-05-21,0,0,0
2976,Madera,2020-05-21,0,0,0
2977,Riverside,2020-05-21,194,91,285
2978,Alameda,2020-05-21,77,162,239
2979,Tehama,2020-05-21,0,0,0
2980,San Benito,2020-05-21,1,0,1
2981,Imperial,2020-05-21,75,3,78
2982,Colusa,2020-05-21,0,0,0
2983,Los Angeles,2020-05-21,1491,614,2105
2984,Yolo,2020-05-21,0,3,3
2985,Tulare,2020-05-21,39,1,40
2986,Stanislaus,2020-05-21,22,30,52
2987,Siskiyou,2020-05-21,0,0,0
2988,Calaveras,2020-05-21,0,1,1
2989,Mono,2020-05-21,0,0,0
2990,Amador,2020-05-21,0,0,0
2991,Napa,2020-05-21,1,0,1
2992,Glenn,2020-05-21,0,0,0
2993,Fresno,2020-05-21,61,57,118
2994,Inyo,2020-05-21,0,0,0
2995,Monterey,2020-05-21,8,1,9
2996,Del Norte,2020-05-21,0,0,0
2997,Shasta,2020-05-21,0,0,0
2998,Merced,2020-05-21,6,0,6
2999,Butte,2020-05-21,8,1,9
3000,Lassen,2020-05-21,0,1,1
3001,Santa Barbara,2020-05-21,24,6,30
3002,Marin,2020-05-21,4,29,33
3003,San Joaquin,2020-05-21,8,23,31
3004,Kern,2020-05-21,44,10,54
3005,Yuba,2020-05-21,1,0,1
3006,Sutter,2020-05-21,0,0,0
3007,Mariposa,2020-05-21,0,0,0
3008,Plumas,2020-05-21,0,0,0
3009,Santa Cruz,2020-05-21,4,1,5
3010,Nevada,2020-05-21,0,0,0
3011,San Luis Obispo,2020-05-21,2,5,7
3012,Contra Costa,2020-05-21,8,75,83
3013,Sacramento,2020-05-21,7,100,107
3014,Lake,2020-05-21,0,0,0
3015,Modoc,2020-05-21,0,1,1
3016,San Diego,2020-05-21,325,53,378
3017,Santa Clara,2020-05-21,39,60,99
3018,Solano,2020-05-21,18,35,53
3019,Mendocino,2020-05-21,1,0,1
3020,San Francisco,2020-05-21,43,37,80
3021,Santa Cruz,2020-05-22,4,1,5
3022,San Luis Obispo,2020-05-22,2,1,3
3023,Sonoma,2020-05-22,5,16,21
3024,Santa Barbara,2020-05-22,20,4,24
3025,Del Norte,2020-05-22,0,0,0
3026,Ventura,2020-05-22,29,35,64
3027,Solano,2020-05-22,18,16,34
3028,Marin,2020-05-22,3,3,6
3029,Orange,2020-05-22,269,89,358
3030,Riverside,2020-05-22,195,115,310
3031,Lassen,2020-05-22,0,1,1
3032,Shasta,2020-05-22,0,1,1
3033,Contra Costa,2020-05-22,11,30,41
3034,Stanislaus,2020-05-22,23,11,34
3035,Merced,2020-05-22,6,1,7
3036,San Diego,2020-05-22,331,50,381
3037,Mendocino,2020-05-22,1,0,1
3038,San Joaquin,2020-05-22,9,26,35
3039,Plumas,2020-05-22,0,0,0
3040,Butte,2020-05-22,7,1,8
3041,Santa Clara,2020-05-22,36,19,55
3042,Siskiyou,2020-05-22,0,2,2
3043,Kern,2020-05-22,45,8,53
3044,Yolo,2020-05-22,0,0,0
3045,Inyo,2020-05-22,0,0,0
3046,Trinity,2020-05-22,0,0,0
3047,Mono,2020-05-22,0,0,0
3048,San Mateo,2020-05-22,40,12,52
3049,Humboldt,2020-05-22,4,13,17
3050,Glenn,2020-05-22,0,0,0
3051,Madera,2020-05-22,1,0,1
3052,El Dorado,2020-05-22,0,4,4
3053,San Francisco,2020-05-22,43,29,72
3054,Tulare,2020-05-22,38,1,39
3055,Sutter,2020-05-22,0,0,0
3056,Napa,2020-05-22,1,7,8
3057,Kings,2020-05-22,23,5,28
3058,Tehama,2020-05-22,0,0,0
3059,San Bernardino,2020-05-22,125,101,226
3060,Los Angeles,2020-05-22,1490,565,2055
3061,Mariposa,2020-05-22,0,0,0
3062,Monterey,2020-05-22,9,1,10
3063,Colusa,2020-05-22,0,0,0
3064,Imperial,2020-05-22,75,2,77
3065,San Benito,2020-05-22,1,0,1
3066,Lake,2020-05-22,0,2,2
3067,Amador,2020-05-22,0,1,1
3068,Tuolumne,2020-05-22,0,0,0
3069,Nevada,2020-05-22,0,0,0
3070,Calaveras,2020-05-22,0,0,0
3071,Yuba,2020-05-22,1,0,1
3072,Modoc,2020-05-22,0,1,1
3073,Sacramento,2020-05-22,10,13,23
3074,Alameda,2020-05-22,79,81,160
3075,Placer,2020-05-22,6,20,26
3076,Fresno,2020-05-22,64,30,94
3077,San Luis Obispo,2020-05-23,2,0,2
3078,Plumas,2020-05-23,0,0,0
3079,Sutter,2020-05-23,0,0,0
3080,Glenn,2020-05-23,0,0,0
3081,San Francisco,2020-05-23,45,28,73
3082,Modoc,2020-05-23,0,1,1
3083,Shasta,2020-05-23,0,1,1
3084,Nevada,2020-05-23,0,0,0
3085,Kings,2020-05-23,25,3,28
3086,Stanislaus,2020-05-23,23,15,38
3087,Fresno,2020-05-23,66,37,103
3088,Tulare,2020-05-23,40,1,41
3089,Sacramento,2020-05-23,12,12,24
3090,Mendocino,2020-05-23,3,2,5
3091,Sonoma,2020-05-23,5,17,22
3092,Yolo,2020-05-23,0,0,0
3093,Tehama,2020-05-23,0,0,0
3094,Riverside,2020-05-23,193,95,288
3095,San Joaquin,2020-05-23,10,21,31
3096,Placer,2020-05-23,6,19,25
3097,Napa,2020-05-23,1,1,2
3098,Inyo,2020-05-23,0,0,0
3099,Lassen,2020-05-23,0,0,0
3100,San Diego,2020-05-23,304,82,386
3101,Contra Costa,2020-05-23,14,34,48
3102,Merced,2020-05-23,7,4,11
3103,Del Norte,2020-05-23,0,0,0
3104,Lake,2020-05-23,0,1,1
3105,El Dorado,2020-05-23,1,5,6
3106,Santa Barbara,2020-05-23,21,3,24
3107,Siskiyou,2020-05-23,0,2,2
3108,Solano,2020-05-23,18,14,32
3109,San Bernardino,2020-05-23,134,100,234
3110,Humboldt,2020-05-23,4,13,17
3111,Alameda,2020-05-23,80,78,158
3112,San Mateo,2020-05-23,39,11,50
3113,Santa Clara,2020-05-23,37,17,54
3114,Kern,2020-05-23,48,10,58
3115,Yuba,2020-05-23,1,0,1
3116,Santa Cruz,2020-05-23,4,1,5
3117,Marin,2020-05-23,2,4,6
3118,Los Angeles,2020-05-23,1440,566,2006
3119,Monterey,2020-05-23,7,1,8
3120,Imperial,2020-05-23,75,2,77
3121,Ventura,2020-05-23,29,25,54
3122,Tuolumne,2020-05-23,0,0,0
3123,Calaveras,2020-05-23,0,0,0
3124,Madera,2020-05-23,0,0,0
3125,Colusa,2020-05-23,0,0,0
3126,Orange,2020-05-23,278,94,372
3127,San Benito,2020-05-23,1,0,1
3128,Mariposa,2020-05-23,0,0,0
3129,Butte,2020-05-23,5,0,5
3130,Trinity,2020-05-23,0,0,0
3131,Mono,2020-05-23,0,0,0
3132,Amador,2020-05-23,0,0,0
3133,Placer,2020-05-24,5,21,26
3134,Colusa,2020-05-24,0,0,0
3135,Solano,2020-05-24,18,19,37
3136,Santa Clara,2020-05-24,35,19,54
3137,San Francisco,2020-05-24,47,41,88
3138,Lassen,2020-05-24,0,0,0
3139,Kings,2020-05-24,25,3,28
3140,Monterey,2020-05-24,7,1,8
3141,Siskiyou,2020-05-24,0,2,2
3142,Sacramento,2020-05-24,9,17,26
3143,Humboldt,2020-05-24,4,3,7
3144,Sutter,2020-05-24,0,0,0
3145,Yuba,2020-05-24,1,0,1
3146,Del Norte,2020-05-24,0,0,0
3147,Contra Costa,2020-05-24,15,27,42
3148,Stanislaus,2020-05-24,22,15,37
3149,Marin,2020-05-24,2,4,6
3150,Madera,2020-05-24,0,1,1
3151,Modoc,2020-05-24,0,1,1
3152,Sonoma,2020-05-24,6,16,22
3153,Tulare,2020-05-24,42,2,44
3154,Alameda,2020-05-24,88,61,149
3155,Inyo,2020-05-24,0,0,0
3156,Merced,2020-05-24,7,5,12
3157,San Bernardino,2020-05-24,139,103,242
3158,Ventura,2020-05-24,32,36,68
3159,Trinity,2020-05-24,0,0,0
3160,Napa,2020-05-24,1,0,1
3161,Amador,2020-05-24,0,0,0
3162,San Luis Obispo,2020-05-24,2,1,3
3163,Fresno,2020-05-24,66,40,106
3164,Los Angeles,2020-05-24,1443,547,1990
3165,Plumas,2020-05-24,0,0,0
3166,El Dorado,2020-05-24,1,4,5
3167,Imperial,2020-05-24,77,4,81
3168,Santa Barbara,2020-05-24,21,6,27
3169,Tehama,2020-05-24,0,0,0
3170,San Benito,2020-05-24,1,0,1
3171,Mono,2020-05-24,0,0,0
3172,Butte,2020-05-24,5,0,5
3173,San Joaquin,2020-05-24,11,25,36
3174,Riverside,2020-05-24,188,80,268
3175,Mariposa,2020-05-24,0,0,0
3176,Nevada,2020-05-24,0,0,0
3177,Santa Cruz,2020-05-24,4,1,5
3178,Glenn,2020-05-24,0,0,0
3179,Kern,2020-05-24,53,4,57
3180,San Mateo,2020-05-24,39,13,52
3181,Calaveras,2020-05-24,0,1,1
3182,San Diego,2020-05-24,310,60,370
3183,Orange,2020-05-24,286,102,388
3184,Mendocino,2020-05-24,3,2,5
3185,Lake,2020-05-24,0,4,4
3186,Yolo,2020-05-24,0,0,0
3187,Tuolumne,2020-05-24,0,0,0
3188,Shasta,2020-05-24,0,0,0
3189,Inyo,2020-05-25,0,0,0
3190,Tuolumne,2020-05-25,0,0,0
3191,Alameda,2020-05-25,91,65,156
3192,Monterey,2020-05-25,10,0,10
3193,Lassen,2020-05-25,0,0,0
3194,Ventura,2020-05-25,33,30,63
3195,Los Angeles,2020-05-25,1477,564,2041
3196,Calaveras,2020-05-25,0,1,1
3197,Contra Costa,2020-05-25,13,35,48
3198,Tulare,2020-05-25,40,2,42
3199,Shasta,2020-05-25,0,0,0
3200,Lake,2020-05-25,0,1,1
3201,Kings,2020-05-25,26,3,29
3202,San Diego,2020-05-25,317,68,385
3203,Imperial,2020-05-25,69,6,75
3204,Del Norte,2020-05-25,0,1,1
3205,San Mateo,2020-05-25,44,13,57
3206,San Luis Obispo,2020-05-25,2,0,2
3207,Napa,2020-05-25,1,0,1
3208,El Dorado,2020-05-25,1,3,4
3209,Placer,2020-05-25,5,20,25
3210,Yolo,2020-05-25,1,0,1
3211,Amador,2020-05-25,0,0,0
3212,Santa Cruz,2020-05-25,4,3,7
3213,Nevada,2020-05-25,0,0,0
3214,Santa Barbara,2020-05-25,19,8,27
3215,Solano,2020-05-25,21,20,41
3216,Sacramento,2020-05-25,9,17,26
3217,Kern,2020-05-25,51,8,59
3218,Trinity,2020-05-25,0,0,0
3219,Madera,2020-05-25,1,1,2
3220,Sonoma,2020-05-25,5,22,27
3221,Plumas,2020-05-25,0,0,0
3222,Tehama,2020-05-25,0,0,0
3223,Mariposa,2020-05-25,0,1,1
3224,Colusa,2020-05-25,0,0,0
3225,Merced,2020-05-25,6,4,10
3226,Marin,2020-05-25,3,4,7
3227,Modoc,2020-05-25,0,1,1
3228,San Benito,2020-05-25,1,0,1
3229,Mono,2020-05-25,0,0,0
3230,Sutter,2020-05-25,0,0,0
3231,Humboldt,2020-05-25,6,4,10
3232,Orange,2020-05-25,300,94,394
3233,Mendocino,2020-05-25,2,0,2
3234,Fresno,2020-05-25,66,38,104
3235,Riverside,2020-05-25,193,88,281
3236,Butte,2020-05-25,7,0,7
3237,San Joaquin,2020-05-25,12,24,36
3238,Santa Clara,2020-05-25,32,20,52
3239,Stanislaus,2020-05-25,18,11,29
3240,Glenn,2020-05-25,0,0,0
3241,San Bernardino,2020-05-25,138,116,254
3242,Siskiyou,2020-05-25,0,2,2
3243,San Francisco,2020-05-25,40,41,81
3244,Yuba,2020-05-25,1,0,1
3245,Mendocino,2020-05-26,3,1,4
3246,Del Norte,2020-05-26,0,1,1
3247,Siskiyou,2020-05-26,0,0,0
3248,El Dorado,2020-05-26,0,2,2
3249,Merced,2020-05-26,6,3,9
3250,San Benito,2020-05-26,1,0,1
3251,Colusa,2020-05-26,0,0,0
3252,Mono,2020-05-26,0,0,0
3253,Plumas,2020-05-26,0,0,0
3254,San Bernardino,2020-05-26,154,125,279
3255,Los Angeles,2020-05-26,1477,610,2087
3256,San Luis Obispo,2020-05-26,2,2,4
3257,Amador,2020-05-26,0,0,0
3258,Shasta,2020-05-26,1,0,1
3259,Fresno,2020-05-26,69,29,98
3260,Stanislaus,2020-05-26,18,14,32
3261,Modoc,2020-05-26,0,1,1
3262,Butte,2020-05-26,5,0,5
3263,Trinity,2020-05-26,0,3,3
3264,Nevada,2020-05-26,1,3,4
3265,San Joaquin,2020-05-26,14,29,43
3266,Imperial,2020-05-26,69,8,77
3267,Sonoma,2020-05-26,5,20,25
3268,Glenn,2020-05-26,0,0,0
3269,Placer,2020-05-26,6,21,27
3270,Riverside,2020-05-26,207,102,309
3271,San Mateo,2020-05-26,45,9,54
3272,Inyo,2020-05-26,0,0,0
3273,Yolo,2020-05-26,1,0,1
3274,Orange,2020-05-26,301,117,418
3275,Humboldt,2020-05-26,5,5,10
3276,Marin,2020-05-26,2,3,5
3277,Contra Costa,2020-05-26,13,36,49
3278,Lake,2020-05-26,0,1,1
3279,Sutter,2020-05-26,0,0,0
3280,Yuba,2020-05-26,1,0,1
3281,Tuolumne,2020-05-26,0,1,1
3282,Alameda,2020-05-26,93,76,169
3283,Ventura,2020-05-26,34,28,62
3284,Tulare,2020-05-26,37,4,41
3285,Solano,2020-05-26,19,16,35
3286,Calaveras,2020-05-26,0,0,0
3287,Monterey,2020-05-26,11,1,12
3288,Tehama,2020-05-26,0,1,1
3289,Madera,2020-05-26,1,4,5
3290,San Diego,2020-05-26,325,58,383
3291,Santa Barbara,2020-05-26,18,5,23
3292,Mariposa,2020-05-26,0,2,2
3293,San Francisco,2020-05-26,40,47,87
3294,Sacramento,2020-05-26,9,9,18
3295,Lassen,2020-05-26,0,1,1
3296,Kings,2020-05-26,24,3,27
3297,Santa Clara,2020-05-26,33,20,53
3298,Kern,2020-05-26,59,7,66
3299,Santa Cruz,2020-05-26,4,1,5
3300,Napa,2020-05-26,1,1,2
3301,San Benito,2020-05-27,1,0,1
3302,Fresno,2020-05-27,71,44,115
3303,Alameda,2020-05-27,95,69,164
3304,Merced,2020-05-27,6,2,8
3305,San Joaquin,2020-05-27,14,23,37
3306,Mariposa,2020-05-27,0,2,2
3307,Placer,2020-05-27,6,14,20
3308,Lassen,2020-05-27,0,1,1
3309,Shasta,2020-05-27,0,0,0
3310,Sutter,2020-05-27,0,0,0
3311,Tehama,2020-05-27,0,0,0
3312,Santa Cruz,2020-05-27,3,0,3
3313,Amador,2020-05-27,0,0,0
3314,Mendocino,2020-05-27,3,1,4
3315,Monterey,2020-05-27,11,0,11
3316,Del Norte,2020-05-27,0,0,0
3317,El Dorado,2020-05-27,1,2,3
3318,Santa Clara,2020-05-27,28,24,52
3319,Yuba,2020-05-27,1,0,1
3320,Mono,2020-05-27,0,0,0
3321,Orange,2020-05-27,307,111,418
3322,Plumas,2020-05-27,0,0,0
3323,Colusa,2020-05-27,0,0,0
3324,Butte,2020-05-27,6,1,7
3325,San Luis Obispo,2020-05-27,2,4,6
3326,Santa Barbara,2020-05-27,22,5,27
3327,Modoc,2020-05-27,0,0,0
3328,Inyo,2020-05-27,0,0,0
3329,Stanislaus,2020-05-27,17,8,25
3330,San Bernardino,2020-05-27,159,101,260
3331,Lake,2020-05-27,0,0,0
3332,Sonoma,2020-05-27,9,22,31
3333,Kings,2020-05-27,23,1,24
3334,Napa,2020-05-27,1,1,2
3335,Madera,2020-05-27,2,2,4
3336,Los Angeles,2020-05-27,1462,628,2090
3337,Humboldt,2020-05-27,5,4,9
3338,San Mateo,2020-05-27,33,8,41
3339,Contra Costa,2020-05-27,11,30,41
3340,Sacramento,2020-05-27,8,21,29
3341,Kern,2020-05-27,63,5,68
3342,San Diego,2020-05-27,329,79,408
3343,Tulare,2020-05-27,36,5,41
3344,Ventura,2020-05-27,28,24,52
3345,Trinity,2020-05-27,0,2,2
3346,Nevada,2020-05-27,1,3,4
3347,Tuolumne,2020-05-27,0,0,0
3348,Marin,2020-05-27,1,1,2
3349,Riverside,2020-05-27,199,114,313
3350,San Francisco,2020-05-27,40,42,82
3351,Calaveras,2020-05-27,0,0,0
3352,Siskiyou,2020-05-27,0,3,3
3353,Solano,2020-05-27,20,14,34
3354,Glenn,2020-05-27,0,0,0
3355,Imperial,2020-05-27,67,17,84
3356,Yolo,2020-05-27,0,0,0
3357,Napa,2020-05-28,1,1,2
3358,Yolo,2020-05-28,0,0,0
3359,San Luis Obispo,2020-05-28,2,0,2
3360,Madera,2020-05-28,1,0,1
3361,Marin,2020-05-28,3,7,10
3362,Contra Costa,2020-05-28,13,38,51
3363,Lassen,2020-05-28,0,1,1
3364,Butte,2020-05-28,5,1,6
3365,San Francisco,2020-05-28,49,42,91
3366,Lake,2020-05-28,0,1,1
3367,Los Angeles,2020-05-28,1415,639,2054
3368,San Mateo,2020-05-28,39,10,49
3369,San Benito,2020-05-28,0,0,0
3370,Sutter,2020-05-28,0,0,0
3371,Mariposa,2020-05-28,0,2,2
3372,Del Norte,2020-05-28,0,0,0
3373,Glenn,2020-05-28,0,0,0
3374,Trinity,2020-05-28,0,3,3
3375,Inyo,2020-05-28,0,0,0
3376,Siskiyou,2020-05-28,0,0,0
3377,Plumas,2020-05-28,0,0,0
3378,Alameda,2020-05-28,96,57,153
3379,San Joaquin,2020-05-28,15,25,40
3380,Mendocino,2020-05-28,3,0,3
3381,Nevada,2020-05-28,1,2,3
3382,Modoc,2020-05-28,0,0,0
3383,Sonoma,2020-05-28,8,30,38
3384,Fresno,2020-05-28,68,39,107
3385,Sacramento,2020-05-28,14,27,41
3386,Humboldt,2020-05-28,5,4,9
3387,Amador,2020-05-28,0,1,1
3388,Santa Cruz,2020-05-28,3,0,3
3389,Imperial,2020-05-28,61,7,68
3390,Yuba,2020-05-28,1,0,1
3391,Mono,2020-05-28,0,0,0
3392,Monterey,2020-05-28,11,0,11
3393,Tulare,2020-05-28,37,2,39
3394,San Bernardino,2020-05-28,156,87,243
3395,Kings,2020-05-28,25,0,25
3396,Colusa,2020-05-28,0,0,0
3397,Solano,2020-05-28,19,16,35
3398,San Diego,2020-05-28,313,70,383
3399,Tuolumne,2020-05-28,0,0,0
3400,El Dorado,2020-05-28,1,5,6
3401,Placer,2020-05-28,5,18,23
3402,Riverside,2020-05-28,202,99,301
3403,Tehama,2020-05-28,0,0,0
3404,Santa Clara,2020-05-28,26,14,40
3405,Shasta,2020-05-28,0,0,0
3406,Kern,2020-05-28,58,8,66
3407,Orange,2020-05-28,291,106,397
3408,Santa Barbara,2020-05-28,19,7,26
3409,Calaveras,2020-05-28,1,0,1
3410,Ventura,2020-05-28,28,19,47
3411,Merced,2020-05-28,6,2,8
3412,Stanislaus,2020-05-28,15,8,23
3413,Colusa,2020-05-29,0,0,0
3414,Stanislaus,2020-05-29,13,11,24
3415,Napa,2020-05-29,0,0,0
3416,Kings,2020-05-29,27,1,28
3417,Amador,2020-05-29,0,0,0
3418,Yolo,2020-05-29,0,0,0
3419,Tehama,2020-05-29,0,0,0
3420,Ventura,2020-05-29,31,16,47
3421,San Mateo,2020-05-29,37,8,45
3422,Sutter,2020-05-29,0,0,0
3423,Contra Costa,2020-05-29,15,35,50
3424,Sonoma,2020-05-29,7,37,44
3425,San Luis Obispo,2020-05-29,3,5,8
3426,Riverside,2020-05-29,191,79,270
3427,Lassen,2020-05-29,0,1,1
3428,Merced,2020-05-29,6,7,13
3429,Imperial,2020-05-29,60,4,64
3430,Kern,2020-05-29,54,16,70
3431,El Dorado,2020-05-29,1,5,6
3432,Los Angeles,2020-05-29,1402,570,1972
3433,Inyo,2020-05-29,0,0,0
3434,Sacramento,2020-05-29,14,23,37
3435,Tulare,2020-05-29,37,3,40
3436,Alameda,2020-05-29,102,77,179
3437,San Diego,2020-05-29,300,58,358
3438,Glenn,2020-05-29,0,0,0
3439,Fresno,2020-05-29,63,44,107
3440,Siskiyou,2020-05-29,1,0,1
3441,San Benito,2020-05-29,0,0,0
3442,San Bernardino,2020-05-29,134,95,229
3443,Santa Clara,2020-05-29,26,22,48
3444,Trinity,2020-05-29,0,0,0
3445,Nevada,2020-05-29,0,2,2
3446,Calaveras,2020-05-29,1,1,2
3447,Shasta,2020-05-29,0,0,0
3448,Mariposa,2020-05-29,0,2,2
3449,Humboldt,2020-05-29,5,8,13
3450,Tuolumne,2020-05-29,0,0,0
3451,San Joaquin,2020-05-29,17,24,41
3452,Butte,2020-05-29,6,0,6
3453,Madera,2020-05-29,0,0,0
3454,Lake,2020-05-29,0,1,1
3455,Mono,2020-05-29,0,0,0
3456,Yuba,2020-05-29,1,0,1
3457,Marin,2020-05-29,4,6,10
3458,Monterey,2020-05-29,10,1,11
3459,Plumas,2020-05-29,0,1,1
3460,Orange,2020-05-29,262,62,324
3461,Santa Cruz,2020-05-29,3,9,12
3462,Del Norte,2020-05-29,0,0,0
3463,Placer,2020-05-29,8,15,23
3464,Modoc,2020-05-29,0,0,0
3465,Solano,2020-05-29,20,11,31
3466,Santa Barbara,2020-05-29,16,11,27
3467,Mendocino,2020-05-29,2,0,2
3468,San Francisco,2020-05-29,49,16,65
3469,Lake,2020-05-30,0,0,0
3470,Nevada,2020-05-30,0,1,1
3471,San Diego,2020-05-30,311,86,397
3472,Napa,2020-05-30,0,4,4
3473,Kern,2020-05-30,55,21,76
3474,Humboldt,2020-05-30,5,12,17
3475,Madera,2020-05-30,1,2,3
3476,Alameda,2020-05-30,105,41,146
3477,Glenn,2020-05-30,0,0,0
3478,Del Norte,2020-05-30,0,0,0
3479,Fresno,2020-05-30,70,48,118
3480,San Mateo,2020-05-30,44,13,57
3481,Shasta,2020-05-30,1,0,1
3482,Siskiyou,2020-05-30,0,0,0
3483,San Bernardino,2020-05-30,130,95,225
3484,Sonoma,2020-05-30,5,56,61
3485,Los Angeles,2020-05-30,1357,577,1934
3486,Sacramento,2020-05-30,14,23,37
3487,Plumas,2020-05-30,0,1,1
3488,Orange,2020-05-30,291,131,422
3489,Merced,2020-05-30,7,7,14
3490,Tulare,2020-05-30,37,2,39
3491,Lassen,2020-05-30,0,1,1
3492,Stanislaus,2020-05-30,14,8,22
3493,Sutter,2020-05-30,0,0,0
3494,Amador,2020-05-30,0,0,0
3495,Mariposa,2020-05-30,0,2,2
3496,El Dorado,2020-05-30,1,6,7
3497,Contra Costa,2020-05-30,14,32,46
3498,Marin,2020-05-30,3,5,8
3499,Riverside,2020-05-30,185,84,269
3500,Modoc,2020-05-30,0,0,0
3501,Santa Clara,2020-05-30,29,17,46
3502,Tehama,2020-05-30,0,0,0
3503,Yolo,2020-05-30,0,0,0
3504,Inyo,2020-05-30,0,0,0
3505,Placer,2020-05-30,6,16,22
3506,Monterey,2020-05-30,11,0,11
3507,San Francisco,2020-05-30,47,17,64
3508,Mendocino,2020-05-30,2,0,2
3509,Colusa,2020-05-30,0,0,0
3510,San Benito,2020-05-30,0,0,0
3511,Trinity,2020-05-30,0,0,0
3512,Butte,2020-05-30,6,0,6
3513,Solano,2020-05-30,18,11,29
3514,Santa Barbara,2020-05-30,18,8,26
3515,Imperial,2020-05-30,73,8,81
3516,Tuolumne,2020-05-30,0,0,0
3517,Mono,2020-05-30,0,0,0
3518,San Joaquin,2020-05-30,19,23,42
3519,Santa Cruz,2020-05-30,3,9,12
3520,San Luis Obispo,2020-05-30,3,2,5
3521,Yuba,2020-05-30,1,0,1
3522,Ventura,2020-05-30,26,20,46
3523,Kings,2020-05-30,27,1,28
3524,Calaveras,2020-05-30,1,1,2
3525,Orange,2020-05-31,283,124,407
3526,San Joaquin,2020-05-31,18,27,45
3527,San Francisco,2020-05-31,50,19,69
3528,Placer,2020-05-31,9,9,18
3529,Sacramento,2020-05-31,16,18,34
3530,Contra Costa,2020-05-31,11,32,43
3531,Calaveras,2020-05-31,1,0,1
3532,Tuolumne,2020-05-31,0,0,0
3533,Solano,2020-05-31,19,10,29
3534,San Luis Obispo,2020-05-31,3,1,4
3535,Sonoma,2020-05-31,5,44,49
3536,Siskiyou,2020-05-31,0,0,0
3537,Mariposa,2020-05-31,0,0,0
3538,San Diego,2020-05-31,306,92,398
3539,Kern,2020-05-31,59,16,75
3540,Merced,2020-05-31,6,5,11
3541,El Dorado,2020-05-31,1,6,7
3542,Lassen,2020-05-31,0,1,1
3543,Inyo,2020-05-31,0,0,0
3544,Humboldt,2020-05-31,4,6,10
3545,Butte,2020-05-31,5,0,5
3546,Ventura,2020-05-31,25,21,46
3547,Modoc,2020-05-31,0,0,0
3548,Los Angeles,2020-05-31,1389,519,1908
3549,Santa Cruz,2020-05-31,3,10,13
3550,Santa Clara,2020-05-31,25,13,38
3551,Mono,2020-05-31,0,0,0
3552,Fresno,2020-05-31,68,52,120
3553,Yolo,2020-05-31,0,0,0
3554,Colusa,2020-05-31,0,1,1
3555,Tehama,2020-05-31,0,0,0
3556,San Bernardino,2020-05-31,136,73,209
3557,Mendocino,2020-05-31,1,0,1
3558,Del Norte,2020-05-31,0,1,1
3559,Sutter,2020-05-31,0,0,0
3560,Nevada,2020-05-31,0,0,0
3561,Trinity,2020-05-31,0,1,1
3562,Alameda,2020-05-31,99,33,132
3563,Shasta,2020-05-31,1,0,1
3564,Napa,2020-05-31,0,2,2
3565,Monterey,2020-05-31,9,0,9
3566,Yuba,2020-05-31,1,0,1
3567,Lake,2020-05-31,1,0,1
3568,Kings,2020-05-31,28,2,30
3569,Stanislaus,2020-05-31,16,17,33
3570,Riverside,2020-05-31,195,99,294
3571,Glenn,2020-05-31,0,0,0
3572,Marin,2020-05-31,2,6,8
3573,Madera,2020-05-31,2,2,4
3574,Santa Barbara,2020-05-31,22,4,26
3575,Tulare,2020-05-31,35,1,36
3576,Imperial,2020-05-31,73,7,80
3577,Plumas,2020-05-31,0,1,1
3578,San Benito,2020-05-31,0,0,0
3579,San Mateo,2020-05-31,46,10,56
3580,Amador,2020-05-31,0,0,0
3581,Colusa,2020-06-01,0,1,1
3582,Shasta,2020-06-01,1,0,1
3583,Glenn,2020-06-01,0,0,0
3584,Santa Barbara,2020-06-01,25,4,29
3585,Mono,2020-06-01,0,0,0
3586,Tehama,2020-06-01,0,0,0
3587,Madera,2020-06-01,2,1,3
3588,El Dorado,2020-06-01,1,5,6
3589,Merced,2020-06-01,5,3,8
3590,Kings,2020-06-01,26,2,28
3591,San Benito,2020-06-01,0,0,0
3592,Santa Clara,2020-06-01,26,14,40
3593,San Mateo,2020-06-01,40,6,46
3594,Plumas,2020-06-01,0,0,0
3595,San Luis Obispo,2020-06-01,3,3,6
3596,Nevada,2020-06-01,0,1,1
3597,Yuba,2020-06-01,1,0,1
3598,Sutter,2020-06-01,0,0,0
3599,Tuolumne,2020-06-01,0,0,0
3600,Solano,2020-06-01,20,17,37
3601,Imperial,2020-06-01,68,3,71
3602,Santa Cruz,2020-06-01,3,1,4
3603,Humboldt,2020-06-01,4,6,10
3604,Contra Costa,2020-06-01,13,17,30
3605,Amador,2020-06-01,0,0,0
3606,Monterey,2020-06-01,9,0,9
3607,Los Angeles,2020-06-01,1422,596,2018
3608,Sonoma,2020-06-01,5,62,67
3609,Lake,2020-06-01,1,1,2
3610,San Diego,2020-06-01,314,83,397
3611,Alameda,2020-06-01,97,51,148
3612,Lassen,2020-06-01,0,1,1
3613,Ventura,2020-06-01,24,21,45
3614,Placer,2020-06-01,9,8,17
3615,Fresno,2020-06-01,68,54,122
3616,Sacramento,2020-06-01,14,18,32
3617,Trinity,2020-06-01,0,1,1
3618,Yolo,2020-06-01,0,0,0
3619,Mendocino,2020-06-01,0,1,1
3620,Calaveras,2020-06-01,1,0,1
3621,Riverside,2020-06-01,203,104,307
3622,Stanislaus,2020-06-01,22,11,33
3623,Kern,2020-06-01,63,14,77
3624,Napa,2020-06-01,0,2,2
3625,Orange,2020-06-01,292,113,405
3626,San Francisco,2020-06-01,45,29,74
3627,Butte,2020-06-01,4,0,4
3628,Modoc,2020-06-01,0,0,0
3629,Inyo,2020-06-01,0,0,0
3630,Del Norte,2020-06-01,0,0,0
3631,Marin,2020-06-01,2,3,5
3632,Mariposa,2020-06-01,0,0,0
3633,Tulare,2020-06-01,34,1,35
3634,San Bernardino,2020-06-01,148,69,217
3635,Siskiyou,2020-06-01,0,3,3
3636,San Joaquin,2020-06-01,23,25,48
3637,San Mateo,2020-06-02,42,17,59
3638,Butte,2020-06-02,4,2,6
3639,Santa Clara,2020-06-02,26,23,49
3640,Trinity,2020-06-02,0,2,2
3641,Mendocino,2020-06-02,1,0,1
3642,Imperial,2020-06-02,66,1,67
3643,Placer,2020-06-02,9,18,27
3644,Solano,2020-06-02,16,16,32
3645,Los Angeles,2020-06-02,1457,570,2027
3646,Humboldt,2020-06-02,3,6,9
3647,Kern,2020-06-02,67,15,82
3648,Riverside,2020-06-02,211,94,305
3649,Inyo,2020-06-02,0,0,0
3650,Tulare,2020-06-02,32,2,34
3651,Tehama,2020-06-02,0,0,0
3652,Santa Cruz,2020-06-02,2,3,5
3653,Del Norte,2020-06-02,0,0,0
3654,Marin,2020-06-02,1,10,11
3655,Sonoma,2020-06-02,3,69,72
3656,Modoc,2020-06-02,0,0,0
3657,Yuba,2020-06-02,1,0,1
3658,Mariposa,2020-06-02,0,0,0
3659,Lassen,2020-06-02,0,1,1
3660,Glenn,2020-06-02,0,0,0
3661,Kings,2020-06-02,31,1,32
3662,Alameda,2020-06-02,92,68,160
3663,Plumas,2020-06-02,0,0,0
3664,Sutter,2020-06-02,0,0,0
3665,San Luis Obispo,2020-06-02,2,2,4
3666,Sacramento,2020-06-02,17,25,42
3667,Madera,2020-06-02,6,4,10
3668,San Diego,2020-06-02,297,72,369
3669,Merced,2020-06-02,4,2,6
3670,Contra Costa,2020-06-02,15,41,56
3671,El Dorado,2020-06-02,1,7,8
3672,Tuolumne,2020-06-02,0,0,0
3673,Lake,2020-06-02,1,1,2
3674,Nevada,2020-06-02,0,1,1
3675,Calaveras,2020-06-02,1,0,1
3676,Siskiyou,2020-06-02,0,3,3
3677,San Benito,2020-06-02,0,0,0
3678,Yolo,2020-06-02,0,0,0
3679,Mono,2020-06-02,0,0,0
3680,San Bernardino,2020-06-02,156,70,226
3681,San Francisco,2020-06-02,43,28,71
3682,Amador,2020-06-02,0,0,0
3683,Colusa,2020-06-02,0,1,1
3684,Fresno,2020-06-02,64,37,101
3685,Santa Barbara,2020-06-02,25,3,28
3686,Napa,2020-06-02,0,2,2
3687,Ventura,2020-06-02,25,21,46
3688,Shasta,2020-06-02,1,0,1
3689,Orange,2020-06-02,306,92,398
3690,San Joaquin,2020-06-02,25,27,52
3691,Stanislaus,2020-06-02,25,11,36
3692,Monterey,2020-06-02,12,0,12
3693,Butte,2020-06-03,4,0,4
3694,San Francisco,2020-06-03,37,34,71
3695,Placer,2020-06-03,11,23,34
3696,Napa,2020-06-03,0,2,2
3697,San Benito,2020-06-03,0,0,0
3698,Imperial,2020-06-03,69,4,73
3699,Santa Barbara,2020-06-03,21,4,25
3700,Marin,2020-06-03,1,10,11
3701,Monterey,2020-06-03,12,0,12
3702,Tuolumne,2020-06-03,0,0,0
3703,Sutter,2020-06-03,0,0,0
3704,Amador,2020-06-03,0,0,0
3705,Sacramento,2020-06-03,19,33,52
3706,San Mateo,2020-06-03,43,23,66
3707,Contra Costa,2020-06-03,15,52,67
3708,Stanislaus,2020-06-03,27,14,41
3709,Santa Cruz,2020-06-03,2,1,3
3710,Orange,2020-06-03,296,80,376
3711,Riverside,2020-06-03,221,101,322
3712,Colusa,2020-06-03,0,0,0
3713,Yuba,2020-06-03,2,0,2
3714,Mono,2020-06-03,0,0,0
3715,Yolo,2020-06-03,0,0,0
3716,San Luis Obispo,2020-06-03,2,1,3
3717,Tehama,2020-06-03,0,0,0
3718,Inyo,2020-06-03,0,0,0
3719,Calaveras,2020-06-03,1,0,1
3720,El Dorado,2020-06-03,1,6,7
3721,Lassen,2020-06-03,0,1,1
3722,Del Norte,2020-06-03,0,0,0
3723,Siskiyou,2020-06-03,0,1,1
3724,Ventura,2020-06-03,24,19,43
3725,San Joaquin,2020-06-03,28,32,60
3726,Alameda,2020-06-03,89,80,169
3727,Madera,2020-06-03,0,0,0
3728,Santa Clara,2020-06-03,30,27,57
3729,Nevada,2020-06-03,0,0,0
3730,Solano,2020-06-03,10,13,23
3731,Mendocino,2020-06-03,1,0,1
3732,Kern,2020-06-03,66,9,75
3733,Kings,2020-06-03,32,0,32
3734,Tulare,2020-06-03,37,2,39
3735,Trinity,2020-06-03,0,2,2
3736,San Bernardino,2020-06-03,157,75,232
3737,Humboldt,2020-06-03,1,5,6
3738,Glenn,2020-06-03,0,0,0
3739,Los Angeles,2020-06-03,1488,502,1990
3740,Modoc,2020-06-03,0,0,0
3741,Sonoma,2020-06-03,3,76,79
3742,San Diego,2020-06-03,295,75,370
3743,Shasta,2020-06-03,1,0,1
3744,Fresno,2020-06-03,59,38,97
3745,Merced,2020-06-03,3,1,4
3746,Lake,2020-06-03,1,0,1
3747,Mariposa,2020-06-03,0,0,0
3748,Plumas,2020-06-03,0,0,0
3749,Monterey,2020-06-04,13,1,14
3750,Mendocino,2020-06-04,1,0,1
3751,Modoc,2020-06-04,0,0,0
3752,Kings,2020-06-04,33,0,33
3753,Tehama,2020-06-04,0,0,0
3754,Los Angeles,2020-06-04,1462,586,2048
3755,Merced,2020-06-04,3,4,7
3756,Contra Costa,2020-06-04,18,70,88
3757,Mariposa,2020-06-04,0,0,0
3758,Yuba,2020-06-04,3,0,3
3759,Del Norte,2020-06-04,0,0,0
3760,Marin,2020-06-04,2,8,10
3761,Imperial,2020-06-04,74,3,77
3762,El Dorado,2020-06-04,1,5,6
3763,Mono,2020-06-04,0,0,0
3764,Amador,2020-06-04,0,0,0
3765,Tuolumne,2020-06-04,1,0,1
3766,Lake,2020-06-04,2,2,4
3767,Inyo,2020-06-04,0,0,0
3768,Yolo,2020-06-04,0,0,0
3769,San Benito,2020-06-04,0,0,0
3770,Santa Cruz,2020-06-04,2,3,5
3771,Butte,2020-06-04,4,0,4
3772,Shasta,2020-06-04,2,0,2
3773,Lassen,2020-06-04,0,1,1
3774,San Diego,2020-06-04,297,82,379
3775,Calaveras,2020-06-04,0,0,0
3776,San Luis Obispo,2020-06-04,2,0,2
3777,Alameda,2020-06-04,82,92,174
3778,San Mateo,2020-06-04,35,18,53
3779,Napa,2020-06-04,0,3,3
3780,Sacramento,2020-06-04,28,33,61
3781,Riverside,2020-06-04,226,91,317
3782,Santa Clara,2020-06-04,37,38,75
3783,San Bernardino,2020-06-04,168,70,238
3784,Ventura,2020-06-04,27,23,50
3785,Nevada,2020-06-04,0,0,0
3786,Humboldt,2020-06-04,0,2,2
3787,Trinity,2020-06-04,0,1,1
3788,Sonoma,2020-06-04,4,54,58
3789,Madera,2020-06-04,1,1,2
3790,Sutter,2020-06-04,0,0,0
3791,Placer,2020-06-04,11,35,46
3792,Fresno,2020-06-04,66,35,101
3793,Santa Barbara,2020-06-04,28,10,38
3794,Solano,2020-06-04,10,21,31
3795,Glenn,2020-06-04,0,0,0
3796,San Francisco,2020-06-04,41,21,62
3797,Tulare,2020-06-04,39,2,41
3798,Siskiyou,2020-06-04,0,1,1
3799,Colusa,2020-06-04,0,0,0
3800,Stanislaus,2020-06-04,29,16,45
3801,Kern,2020-06-04,62,14,76
3802,Plumas,2020-06-04,0,0,0
3803,Orange,2020-06-04,300,110,410
3804,San Joaquin,2020-06-04,28,27,55
3805,Sutter,2020-06-05,0,0,0
3806,Glenn,2020-06-05,0,0,0
3807,Lassen,2020-06-05,0,0,0
3808,San Bernardino,2020-06-05,180,63,243
3809,Marin,2020-06-05,2,9,11
3810,Sacramento,2020-06-05,35,37,72
3811,Lake,2020-06-05,1,0,1
3812,Madera,2020-06-05,3,2,5
3813,Tuolumne,2020-06-05,1,0,1
3814,Kings,2020-06-05,31,0,31
3815,Nevada,2020-06-05,0,2,2
3816,San Benito,2020-06-05,0,0,0
3817,Plumas,2020-06-05,0,0,0
3818,Mendocino,2020-06-05,1,0,1
3819,Imperial,2020-06-05,79,3,82
3820,San Francisco,2020-06-05,42,22,64
3821,Del Norte,2020-06-05,0,0,0
3822,Modoc,2020-06-05,0,0,0
3823,Calaveras,2020-06-05,0,0,0
3824,Santa Clara,2020-06-05,43,32,75
3825,Stanislaus,2020-06-05,25,14,39
3826,Riverside,2020-06-05,228,98,326
3827,El Dorado,2020-06-05,2,3,5
3828,Placer,2020-06-05,11,21,32
3829,San Luis Obispo,2020-06-05,3,3,6
3830,San Diego,2020-06-05,299,69,368
3831,Yolo,2020-06-05,0,0,0
3832,Mariposa,2020-06-05,0,0,0
3833,Fresno,2020-06-05,67,30,97
3834,Humboldt,2020-06-05,0,1,1
3835,Shasta,2020-06-05,0,0,0
3836,Monterey,2020-06-05,14,1,15
3837,Contra Costa,2020-06-05,17,46,63
3838,Alameda,2020-06-05,82,68,150
3839,Ventura,2020-06-05,29,21,50
3840,Merced,2020-06-05,4,1,5
3841,Tulare,2020-06-05,39,2,41
3842,Orange,2020-06-05,315,80,395
3843,Tehama,2020-06-05,0,0,0
3844,Napa,2020-06-05,1,2,3
3845,Yuba,2020-06-05,3,0,3
3846,Sonoma,2020-06-05,3,69,72
3847,Santa Cruz,2020-06-05,2,3,5
3848,Trinity,2020-06-05,0,0,0
3849,Santa Barbara,2020-06-05,29,8,37
3850,Siskiyou,2020-06-05,0,1,1
3851,Butte,2020-06-05,2,0,2
3852,Los Angeles,2020-06-05,1451,547,1998
3853,Kern,2020-06-05,62,16,78
3854,San Joaquin,2020-06-05,26,33,59
3855,San Mateo,2020-06-05,36,18,54
3856,Solano,2020-06-05,13,20,33
3857,Colusa,2020-06-05,0,0,0
3858,Inyo,2020-06-05,0,0,0
3859,Amador,2020-06-05,0,0,0
3860,Mono,2020-06-05,0,0,0
3861,Lassen,2020-06-06,0,0,0
3862,Monterey,2020-06-06,13,0,13
3863,Merced,2020-06-06,5,0,5
3864,Santa Barbara,2020-06-06,30,3,33
3865,San Joaquin,2020-06-06,30,34,64
3866,Butte,2020-06-06,1,0,1
3867,Kings,2020-06-06,26,1,27
3868,El Dorado,2020-06-06,1,4,5
3869,Sutter,2020-06-06,0,0,0
3870,Yolo,2020-06-06,0,0,0
3871,Inyo,2020-06-06,0,0,0
3872,San Luis Obispo,2020-06-06,3,4,7
3873,Solano,2020-06-06,12,16,28
3874,Mono,2020-06-06,0,0,0
3875,Napa,2020-06-06,1,3,4
3876,Sacramento,2020-06-06,33,28,61
3877,Trinity,2020-06-06,0,0,0
3878,Calaveras,2020-06-06,0,0,0
3879,Tulare,2020-06-06,34,1,35
3880,Imperial,2020-06-06,81,2,83
3881,Orange,2020-06-06,309,67,376
3882,Alameda,2020-06-06,83,72,155
3883,Tuolumne,2020-06-06,0,0,0
3884,Contra Costa,2020-06-06,18,43,61
3885,Marin,2020-06-06,3,6,9
3886,Amador,2020-06-06,0,0,0
3887,Tehama,2020-06-06,0,0,0
3888,San Bernardino,2020-06-06,195,59,254
3889,Glenn,2020-06-06,0,0,0
3890,Kern,2020-06-06,80,32,112
3891,San Diego,2020-06-06,285,76,361
3892,Yuba,2020-06-06,5,0,5
3893,Ventura,2020-06-06,33,28,61
3894,Shasta,2020-06-06,0,0,0
3895,Sonoma,2020-06-06,4,71,75
3896,Placer,2020-06-06,10,24,34
3897,Lake,2020-06-06,1,1,2
3898,Santa Clara,2020-06-06,41,32,73
3899,Mariposa,2020-06-06,0,0,0
3900,Madera,2020-06-06,5,3,8
3901,San Benito,2020-06-06,0,0,0
3902,Colusa,2020-06-06,0,0,0
3903,San Mateo,2020-06-06,37,21,58
3904,Plumas,2020-06-06,0,0,0
3905,Los Angeles,2020-06-06,1399,582,1981
3906,Riverside,2020-06-06,220,89,309
3907,Siskiyou,2020-06-06,0,1,1
3908,Nevada,2020-06-06,0,2,2
3909,Del Norte,2020-06-06,0,0,0
3910,Modoc,2020-06-06,0,0,0
3911,Fresno,2020-06-06,70,41,111
3912,Mendocino,2020-06-06,1,0,1
3913,Humboldt,2020-06-06,1,5,6
3914,Santa Cruz,2020-06-06,1,3,4
3915,Stanislaus,2020-06-06,26,9,35
3916,San Francisco,2020-06-06,41,24,65
3917,Fresno,2020-06-07,69,31,100
3918,Alameda,2020-06-07,92,74,166
3919,El Dorado,2020-06-07,2,4,6
3920,San Francisco,2020-06-07,34,14,48
3921,Kern,2020-06-07,83,24,107
3922,Humboldt,2020-06-07,1,4,5
3923,Inyo,2020-06-07,0,0,0
3924,Mendocino,2020-06-07,1,0,1
3925,Colusa,2020-06-07,0,0,0
3926,Napa,2020-06-07,1,2,3
3927,San Luis Obispo,2020-06-07,3,2,5
3928,Lassen,2020-06-07,0,0,0
3929,Trinity,2020-06-07,0,0,0
3930,Lake,2020-06-07,0,0,0
3931,Solano,2020-06-07,13,17,30
3932,Yuba,2020-06-07,5,0,5
3933,Yolo,2020-06-07,0,2,2
3934,Tehama,2020-06-07,0,0,0
3935,Kings,2020-06-07,27,1,28
3936,Butte,2020-06-07,1,0,1
3937,San Bernardino,2020-06-07,164,57,221
3938,San Benito,2020-06-07,0,0,0
3939,San Joaquin,2020-06-07,39,24,63
3940,Santa Cruz,2020-06-07,1,3,4
3941,Tuolumne,2020-06-07,0,0,0
3942,Siskiyou,2020-06-07,0,0,0
3943,Riverside,2020-06-07,217,79,296
3944,Mariposa,2020-06-07,0,0,0
3945,Marin,2020-06-07,1,6,7
3946,Del Norte,2020-06-07,0,1,1
3947,Imperial,2020-06-07,87,1,88
3948,Modoc,2020-06-07,0,0,0
3949,Placer,2020-06-07,10,24,34
3950,Merced,2020-06-07,5,2,7
3951,Sutter,2020-06-07,0,0,0
3952,Amador,2020-06-07,0,1,1
3953,Mono,2020-06-07,0,0,0
3954,Tulare,2020-06-07,28,0,28
3955,Ventura,2020-06-07,39,32,71
3956,Orange,2020-06-07,322,77,399
3957,Monterey,2020-06-07,12,1,13
3958,Plumas,2020-06-07,0,0,0
3959,Nevada,2020-06-07,0,1,1
3960,Glenn,2020-06-07,0,0,0
3961,San Diego,2020-06-07,286,73,359
3962,Madera,2020-06-07,5,6,11
3963,Sonoma,2020-06-07,5,66,71
3964,Calaveras,2020-06-07,0,1,1
3965,San Mateo,2020-06-07,37,20,57
3966,Stanislaus,2020-06-07,27,10,37
3967,Los Angeles,2020-06-07,1453,558,2011
3968,Sacramento,2020-06-07,33,26,59
3969,Contra Costa,2020-06-07,23,44,67
3970,Santa Barbara,2020-06-07,20,3,23
3971,Santa Clara,2020-06-07,38,31,69
3972,Shasta,2020-06-07,0,0,0
3973,Santa Barbara,2020-06-08,22,6,28
3974,Lassen,2020-06-08,0,0,0
3975,Tehama,2020-06-08,0,0,0
3976,Sutter,2020-06-08,0,0,0
3977,Mariposa,2020-06-08,0,0,0
3978,Glenn,2020-06-08,0,0,0
3979,El Dorado,2020-06-08,1,5,6
3980,Contra Costa,2020-06-08,20,35,55
3981,Monterey,2020-06-08,12,0,12
3982,Sonoma,2020-06-08,5,74,79
3983,Butte,2020-06-08,4,0,4
3984,Merced,2020-06-08,5,3,8
3985,Trinity,2020-06-08,0,3,3
3986,Madera,2020-06-08,5,4,9
3987,Plumas,2020-06-08,0,0,0
3988,Marin,2020-06-08,2,0,2
3989,Fresno,2020-06-08,70,37,107
3990,Humboldt,2020-06-08,1,6,7
3991,Santa Clara,2020-06-08,44,17,61
3992,Shasta,2020-06-08,1,0,1
3993,Kings,2020-06-08,24,1,25
3994,Amador,2020-06-08,0,0,0
3995,San Benito,2020-06-08,0,0,0
3996,Imperial,2020-06-08,85,2,87
3997,Colusa,2020-06-08,0,1,1
3998,Santa Cruz,2020-06-08,1,1,2
3999,Stanislaus,2020-06-08,26,13,39
4000,Mono,2020-06-08,0,0,0
4001,San Bernardino,2020-06-08,197,54,251
4002,Los Angeles,2020-06-08,1458,595,2053
4003,Inyo,2020-06-08,1,0,1
4004,Solano,2020-06-08,13,15,28
4005,San Joaquin,2020-06-08,43,27,70
4006,San Luis Obispo,2020-06-08,3,0,3
4007,Nevada,2020-06-08,0,2,2
4008,Calaveras,2020-06-08,0,0,0
4009,Modoc,2020-06-08,0,0,0
4010,Kern,2020-06-08,87,26,113
4011,Napa,2020-06-08,1,6,7
4012,Sacramento,2020-06-08,37,24,61
4013,Riverside,2020-06-08,220,108,328
4014,Orange,2020-06-08,327,64,391
4015,Del Norte,2020-06-08,0,0,0
4016,San Diego,2020-06-08,291,80,371
4017,Siskiyou,2020-06-08,0,0,0
4018,Lake,2020-06-08,0,0,0
4019,Tulare,2020-06-08,34,2,36
4020,Yolo,2020-06-08,0,1,1
4021,Alameda,2020-06-08,92,60,152
4022,Tuolumne,2020-06-08,0,0,0
4023,Yuba,2020-06-08,5,0,5
4024,San Mateo,2020-06-08,34,5,39
4025,Placer,2020-06-08,11,11,22
4026,Mendocino,2020-06-08,1,0,1
4027,Ventura,2020-06-08,42,27,69
4028,San Francisco,2020-06-08,32,11,43
4029,Sacramento,2020-06-09,33,19,52
4030,Tehama,2020-06-09,0,0,0
4031,Amador,2020-06-09,0,0,0
4032,San Bernardino,2020-06-09,205,71,276
4033,Fresno,2020-06-09,68,36,104
4034,Yuba,2020-06-09,4,0,4
4035,Kings,2020-06-09,30,0,30
4036,Merced,2020-06-09,4,0,4
4037,San Diego,2020-06-09,299,74,373
4038,Tulare,2020-06-09,36,8,44
4039,Humboldt,2020-06-09,1,8,9
4040,Los Angeles,2020-06-09,1416,695,2111
4041,Kern,2020-06-09,83,22,105
4042,Mariposa,2020-06-09,0,0,0
4043,San Joaquin,2020-06-09,45,31,76
4044,Shasta,2020-06-09,1,0,1
4045,Santa Cruz,2020-06-09,1,3,4
4046,Sonoma,2020-06-09,5,70,75
4047,Plumas,2020-06-09,0,0,0
4048,Orange,2020-06-09,315,69,384
4049,Contra Costa,2020-06-09,21,40,61
4050,Ventura,2020-06-09,42,45,87
4051,Inyo,2020-06-09,1,0,1
4052,San Benito,2020-06-09,0,0,0
4053,Glenn,2020-06-09,1,0,1
4054,San Mateo,2020-06-09,31,13,44
4055,El Dorado,2020-06-09,0,3,3
4056,Napa,2020-06-09,0,6,6
4057,Del Norte,2020-06-09,0,0,0
4058,Calaveras,2020-06-09,0,0,0
4059,Riverside,2020-06-09,227,106,333
4060,San Francisco,2020-06-09,37,12,49
4061,Alameda,2020-06-09,94,52,146
4062,Modoc,2020-06-09,0,0,0
4063,Butte,2020-06-09,6,0,6
4064,Santa Barbara,2020-06-09,25,7,32
4065,Trinity,2020-06-09,0,2,2
4066,Mono,2020-06-09,0,0,0
4067,Stanislaus,2020-06-09,29,13,42
4068,Sutter,2020-06-09,0,0,0
4069,Yolo,2020-06-09,0,1,1
4070,Madera,2020-06-09,6,5,11
4071,Nevada,2020-06-09,0,3,3
4072,Siskiyou,2020-06-09,0,1,1
4073,Mendocino,2020-06-09,1,0,1
4074,Santa Clara,2020-06-09,41,18,59
4075,Placer,2020-06-09,10,12,22
4076,Colusa,2020-06-09,0,0,0
4077,Monterey,2020-06-09,13,0,13
4078,Tuolumne,2020-06-09,0,0,0
4079,Lassen,2020-06-09,0,0,0
4080,Lake,2020-06-09,0,1,1
4081,Imperial,2020-06-09,83,2,85
4082,San Luis Obispo,2020-06-09,3,2,5
4083,Solano,2020-06-09,17,25,42
4084,Marin,2020-06-09,6,4,10
4085,San Luis Obispo,2020-06-10,3,2,5
4086,Kings,2020-06-10,30,1,31
4087,Plumas,2020-06-10,0,0,0
4088,Orange,2020-06-10,312,72,384
4089,Humboldt,2020-06-10,1,14,15
4090,Sacramento,2020-06-10,36,26,62
4091,Mono,2020-06-10,0,0,0
4092,Santa Cruz,2020-06-10,3,3,6
4093,Stanislaus,2020-06-10,26,15,41
4094,Alameda,2020-06-10,88,46,134
4095,Monterey,2020-06-10,16,0,16
4096,Mariposa,2020-06-10,0,0,0
4097,Yuba,2020-06-10,5,1,6
4098,El Dorado,2020-06-10,0,1,1
4099,San Benito,2020-06-10,0,0,0
4100,Butte,2020-06-10,7,23,30
4101,San Diego,2020-06-10,286,76,362
4102,Santa Barbara,2020-06-10,26,5,31
4103,Merced,2020-06-10,3,4,7
4104,Lake,2020-06-10,0,2,2
4105,Lassen,2020-06-10,0,0,0
4106,Madera,2020-06-10,6,5,11
4107,Ventura,2020-06-10,44,56,100
4108,Tehama,2020-06-10,0,0,0
4109,Los Angeles,2020-06-10,1389,564,1953
4110,San Bernardino,2020-06-10,171,76,247
4111,Riverside,2020-06-10,232,101,333
4112,Tulare,2020-06-10,38,5,43
4113,Modoc,2020-06-10,0,0,0
4114,Santa Clara,2020-06-10,40,22,62
4115,Nevada,2020-06-10,0,2,2
4116,Tuolumne,2020-06-10,0,1,1
4117,Trinity,2020-06-10,0,1,1
4118,Colusa,2020-06-10,0,0,0
4119,Glenn,2020-06-10,1,0,1
4120,Yolo,2020-06-10,0,0,0
4121,Solano,2020-06-10,18,15,33
4122,San Joaquin,2020-06-10,45,38,83
4123,Marin,2020-06-10,8,3,11
4124,Placer,2020-06-10,11,12,23
4125,Amador,2020-06-10,0,0,0
4126,San Mateo,2020-06-10,29,11,40
4127,San Francisco,2020-06-10,39,11,50
4128,Kern,2020-06-10,89,23,112
4129,Calaveras,2020-06-10,0,0,0
4130,Contra Costa,2020-06-10,20,23,43
4131,Siskiyou,2020-06-10,0,0,0
4132,Fresno,2020-06-10,67,35,102
4133,Mendocino,2020-06-10,1,0,1
4134,Imperial,2020-06-10,79,0,79
4135,Del Norte,2020-06-10,0,0,0
4136,Sutter,2020-06-10,0,0,0
4137,Shasta,2020-06-10,1,0,1
4138,Napa,2020-06-10,1,5,6
4139,Inyo,2020-06-10,1,0,1
4140,Sonoma,2020-06-10,5,57,62
4141,Madera,2020-06-11,7,4,11
4142,Monterey,2020-06-11,17,0,17
4143,Lake,2020-06-11,0,0,0
4144,Marin,2020-06-11,8,2,10
4145,Kern,2020-06-11,90,19,109
4146,San Francisco,2020-06-11,38,13,51
4147,Mariposa,2020-06-11,0,0,0
4148,San Luis Obispo,2020-06-11,2,3,5
4149,Santa Clara,2020-06-11,39,18,57
4150,Santa Cruz,2020-06-11,4,2,6
4151,San Benito,2020-06-11,0,0,0
4152,Solano,2020-06-11,19,12,31
4153,Merced,2020-06-11,4,1,5
4154,Amador,2020-06-11,0,0,0
4155,Colusa,2020-06-11,0,0,0
4156,Riverside,2020-06-11,238,68,306
4157,Santa Barbara,2020-06-11,30,7,37
4158,Nevada,2020-06-11,0,2,2
4159,Sutter,2020-06-11,0,0,0
4160,Trinity,2020-06-11,0,0,0
4161,San Bernardino,2020-06-11,194,77,271
4162,Tehama,2020-06-11,0,0,0
4163,Plumas,2020-06-11,0,0,0
4164,Inyo,2020-06-11,1,0,1
4165,Mono,2020-06-11,0,1,1
4166,Glenn,2020-06-11,1,0,1
4167,Tuolumne,2020-06-11,0,0,0
4168,Butte,2020-06-11,5,37,42
4169,Imperial,2020-06-11,86,1,87
4170,Contra Costa,2020-06-11,22,29,51
4171,Tulare,2020-06-11,35,6,41
4172,Yuba,2020-06-11,5,1,6
4173,Siskiyou,2020-06-11,0,0,0
4174,Shasta,2020-06-11,2,0,2
4175,San Mateo,2020-06-11,26,7,33
4176,Kings,2020-06-11,29,2,31
4177,Alameda,2020-06-11,86,38,124
4178,Napa,2020-06-11,0,3,3
4179,Mendocino,2020-06-11,0,0,0
4180,Sonoma,2020-06-11,4,23,27
4181,Los Angeles,2020-06-11,1397,576,1973
4182,Ventura,2020-06-11,43,47,90
4183,San Joaquin,2020-06-11,42,25,67
4184,Orange,2020-06-11,325,67,392
4185,Yolo,2020-06-11,0,1,1
4186,Del Norte,2020-06-11,0,1,1
4187,Sacramento,2020-06-11,39,23,62
4188,Placer,2020-06-11,10,8,18
4189,Lassen,2020-06-11,0,0,0
4190,Modoc,2020-06-11,0,0,0
4191,Humboldt,2020-06-11,1,8,9
4192,San Diego,2020-06-11,277,75,352
4193,Calaveras,2020-06-11,0,0,0
4194,Stanislaus,2020-06-11,29,18,47
4195,Fresno,2020-06-11,67,32,99
4196,El Dorado,2020-06-11,0,1,1
4197,Butte,2020-06-12,5,0,5
4198,Colusa,2020-06-12,0,0,0
4199,Solano,2020-06-12,18,9,27
4200,Imperial,2020-06-12,81,1,82
4201,Calaveras,2020-06-12,0,0,0
4202,Sonoma,2020-06-12,4,38,42
4203,Marin,2020-06-12,8,3,11
4204,Mono,2020-06-12,0,0,0
4205,Humboldt,2020-06-12,1,13,14
4206,Fresno,2020-06-12,69,33,102
4207,Tulare,2020-06-12,12,13,25
4208,Modoc,2020-06-12,0,0,0
4209,Nevada,2020-06-12,0,0,0
4210,Merced,2020-06-12,5,1,6
4211,Mariposa,2020-06-12,0,0,0
4212,Tuolumne,2020-06-12,0,0,0
4213,Siskiyou,2020-06-12,0,1,1
4214,San Joaquin,2020-06-12,49,19,68
4215,San Francisco,2020-06-12,41,11,52
4216,Kern,2020-06-12,96,15,111
4217,Yolo,2020-06-12,0,0,0
4218,Ventura,2020-06-12,46,63,109
4219,Napa,2020-06-12,0,8,8
4220,Madera,2020-06-12,5,4,9
4221,Lake,2020-06-12,0,2,2
4222,Stanislaus,2020-06-12,34,34,68
4223,Monterey,2020-06-12,15,0,15
4224,Placer,2020-06-12,7,8,15
4225,Contra Costa,2020-06-12,22,20,42
4226,Lassen,2020-06-12,0,0,0
4227,Plumas,2020-06-12,0,0,0
4228,Del Norte,2020-06-12,0,0,0
4229,Mendocino,2020-06-12,0,0,0
4230,San Diego,2020-06-12,275,41,316
4231,Santa Barbara,2020-06-12,30,4,34
4232,Trinity,2020-06-12,0,0,0
4233,Alameda,2020-06-12,84,42,126
4234,El Dorado,2020-06-12,0,3,3
4235,San Luis Obispo,2020-06-12,2,3,5
4236,Amador,2020-06-12,0,0,0
4237,Tehama,2020-06-12,0,1,1
4238,Yuba,2020-06-12,6,0,6
4239,Sutter,2020-06-12,0,0,0
4240,San Mateo,2020-06-12,22,10,32
4241,Riverside,2020-06-12,236,83,319
4242,Kings,2020-06-12,34,0,34
4243,San Benito,2020-06-12,0,0,0
4244,Inyo,2020-06-12,1,0,1
4245,Santa Clara,2020-06-12,43,17,60
4246,Sacramento,2020-06-12,35,32,67
4247,Glenn,2020-06-12,1,0,1
4248,San Bernardino,2020-06-12,205,78,283
4249,Los Angeles,2020-06-12,1383,487,1870
4250,Santa Cruz,2020-06-12,4,6,10
4251,Orange,2020-06-12,311,117,428
4252,Shasta,2020-06-12,1,0,1
4253,San Mateo,2020-06-13,18,9,27
4254,Yolo,2020-06-13,0,0,0
4255,San Joaquin,2020-06-13,50,21,71
4256,Sacramento,2020-06-13,28,23,51
4257,Kings,2020-06-13,33,1,34
4258,Santa Barbara,2020-06-13,36,6,42
4259,Inyo,2020-06-13,1,0,1
4260,El Dorado,2020-06-13,0,3,3
4261,San Benito,2020-06-13,0,0,0
4262,Fresno,2020-06-13,64,34,98
4263,Marin,2020-06-13,10,2,12
4264,Nevada,2020-06-13,0,0,0
4265,Santa Cruz,2020-06-13,4,5,9
4266,Ventura,2020-06-13,44,50,94
4267,Solano,2020-06-13,17,5,22
4268,Sonoma,2020-06-13,5,6,11
4269,Lassen,2020-06-13,0,0,0
4270,San Francisco,2020-06-13,41,9,50
4271,Calaveras,2020-06-13,0,0,0
4272,Modoc,2020-06-13,0,0,0
4273,Riverside,2020-06-13,235,101,336
4274,Del Norte,2020-06-13,0,0,0
4275,Yuba,2020-06-13,6,0,6
4276,San Luis Obispo,2020-06-13,2,6,8
4277,Los Angeles,2020-06-13,1285,483,1768
4278,Merced,2020-06-13,3,1,4
4279,Stanislaus,2020-06-13,41,21,62
4280,Tulare,2020-06-13,9,27,36
4281,Plumas,2020-06-13,0,0,0
4282,Mono,2020-06-13,0,0,0
4283,Humboldt,2020-06-13,1,13,14
4284,Sutter,2020-06-13,0,0,0
4285,Orange,2020-06-13,336,70,406
4286,San Diego,2020-06-13,284,58,342
4287,Imperial,2020-06-13,78,8,86
4288,Alameda,2020-06-13,87,27,114
4289,Shasta,2020-06-13,1,0,1
4290,Butte,2020-06-13,3,0,3
4291,Amador,2020-06-13,0,0,0
4292,Mariposa,2020-06-13,0,0,0
4293,Colusa,2020-06-13,0,0,0
4294,Contra Costa,2020-06-13,23,24,47
4295,Lake,2020-06-13,0,1,1
4296,Siskiyou,2020-06-13,0,1,1
4297,Santa Clara,2020-06-13,35,14,49
4298,Glenn,2020-06-13,1,0,1
4299,Trinity,2020-06-13,0,1,1
4300,Monterey,2020-06-13,15,3,18
4301,Placer,2020-06-13,7,6,13
4302,Kern,2020-06-13,79,28,107
4303,Tehama,2020-06-13,0,0,0
4304,Mendocino,2020-06-13,0,0,0
4305,San Bernardino,2020-06-13,204,81,285
4306,Tuolumne,2020-06-13,0,0,0
4307,Madera,2020-06-13,6,2,8
4308,Napa,2020-06-13,0,5,5
4309,Marin,2020-06-14,9,2,11
4310,Plumas,2020-06-14,0,0,0
4311,Nevada,2020-06-14,0,1,1
4312,San Joaquin,2020-06-14,49,25,74
4313,Calaveras,2020-06-14,0,0,0
4314,Yolo,2020-06-14,0,0,0
4315,Butte,2020-06-14,3,0,3
4316,Sacramento,2020-06-14,30,21,51
4317,Alameda,2020-06-14,88,36,124
4318,San Luis Obispo,2020-06-14,2,10,12
4319,Imperial,2020-06-14,79,11,90
4320,Trinity,2020-06-14,0,0,0
4321,San Francisco,2020-06-14,40,9,49
4322,Glenn,2020-06-14,1,0,1
4323,Mono,2020-06-14,0,0,0
4324,Monterey,2020-06-14,11,4,15
4325,Mendocino,2020-06-14,0,0,0
4326,Shasta,2020-06-14,0,0,0
4327,Siskiyou,2020-06-14,0,1,1
4328,Yuba,2020-06-14,7,0,7
4329,Los Angeles,2020-06-14,1288,509,1797
4330,San Mateo,2020-06-14,18,11,29
4331,Lassen,2020-06-14,0,0,0
4332,Kern,2020-06-14,81,22,103
4333,Del Norte,2020-06-14,0,0,0
4334,Napa,2020-06-14,2,1,3
4335,Fresno,2020-06-14,58,35,93
4336,Modoc,2020-06-14,0,0,0
4337,Sutter,2020-06-14,0,0,0
4338,Riverside,2020-06-14,228,92,320
4339,Tehama,2020-06-14,0,0,0
4340,San Diego,2020-06-14,282,84,366
4341,Placer,2020-06-14,7,6,13
4342,Lake,2020-06-14,0,1,1
4343,Kings,2020-06-14,38,2,40
4344,Inyo,2020-06-14,0,0,0
4345,Colusa,2020-06-14,0,0,0
4346,Ventura,2020-06-14,42,47,89
4347,Merced,2020-06-14,3,1,4
4348,Santa Barbara,2020-06-14,37,4,41
4349,Santa Cruz,2020-06-14,3,6,9
4350,Solano,2020-06-14,14,7,21
4351,Santa Clara,2020-06-14,38,16,54
4352,San Bernardino,2020-06-14,206,89,295
4353,Amador,2020-06-14,0,0,0
4354,El Dorado,2020-06-14,0,4,4
4355,Stanislaus,2020-06-14,44,12,56
4356,San Benito,2020-06-14,0,0,0
4357,Madera,2020-06-14,5,0,5
4358,Sonoma,2020-06-14,5,29,34
4359,Tuolumne,2020-06-14,0,0,0
4360,Mariposa,2020-06-14,0,0,0
4361,Tulare,2020-06-14,38,2,40
4362,Contra Costa,2020-06-14,26,16,42
4363,Humboldt,2020-06-14,0,4,4
4364,Orange,2020-06-14,321,100,421
4365,San Bernardino,2020-06-15,221,74,295
4366,Yuba,2020-06-15,6,0,6
4367,Amador,2020-06-15,1,0,1
4368,Sutter,2020-06-15,0,0,0
4369,Glenn,2020-06-15,1,0,1
4370,Sonoma,2020-06-15,6,30,36
4371,Merced,2020-06-15,3,0,3
4372,Santa Clara,2020-06-15,38,16,54
4373,Kings,2020-06-15,38,1,39
4374,San Francisco,2020-06-15,37,8,45
4375,Tuolumne,2020-06-15,0,0,0
4376,Madera,2020-06-15,5,2,7
4377,Shasta,2020-06-15,0,0,0
4378,Solano,2020-06-15,16,7,23
4379,Contra Costa,2020-06-15,27,6,33
4380,Trinity,2020-06-15,0,0,0
4381,Fresno,2020-06-15,61,25,86
4382,Tulare,2020-06-15,46,3,49
4383,Santa Cruz,2020-06-15,2,3,5
4384,Mariposa,2020-06-15,0,0,0
4385,Siskiyou,2020-06-15,0,0,0
4386,San Luis Obispo,2020-06-15,3,1,4
4387,Butte,2020-06-15,3,2,5
4388,Kern,2020-06-15,90,17,107
4389,Colusa,2020-06-15,0,0,0
4390,Napa,2020-06-15,5,1,6
4391,Mono,2020-06-15,0,0,0
4392,Del Norte,2020-06-15,0,0,0
4393,El Dorado,2020-06-15,0,2,2
4394,Tehama,2020-06-15,0,0,0
4395,San Benito,2020-06-15,0,0,0
4396,Calaveras,2020-06-15,0,0,0
4397,Santa Barbara,2020-06-15,42,7,49
4398,Inyo,2020-06-15,0,0,0
4399,Los Angeles,2020-06-15,1420,536,1956
4400,Alameda,2020-06-15,98,31,129
4401,Orange,2020-06-15,346,79,425
4402,Riverside,2020-06-15,237,98,335
4403,Marin,2020-06-15,6,3,9
4404,Ventura,2020-06-15,44,39,83
4405,Yolo,2020-06-15,0,0,0
4406,Imperial,2020-06-15,79,3,82
4407,San Joaquin,2020-06-15,46,13,59
4408,Lassen,2020-06-15,0,0,0
4409,Nevada,2020-06-15,0,2,2
4410,Stanislaus,2020-06-15,43,18,61
4411,San Mateo,2020-06-15,17,5,22
4412,Plumas,2020-06-15,0,0,0
4413,Placer,2020-06-15,7,6,13
4414,Monterey,2020-06-15,14,2,16
4415,Modoc,2020-06-15,0,0,0
4416,Mendocino,2020-06-15,0,1,1
4417,Lake,2020-06-15,0,0,0
4418,Humboldt,2020-06-15,0,5,5
4419,Sacramento,2020-06-15,33,15,48
4420,San Diego,2020-06-15,294,66,360
4421,Modoc,2020-06-16,0,0,0
4422,Nevada,2020-06-16,0,1,1
4423,Fresno,2020-06-16,67,36,103
4424,Madera,2020-06-16,5,3,8
4425,Kings,2020-06-16,47,0,47
4426,San Luis Obispo,2020-06-16,5,8,13
4427,Mariposa,2020-06-16,0,0,0
4428,San Benito,2020-06-16,0,0,0
4429,Tuolumne,2020-06-16,0,0,0
4430,Monterey,2020-06-16,13,4,17
4431,Lassen,2020-06-16,0,0,0
4432,Imperial,2020-06-16,83,2,85
4433,Santa Clara,2020-06-16,32,16,48
4434,Kern,2020-06-16,96,14,110
4435,Del Norte,2020-06-16,0,0,0
4436,El Dorado,2020-06-16,0,1,1
4437,San Mateo,2020-06-16,17,11,28
4438,Ventura,2020-06-16,47,45,92
4439,San Joaquin,2020-06-16,47,14,61
4440,Shasta,2020-06-16,0,0,0
4441,Sonoma,2020-06-16,5,13,18
4442,Calaveras,2020-06-16,0,0,0
4443,Sacramento,2020-06-16,36,21,57
4444,Contra Costa,2020-06-16,26,14,40
4445,Solano,2020-06-16,17,8,25
4446,Los Angeles,2020-06-16,1429,518,1947
4447,San Francisco,2020-06-16,34,8,42
4448,Mendocino,2020-06-16,0,0,0
4449,Santa Barbara,2020-06-16,42,8,50
4450,Tulare,2020-06-16,49,4,53
4451,Marin,2020-06-16,6,3,9
4452,Amador,2020-06-16,1,0,1
4453,Plumas,2020-06-16,0,0,0
4454,Placer,2020-06-16,8,10,18
4455,San Bernardino,2020-06-16,229,64,293
4456,Glenn,2020-06-16,1,0,1
4457,Orange,2020-06-16,364,65,429
4458,San Diego,2020-06-16,289,54,343
4459,Yolo,2020-06-16,1,0,1
4460,Merced,2020-06-16,6,2,8
4461,Lake,2020-06-16,0,2,2
4462,Santa Cruz,2020-06-16,3,1,4
4463,Riverside,2020-06-16,257,84,341
4464,Tehama,2020-06-16,0,0,0
4465,Alameda,2020-06-16,95,38,133
4466,Yuba,2020-06-16,6,0,6
4467,Sutter,2020-06-16,0,0,0
4468,Colusa,2020-06-16,0,1,1
4469,Stanislaus,2020-06-16,50,14,64
4470,Inyo,2020-06-16,0,0,0
4471,Butte,2020-06-16,3,0,3
4472,Napa,2020-06-16,4,6,10
4473,Trinity,2020-06-16,0,0,0
4474,Mono,2020-06-16,0,0,0
4475,Humboldt,2020-06-16,1,7,8
4476,Siskiyou,2020-06-16,0,1,1
4477,Orange,2020-06-17,351,74,425
4478,Madera,2020-06-17,4,3,7
4479,Los Angeles,2020-06-17,1446,512,1958
4480,Amador,2020-06-17,1,0,1
4481,Marin,2020-06-17,7,1,8
4482,Sacramento,2020-06-17,34,18,52
4483,Plumas,2020-06-17,0,0,0
4484,Kern,2020-06-17,99,24,123
4485,Sonoma,2020-06-17,6,13,19
4486,Tulare,2020-06-17,46,3,49
4487,Butte,2020-06-17,3,0,3
4488,Mendocino,2020-06-17,0,0,0
4489,Fresno,2020-06-17,73,30,103
4490,Santa Barbara,2020-06-17,38,10,48
4491,Tuolumne,2020-06-17,0,0,0
4492,Santa Cruz,2020-06-17,3,4,7
4493,Ventura,2020-06-17,37,64,101
4494,Merced,2020-06-17,6,4,10
4495,Calaveras,2020-06-17,0,0,0
4496,Yuba,2020-06-17,5,0,5
4497,San Francisco,2020-06-17,35,9,44
4498,Inyo,2020-06-17,0,0,0
4499,Yolo,2020-06-17,2,0,2
4500,San Luis Obispo,2020-06-17,4,3,7
4501,Napa,2020-06-17,3,6,9
4502,Glenn,2020-06-17,1,0,1
4503,Tehama,2020-06-17,0,0,0
4504,Lake,2020-06-17,0,1,1
4505,Stanislaus,2020-06-17,49,25,74
4506,El Dorado,2020-06-17,0,2,2
4507,Santa Clara,2020-06-17,37,18,55
4508,San Bernardino,2020-06-17,233,64,297
4509,Sutter,2020-06-17,0,0,0
4510,Solano,2020-06-17,13,6,19
4511,Del Norte,2020-06-17,0,0,0
4512,San Benito,2020-06-17,0,0,0
4513,Mariposa,2020-06-17,0,0,0
4514,Riverside,2020-06-17,285,94,379
4515,Colusa,2020-06-17,0,0,0
4516,Humboldt,2020-06-17,0,3,3
4517,Contra Costa,2020-06-17,23,9,32
4518,Modoc,2020-06-17,0,0,0
4519,Lassen,2020-06-17,0,0,0
4520,Imperial,2020-06-17,86,3,89
4521,San Diego,2020-06-17,283,60,343
4522,Monterey,2020-06-17,15,2,17
4523,San Joaquin,2020-06-17,50,11,61
4524,Siskiyou,2020-06-17,1,3,4
4525,Trinity,2020-06-17,0,2,2
4526,Placer,2020-06-17,6,10,16
4527,Shasta,2020-06-17,0,0,0
4528,Kings,2020-06-17,48,1,49
4529,Mono,2020-06-17,0,0,0
4530,Nevada,2020-06-17,2,0,2
4531,Alameda,2020-06-17,90,47,137
4532,San Mateo,2020-06-17,14,6,20
4533,Madera,2020-06-18,10,6,16
4534,San Diego,2020-06-18,288,63,351
4535,San Luis Obispo,2020-06-18,6,2,8
4536,Mariposa,2020-06-18,0,0,0
4537,Contra Costa,2020-06-18,25,18,43
4538,Solano,2020-06-18,18,11,29
4539,Marin,2020-06-18,5,1,6
4540,Kern,2020-06-18,89,14,103
4541,Inyo,2020-06-18,0,0,0
4542,Nevada,2020-06-18,2,1,3
4543,Los Angeles,2020-06-18,1406,494,1900
4544,Modoc,2020-06-18,0,0,0
4545,Trinity,2020-06-18,0,2,2
4546,Kings,2020-06-18,48,2,50
4547,Imperial,2020-06-18,72,1,73
4548,Placer,2020-06-18,12,7,19
4549,Shasta,2020-06-18,1,0,1
4550,Merced,2020-06-18,12,5,17
4551,Glenn,2020-06-18,1,0,1
4552,Tehama,2020-06-18,0,0,0
4553,Tulare,2020-06-18,47,4,51
4554,Napa,2020-06-18,4,3,7
4555,Calaveras,2020-06-18,0,1,1
4556,Siskiyou,2020-06-18,1,0,1
4557,Yuba,2020-06-18,4,0,4
4558,Tuolumne,2020-06-18,0,0,0
4559,Fresno,2020-06-18,72,26,98
4560,San Mateo,2020-06-18,15,9,24
4561,San Benito,2020-06-18,0,0,0
4562,Humboldt,2020-06-18,0,3,3
4563,Riverside,2020-06-18,292,129,421
4564,Santa Cruz,2020-06-18,2,2,4
4565,San Joaquin,2020-06-18,56,20,76
4566,Santa Clara,2020-06-18,38,11,49
4567,Monterey,2020-06-18,20,1,21
4568,Sonoma,2020-06-18,5,11,16
4569,Del Norte,2020-06-18,0,0,0
4570,San Bernardino,2020-06-18,253,60,313
4571,Colusa,2020-06-18,0,0,0
4572,Ventura,2020-06-18,40,37,77
4573,San Francisco,2020-06-18,33,12,45
4574,Butte,2020-06-18,4,0,4
4575,Plumas,2020-06-18,0,0,0
4576,Sacramento,2020-06-18,34,13,47
4577,Stanislaus,2020-06-18,56,37,93
4578,Orange,2020-06-18,335,87,422
4579,Santa Barbara,2020-06-18,42,6,48
4580,Alameda,2020-06-18,77,53,130
4581,Sutter,2020-06-18,0,0,0
4582,Mono,2020-06-18,0,0,0
4583,Lassen,2020-06-18,0,0,0
4584,Lake,2020-06-18,0,2,2
4585,Mendocino,2020-06-18,0,0,0
4586,Amador,2020-06-18,1,1,2
4587,Yolo,2020-06-18,2,1,3
4588,El Dorado,2020-06-18,0,3,3
4589,Imperial,2020-06-19,80,0,80
4590,Glenn,2020-06-19,0,0,0
4591,Marin,2020-06-19,5,0,5
4592,Placer,2020-06-19,11,11,22
4593,Humboldt,2020-06-19,0,1,1
4594,Tehama,2020-06-19,0,0,0
4595,Colusa,2020-06-19,0,0,0
4596,Solano,2020-06-19,17,7,24
4597,Sonoma,2020-06-19,4,4,8
4598,San Benito,2020-06-19,0,0,0
4599,Tuolumne,2020-06-19,0,0,0
4600,San Luis Obispo,2020-06-19,5,2,7
4601,Napa,2020-06-19,3,8,11
4602,Los Angeles,2020-06-19,1426,494,1920
4603,Merced,2020-06-19,9,1,10
4604,Sutter,2020-06-19,0,0,0
4605,Mariposa,2020-06-19,0,0,0
4606,San Bernardino,2020-06-19,261,57,318
4607,Amador,2020-06-19,0,0,0
4608,Kings,2020-06-19,49,1,50
4609,Yuba,2020-06-19,4,0,4
4610,El Dorado,2020-06-19,0,3,3
4611,Fresno,2020-06-19,64,37,101
4612,Riverside,2020-06-19,296,90,386
4613,Sacramento,2020-06-19,37,17,54
4614,Modoc,2020-06-19,0,0,0
4615,Shasta,2020-06-19,1,0,1
4616,Lassen,2020-06-19,0,0,0
4617,Santa Cruz,2020-06-19,4,4,8
4618,Mendocino,2020-06-19,1,3,4
4619,Contra Costa,2020-06-19,30,11,41
4620,Kern,2020-06-19,93,10,103
4621,Nevada,2020-06-19,2,3,5
4622,Siskiyou,2020-06-19,1,0,1
4623,Butte,2020-06-19,4,1,5
4624,Del Norte,2020-06-19,0,0,0
4625,Orange,2020-06-19,344,66,410
4626,San Mateo,2020-06-19,15,5,20
4627,Plumas,2020-06-19,0,0,0
4628,San Diego,2020-06-19,294,65,359
4629,San Joaquin,2020-06-19,59,15,74
4630,Yolo,2020-06-19,2,0,2
4631,Ventura,2020-06-19,43,38,81
4632,Monterey,2020-06-19,18,1,19
4633,Lake,2020-06-19,0,0,0
4634,Trinity,2020-06-19,0,4,4
4635,Inyo,2020-06-19,0,0,0
4636,San Francisco,2020-06-19,30,9,39
4637,Calaveras,2020-06-19,0,1,1
4638,Stanislaus,2020-06-19,59,34,93
4639,Tulare,2020-06-19,48,2,50
4640,Madera,2020-06-19,10,1,11
4641,Alameda,2020-06-19,80,57,137
4642,Mono,2020-06-19,0,0,0
4643,Santa Barbara,2020-06-19,46,4,50
4644,Santa Clara,2020-06-19,39,21,60
4645,Inyo,2020-06-20,0,0,0
4646,El Dorado,2020-06-20,0,2,2
4647,Stanislaus,2020-06-20,67,30,97
4648,Contra Costa,2020-06-20,34,17,51
4649,Calaveras,2020-06-20,1,1,2
4650,Orange,2020-06-20,363,83,446
4651,Modoc,2020-06-20,0,0,0
4652,Fresno,2020-06-20,71,44,115
4653,San Benito,2020-06-20,0,0,0
4654,San Diego,2020-06-20,280,50,330
4655,Sonoma,2020-06-20,5,0,5
4656,Riverside,2020-06-20,297,69,366
4657,San Mateo,2020-06-20,15,6,21
4658,Del Norte,2020-06-20,0,0,0
4659,Mendocino,2020-06-20,0,0,0
4660,Los Angeles,2020-06-20,1453,516,1969
4661,Santa Barbara,2020-06-20,52,5,57
4662,Napa,2020-06-20,2,8,10
4663,Kern,2020-06-20,103,13,116
4664,Shasta,2020-06-20,1,0,1
4665,Lassen,2020-06-20,0,0,0
4666,Trinity,2020-06-20,0,4,4
4667,Tuolumne,2020-06-20,0,0,0
4668,Humboldt,2020-06-20,0,1,1
4669,Lake,2020-06-20,0,0,0
4670,Glenn,2020-06-20,0,0,0
4671,Sutter,2020-06-20,0,0,0
4672,Colusa,2020-06-20,0,0,0
4673,Alameda,2020-06-20,77,44,121
4674,Tulare,2020-06-20,47,2,49
4675,Merced,2020-06-20,9,1,10
4676,Monterey,2020-06-20,19,0,19
4677,Marin,2020-06-20,5,0,5
4678,San Luis Obispo,2020-06-20,5,4,9
4679,Mariposa,2020-06-20,0,0,0
4680,Mono,2020-06-20,0,0,0
4681,Imperial,2020-06-20,89,0,89
4682,Yuba,2020-06-20,3,0,3
4683,Amador,2020-06-20,0,0,0
4684,Plumas,2020-06-20,0,0,0
4685,Yolo,2020-06-20,3,0,3
4686,Placer,2020-06-20,10,11,21
4687,San Joaquin,2020-06-20,67,20,87
4688,Santa Cruz,2020-06-20,4,3,7
4689,Sacramento,2020-06-20,39,14,53
4690,Butte,2020-06-20,3,0,3
4691,Ventura,2020-06-20,47,26,73
4692,San Bernardino,2020-06-20,252,78,330
4693,Siskiyou,2020-06-20,1,0,1
4694,San Francisco,2020-06-20,32,24,56
4695,Santa Clara,2020-06-20,41,14,55
4696,Madera,2020-06-20,8,2,10
4697,Kings,2020-06-20,44,0,44
4698,Solano,2020-06-20,22,10,32
4699,Tehama,2020-06-20,0,0,0
4700,Nevada,2020-06-20,3,3,6
4701,Lake,2020-06-21,0,1,1
4702,Fresno,2020-06-21,73,31,104
4703,Alameda,2020-06-21,76,43,119
4704,Kern,2020-06-21,108,17,125
4705,Mariposa,2020-06-21,0,0,0
4706,San Diego,2020-06-21,277,49,326
4707,Imperial,2020-06-21,95,0,95
4708,Orange,2020-06-21,361,85,446
4709,Plumas,2020-06-21,0,0,0
4710,Inyo,2020-06-21,0,0,0
4711,San Joaquin,2020-06-21,81,21,102
4712,Trinity,2020-06-21,0,3,3
4713,San Mateo,2020-06-21,18,9,27
4714,San Francisco,2020-06-21,37,7,44
4715,Yuba,2020-06-21,3,0,3
4716,Sonoma,2020-06-21,4,3,7
4717,Humboldt,2020-06-21,0,1,1
4718,Solano,2020-06-21,20,9,29
4719,Santa Cruz,2020-06-21,5,4,9
4720,Sacramento,2020-06-21,46,15,61
4721,Los Angeles,2020-06-21,1515,486,2001
4722,Glenn,2020-06-21,0,0,0
4723,Lassen,2020-06-21,0,0,0
4724,San Bernardino,2020-06-21,270,74,344
4725,El Dorado,2020-06-21,0,2,2
4726,Sutter,2020-06-21,0,0,0
4727,Santa Barbara,2020-06-21,46,8,54
4728,San Benito,2020-06-21,0,0,0
4729,Napa,2020-06-21,5,3,8
4730,Nevada,2020-06-21,3,4,7
4731,Tuolumne,2020-06-21,0,0,0
4732,Placer,2020-06-21,11,9,20
4733,San Luis Obispo,2020-06-21,4,2,6
4734,Amador,2020-06-21,0,1,1
4735,Ventura,2020-06-21,51,37,88
4736,Del Norte,2020-06-21,0,0,0
4737,Santa Clara,2020-06-21,40,21,61
4738,Tehama,2020-06-21,0,0,0
4739,Riverside,2020-06-21,299,106,405
4740,Monterey,2020-06-21,18,0,18
4741,Marin,2020-06-21,9,2,11
4742,Yolo,2020-06-21,3,1,4
4743,Mono,2020-06-21,0,0,0
4744,Colusa,2020-06-21,0,1,1
4745,Contra Costa,2020-06-21,35,16,51
4746,Mendocino,2020-06-21,0,0,0
4747,Shasta,2020-06-21,2,1,3
4748,Madera,2020-06-21,7,0,7
4749,Merced,2020-06-21,9,3,12
4750,Stanislaus,2020-06-21,70,21,91
4751,Calaveras,2020-06-21,0,1,1
4752,Tulare,2020-06-21,49,5,54
4753,Siskiyou,2020-06-21,1,0,1
4754,Kings,2020-06-21,45,0,45
4755,Butte,2020-06-21,6,0,6
4756,Modoc,2020-06-21,0,0,0
4757,Kern,2020-06-22,115,14,129
4758,San Joaquin,2020-06-22,91,50,141
4759,Butte,2020-06-22,6,3,9
4760,Siskiyou,2020-06-22,1,0,1
4761,Nevada,2020-06-22,3,3,6
4762,Inyo,2020-06-22,0,0,0
4763,Del Norte,2020-06-22,0,0,0
4764,Yolo,2020-06-22,1,0,1
4765,Monterey,2020-06-22,20,1,21
4766,Plumas,2020-06-22,0,0,0
4767,Lassen,2020-06-22,0,0,0
4768,Trinity,2020-06-22,0,2,2
4769,Mono,2020-06-22,0,0,0
4770,Mendocino,2020-06-22,0,0,0
4771,San Diego,2020-06-22,286,60,346
4772,Santa Cruz,2020-06-22,6,4,10
4773,San Luis Obispo,2020-06-22,4,3,7
4774,Contra Costa,2020-06-22,32,19,51
4775,Glenn,2020-06-22,0,0,0
4776,San Bernardino,2020-06-22,301,84,385
4777,Sonoma,2020-06-22,6,1,7
4778,San Benito,2020-06-22,0,0,0
4779,Fresno,2020-06-22,83,39,122
4780,Amador,2020-06-22,0,0,0
4781,Napa,2020-06-22,5,5,10
4782,Sacramento,2020-06-22,46,8,54
4783,Tuolumne,2020-06-22,0,0,0
4784,Solano,2020-06-22,19,7,26
4785,Tehama,2020-06-22,0,0,0
4786,Placer,2020-06-22,11,9,20
4787,Imperial,2020-06-22,95,0,95
4788,Santa Clara,2020-06-22,48,16,64
4789,Tulare,2020-06-22,53,4,57
4790,Alameda,2020-06-22,78,34,112
4791,Yuba,2020-06-22,4,0,4
4792,Madera,2020-06-22,6,1,7
4793,Lake,2020-06-22,0,0,0
4794,Humboldt,2020-06-22,0,1,1
4795,Stanislaus,2020-06-22,73,19,92
4796,Santa Barbara,2020-06-22,51,7,58
4797,Calaveras,2020-06-22,0,0,0
4798,Shasta,2020-06-22,2,0,2
4799,Kings,2020-06-22,47,0,47
4800,Los Angeles,2020-06-22,1556,534,2090
4801,Sutter,2020-06-22,0,0,0
4802,Orange,2020-06-22,376,90,466
4803,Merced,2020-06-22,7,2,9
4804,Modoc,2020-06-22,0,0,0
4805,El Dorado,2020-06-22,1,0,1
4806,Ventura,2020-06-22,49,56,105
4807,Marin,2020-06-22,11,2,13
4808,San Francisco,2020-06-22,40,7,47
4809,San Mateo,2020-06-22,19,4,23
4810,Riverside,2020-06-22,316,107,423
4811,Mariposa,2020-06-22,0,0,0
4812,Colusa,2020-06-22,0,1,1
4813,Mono,2020-06-23,0,0,0
4814,San Diego,2020-06-23,312,58,370
4815,Ventura,2020-06-23,54,40,94
4816,Madera,2020-06-23,7,0,7
4817,Del Norte,2020-06-23,1,0,1
4818,Fresno,2020-06-23,91,48,139
4819,Glenn,2020-06-23,0,0,0
4820,Tehama,2020-06-23,0,0,0
4821,Alameda,2020-06-23,86,42,128
4822,Siskiyou,2020-06-23,1,0,1
4823,Sacramento,2020-06-23,50,15,65
4824,Los Angeles,2020-06-23,1633,626,2259
4825,Kings,2020-06-23,51,0,51
4826,Mariposa,2020-06-23,0,0,0
4827,San Luis Obispo,2020-06-23,5,2,7
4828,Solano,2020-06-23,23,3,26
4829,Marin,2020-06-23,12,2,14
4830,Orange,2020-06-23,406,79,485
4831,Placer,2020-06-23,10,3,13
4832,Merced,2020-06-23,9,3,12
4833,Modoc,2020-06-23,0,0,0
4834,Plumas,2020-06-23,0,0,0
4835,Amador,2020-06-23,0,0,0
4836,Santa Cruz,2020-06-23,6,3,9
4837,Lassen,2020-06-23,0,0,0
4838,Monterey,2020-06-23,21,2,23
4839,Tulare,2020-06-23,56,5,61
4840,Contra Costa,2020-06-23,37,15,52
4841,Santa Clara,2020-06-23,57,15,72
4842,Butte,2020-06-23,7,0,7
4843,Nevada,2020-06-23,3,2,5
4844,El Dorado,2020-06-23,1,2,3
4845,Tuolumne,2020-06-23,1,0,1
4846,Sonoma,2020-06-23,9,5,14
4847,San Francisco,2020-06-23,45,8,53
4848,Colusa,2020-06-23,0,1,1
4849,Santa Barbara,2020-06-23,53,8,61
4850,Yolo,2020-06-23,1,0,1
4851,Kern,2020-06-23,118,15,133
4852,Inyo,2020-06-23,0,0,0
4853,San Mateo,2020-06-23,22,5,27
4854,Stanislaus,2020-06-23,82,16,98
4855,Trinity,2020-06-23,0,1,1
4856,Napa,2020-06-23,7,7,14
4857,Imperial,2020-06-23,93,0,93
4858,San Joaquin,2020-06-23,89,20,109
4859,San Benito,2020-06-23,0,0,0
4860,Yuba,2020-06-23,6,1,7
4861,Calaveras,2020-06-23,0,1,1
4862,Humboldt,2020-06-23,1,1,2
4863,San Bernardino,2020-06-23,311,130,441
4864,Riverside,2020-06-23,315,119,434
4865,Mendocino,2020-06-23,0,0,0
4866,Lake,2020-06-23,0,1,1
4867,Sutter,2020-06-23,0,0,0
4868,Shasta,2020-06-23,3,0,3
4869,Del Norte,2020-06-24,1,0,1
4870,Marin,2020-06-24,14,2,16
4871,Mono,2020-06-24,0,0,0
4872,Lake,2020-06-24,0,1,1
4873,Amador,2020-06-24,0,0,0
4874,Sutter,2020-06-24,0,0,0
4875,Tehama,2020-06-24,0,0,0
4876,San Francisco,2020-06-24,46,9,55
4877,Merced,2020-06-24,14,3,17
4878,Napa,2020-06-24,6,1,7
4879,Colusa,2020-06-24,1,0,1
4880,Kern,2020-06-24,118,14,132
4881,San Joaquin,2020-06-24,89,33,122
4882,Calaveras,2020-06-24,0,0,0
4883,Humboldt,2020-06-24,1,2,3
4884,Santa Clara,2020-06-24,65,13,78
4885,Glenn,2020-06-24,0,0,0
4886,Monterey,2020-06-24,21,4,25
4887,Riverside,2020-06-24,312,125,437
4888,Santa Barbara,2020-06-24,54,3,57
4889,Trinity,2020-06-24,0,2,2
4890,Kings,2020-06-24,54,0,54
4891,Shasta,2020-06-24,3,0,3
4892,Modoc,2020-06-24,0,0,0
4893,Inyo,2020-06-24,0,1,1
4894,Stanislaus,2020-06-24,85,17,102
4895,Imperial,2020-06-24,82,0,82
4896,Placer,2020-06-24,8,8,16
4897,Fresno,2020-06-24,93,46,139
4898,Yolo,2020-06-24,5,0,5
4899,Sonoma,2020-06-24,7,1,8
4900,San Benito,2020-06-24,0,0,0
4901,Tulare,2020-06-24,56,3,59
4902,Siskiyou,2020-06-24,1,0,1
4903,San Bernardino,2020-06-24,331,101,432
4904,El Dorado,2020-06-24,1,0,1
4905,Sacramento,2020-06-24,61,16,77
4906,San Luis Obispo,2020-06-24,6,5,11
4907,Mariposa,2020-06-24,0,0,0
4908,Santa Cruz,2020-06-24,6,3,9
4909,Nevada,2020-06-24,3,0,3
4910,Lassen,2020-06-24,0,0,0
4911,Ventura,2020-06-24,52,34,86
4912,Madera,2020-06-24,9,4,13
4913,Alameda,2020-06-24,89,41,130
4914,Yuba,2020-06-24,5,0,5
4915,San Mateo,2020-06-24,24,5,29
4916,San Diego,2020-06-24,333,50,383
4917,Los Angeles,2020-06-24,1676,607,2283
4918,Mendocino,2020-06-24,0,0,0
4919,Orange,2020-06-24,437,106,543
4920,Butte,2020-06-24,6,1,7
4921,Plumas,2020-06-24,0,0,0
4922,Tuolumne,2020-06-24,0,0,0
4923,Solano,2020-06-24,26,2,28
4924,Contra Costa,2020-06-24,39,19,58
4925,Alameda,2020-06-25,91,49,140
4926,Tehama,2020-06-25,0,0,0
4927,Sutter,2020-06-25,0,0,0
4928,Shasta,2020-06-25,4,1,5
4929,Marin,2020-06-25,14,2,16
4930,Imperial,2020-06-25,76,1,77
4931,Tulare,2020-06-25,55,4,59
4932,Lake,2020-06-25,0,2,2
4933,Lassen,2020-06-25,0,0,0
4934,Kern,2020-06-25,123,14,137
4935,Ventura,2020-06-25,60,38,98
4936,Glenn,2020-06-25,0,0,0
4937,Santa Cruz,2020-06-25,6,7,13
4938,Sonoma,2020-06-25,7,4,11
4939,Madera,2020-06-25,9,4,13
4940,Del Norte,2020-06-25,1,0,1
4941,Kings,2020-06-25,57,0,57
4942,Inyo,2020-06-25,0,0,0
4943,San Diego,2020-06-25,368,57,425
4944,Fresno,2020-06-25,103,44,147
4945,Siskiyou,2020-06-25,1,0,1
4946,El Dorado,2020-06-25,1,0,1
4947,Tuolumne,2020-06-25,1,0,1
4948,Amador,2020-06-25,0,0,0
4949,Monterey,2020-06-25,17,7,24
4950,Contra Costa,2020-06-25,42,18,60
4951,Butte,2020-06-25,6,0,6
4952,Placer,2020-06-25,8,8,16
4953,Solano,2020-06-25,25,4,29
4954,Napa,2020-06-25,5,0,5
4955,Calaveras,2020-06-25,1,1,2
4956,San Francisco,2020-06-25,44,10,54
4957,Orange,2020-06-25,451,95,546
4958,Modoc,2020-06-25,0,0,0
4959,San Joaquin,2020-06-25,101,36,137
4960,San Luis Obispo,2020-06-25,7,1,8
4961,Sacramento,2020-06-25,73,24,97
4962,Santa Clara,2020-06-25,68,14,82
4963,Yolo,2020-06-25,6,0,6
4964,Santa Barbara,2020-06-25,55,4,59
4965,Plumas,2020-06-25,0,0,0
4966,San Benito,2020-06-25,0,0,0
4967,Yuba,2020-06-25,6,0,6
4968,Nevada,2020-06-25,3,1,4
4969,San Mateo,2020-06-25,22,5,27
4970,Mendocino,2020-06-25,0,0,0
4971,Mono,2020-06-25,0,0,0
4972,Riverside,2020-06-25,319,141,460
4973,Colusa,2020-06-25,1,0,1
4974,San Bernardino,2020-06-25,338,98,436
4975,Humboldt,2020-06-25,1,2,3
4976,Los Angeles,2020-06-25,1698,539,2237
4977,Merced,2020-06-25,13,1,14
4978,Trinity,2020-06-25,0,2,2
4979,Stanislaus,2020-06-25,93,21,114
4980,Mariposa,2020-06-25,0,0,0
4981,Riverside,2020-06-26,339,135,474
4982,Solano,2020-06-26,28,5,33
4983,Nevada,2020-06-26,1,5,6
4984,Ventura,2020-06-26,62,38,100
4985,Amador,2020-06-26,0,0,0
4986,San Bernardino,2020-06-26,349,97,446
4987,San Luis Obispo,2020-06-26,7,1,8
4988,Sutter,2020-06-26,0,0,0
4989,Siskiyou,2020-06-26,0,0,0
4990,Tehama,2020-06-26,0,0,0
4991,Yuba,2020-06-26,5,1,6
4992,Calaveras,2020-06-26,1,1,2
4993,Monterey,2020-06-26,17,2,19
4994,Kings,2020-06-26,58,0,58
4995,Glenn,2020-06-26,0,1,1
4996,Sacramento,2020-06-26,73,10,83
4997,Merced,2020-06-26,15,0,15
4998,Alameda,2020-06-26,92,41,133
4999,San Francisco,2020-06-26,54,14,68
5000,Mariposa,2020-06-26,0,0,0
5001,Butte,2020-06-26,6,0,6
5002,Mendocino,2020-06-26,0,0,0
5003,Santa Clara,2020-06-26,66,16,82
5004,Shasta,2020-06-26,5,1,6
5005,Modoc,2020-06-26,0,1,1
5006,Plumas,2020-06-26,0,0,0
5007,Del Norte,2020-06-26,1,0,1
5008,Inyo,2020-06-26,0,0,0
5009,San Diego,2020-06-26,362,65,427
5010,Orange,2020-06-26,467,93,560
5011,Marin,2020-06-26,13,8,21
5012,Stanislaus,2020-06-26,101,21,122
5013,Lassen,2020-06-26,0,0,0
5014,Trinity,2020-06-26,0,1,1
5015,El Dorado,2020-06-26,1,0,1
5016,Mono,2020-06-26,0,0,0
5017,Contra Costa,2020-06-26,42,23,65
5018,San Benito,2020-06-26,0,0,0
5019,Imperial,2020-06-26,71,3,74
5020,Tulare,2020-06-26,58,8,66
5021,Placer,2020-06-26,8,5,13
5022,Colusa,2020-06-26,1,0,1
5023,Humboldt,2020-06-26,2,3,5
5024,Kern,2020-06-26,136,11,147
5025,Fresno,2020-06-26,107,50,157
5026,Madera,2020-06-26,11,2,13
5027,San Mateo,2020-06-26,20,1,21
5028,Yolo,2020-06-26,6,0,6
5029,Santa Cruz,2020-06-26,8,6,14
5030,Lake,2020-06-26,0,1,1
5031,Tuolumne,2020-06-26,1,0,1
5032,Sonoma,2020-06-26,8,4,12
5033,Los Angeles,2020-06-26,1717,579,2296
5034,Santa Barbara,2020-06-26,53,6,59
5035,Napa,2020-06-26,6,1,7
5036,San Joaquin,2020-06-26,116,36,152
5037,Santa Clara,2020-06-27,77,18,95
5038,Trinity,2020-06-27,0,1,1
5039,San Luis Obispo,2020-06-27,8,3,11
5040,San Benito,2020-06-27,0,0,0
5041,Yuba,2020-06-27,6,0,6
5042,Del Norte,2020-06-27,1,0,1
5043,Humboldt,2020-06-27,1,3,4
5044,Shasta,2020-06-27,5,0,5
5045,Sacramento,2020-06-27,77,17,94
5046,Tehama,2020-06-27,0,0,0
5047,San Bernardino,2020-06-27,353,79,432
5048,San Francisco,2020-06-27,56,16,72
5049,Merced,2020-06-27,15,0,15
5050,Mendocino,2020-06-27,0,0,0
5051,San Joaquin,2020-06-27,126,28,154
5052,San Mateo,2020-06-27,23,4,27
5053,Mono,2020-06-27,0,0,0
5054,Solano,2020-06-27,31,5,36
5055,Ventura,2020-06-27,65,41,106
5056,Monterey,2020-06-27,19,2,21
5057,Contra Costa,2020-06-27,38,25,63
5058,Butte,2020-06-27,5,0,5
5059,Santa Barbara,2020-06-27,60,5,65
5060,Imperial,2020-06-27,77,2,79
5061,Riverside,2020-06-27,340,145,485
5062,Lake,2020-06-27,0,3,3
5063,Placer,2020-06-27,11,3,14
5064,Plumas,2020-06-27,0,0,0
5065,Orange,2020-06-27,492,103,595
5066,Lassen,2020-06-27,0,0,0
5067,Siskiyou,2020-06-27,0,0,0
5068,Sutter,2020-06-27,0,0,0
5069,Kings,2020-06-27,54,1,55
5070,Tuolumne,2020-06-27,1,1,2
5071,Madera,2020-06-27,12,10,22
5072,El Dorado,2020-06-27,1,1,2
5073,Fresno,2020-06-27,111,53,164
5074,Calaveras,2020-06-27,1,0,1
5075,Yolo,2020-06-27,5,1,6
5076,Santa Cruz,2020-06-27,9,6,15
5077,Glenn,2020-06-27,0,1,1
5078,Modoc,2020-06-27,0,0,0
5079,Napa,2020-06-27,7,1,8
5080,Nevada,2020-06-27,1,3,4
5081,Amador,2020-06-27,0,0,0
5082,Sonoma,2020-06-27,10,3,13
5083,Marin,2020-06-27,12,2,14
5084,Mariposa,2020-06-27,0,0,0
5085,Colusa,2020-06-27,1,1,2
5086,Tulare,2020-06-27,54,7,61
5087,Los Angeles,2020-06-27,1710,606,2316
5088,Stanislaus,2020-06-27,98,31,129
5089,Kern,2020-06-27,142,34,176
5090,Alameda,2020-06-27,99,40,139
5091,Inyo,2020-06-27,0,0,0
5092,San Diego,2020-06-27,363,74,437
5093,Lassen,2020-06-28,0,0,0
5094,Riverside,2020-06-28,367,115,482
5095,Los Angeles,2020-06-28,1783,682,2465
5096,San Luis Obispo,2020-06-28,8,2,10
5097,Alameda,2020-06-28,102,39,141
5098,Calaveras,2020-06-28,1,1,2
5099,Kings,2020-06-28,53,1,54
5100,Yuba,2020-06-28,7,0,7
5101,El Dorado,2020-06-28,1,3,4
5102,San Mateo,2020-06-28,27,5,32
5103,Orange,2020-06-28,485,110,595
5104,Placer,2020-06-28,13,5,18
5105,Siskiyou,2020-06-28,0,0,0
5106,Modoc,2020-06-28,0,0,0
5107,Marin,2020-06-28,15,4,19
5108,Lake,2020-06-28,2,0,2
5109,Kern,2020-06-28,146,9,155
5110,Nevada,2020-06-28,1,3,4
5111,Yolo,2020-06-28,3,1,4
5112,Shasta,2020-06-28,8,2,10
5113,Ventura,2020-06-28,66,32,98
5114,Santa Cruz,2020-06-28,9,10,19
5115,Napa,2020-06-28,7,3,10
5116,Colusa,2020-06-28,0,0,0
5117,Santa Clara,2020-06-28,83,22,105
5118,Tulare,2020-06-28,66,5,71
5119,Madera,2020-06-28,9,7,16
5120,Inyo,2020-06-28,0,0,0
5121,Fresno,2020-06-28,118,48,166
5122,Mariposa,2020-06-28,0,0,0
5123,San Francisco,2020-06-28,59,10,69
5124,San Bernardino,2020-06-28,376,83,459
5125,Amador,2020-06-28,0,0,0
5126,Stanislaus,2020-06-28,108,28,136
5127,Sonoma,2020-06-28,11,1,12
5128,Sutter,2020-06-28,0,0,0
5129,Mendocino,2020-06-28,0,0,0
5130,Merced,2020-06-28,19,0,19
5131,Tehama,2020-06-28,0,0,0
5132,San Diego,2020-06-28,373,85,458
5133,Del Norte,2020-06-28,1,1,2
5134,Contra Costa,2020-06-28,32,18,50
5135,San Benito,2020-06-28,0,0,0
5136,Solano,2020-06-28,30,5,35
5137,Plumas,2020-06-28,0,0,0
5138,Santa Barbara,2020-06-28,66,3,69
5139,Humboldt,2020-06-28,1,3,4
5140,Imperial,2020-06-28,72,2,74
5141,Butte,2020-06-28,5,0,5
5142,Trinity,2020-06-28,0,4,4
5143,Sacramento,2020-06-28,87,19,106
5144,San Joaquin,2020-06-28,129,31,160
5145,Glenn,2020-06-28,0,1,1
5146,Mono,2020-06-28,0,0,0
5147,Tuolumne,2020-06-28,1,0,1
5148,Monterey,2020-06-28,26,0,26
5149,Orange,2020-06-29,510,114,624
5150,Santa Clara,2020-06-29,87,18,105
5151,Colusa,2020-06-29,0,0,0
5152,San Benito,2020-06-29,0,0,0
5153,Solano,2020-06-29,39,5,44
5154,Inyo,2020-06-29,0,0,0
5155,Tuolumne,2020-06-29,1,0,1
5156,Riverside,2020-06-29,405,102,507
5157,El Dorado,2020-06-29,1,1,2
5158,Butte,2020-06-29,6,1,7
5159,Tulare,2020-06-29,74,6,80
5160,Lake,2020-06-29,2,0,2
5161,Los Angeles,2020-06-29,1889,622,2511
5162,Madera,2020-06-29,9,6,15
5163,Merced,2020-06-29,16,2,18
5164,Marin,2020-06-29,25,4,29
5165,Sacramento,2020-06-29,98,32,130
5166,Santa Cruz,2020-06-29,10,6,16
5167,Amador,2020-06-29,1,0,1
5168,Calaveras,2020-06-29,1,1,2
5169,Santa Barbara,2020-06-29,62,8,70
5170,Monterey,2020-06-29,33,2,35
5171,Ventura,2020-06-29,74,37,111
5172,Siskiyou,2020-06-29,0,0,0
5173,Nevada,2020-06-29,3,4,7
5174,Fresno,2020-06-29,116,54,170
5175,Glenn,2020-06-29,0,0,0
5176,San Luis Obispo,2020-06-29,9,6,15
5177,Imperial,2020-06-29,70,2,72
5178,San Francisco,2020-06-29,63,16,79
5179,Lassen,2020-06-29,0,0,0
5180,Stanislaus,2020-06-29,113,29,142
5181,Yolo,2020-06-29,3,1,4
5182,Sonoma,2020-06-29,11,1,12
5183,Del Norte,2020-06-29,1,0,1
5184,Kern,2020-06-29,151,9,160
5185,San Mateo,2020-06-29,33,8,41
5186,Trinity,2020-06-29,0,5,5
5187,Kings,2020-06-29,55,1,56
5188,Tehama,2020-06-29,0,0,0
5189,Sutter,2020-06-29,0,0,0
5190,San Diego,2020-06-29,395,98,493
5191,Mendocino,2020-06-29,0,0,0
5192,Humboldt,2020-06-29,0,3,3
5193,Yuba,2020-06-29,8,0,8
5194,Mariposa,2020-06-29,0,0,0
5195,Modoc,2020-06-29,0,0,0
5196,Alameda,2020-06-29,111,35,146
5197,Plumas,2020-06-29,0,0,0
5198,Contra Costa,2020-06-29,37,24,61
5199,Placer,2020-06-29,13,9,22
5200,Napa,2020-06-29,7,3,10
5201,Mono,2020-06-29,0,0,0
5202,Shasta,2020-06-29,9,3,12
5203,San Bernardino,2020-06-29,393,85,478
5204,San Joaquin,2020-06-29,133,26,159
5205,Santa Barbara,2020-06-30,64,6,70
5206,Los Angeles,2020-06-30,1893,645,2538
5207,Lassen,2020-06-30,0,0,0
5208,Imperial,2020-06-30,72,2,74
5209,Calaveras,2020-06-30,1,2,3
5210,Mariposa,2020-06-30,0,0,0
5211,Mono,2020-06-30,0,0,0
5212,Tuolumne,2020-06-30,1,0,1
5213,Colusa,2020-06-30,1,2,3
5214,San Francisco,2020-06-30,68,12,80
5215,El Dorado,2020-06-30,3,1,4
5216,Madera,2020-06-30,8,2,10
5217,Sonoma,2020-06-30,11,4,15
5218,Del Norte,2020-06-30,1,0,1
5219,San Luis Obispo,2020-06-30,9,3,12
5220,Alameda,2020-06-30,116,41,157
5221,Lake,2020-06-30,3,2,5
5222,Siskiyou,2020-06-30,0,0,0
5223,Modoc,2020-06-30,0,0,0
5224,Yuba,2020-06-30,5,0,5
5225,Shasta,2020-06-30,10,2,12
5226,Inyo,2020-06-30,0,0,0
5227,Riverside,2020-06-30,419,112,531
5228,Orange,2020-06-30,542,120,662
5229,Tehama,2020-06-30,0,0,0
5230,Sacramento,2020-06-30,106,21,127
5231,Mendocino,2020-06-30,0,0,0
5232,Solano,2020-06-30,41,5,46
5233,Kern,2020-06-30,163,12,175
5234,Plumas,2020-06-30,0,0,0
5235,Kings,2020-06-30,41,0,41
5236,San Bernardino,2020-06-30,406,85,491
5237,Nevada,2020-06-30,4,3,7
5238,Sutter,2020-06-30,0,0,0
5239,Monterey,2020-06-30,36,5,41
5240,Fresno,2020-06-30,129,42,171
5241,San Mateo,2020-06-30,40,7,47
5242,Amador,2020-06-30,1,1,2
5243,Placer,2020-06-30,13,11,24
5244,San Joaquin,2020-06-30,140,56,196
5245,Stanislaus,2020-06-30,118,52,170
5246,Santa Cruz,2020-06-30,10,6,16
5247,Tulare,2020-06-30,73,6,79
5248,Contra Costa,2020-06-30,41,20,61
5249,Merced,2020-06-30,15,1,16
5250,Butte,2020-06-30,6,0,6
5251,San Benito,2020-06-30,1,0,1
5252,Napa,2020-06-30,7,2,9
5253,Glenn,2020-06-30,0,0,0
5254,San Diego,2020-06-30,391,62,453
5255,Yolo,2020-06-30,4,1,5
5256,Humboldt,2020-06-30,1,3,4
5257,Trinity,2020-06-30,0,0,0
5258,Santa Clara,2020-06-30,81,12,93
5259,Ventura,2020-06-30,76,43,119
5260,Marin,2020-06-30,25,4,29
5261,Sacramento,2020-07-01,109,27,136
5262,Imperial,2020-07-01,79,2,81
5263,Madera,2020-07-01,15,7,22
5264,Marin,2020-07-01,30,2,32
5265,Alameda,2020-07-01,123,47,170
5266,Siskiyou,2020-07-01,0,0,0
5267,Riverside,2020-07-01,431,116,547
5268,Placer,2020-07-01,13,20,33
5269,San Diego,2020-07-01,398,64,462
5270,Tulare,2020-07-01,78,5,83
5271,Contra Costa,2020-07-01,50,21,71
5272,San Joaquin,2020-07-01,128,35,163
5273,Merced,2020-07-01,17,9,26
5274,Santa Barbara,2020-07-01,62,4,66
5275,Santa Cruz,2020-07-01,10,0,10
5276,Glenn,2020-07-01,0,0,0
5277,San Bernardino,2020-07-01,428,88,516
5278,Calaveras,2020-07-01,2,0,2
5279,Tuolumne,2020-07-01,3,0,3
5280,Napa,2020-07-01,7,1,8
5281,Lassen,2020-07-01,0,0,0
5282,Humboldt,2020-07-01,1,3,4
5283,Kern,2020-07-01,164,14,178
5284,Orange,2020-07-01,556,149,705
5285,Amador,2020-07-01,1,1,2
5286,Mendocino,2020-07-01,0,0,0
5287,Mariposa,2020-07-01,0,0,0
5288,Los Angeles,2020-07-01,1937,643,2580
5289,Stanislaus,2020-07-01,121,61,182
5290,Solano,2020-07-01,48,9,57
5291,Del Norte,2020-07-01,1,0,1
5292,Yolo,2020-07-01,4,1,5
5293,Fresno,2020-07-01,125,24,149
5294,Kings,2020-07-01,40,1,41
5295,Ventura,2020-07-01,79,38,117
5296,Inyo,2020-07-01,0,0,0
5297,Tehama,2020-07-01,0,0,0
5298,Plumas,2020-07-01,0,0,0
5299,Santa Clara,2020-07-01,82,18,100
5300,San Mateo,2020-07-01,45,10,55
5301,San Francisco,2020-07-01,71,14,85
5302,Monterey,2020-07-01,41,2,43
5303,El Dorado,2020-07-01,5,1,6
5304,Sutter,2020-07-01,0,0,0
5305,Mono,2020-07-01,0,0,0
5306,Modoc,2020-07-01,0,2,2
5307,Lake,2020-07-01,3,0,3
5308,Shasta,2020-07-01,7,1,8
5309,Sonoma,2020-07-01,13,4,17
5310,San Benito,2020-07-01,1,0,1
5311,San Luis Obispo,2020-07-01,8,6,14
5312,Nevada,2020-07-01,4,2,6
5313,Trinity,2020-07-01,0,0,0
5314,Butte,2020-07-01,7,2,9
5315,Yuba,2020-07-01,8,1,9
5316,Colusa,2020-07-01,0,2,2
5317,San Francisco,2020-07-02,66,16,82
5318,Lassen,2020-07-02,1,0,1
5319,Placer,2020-07-02,17,22,39
5320,El Dorado,2020-07-02,3,2,5
5321,Tehama,2020-07-02,0,0,0
5322,San Benito,2020-07-02,1,0,1
5323,Mariposa,2020-07-02,0,0,0
5324,Trinity,2020-07-02,0,0,0
5325,Tuolumne,2020-07-02,4,0,4
5326,San Joaquin,2020-07-02,151,42,193
5327,Monterey,2020-07-02,36,1,37
5328,Santa Cruz,2020-07-02,10,3,13
5329,Sacramento,2020-07-02,128,21,149
5330,Imperial,2020-07-02,86,3,89
5331,Kings,2020-07-02,38,1,39
5332,Mono,2020-07-02,0,0,0
5333,Madera,2020-07-02,17,1,18
5334,Stanislaus,2020-07-02,133,76,209
5335,Amador,2020-07-02,1,0,1
5336,San Bernardino,2020-07-02,438,91,529
5337,Santa Barbara,2020-07-02,64,6,70
5338,Orange,2020-07-02,584,132,716
5339,Shasta,2020-07-02,7,1,8
5340,Sutter,2020-07-02,0,0,0
5341,Nevada,2020-07-02,5,1,6
5342,Ventura,2020-07-02,80,42,122
5343,Los Angeles,2020-07-02,1933,679,2612
5344,Solano,2020-07-02,39,9,48
5345,Napa,2020-07-02,7,2,9
5346,Kern,2020-07-02,173,33,206
5347,Riverside,2020-07-02,465,111,576
5348,Humboldt,2020-07-02,1,0,1
5349,Contra Costa,2020-07-02,56,20,76
5350,Butte,2020-07-02,9,3,12
5351,Yuba,2020-07-02,8,3,11
5352,Inyo,2020-07-02,0,0,0
5353,Siskiyou,2020-07-02,0,0,0
5354,Marin,2020-07-02,27,3,30
5355,Lake,2020-07-02,3,1,4
5356,San Diego,2020-07-02,380,79,459
5357,Mendocino,2020-07-02,0,0,0
5358,Merced,2020-07-02,19,4,23
5359,Yolo,2020-07-02,6,3,9
5360,Fresno,2020-07-02,128,17,145
5361,Santa Clara,2020-07-02,91,16,107
5362,Calaveras,2020-07-02,0,3,3
5363,Del Norte,2020-07-02,1,0,1
5364,Tulare,2020-07-02,77,2,79
5365,Sonoma,2020-07-02,12,3,15
5366,Plumas,2020-07-02,0,0,0
5367,Modoc,2020-07-02,0,0,0
5368,Alameda,2020-07-02,141,52,193
5369,San Luis Obispo,2020-07-02,8,7,15
5370,Colusa,2020-07-02,0,2,2
5371,Glenn,2020-07-02,0,1,1
5372,San Mateo,2020-07-02,52,4,56
5373,Fresno,2020-07-03,133,21,154
5374,Santa Cruz,2020-07-03,11,6,17
5375,Yolo,2020-07-03,7,2,9
5376,Tuolumne,2020-07-03,1,0,1
5377,Merced,2020-07-03,20,6,26
5378,Madera,2020-07-03,10,9,19
5379,Imperial,2020-07-03,83,2,85
5380,Napa,2020-07-03,6,2,8
5381,Marin,2020-07-03,28,3,31
5382,Shasta,2020-07-03,8,1,9
5383,Santa Barbara,2020-07-03,71,4,75
5384,Mendocino,2020-07-03,0,0,0
5385,Siskiyou,2020-07-03,0,0,0
5386,Riverside,2020-07-03,472,99,571
5387,San Luis Obispo,2020-07-03,8,3,11
5388,Ventura,2020-07-03,85,38,123
5389,San Benito,2020-07-03,1,0,1
5390,San Mateo,2020-07-03,56,4,60
5391,Butte,2020-07-03,7,2,9
5392,Mariposa,2020-07-03,0,0,0
5393,Tulare,2020-07-03,75,3,78
5394,Plumas,2020-07-03,0,0,0
5395,Lassen,2020-07-03,1,0,1
5396,Santa Clara,2020-07-03,84,16,100
5397,Mono,2020-07-03,0,0,0
5398,San Joaquin,2020-07-03,165,41,206
5399,Amador,2020-07-03,1,0,1
5400,Kern,2020-07-03,189,14,203
5401,Del Norte,2020-07-03,1,0,1
5402,Humboldt,2020-07-03,1,0,1
5403,Lake,2020-07-03,3,0,3
5404,Sacramento,2020-07-03,129,15,144
5405,Calaveras,2020-07-03,0,0,0
5406,Monterey,2020-07-03,35,1,36
5407,Solano,2020-07-03,38,9,47
5408,Nevada,2020-07-03,4,1,5
5409,Kings,2020-07-03,39,1,40
5410,San Diego,2020-07-03,367,68,435
5411,Glenn,2020-07-03,0,1,1
5412,Sonoma,2020-07-03,15,3,18
5413,Trinity,2020-07-03,0,0,0
5414,San Bernardino,2020-07-03,451,88,539
5415,Yuba,2020-07-03,9,1,10
5416,Stanislaus,2020-07-03,137,73,210
5417,Los Angeles,2020-07-03,1947,696,2643
5418,Sutter,2020-07-03,0,0,0
5419,Placer,2020-07-03,19,26,45
5420,San Francisco,2020-07-03,70,15,85
5421,Modoc,2020-07-03,0,0,0
5422,Colusa,2020-07-03,0,0,0
5423,Inyo,2020-07-03,0,0,0
5424,Tehama,2020-07-03,0,0,0
5425,Orange,2020-07-03,594,150,744
5426,Contra Costa,2020-07-03,54,21,75
5427,El Dorado,2020-07-03,3,1,4
5428,Alameda,2020-07-03,157,51,208
5429,Lassen,2020-07-04,1,0,1
5430,Siskiyou,2020-07-04,0,0,0
5431,Del Norte,2020-07-04,1,0,1
5432,Sutter,2020-07-04,0,0,0
5433,Merced,2020-07-04,23,1,24
5434,Imperial,2020-07-04,87,4,91
5435,Ventura,2020-07-04,82,22,104
5436,Contra Costa,2020-07-04,59,22,81
5437,Colusa,2020-07-04,0,0,0
5438,Madera,2020-07-04,15,12,27
5439,Mendocino,2020-07-04,0,1,1
5440,Yolo,2020-07-04,9,0,9
5441,Calaveras,2020-07-04,0,1,1
5442,San Bernardino,2020-07-04,461,96,557
5443,Santa Barbara,2020-07-04,69,7,76
5444,Santa Clara,2020-07-04,83,18,101
5445,Humboldt,2020-07-04,1,0,1
5446,Tuolumne,2020-07-04,1,0,1
5447,Mariposa,2020-07-04,0,0,0
5448,Kings,2020-07-04,46,2,48
5449,Alameda,2020-07-04,146,44,190
5450,Orange,2020-07-04,624,148,772
5451,Kern,2020-07-04,204,16,220
5452,Lake,2020-07-04,3,1,4
5453,Trinity,2020-07-04,0,0,0
5454,Plumas,2020-07-04,0,0,0
5455,Butte,2020-07-04,8,0,8
5456,Tehama,2020-07-04,0,0,0
5457,Stanislaus,2020-07-04,147,75,222
5458,El Dorado,2020-07-04,2,2,4
5459,Tulare,2020-07-04,78,2,80
5460,Monterey,2020-07-04,38,1,39
5461,Riverside,2020-07-04,485,115,600
5462,Nevada,2020-07-04,5,2,7
5463,Modoc,2020-07-04,0,0,0
5464,Fresno,2020-07-04,139,23,162
5465,Mono,2020-07-04,0,0,0
5466,Solano,2020-07-04,38,7,45
5467,San Benito,2020-07-04,1,0,1
5468,San Joaquin,2020-07-04,155,39,194
5469,Amador,2020-07-04,1,0,1
5470,Placer,2020-07-04,19,27,46
5471,Santa Cruz,2020-07-04,10,5,15
5472,Los Angeles,2020-07-04,1921,653,2574
5473,Sonoma,2020-07-04,18,8,26
5474,Shasta,2020-07-04,8,1,9
5475,Yuba,2020-07-04,10,2,12
5476,San Francisco,2020-07-04,68,14,82
5477,Inyo,2020-07-04,0,0,0
5478,Napa,2020-07-04,6,1,7
5479,San Mateo,2020-07-04,46,4,50
5480,Glenn,2020-07-04,0,1,1
5481,San Luis Obispo,2020-07-04,8,4,12
5482,San Diego,2020-07-04,372,73,445
5483,Marin,2020-07-04,29,1,30
5484,Sacramento,2020-07-04,142,25,167
5485,Calaveras,2020-07-05,0,2,2
5486,Alameda,2020-07-05,146,37,183
5487,Yolo,2020-07-05,7,1,8
5488,El Dorado,2020-07-05,2,0,2
5489,San Mateo,2020-07-05,45,8,53
5490,Sutter,2020-07-05,0,0,0
5491,Modoc,2020-07-05,0,0,0
5492,Lake,2020-07-05,3,1,4
5493,Santa Clara,2020-07-05,84,26,110
5494,Mariposa,2020-07-05,0,0,0
5495,Kings,2020-07-05,45,2,47
5496,Contra Costa,2020-07-05,49,39,88
5497,Tuolumne,2020-07-05,0,0,0
5498,Trinity,2020-07-05,0,0,0
5499,Placer,2020-07-05,22,19,41
5500,Siskiyou,2020-07-05,0,1,1
5501,Plumas,2020-07-05,0,0,0
5502,Santa Cruz,2020-07-05,10,9,19
5503,Santa Barbara,2020-07-05,67,6,73
5504,Kern,2020-07-05,210,12,222
5505,Amador,2020-07-05,1,0,1
5506,Sacramento,2020-07-05,148,21,169
5507,Lassen,2020-07-05,1,0,1
5508,Solano,2020-07-05,39,8,47
5509,Monterey,2020-07-05,38,2,40
5510,Riverside,2020-07-05,498,116,614
5511,San Bernardino,2020-07-05,484,81,565
5512,Nevada,2020-07-05,4,5,9
5513,Glenn,2020-07-05,0,1,1
5514,Yuba,2020-07-05,14,2,16
5515,Shasta,2020-07-05,6,1,7
5516,San Benito,2020-07-05,0,0,0
5517,Ventura,2020-07-05,77,26,103
5518,Merced,2020-07-05,24,0,24
5519,Colusa,2020-07-05,0,0,0
5520,Marin,2020-07-05,32,8,40
5521,San Joaquin,2020-07-05,158,30,188
5522,Sonoma,2020-07-05,20,10,30
5523,Humboldt,2020-07-05,1,1,2
5524,Napa,2020-07-05,6,1,7
5525,Stanislaus,2020-07-05,154,59,213
5526,Madera,2020-07-05,17,4,21
5527,Orange,2020-07-05,634,158,792
5528,Los Angeles,2020-07-05,1969,676,2645
5529,San Diego,2020-07-05,374,67,441
5530,Imperial,2020-07-05,89,4,93
5531,Mendocino,2020-07-05,0,0,0
5532,Fresno,2020-07-05,140,23,163
5533,Tulare,2020-07-05,78,2,80
5534,San Luis Obispo,2020-07-05,10,7,17
5535,Tehama,2020-07-05,0,0,0
5536,Inyo,2020-07-05,0,1,1
5537,Mono,2020-07-05,0,0,0
5538,Butte,2020-07-05,10,0,10
5539,San Francisco,2020-07-05,73,11,84
5540,Del Norte,2020-07-05,1,0,1
5541,Lake,2020-07-06,3,3,6
5542,San Joaquin,2020-07-06,168,74,242
5543,Tuolumne,2020-07-06,1,0,1
5544,Riverside,2020-07-06,520,138,658
5545,San Francisco,2020-07-06,68,12,80
5546,Colusa,2020-07-06,0,0,0
5547,Santa Barbara,2020-07-06,72,8,80
5548,Los Angeles,2020-07-06,2004,666,2670
5549,Sonoma,2020-07-06,22,11,33
5550,Orange,2020-07-06,659,180,839
5551,Madera,2020-07-06,26,6,32
5552,San Luis Obispo,2020-07-06,11,2,13
5553,San Benito,2020-07-06,0,0,0
5554,Del Norte,2020-07-06,1,0,1
5555,Inyo,2020-07-06,0,1,1
5556,Tehama,2020-07-06,0,0,0
5557,Contra Costa,2020-07-06,57,27,84
5558,Plumas,2020-07-06,0,1,1
5559,Santa Clara,2020-07-06,88,16,104
5560,Yolo,2020-07-06,9,0,9
5561,Kern,2020-07-06,211,12,223
5562,Sutter,2020-07-06,0,0,0
5563,Placer,2020-07-06,26,15,41
5564,Mendocino,2020-07-06,0,0,0
5565,Nevada,2020-07-06,3,3,6
5566,Mono,2020-07-06,0,0,0
5567,Yuba,2020-07-06,20,1,21
5568,Imperial,2020-07-06,89,2,91
5569,San Mateo,2020-07-06,48,7,55
5570,Siskiyou,2020-07-06,0,0,0
5571,Alameda,2020-07-06,142,45,187
5572,Shasta,2020-07-06,5,1,6
5573,Santa Cruz,2020-07-06,11,2,13
5574,Merced,2020-07-06,22,2,24
5575,Fresno,2020-07-06,148,14,162
5576,Sacramento,2020-07-06,157,15,172
5577,Solano,2020-07-06,38,5,43
5578,El Dorado,2020-07-06,2,0,2
5579,Monterey,2020-07-06,35,2,37
5580,Ventura,2020-07-06,92,28,120
5581,Marin,2020-07-06,34,5,39
5582,Butte,2020-07-06,12,1,13
5583,Calaveras,2020-07-06,0,3,3
5584,Mariposa,2020-07-06,0,0,0
5585,Tulare,2020-07-06,81,5,86
5586,Amador,2020-07-06,1,0,1
5587,Stanislaus,2020-07-06,160,46,206
5588,Humboldt,2020-07-06,1,2,3
5589,Napa,2020-07-06,7,0,7
5590,Glenn,2020-07-06,0,1,1
5591,Trinity,2020-07-06,0,0,0
5592,San Bernardino,2020-07-06,501,73,574
5593,San Diego,2020-07-06,384,72,456
5594,Modoc,2020-07-06,0,0,0
5595,Lassen,2020-07-06,1,0,1
5596,Kings,2020-07-06,49,3,52
5597,Trinity,2020-07-07,0,0,0
5598,Tehama,2020-07-07,0,0,0
5599,Los Angeles,2020-07-07,2037,792,2829
5600,El Dorado,2020-07-07,2,1,3
5601,Lake,2020-07-07,1,0,1
5602,Alameda,2020-07-07,145,45,190
5603,Modoc,2020-07-07,0,0,0
5604,San Joaquin,2020-07-07,168,41,209
5605,Fresno,2020-07-07,164,13,177
5606,Mendocino,2020-07-07,0,0,0
5607,Sutter,2020-07-07,0,0,0
5608,Orange,2020-07-07,679,138,817
5609,Del Norte,2020-07-07,1,0,1
5610,Imperial,2020-07-07,93,0,93
5611,Mariposa,2020-07-07,0,0,0
5612,San Luis Obispo,2020-07-07,14,5,19
5613,Plumas,2020-07-07,0,1,1
5614,Tuolumne,2020-07-07,2,0,2
5615,Stanislaus,2020-07-07,166,49,215
5616,Placer,2020-07-07,27,28,55
5617,Sacramento,2020-07-07,155,18,173
5618,Santa Barbara,2020-07-07,80,9,89
5619,Monterey,2020-07-07,37,2,39
5620,Contra Costa,2020-07-07,55,31,86
5621,San Francisco,2020-07-07,72,16,88
5622,Solano,2020-07-07,36,8,44
5623,Nevada,2020-07-07,1,1,2
5624,Mono,2020-07-07,0,0,0
5625,Colusa,2020-07-07,0,1,1
5626,Kern,2020-07-07,203,20,223
5627,Ventura,2020-07-07,87,29,116
5628,Riverside,2020-07-07,508,143,651
5629,San Benito,2020-07-07,1,0,1
5630,Sonoma,2020-07-07,24,9,33
5631,Humboldt,2020-07-07,1,2,3
5632,Kings,2020-07-07,52,2,54
5633,Lassen,2020-07-07,0,0,0
5634,Shasta,2020-07-07,2,3,5
5635,San Diego,2020-07-07,406,73,479
5636,Yuba,2020-07-07,21,1,22
5637,Marin,2020-07-07,36,8,44
5638,Glenn,2020-07-07,0,1,1
5639,San Bernardino,2020-07-07,511,68,579
5640,Calaveras,2020-07-07,0,0,0
5641,Yolo,2020-07-07,8,0,8
5642,Napa,2020-07-07,7,1,8
5643,San Mateo,2020-07-07,53,7,60
5644,Santa Cruz,2020-07-07,13,3,16
5645,Amador,2020-07-07,1,1,2
5646,Santa Clara,2020-07-07,98,16,114
5647,Siskiyou,2020-07-07,0,0,0
5648,Merced,2020-07-07,21,2,23
5649,Madera,2020-07-07,20,8,28
5650,Tulare,2020-07-07,78,7,85
5651,Butte,2020-07-07,14,1,15
5652,Inyo,2020-07-07,0,1,1
5653,Calaveras,2020-07-08,0,0,0
5654,Plumas,2020-07-08,0,0,0
5655,Santa Barbara,2020-07-08,75,11,86
5656,Orange,2020-07-08,691,124,815
5657,Trinity,2020-07-08,0,0,0
5658,Sutter,2020-07-08,0,0,0
5659,San Francisco,2020-07-08,73,15,88
5660,Sonoma,2020-07-08,24,11,35
5661,Tehama,2020-07-08,0,0,0
5662,San Luis Obispo,2020-07-08,14,4,18
5663,Butte,2020-07-08,13,1,14
5664,Kern,2020-07-08,215,12,227
5665,Marin,2020-07-08,33,10,43
5666,Mono,2020-07-08,0,0,0
5667,Lassen,2020-07-08,0,1,1
5668,Imperial,2020-07-08,84,1,85
5669,Placer,2020-07-08,28,28,56
5670,Alameda,2020-07-08,140,48,188
5671,Modoc,2020-07-08,0,0,0
5672,Amador,2020-07-08,1,0,1
5673,El Dorado,2020-07-08,3,0,3
5674,Lake,2020-07-08,1,2,3
5675,Sacramento,2020-07-08,152,25,177
5676,Inyo,2020-07-08,0,1,1
5677,Yolo,2020-07-08,11,0,11
5678,Ventura,2020-07-08,85,26,111
5679,Mendocino,2020-07-08,0,0,0
5680,Tuolumne,2020-07-08,2,1,3
5681,Santa Cruz,2020-07-08,13,5,18
5682,Del Norte,2020-07-08,0,0,0
5683,Shasta,2020-07-08,6,1,7
5684,Mariposa,2020-07-08,0,0,0
5685,Stanislaus,2020-07-08,170,45,215
5686,Fresno,2020-07-08,172,34,206
5687,San Mateo,2020-07-08,51,9,60
5688,Tulare,2020-07-08,78,2,80
5689,Merced,2020-07-08,19,3,22
5690,Humboldt,2020-07-08,0,0,0
5691,San Benito,2020-07-08,2,0,2
5692,Siskiyou,2020-07-08,0,0,0
5693,San Bernardino,2020-07-08,505,94,599
5694,San Joaquin,2020-07-08,186,58,244
5695,Monterey,2020-07-08,43,1,44
5696,Colusa,2020-07-08,0,1,1
5697,Santa Clara,2020-07-08,107,18,125
5698,Madera,2020-07-08,27,6,33
5699,Glenn,2020-07-08,0,1,1
5700,Contra Costa,2020-07-08,68,39,107
5701,Nevada,2020-07-08,1,1,2
5702,Yuba,2020-07-08,20,0,20
5703,San Diego,2020-07-08,407,76,483
5704,Solano,2020-07-08,37,8,45
5705,Riverside,2020-07-08,515,149,664
5706,Los Angeles,2020-07-08,1995,822,2817
5707,Napa,2020-07-08,8,0,8
5708,Kings,2020-07-08,51,1,52
5709,Modoc,2020-07-09,0,0,0
5710,Orange,2020-07-09,672,128,800
5711,Imperial,2020-07-09,77,0,77
5712,Solano,2020-07-09,39,8,47
5713,Alameda,2020-07-09,133,52,185
5714,Napa,2020-07-09,9,0,9
5715,Trinity,2020-07-09,0,0,0
5716,Kings,2020-07-09,56,1,57
5717,Kern,2020-07-09,217,10,227
5718,Sutter,2020-07-09,0,0,0
5719,Butte,2020-07-09,16,0,16
5720,Marin,2020-07-09,32,6,38
5721,Ventura,2020-07-09,81,22,103
5722,Shasta,2020-07-09,5,1,6
5723,San Bernardino,2020-07-09,522,78,600
5724,Del Norte,2020-07-09,0,0,0
5725,Amador,2020-07-09,1,0,1
5726,Yolo,2020-07-09,15,0,15
5727,Madera,2020-07-09,23,7,30
5728,Calaveras,2020-07-09,0,0,0
5729,Santa Cruz,2020-07-09,13,3,16
5730,Tuolumne,2020-07-09,0,0,0
5731,Santa Clara,2020-07-09,112,23,135
5732,Tulare,2020-07-09,72,2,74
5733,Los Angeles,2020-07-09,2032,817,2849
5734,San Joaquin,2020-07-09,189,55,244
5735,Sonoma,2020-07-09,25,5,30
5736,Colusa,2020-07-09,0,0,0
5737,San Francisco,2020-07-09,76,18,94
5738,San Mateo,2020-07-09,47,11,58
5739,Santa Barbara,2020-07-09,73,9,82
5740,Contra Costa,2020-07-09,77,35,112
5741,Placer,2020-07-09,27,21,48
5742,Glenn,2020-07-09,0,0,0
5743,Lassen,2020-07-09,0,1,1
5744,Monterey,2020-07-09,46,1,47
5745,Stanislaus,2020-07-09,167,61,228
5746,Fresno,2020-07-09,179,50,229
5747,Mendocino,2020-07-09,0,0,0
5748,Merced,2020-07-09,22,11,33
5749,Tehama,2020-07-09,0,0,0
5750,Humboldt,2020-07-09,0,1,1
5751,San Diego,2020-07-09,404,85,489
5752,Inyo,2020-07-09,0,1,1
5753,Yuba,2020-07-09,16,1,17
5754,Siskiyou,2020-07-09,0,0,0
5755,Plumas,2020-07-09,0,0,0
5756,Mariposa,2020-07-09,0,0,0
5757,Mono,2020-07-09,0,0,0
5758,San Luis Obispo,2020-07-09,10,5,15
5759,Sacramento,2020-07-09,150,31,181
5760,San Benito,2020-07-09,3,0,3
5761,Lake,2020-07-09,1,1,2
5762,El Dorado,2020-07-09,3,0,3
5763,Nevada,2020-07-09,1,2,3
5764,Riverside,2020-07-09,528,162,690
5765,Kings,2020-07-10,57,1,58
5766,Santa Cruz,2020-07-10,13,4,17
5767,Inyo,2020-07-10,0,0,0
5768,Imperial,2020-07-10,74,0,74
5769,Yuba,2020-07-10,20,0,20
5770,Del Norte,2020-07-10,0,0,0
5771,Sutter,2020-07-10,0,0,0
5772,Lake,2020-07-10,2,1,3
5773,Amador,2020-07-10,1,1,2
5774,Plumas,2020-07-10,0,0,0
5775,Fresno,2020-07-10,186,49,235
5776,Modoc,2020-07-10,0,0,0
5777,Merced,2020-07-10,30,8,38
5778,San Benito,2020-07-10,4,0,4
5779,Mendocino,2020-07-10,2,0,2
5780,Ventura,2020-07-10,79,26,105
5781,San Luis Obispo,2020-07-10,12,5,17
5782,Mariposa,2020-07-10,0,0,0
5783,Orange,2020-07-10,671,114,785
5784,Sacramento,2020-07-10,157,19,176
5785,Los Angeles,2020-07-10,2093,684,2777
5786,Tuolumne,2020-07-10,2,0,2
5787,Trinity,2020-07-10,0,0,0
5788,Marin,2020-07-10,30,6,36
5789,Mono,2020-07-10,0,0,0
5790,Placer,2020-07-10,31,18,49
5791,Napa,2020-07-10,7,0,7
5792,Santa Barbara,2020-07-10,72,9,81
5793,Calaveras,2020-07-10,0,0,0
5794,Santa Clara,2020-07-10,117,25,142
5795,Madera,2020-07-10,29,12,41
5796,Stanislaus,2020-07-10,172,59,231
5797,Lassen,2020-07-10,0,1,1
5798,Tulare,2020-07-10,69,2,71
5799,Butte,2020-07-10,16,0,16
5800,Sonoma,2020-07-10,28,8,36
5801,Contra Costa,2020-07-10,83,24,107
5802,Riverside,2020-07-10,532,149,681
5803,Yolo,2020-07-10,12,3,15
5804,Glenn,2020-07-10,0,0,0
5805,Kern,2020-07-10,234,16,250
5806,Colusa,2020-07-10,0,0,0
5807,Tehama,2020-07-10,0,0,0
5808,Nevada,2020-07-10,1,1,2
5809,San Mateo,2020-07-10,48,14,62
5810,Solano,2020-07-10,41,5,46
5811,San Joaquin,2020-07-10,194,50,244
5812,Shasta,2020-07-10,5,1,6
5813,San Diego,2020-07-10,411,79,490
5814,San Bernardino,2020-07-10,558,84,642
5815,Siskiyou,2020-07-10,1,1,2
5816,El Dorado,2020-07-10,2,0,2
5817,San Francisco,2020-07-10,76,21,97
5818,Monterey,2020-07-10,48,0,48
5819,Humboldt,2020-07-10,0,1,1
5820,Alameda,2020-07-10,137,46,183
5821,Amador,2020-07-11,0,0,0
5822,Orange,2020-07-11,675,111,786
5823,San Benito,2020-07-11,3,0,3
5824,Lake,2020-07-11,3,1,4
5825,Tuolumne,2020-07-11,1,0,1
5826,Kings,2020-07-11,65,0,65
5827,Inyo,2020-07-11,0,0,0
5828,Riverside,2020-07-11,511,136,647
5829,San Joaquin,2020-07-11,188,44,232
5830,Stanislaus,2020-07-11,172,46,218
5831,Ventura,2020-07-11,83,17,100
5832,Shasta,2020-07-11,3,2,5
5833,Trinity,2020-07-11,0,0,0
5834,Sutter,2020-07-11,0,0,0
5835,Merced,2020-07-11,27,7,34
5836,Calaveras,2020-07-11,0,0,0
5837,Mono,2020-07-11,0,0,0
5838,Madera,2020-07-11,25,11,36
5839,Santa Barbara,2020-07-11,76,5,81
5840,Imperial,2020-07-11,76,0,76
5841,Colusa,2020-07-11,0,2,2
5842,Yolo,2020-07-11,11,0,11
5843,Napa,2020-07-11,8,0,8
5844,Mendocino,2020-07-11,2,0,2
5845,Del Norte,2020-07-11,0,0,0
5846,San Francisco,2020-07-11,79,18,97
5847,Tulare,2020-07-11,74,3,77
5848,San Diego,2020-07-11,385,81,466
5849,Nevada,2020-07-11,2,0,2
5850,Lassen,2020-07-11,0,3,3
5851,San Luis Obispo,2020-07-11,9,2,11
5852,Los Angeles,2020-07-11,2056,713,2769
5853,Modoc,2020-07-11,0,0,0
5854,Tehama,2020-07-11,1,0,1
5855,Monterey,2020-07-11,42,0,42
5856,Kern,2020-07-11,249,24,273
5857,El Dorado,2020-07-11,2,0,2
5858,Yuba,2020-07-11,21,0,21
5859,Mariposa,2020-07-11,0,0,0
5860,San Mateo,2020-07-11,50,9,59
5861,Siskiyou,2020-07-11,1,0,1
5862,Humboldt,2020-07-11,0,1,1
5863,Placer,2020-07-11,35,26,61
5864,Santa Clara,2020-07-11,121,20,141
5865,San Bernardino,2020-07-11,564,88,652
5866,Butte,2020-07-11,15,1,16
5867,Plumas,2020-07-11,0,0,0
5868,Sonoma,2020-07-11,25,8,33
5869,Fresno,2020-07-11,197,42,239
5870,Santa Cruz,2020-07-11,13,4,17
5871,Solano,2020-07-11,41,11,52
5872,Marin,2020-07-11,31,4,35
5873,Contra Costa,2020-07-11,79,24,103
5874,Alameda,2020-07-11,144,44,188
5875,Glenn,2020-07-11,0,1,1
5876,Sacramento,2020-07-11,157,23,180
5877,Modoc,2020-07-12,0,0,0
5878,Riverside,2020-07-12,513,122,635
5879,Santa Barbara,2020-07-12,76,8,84
5880,Solano,2020-07-12,43,8,51
5881,Yolo,2020-07-12,11,0,11
5882,Contra Costa,2020-07-12,79,26,105
5883,Stanislaus,2020-07-12,188,42,230
5884,Mariposa,2020-07-12,0,0,0
5885,Fresno,2020-07-12,203,38,241
5886,Butte,2020-07-12,16,1,17
5887,San Joaquin,2020-07-12,202,35,237
5888,Orange,2020-07-12,674,84,758
5889,Mono,2020-07-12,0,0,0
5890,Monterey,2020-07-12,43,0,43
5891,Amador,2020-07-12,0,0,0
5892,Sonoma,2020-07-12,25,9,34
5893,Kern,2020-07-12,238,17,255
5894,El Dorado,2020-07-12,3,0,3
5895,Plumas,2020-07-12,0,0,0
5896,San Bernardino,2020-07-12,587,82,669
5897,Ventura,2020-07-12,92,17,109
5898,Sutter,2020-07-12,0,0,0
5899,Imperial,2020-07-12,73,0,73
5900,Alameda,2020-07-12,150,37,187
5901,San Luis Obispo,2020-07-12,9,4,13
5902,Trinity,2020-07-12,0,0,0
5903,Lassen,2020-07-12,0,2,2
5904,Napa,2020-07-12,8,0,8
5905,Nevada,2020-07-12,1,0,1
5906,Merced,2020-07-12,34,4,38
5907,Lake,2020-07-12,3,1,4
5908,Colusa,2020-07-12,0,4,4
5909,San Mateo,2020-07-12,51,14,65
5910,Calaveras,2020-07-12,0,2,2
5911,Marin,2020-07-12,29,1,30
5912,Del Norte,2020-07-12,0,0,0
5913,Kings,2020-07-12,64,0,64
5914,Mendocino,2020-07-12,2,0,2
5915,Madera,2020-07-12,27,8,35
5916,Tulare,2020-07-12,86,3,89
5917,San Benito,2020-07-12,2,0,2
5918,Los Angeles,2020-07-12,2103,670,2773
5919,Inyo,2020-07-12,0,0,0
5920,Tuolumne,2020-07-12,2,0,2
5921,Placer,2020-07-12,38,25,63
5922,Glenn,2020-07-12,0,1,1
5923,Tehama,2020-07-12,1,1,2
5924,Siskiyou,2020-07-12,2,0,2
5925,Santa Clara,2020-07-12,129,20,149
5926,Humboldt,2020-07-12,0,2,2
5927,San Diego,2020-07-12,389,78,467
5928,San Francisco,2020-07-12,80,14,94
5929,Sacramento,2020-07-12,175,25,200
5930,Santa Cruz,2020-07-12,12,5,17
5931,Yuba,2020-07-12,19,0,19
5932,Shasta,2020-07-12,3,0,3
5933,Fresno,2020-07-13,212,40,252
5934,Orange,2020-07-13,712,83,795
5935,Kern,2020-07-13,240,13,253
5936,Los Angeles,2020-07-13,2193,612,2805
5937,Plumas,2020-07-13,0,0,0
5938,San Francisco,2020-07-13,89,20,109
5939,Santa Barbara,2020-07-13,81,7,88
5940,Amador,2020-07-13,1,0,1
5941,Yolo,2020-07-13,12,0,12
5942,Solano,2020-07-13,48,7,55
5943,Modoc,2020-07-13,0,1,1
5944,Mendocino,2020-07-13,0,0,0
5945,Stanislaus,2020-07-13,182,58,240
5946,Glenn,2020-07-13,0,0,0
5947,Mono,2020-07-13,0,0,0
5948,Calaveras,2020-07-13,0,3,3
5949,Trinity,2020-07-13,0,0,0
5950,Placer,2020-07-13,40,27,67
5951,Sacramento,2020-07-13,176,25,201
5952,Nevada,2020-07-13,2,1,3
5953,Napa,2020-07-13,9,2,11
5954,Kings,2020-07-13,62,0,62
5955,Santa Clara,2020-07-13,139,27,166
5956,Marin,2020-07-13,29,0,29
5957,Madera,2020-07-13,31,7,38
5958,Riverside,2020-07-13,538,124,662
5959,Sutter,2020-07-13,0,0,0
5960,Alameda,2020-07-13,152,48,200
5961,Mariposa,2020-07-13,0,0,0
5962,San Luis Obispo,2020-07-13,10,4,14
5963,Del Norte,2020-07-13,0,1,1
5964,San Benito,2020-07-13,2,0,2
5965,San Mateo,2020-07-13,56,26,82
5966,Ventura,2020-07-13,99,25,124
5967,Santa Cruz,2020-07-13,16,4,20
5968,Lassen,2020-07-13,0,1,1
5969,Shasta,2020-07-13,3,1,4
5970,Humboldt,2020-07-13,0,1,1
5971,San Diego,2020-07-13,383,75,458
5972,Tulare,2020-07-13,89,3,92
5973,San Bernardino,2020-07-13,616,64,680
5974,Yuba,2020-07-13,19,0,19
5975,San Joaquin,2020-07-13,205,42,247
5976,Monterey,2020-07-13,49,2,51
5977,Inyo,2020-07-13,0,0,0
5978,El Dorado,2020-07-13,2,0,2
5979,Siskiyou,2020-07-13,2,0,2
5980,Merced,2020-07-13,33,1,34
5981,Imperial,2020-07-13,81,0,81
5982,Tuolumne,2020-07-13,1,0,1
5983,Sonoma,2020-07-13,27,11,38
5984,Tehama,2020-07-13,1,0,1
5985,Lake,2020-07-13,4,2,6
5986,Butte,2020-07-13,15,2,17
5987,Colusa,2020-07-13,0,4,4
5988,Contra Costa,2020-07-13,84,26,110
5989,Del Norte,2020-07-14,0,1,1
5990,Orange,2020-07-14,722,87,809
5991,San Joaquin,2020-07-14,197,39,236
5992,Shasta,2020-07-14,4,1,5
5993,Kings,2020-07-14,68,1,69
5994,Mendocino,2020-07-14,0,0,0
5995,Humboldt,2020-07-14,0,1,1
5996,Santa Barbara,2020-07-14,81,10,91
5997,Kern,2020-07-14,245,9,254
5998,Siskiyou,2020-07-14,4,0,4
5999,Riverside,2020-07-14,550,166,716
6000,San Diego,2020-07-14,394,88,482
6001,Monterey,2020-07-14,49,1,50
6002,Marin,2020-07-14,32,2,34
6003,Tuolumne,2020-07-14,3,0,3
6004,Yolo,2020-07-14,14,8,22
6005,Calaveras,2020-07-14,0,4,4
6006,Colusa,2020-07-14,1,2,3
6007,Sacramento,2020-07-14,169,26,195
6008,Tehama,2020-07-14,1,0,1
6009,Merced,2020-07-14,35,2,37
6010,Lassen,2020-07-14,0,1,1
6011,Santa Clara,2020-07-14,143,26,169
6012,Trinity,2020-07-14,0,0,0
6013,Santa Cruz,2020-07-14,14,6,20
6014,Los Angeles,2020-07-14,2173,726,2899
6015,Yuba,2020-07-14,20,0,20
6016,Contra Costa,2020-07-14,84,28,112
6017,Stanislaus,2020-07-14,192,46,238
6018,Alameda,2020-07-14,158,46,204
6019,Modoc,2020-07-14,0,0,0
6020,Ventura,2020-07-14,101,19,120
6021,San Francisco,2020-07-14,90,15,105
6022,Placer,2020-07-14,45,27,72
6023,Sutter,2020-07-14,0,0,0
6024,San Mateo,2020-07-14,59,18,77
6025,El Dorado,2020-07-14,2,0,2
6026,Lake,2020-07-14,2,0,2
6027,Mono,2020-07-14,0,0,0
6028,Napa,2020-07-14,8,0,8
6029,Glenn,2020-07-14,0,0,0
6030,Amador,2020-07-14,2,0,2
6031,Nevada,2020-07-14,1,1,2
6032,San Luis Obispo,2020-07-14,7,3,10
6033,Butte,2020-07-14,17,1,18
6034,San Bernardino,2020-07-14,603,73,676
6035,Sonoma,2020-07-14,30,11,41
6036,Imperial,2020-07-14,83,2,85
6037,Solano,2020-07-14,46,6,52
6038,Plumas,2020-07-14,0,0,0
6039,Tulare,2020-07-14,86,3,89
6040,Madera,2020-07-14,30,10,40
6041,Inyo,2020-07-14,0,0,0
6042,Fresno,2020-07-14,219,51,270
6043,San Benito,2020-07-14,2,0,2
6044,Mariposa,2020-07-14,0,0,0
6045,El Dorado,2020-07-15,2,1,3
6046,Colusa,2020-07-15,2,2,4
6047,Contra Costa,2020-07-15,81,36,117
6048,Humboldt,2020-07-15,0,3,3
6049,Inyo,2020-07-15,0,0,0
6050,Shasta,2020-07-15,4,1,5
6051,Plumas,2020-07-15,0,0,0
6052,Mono,2020-07-15,0,0,0
6053,San Benito,2020-07-15,1,0,1
6054,Modoc,2020-07-15,0,1,1
6055,San Diego,2020-07-15,401,99,500
6056,Napa,2020-07-15,9,0,9
6057,Trinity,2020-07-15,0,0,0
6058,Fresno,2020-07-15,229,45,274
6059,Ventura,2020-07-15,105,46,151
6060,Imperial,2020-07-15,89,1,90
6061,Los Angeles,2020-07-15,2122,729,2851
6062,Sonoma,2020-07-15,33,10,43
6063,Siskiyou,2020-07-15,3,0,3
6064,Sutter,2020-07-15,0,0,0
6065,Yuba,2020-07-15,19,1,20
6066,Tehama,2020-07-15,1,0,1
6067,Kings,2020-07-15,72,2,74
6068,Monterey,2020-07-15,51,1,52
6069,Madera,2020-07-15,28,4,32
6070,Kern,2020-07-15,236,14,250
6071,Mendocino,2020-07-15,2,0,2
6072,Solano,2020-07-15,46,4,50
6073,Yolo,2020-07-15,14,7,21
6074,Placer,2020-07-15,45,24,69
6075,Mariposa,2020-07-15,0,0,0
6076,San Bernardino,2020-07-15,589,67,656
6077,Tuolumne,2020-07-15,2,0,2
6078,Amador,2020-07-15,1,1,2
6079,Santa Clara,2020-07-15,146,37,183
6080,Alameda,2020-07-15,159,43,202
6081,Sacramento,2020-07-15,184,20,204
6082,Glenn,2020-07-15,0,0,0
6083,San Francisco,2020-07-15,95,13,108
6084,Del Norte,2020-07-15,0,0,0
6085,Lassen,2020-07-15,0,1,1
6086,Lake,2020-07-15,1,0,1
6087,Stanislaus,2020-07-15,193,42,235
6088,Nevada,2020-07-15,3,4,7
6089,Calaveras,2020-07-15,0,3,3
6090,San Mateo,2020-07-15,56,21,77
6091,Marin,2020-07-15,29,1,30
6092,Riverside,2020-07-15,531,151,682
6093,Tulare,2020-07-15,88,4,92
6094,Orange,2020-07-15,711,102,813
6095,Santa Barbara,2020-07-15,77,9,86
6096,Butte,2020-07-15,17,2,19
6097,San Luis Obispo,2020-07-15,9,2,11
6098,Santa Cruz,2020-07-15,12,1,13
6099,Merced,2020-07-15,33,3,36
6100,San Joaquin,2020-07-15,246,28,274
6101,Napa,2020-07-16,8,0,8
6102,Tuolumne,2020-07-16,3,0,3
6103,San Benito,2020-07-16,1,0,1
6104,Solano,2020-07-16,51,5,56
6105,Santa Barbara,2020-07-16,74,10,84
6106,Yuba,2020-07-16,17,2,19
6107,Contra Costa,2020-07-16,86,34,120
6108,Santa Cruz,2020-07-16,11,1,12
6109,Placer,2020-07-16,51,30,81
6110,Tehama,2020-07-16,1,0,1
6111,Siskiyou,2020-07-16,2,1,3
6112,Madera,2020-07-16,19,5,24
6113,Del Norte,2020-07-16,0,0,0
6114,Fresno,2020-07-16,242,39,281
6115,San Francisco,2020-07-16,90,17,107
6116,Orange,2020-07-16,682,119,801
6117,Amador,2020-07-16,2,1,3
6118,Sutter,2020-07-16,0,0,0
6119,Colusa,2020-07-16,1,1,2
6120,Marin,2020-07-16,26,3,29
6121,Sacramento,2020-07-16,185,33,218
6122,Kings,2020-07-16,78,2,80
6123,Yolo,2020-07-16,14,0,14
6124,Lake,2020-07-16,2,2,4
6125,Glenn,2020-07-16,0,1,1
6126,Kern,2020-07-16,245,28,273
6127,Stanislaus,2020-07-16,200,53,253
6128,San Joaquin,2020-07-16,193,40,233
6129,Mariposa,2020-07-16,0,0,0
6130,Ventura,2020-07-16,104,31,135
6131,San Luis Obispo,2020-07-16,10,2,12
6132,Mendocino,2020-07-16,5,0,5
6133,El Dorado,2020-07-16,2,3,5
6134,Trinity,2020-07-16,0,0,0
6135,Inyo,2020-07-16,0,0,0
6136,Riverside,2020-07-16,535,140,675
6137,Shasta,2020-07-16,3,0,3
6138,Butte,2020-07-16,18,1,19
6139,Lassen,2020-07-16,0,1,1
6140,Calaveras,2020-07-16,0,0,0
6141,Mono,2020-07-16,0,0,0
6142,Tulare,2020-07-16,86,7,93
6143,Imperial,2020-07-16,94,1,95
6144,Modoc,2020-07-16,0,0,0
6145,Nevada,2020-07-16,0,1,1
6146,Sonoma,2020-07-16,32,14,46
6147,Santa Clara,2020-07-16,147,36,183
6148,Monterey,2020-07-16,54,0,54
6149,Los Angeles,2020-07-16,2188,719,2907
6150,San Mateo,2020-07-16,61,19,80
6151,Alameda,2020-07-16,164,47,211
6152,Plumas,2020-07-16,0,0,0
6153,Humboldt,2020-07-16,1,3,4
6154,San Diego,2020-07-16,388,110,498
6155,Merced,2020-07-16,32,4,36
6156,San Bernardino,2020-07-16,600,76,676
6157,Merced,2020-07-17,33,0,33
6158,San Bernardino,2020-07-17,625,55,680
6159,San Francisco,2020-07-17,89,16,105
6160,San Joaquin,2020-07-17,192,40,232
6161,Yolo,2020-07-17,17,0,17
6162,Del Norte,2020-07-17,0,0,0
6163,Calaveras,2020-07-17,0,0,0
6164,Fresno,2020-07-17,240,44,284
6165,Tuolumne,2020-07-17,4,1,5
6166,Stanislaus,2020-07-17,208,59,267
6167,El Dorado,2020-07-17,3,3,6
6168,Solano,2020-07-17,52,5,57
6169,Tulare,2020-07-17,73,10,83
6170,Modoc,2020-07-17,0,0,0
6171,Riverside,2020-07-17,515,179,694
6172,Kern,2020-07-17,252,30,282
6173,Butte,2020-07-17,16,1,17
6174,Santa Barbara,2020-07-17,74,14,88
6175,Mendocino,2020-07-17,9,1,10
6176,Tehama,2020-07-17,1,0,1
6177,Yuba,2020-07-17,19,2,21
6178,Sonoma,2020-07-17,38,21,59
6179,Contra Costa,2020-07-17,89,27,116
6180,Sutter,2020-07-17,0,0,0
6181,Lassen,2020-07-17,0,0,0
6182,Shasta,2020-07-17,4,1,5
6183,Sacramento,2020-07-17,196,26,222
6184,Siskiyou,2020-07-17,2,0,2
6185,Santa Clara,2020-07-17,153,31,184
6186,Imperial,2020-07-17,97,2,99
6187,Los Angeles,2020-07-17,2216,660,2876
6188,Plumas,2020-07-17,0,0,0
6189,Alameda,2020-07-17,157,49,206
6190,San Luis Obispo,2020-07-17,13,7,20
6191,Marin,2020-07-17,29,4,33
6192,Kings,2020-07-17,79,2,81
6193,Napa,2020-07-17,5,0,5
6194,Trinity,2020-07-17,0,0,0
6195,Humboldt,2020-07-17,1,2,3
6196,Monterey,2020-07-17,45,1,46
6197,Placer,2020-07-17,48,28,76
6198,Madera,2020-07-17,33,7,40
6199,Mono,2020-07-17,0,1,1
6200,Orange,2020-07-17,692,92,784
6201,Inyo,2020-07-17,0,1,1
6202,Lake,2020-07-17,2,2,4
6203,Amador,2020-07-17,1,1,2
6204,Ventura,2020-07-17,95,43,138
6205,San Diego,2020-07-17,402,107,509
6206,San Benito,2020-07-17,2,0,2
6207,Glenn,2020-07-17,0,1,1
6208,Santa Cruz,2020-07-17,11,10,21
6209,San Mateo,2020-07-17,60,20,80
6210,Colusa,2020-07-17,1,1,2
6211,Mariposa,2020-07-17,0,0,0
6212,Nevada,2020-07-17,1,1,2
6213,Santa Barbara,2020-07-18,82,9,91
6214,Plumas,2020-07-18,0,0,0
6215,Mono,2020-07-18,0,1,1
6216,El Dorado,2020-07-18,3,0,3
6217,Ventura,2020-07-18,92,31,123
6218,Sutter,2020-07-18,0,0,0
6219,San Joaquin,2020-07-18,205,32,237
6220,Orange,2020-07-18,665,64,729
6221,Madera,2020-07-18,26,10,36
6222,Tuolumne,2020-07-18,4,1,5
6223,Mendocino,2020-07-18,9,1,10
6224,Placer,2020-07-18,48,22,70
6225,Siskiyou,2020-07-18,2,0,2
6226,Lake,2020-07-18,1,2,3
6227,Stanislaus,2020-07-18,205,52,257
6228,Sonoma,2020-07-18,37,13,50
6229,Fresno,2020-07-18,261,36,297
6230,Los Angeles,2020-07-18,2232,608,2840
6231,Santa Cruz,2020-07-18,11,9,20
6232,Contra Costa,2020-07-18,82,30,112
6233,San Mateo,2020-07-18,67,17,84
6234,Tulare,2020-07-18,80,6,86
6235,Inyo,2020-07-18,0,1,1
6236,Humboldt,2020-07-18,1,1,2
6237,Trinity,2020-07-18,0,0,0
6238,Yuba,2020-07-18,18,0,18
6239,Shasta,2020-07-18,4,0,4
6240,Kern,2020-07-18,253,24,277
6241,Colusa,2020-07-18,1,1,2
6242,Imperial,2020-07-18,92,1,93
6243,Alameda,2020-07-18,163,63,226
6244,Napa,2020-07-18,8,4,12
6245,San Bernardino,2020-07-18,611,88,699
6246,San Francisco,2020-07-18,91,16,107
6247,Amador,2020-07-18,1,1,2
6248,Santa Clara,2020-07-18,149,45,194
6249,Sacramento,2020-07-18,195,28,223
6250,Glenn,2020-07-18,0,1,1
6251,Marin,2020-07-18,31,2,33
6252,Tehama,2020-07-18,0,0,0
6253,Del Norte,2020-07-18,0,0,0
6254,Yolo,2020-07-18,18,1,19
6255,Lassen,2020-07-18,0,0,0
6256,Mariposa,2020-07-18,0,0,0
6257,Modoc,2020-07-18,0,0,0
6258,San Luis Obispo,2020-07-18,13,1,14
6259,Merced,2020-07-18,35,0,35
6260,Solano,2020-07-18,51,6,57
6261,Nevada,2020-07-18,1,2,3
6262,San Benito,2020-07-18,3,0,3
6263,Calaveras,2020-07-18,1,5,6
6264,Butte,2020-07-18,23,0,23
6265,San Diego,2020-07-18,396,91,487
6266,Riverside,2020-07-18,507,170,677
6267,Monterey,2020-07-18,43,1,44
6268,Kings,2020-07-18,78,2,80
6269,Yolo,2020-07-19,13,0,13
6270,Placer,2020-07-19,47,17,64
6271,Ventura,2020-07-19,91,27,118
6272,Lassen,2020-07-19,0,0,0
6273,Butte,2020-07-19,22,1,23
6274,Calaveras,2020-07-19,1,1,2
6275,Plumas,2020-07-19,0,0,0
6276,Inyo,2020-07-19,0,1,1
6277,Santa Cruz,2020-07-19,12,10,22
6278,Glenn,2020-07-19,0,1,1
6279,Los Angeles,2020-07-19,2218,616,2834
6280,Stanislaus,2020-07-19,209,39,248
6281,Mono,2020-07-19,0,1,1
6282,Napa,2020-07-19,6,0,6
6283,Tuolumne,2020-07-19,4,1,5
6284,San Mateo,2020-07-19,68,12,80
6285,El Dorado,2020-07-19,3,1,4
6286,Tehama,2020-07-19,0,0,0
6287,Riverside,2020-07-19,507,161,668
6288,Kern,2020-07-19,248,22,270
6289,Kings,2020-07-19,78,2,80
6290,Merced,2020-07-19,35,1,36
6291,Del Norte,2020-07-19,0,2,2
6292,San Bernardino,2020-07-19,613,61,674
6293,Orange,2020-07-19,666,81,747
6294,Marin,2020-07-19,32,3,35
6295,Shasta,2020-07-19,4,0,4
6296,San Francisco,2020-07-19,96,13,109
6297,San Joaquin,2020-07-19,210,38,248
6298,Imperial,2020-07-19,95,1,96
6299,Monterey,2020-07-19,43,2,45
6300,Alameda,2020-07-19,159,69,228
6301,Siskiyou,2020-07-19,2,0,2
6302,San Benito,2020-07-19,3,0,3
6303,Colusa,2020-07-19,2,1,3
6304,San Diego,2020-07-19,390,92,482
6305,Mendocino,2020-07-19,9,2,11
6306,Contra Costa,2020-07-19,88,33,121
6307,Madera,2020-07-19,30,18,48
6308,Solano,2020-07-19,51,8,59
6309,Yuba,2020-07-19,18,0,18
6310,Humboldt,2020-07-19,1,1,2
6311,Sacramento,2020-07-19,204,37,241
6312,Santa Barbara,2020-07-19,82,6,88
6313,Lake,2020-07-19,1,1,2
6314,Amador,2020-07-19,2,0,2
6315,Sutter,2020-07-19,0,0,0
6316,Trinity,2020-07-19,0,0,0
6317,Mariposa,2020-07-19,0,0,0
6318,Modoc,2020-07-19,0,0,0
6319,Tulare,2020-07-19,84,8,92
6320,Nevada,2020-07-19,1,2,3
6321,Santa Clara,2020-07-19,157,47,204
6322,Fresno,2020-07-19,269,38,307
6323,San Luis Obispo,2020-07-19,11,6,17
6324,Sonoma,2020-07-19,36,14,50
6325,Sonoma,2020-07-20,41,15,56
6326,San Diego,2020-07-20,402,97,499
6327,Amador,2020-07-20,2,0,2
6328,Inyo,2020-07-20,0,2,2
6329,Mendocino,2020-07-20,8,2,10
6330,Yolo,2020-07-20,12,0,12
6331,Merced,2020-07-20,44,3,47
6332,Plumas,2020-07-20,0,0,0
6333,Orange,2020-07-20,700,73,773
6334,Tuolumne,2020-07-20,4,0,4
6335,Lassen,2020-07-20,0,0,0
6336,Sacramento,2020-07-20,212,33,245
6337,Lake,2020-07-20,0,0,0
6338,Mono,2020-07-20,1,0,1
6339,Calaveras,2020-07-20,3,0,3
6340,Del Norte,2020-07-20,0,1,1
6341,Sutter,2020-07-20,0,0,0
6342,Siskiyou,2020-07-20,2,0,2
6343,San Mateo,2020-07-20,71,11,82
6344,Santa Cruz,2020-07-20,12,8,20
6345,Los Angeles,2020-07-20,2207,670,2877
6346,Butte,2020-07-20,24,2,26
6347,Solano,2020-07-20,52,6,58
6348,Kings,2020-07-20,75,2,77
6349,San Benito,2020-07-20,2,0,2
6350,Stanislaus,2020-07-20,210,51,261
6351,Tulare,2020-07-20,87,9,96
6352,Yuba,2020-07-20,16,0,16
6353,Trinity,2020-07-20,0,0,0
6354,Madera,2020-07-20,32,11,43
6355,Humboldt,2020-07-20,0,1,1
6356,Monterey,2020-07-20,41,3,44
6357,Contra Costa,2020-07-20,93,31,124
6358,Modoc,2020-07-20,0,0,0
6359,Santa Clara,2020-07-20,168,41,209
6360,San Bernardino,2020-07-20,607,69,676
6361,San Joaquin,2020-07-20,220,50,270
6362,Colusa,2020-07-20,2,2,4
6363,San Luis Obispo,2020-07-20,11,4,15
6364,Nevada,2020-07-20,1,1,2
6365,Glenn,2020-07-20,0,1,1
6366,Marin,2020-07-20,29,4,33
6367,Placer,2020-07-20,52,21,73
6368,San Francisco,2020-07-20,95,10,105
6369,Fresno,2020-07-20,283,53,336
6370,Ventura,2020-07-20,92,34,126
6371,Napa,2020-07-20,8,2,10
6372,Alameda,2020-07-20,171,59,230
6373,Mariposa,2020-07-20,0,0,0
6374,Riverside,2020-07-20,536,171,707
6375,Shasta,2020-07-20,4,0,4
6376,Tehama,2020-07-20,0,0,0
6377,Imperial,2020-07-20,95,2,97
6378,El Dorado,2020-07-20,2,1,3
6379,Kern,2020-07-20,277,23,300
6380,Santa Barbara,2020-07-20,85,11,96
6381,Siskiyou,2020-07-21,0,0,0
6382,Tuolumne,2020-07-21,3,0,3
6383,Yuba,2020-07-21,22,2,24
6384,San Mateo,2020-07-21,72,8,80
6385,San Francisco,2020-07-21,96,25,121
6386,Sacramento,2020-07-21,213,56,269
6387,Contra Costa,2020-07-21,101,40,141
6388,Modoc,2020-07-21,0,0,0
6389,Calaveras,2020-07-21,2,2,4
6390,San Joaquin,2020-07-21,216,44,260
6391,Del Norte,2020-07-21,0,0,0
6392,Riverside,2020-07-21,528,160,688
6393,Plumas,2020-07-21,0,3,3
6394,Humboldt,2020-07-21,0,3,3
6395,Stanislaus,2020-07-21,221,45,266
6396,Monterey,2020-07-21,45,3,48
6397,Lassen,2020-07-21,0,0,0
6398,Tehama,2020-07-21,0,0,0
6399,San Bernardino,2020-07-21,606,118,724
6400,Tulare,2020-07-21,93,11,104
6401,Sutter,2020-07-21,0,0,0
6402,Kern,2020-07-21,280,26,306
6403,San Luis Obispo,2020-07-21,11,6,17
6404,Madera,2020-07-21,45,13,58
6405,Lake,2020-07-21,0,0,0
6406,San Benito,2020-07-21,4,0,4
6407,Yolo,2020-07-21,10,8,18
6408,Alameda,2020-07-21,176,63,239
6409,Glenn,2020-07-21,0,2,2
6410,Inyo,2020-07-21,0,1,1
6411,Amador,2020-07-21,3,1,4
6412,Ventura,2020-07-21,98,37,135
6413,Mendocino,2020-07-21,6,2,8
6414,El Dorado,2020-07-21,2,1,3
6415,Napa,2020-07-21,10,0,10
6416,Kings,2020-07-21,80,1,81
6417,Santa Barbara,2020-07-21,86,8,94
6418,Placer,2020-07-21,53,33,86
6419,Santa Clara,2020-07-21,170,46,216
6420,Mariposa,2020-07-21,0,0,0
6421,Sonoma,2020-07-21,40,18,58
6422,Santa Cruz,2020-07-21,19,14,33
6423,Mono,2020-07-21,1,0,1
6424,Fresno,2020-07-21,296,56,352
6425,Merced,2020-07-21,50,1,51
6426,Colusa,2020-07-21,0,0,0
6427,Imperial,2020-07-21,89,1,90
6428,Nevada,2020-07-21,1,2,3
6429,Shasta,2020-07-21,3,0,3
6430,Solano,2020-07-21,51,5,56
6431,Marin,2020-07-21,31,6,37
6432,Butte,2020-07-21,27,1,28
6433,Orange,2020-07-21,699,74,773
6434,Los Angeles,2020-07-21,2210,620,2830
6435,San Diego,2020-07-21,401,84,485
6436,Trinity,2020-07-21,0,0,0
6437,Kern,2020-07-22,257,16,273
6438,El Dorado,2020-07-22,2,1,3
6439,Los Angeles,2020-07-22,1928,542,2470
6440,Placer,2020-07-22,53,35,88
6441,Napa,2020-07-22,11,4,15
6442,Santa Barbara,2020-07-22,85,7,92
6443,Colusa,2020-07-22,1,0,1
6444,San Mateo,2020-07-22,70,13,83
6445,Mariposa,2020-07-22,0,0,0
6446,Monterey,2020-07-22,41,2,43
6447,Ventura,2020-07-22,93,46,139
6448,San Benito,2020-07-22,2,0,2
6449,Lassen,2020-07-22,0,1,1
6450,Trinity,2020-07-22,0,0,0
6451,Humboldt,2020-07-22,0,0,0
6452,Inyo,2020-07-22,0,0,0
6453,Siskiyou,2020-07-22,0,0,0
6454,Alameda,2020-07-22,166,75,241
6455,Madera,2020-07-22,48,22,70
6456,Tulare,2020-07-22,105,6,111
6457,Mono,2020-07-22,1,0,1
6458,Nevada,2020-07-22,2,1,3
6459,Marin,2020-07-22,32,3,35
6460,Sonoma,2020-07-22,38,11,49
6461,Tuolumne,2020-07-22,5,1,6
6462,Stanislaus,2020-07-22,232,52,284
6463,Mendocino,2020-07-22,5,0,5
6464,Glenn,2020-07-22,0,0,0
6465,San Bernardino,2020-07-22,586,102,688
6466,Modoc,2020-07-22,0,0,0
6467,San Joaquin,2020-07-22,221,46,267
6468,Del Norte,2020-07-22,0,0,0
6469,Contra Costa,2020-07-22,106,41,147
6470,Santa Clara,2020-07-22,180,37,217
6471,Imperial,2020-07-22,78,0,78
6472,San Diego,2020-07-22,351,82,433
6473,Calaveras,2020-07-22,2,0,2
6474,Yuba,2020-07-22,22,3,25
6475,Yolo,2020-07-22,13,1,14
6476,Sacramento,2020-07-22,236,57,293
6477,Fresno,2020-07-22,295,57,352
6478,Riverside,2020-07-22,534,139,673
6479,Shasta,2020-07-22,4,0,4
6480,San Luis Obispo,2020-07-22,12,5,17
6481,Lake,2020-07-22,0,2,2
6482,Solano,2020-07-22,57,10,67
6483,Amador,2020-07-22,2,1,3
6484,Butte,2020-07-22,26,1,27
6485,Sutter,2020-07-22,0,0,0
6486,Kings,2020-07-22,77,1,78
6487,Santa Cruz,2020-07-22,7,7,14
6488,Merced,2020-07-22,53,4,57
6489,Orange,2020-07-22,690,61,751
6490,San Francisco,2020-07-22,96,17,113
6491,Tehama,2020-07-22,0,0,0
6492,Plumas,2020-07-22,0,0,0
6493,Mariposa,2020-07-23,0,0,0
6494,Alameda,2020-07-23,201,82,283
6495,Inyo,2020-07-23,0,1,1
6496,Riverside,2020-07-23,523,138,661
6497,Fresno,2020-07-23,297,79,376
6498,Humboldt,2020-07-23,0,1,1
6499,San Luis Obispo,2020-07-23,9,7,16
6500,Contra Costa,2020-07-23,108,45,153
6501,Santa Cruz,2020-07-23,17,20,37
6502,Stanislaus,2020-07-23,232,55,287
6503,Sonoma,2020-07-23,41,24,65
6504,Santa Barbara,2020-07-23,78,6,84
6505,Del Norte,2020-07-23,0,0,0
6506,El Dorado,2020-07-23,1,2,3
6507,Sacramento,2020-07-23,239,70,309
6508,San Francisco,2020-07-23,97,17,114
6509,Napa,2020-07-23,13,3,16
6510,Tuolumne,2020-07-23,3,0,3
6511,Glenn,2020-07-23,0,2,2
6512,San Joaquin,2020-07-23,215,32,247
6513,Lassen,2020-07-23,0,1,1
6514,Merced,2020-07-23,50,7,57
6515,Shasta,2020-07-23,4,0,4
6516,Marin,2020-07-23,29,2,31
6517,Madera,2020-07-23,52,12,64
6518,Ventura,2020-07-23,97,39,136
6519,Tulare,2020-07-23,110,5,115
6520,Lake,2020-07-23,0,2,2
6521,Sutter,2020-07-23,0,0,0
6522,Amador,2020-07-23,0,0,0
6523,Kings,2020-07-23,74,1,75
6524,Nevada,2020-07-23,2,2,4
6525,Placer,2020-07-23,57,30,87
6526,San Bernardino,2020-07-23,600,104,704
6527,Calaveras,2020-07-23,2,0,2
6528,Trinity,2020-07-23,0,0,0
6529,San Diego,2020-07-23,356,86,442
6530,Butte,2020-07-23,31,0,31
6531,Mono,2020-07-23,1,0,1
6532,Mendocino,2020-07-23,5,1,6
6533,Modoc,2020-07-23,0,0,0
6534,Plumas,2020-07-23,0,0,0
6535,Yuba,2020-07-23,24,2,26
6536,Imperial,2020-07-23,80,0,80
6537,Yolo,2020-07-23,15,1,16
6538,San Mateo,2020-07-23,68,12,80
6539,Tehama,2020-07-23,0,0,0
6540,Kern,2020-07-23,269,24,293
6541,Siskiyou,2020-07-23,0,0,0
6542,Solano,2020-07-23,57,20,77
6543,San Benito,2020-07-23,3,0,3
6544,Santa Clara,2020-07-23,183,40,223
6545,Orange,2020-07-23,652,59,711
6546,Monterey,2020-07-23,41,1,42
6547,Los Angeles,2020-07-23,2016,582,2598
6548,Colusa,2020-07-23,0,2,2
6549,San Diego,2020-07-24,347,73,420
6550,Calaveras,2020-07-24,1,1,2
6551,Sonoma,2020-07-24,40,16,56
6552,Kings,2020-07-24,73,1,74
6553,Lassen,2020-07-24,0,0,0
6554,Stanislaus,2020-07-24,206,39,245
6555,Trinity,2020-07-24,0,0,0
6556,Imperial,2020-07-24,77,0,77
6557,Tuolumne,2020-07-24,4,1,5
6558,San Francisco,2020-07-24,95,15,110
6559,Humboldt,2020-07-24,0,6,6
6560,Lake,2020-07-24,0,1,1
6561,Sacramento,2020-07-24,233,47,280
6562,Del Norte,2020-07-24,0,0,0
6563,Los Angeles,2020-07-24,2033,595,2628
6564,Riverside,2020-07-24,489,109,598
6565,Glenn,2020-07-24,0,2,2
6566,Napa,2020-07-24,11,1,12
6567,Marin,2020-07-24,24,1,25
6568,San Mateo,2020-07-24,62,13,75
6569,Plumas,2020-07-24,0,0,0
6570,Yolo,2020-07-24,11,1,12
6571,San Bernardino,2020-07-24,607,108,715
6572,Modoc,2020-07-24,0,0,0
6573,Inyo,2020-07-24,2,0,2
6574,Yuba,2020-07-24,21,4,25
6575,Santa Barbara,2020-07-24,80,5,85
6576,Merced,2020-07-24,49,2,51
6577,Ventura,2020-07-24,95,44,139
6578,Santa Cruz,2020-07-24,18,21,39
6579,Solano,2020-07-24,52,16,68
6580,Fresno,2020-07-24,311,65,376
6581,Siskiyou,2020-07-24,0,0,0
6582,Tehama,2020-07-24,0,0,0
6583,Placer,2020-07-24,52,29,81
6584,Butte,2020-07-24,28,1,29
6585,Monterey,2020-07-24,47,2,49
6586,Nevada,2020-07-24,1,1,2
6587,Shasta,2020-07-24,5,0,5
6588,Alameda,2020-07-24,188,65,253
6589,Orange,2020-07-24,685,91,776
6590,Mariposa,2020-07-24,0,0,0
6591,El Dorado,2020-07-24,1,0,1
6592,Madera,2020-07-24,58,8,66
6593,San Joaquin,2020-07-24,221,39,260
6594,Mendocino,2020-07-24,6,0,6
6595,San Luis Obispo,2020-07-24,12,3,15
6596,Amador,2020-07-24,0,0,0
6597,Santa Clara,2020-07-24,180,46,226
6598,San Benito,2020-07-24,6,0,6
6599,Contra Costa,2020-07-24,97,50,147
6600,Colusa,2020-07-24,1,2,3
6601,Sutter,2020-07-24,0,0,0
6602,Mono,2020-07-24,1,0,1
6603,Tulare,2020-07-24,111,4,115
6604,Kern,2020-07-24,254,26,280
6605,San Mateo,2020-07-25,72,10,82
6606,Lake,2020-07-25,0,1,1
6607,Inyo,2020-07-25,1,0,1
6608,Yuba,2020-07-25,21,3,24
6609,Trinity,2020-07-25,0,0,0
6610,Alameda,2020-07-25,180,67,247
6611,Shasta,2020-07-25,5,0,5
6612,Fresno,2020-07-25,298,59,357
6613,Colusa,2020-07-25,2,0,2
6614,Orange,2020-07-25,687,67,754
6615,Sacramento,2020-07-25,239,46,285
6616,Los Angeles,2020-07-25,2017,535,2552
6617,Santa Cruz,2020-07-25,17,22,39
6618,Stanislaus,2020-07-25,205,43,248
6619,Ventura,2020-07-25,90,33,123
6620,San Benito,2020-07-25,6,0,6
6621,Imperial,2020-07-25,77,1,78
6622,Riverside,2020-07-25,483,127,610
6623,Glenn,2020-07-25,0,2,2
6624,Kern,2020-07-25,248,29,277
6625,Placer,2020-07-25,60,32,92
6626,Tulare,2020-07-25,111,3,114
6627,Kings,2020-07-25,84,1,85
6628,Nevada,2020-07-25,0,2,2
6629,Lassen,2020-07-25,0,0,0
6630,Mendocino,2020-07-25,7,0,7
6631,San Luis Obispo,2020-07-25,16,2,18
6632,Marin,2020-07-25,22,1,23
6633,San Joaquin,2020-07-25,224,25,249
6634,El Dorado,2020-07-25,1,0,1
6635,Merced,2020-07-25,53,0,53
6636,Yolo,2020-07-25,12,0,12
6637,Siskiyou,2020-07-25,0,0,0
6638,San Francisco,2020-07-25,93,25,118
6639,Contra Costa,2020-07-25,99,34,133
6640,Plumas,2020-07-25,0,0,0
6641,Humboldt,2020-07-25,0,1,1
6642,Calaveras,2020-07-25,0,0,0
6643,Amador,2020-07-25,1,0,1
6644,Monterey,2020-07-25,43,4,47
6645,Butte,2020-07-25,26,2,28
6646,Modoc,2020-07-25,0,0,0
6647,Del Norte,2020-07-25,0,0,0
6648,Solano,2020-07-25,45,14,59
6649,San Bernardino,2020-07-25,638,100,738
6650,Santa Barbara,2020-07-25,79,3,82
6651,Tuolumne,2020-07-25,2,0,2
6652,Madera,2020-07-25,55,9,64
6653,Tehama,2020-07-25,0,0,0
6654,Mariposa,2020-07-25,0,0,0
6655,Santa Clara,2020-07-25,176,56,232
6656,Napa,2020-07-25,14,3,17
6657,Mono,2020-07-25,1,0,1
6658,Sonoma,2020-07-25,48,18,66
6659,San Diego,2020-07-25,354,88,442
6660,Sutter,2020-07-25,0,0,0
6661,Amador,2020-07-26,2,0,2
6662,Modoc,2020-07-26,0,0,0
6663,Humboldt,2020-07-26,0,3,3
6664,Monterey,2020-07-26,39,3,42
6665,Placer,2020-07-26,57,29,86
6666,Lake,2020-07-26,0,0,0
6667,Madera,2020-07-26,52,12,64
6668,Nevada,2020-07-26,1,2,3
6669,Tehama,2020-07-26,0,0,0
6670,Mono,2020-07-26,1,0,1
6671,Merced,2020-07-26,61,3,64
6672,Riverside,2020-07-26,488,142,630
6673,Ventura,2020-07-26,85,29,114
6674,San Diego,2020-07-26,369,89,458
6675,Sonoma,2020-07-26,46,15,61
6676,Tulare,2020-07-26,102,0,102
6677,Inyo,2020-07-26,1,0,1
6678,Kern,2020-07-26,260,21,281
6679,Solano,2020-07-26,48,16,64
6680,Marin,2020-07-26,21,2,23
6681,Shasta,2020-07-26,7,0,7
6682,Del Norte,2020-07-26,0,0,0
6683,Santa Cruz,2020-07-26,14,19,33
6684,Santa Clara,2020-07-26,171,46,217
6685,Tuolumne,2020-07-26,2,0,2
6686,El Dorado,2020-07-26,2,1,3
6687,Contra Costa,2020-07-26,103,27,130
6688,Trinity,2020-07-26,0,0,0
6689,San Francisco,2020-07-26,99,18,117
6690,Fresno,2020-07-26,302,62,364
6691,Colusa,2020-07-26,2,0,2
6692,Alameda,2020-07-26,188,69,257
6693,Mendocino,2020-07-26,7,1,8
6694,Yuba,2020-07-26,25,3,28
6695,Sacramento,2020-07-26,246,47,293
6696,Los Angeles,2020-07-26,2051,570,2621
6697,Siskiyou,2020-07-26,0,3,3
6698,Kings,2020-07-26,85,1,86
6699,San Benito,2020-07-26,6,0,6
6700,Plumas,2020-07-26,0,0,0
6701,Napa,2020-07-26,13,2,15
6702,San Bernardino,2020-07-26,609,104,713
6703,Calaveras,2020-07-26,0,1,1
6704,Mariposa,2020-07-26,0,0,0
6705,Imperial,2020-07-26,75,2,77
6706,San Joaquin,2020-07-26,227,36,263
6707,Stanislaus,2020-07-26,209,39,248
6708,Yolo,2020-07-26,13,0,13
6709,Sutter,2020-07-26,0,0,0
6710,San Luis Obispo,2020-07-26,13,4,17
6711,Santa Barbara,2020-07-26,80,5,85
6712,Butte,2020-07-26,22,1,23
6713,San Mateo,2020-07-26,70,9,79
6714,Orange,2020-07-26,661,46,707
6715,Glenn,2020-07-26,0,2,2
6716,Lassen,2020-07-26,0,0,0
6717,San Bernardino,2020-07-27,595,93,688
6718,Mariposa,2020-07-27,0,0,0
6719,Del Norte,2020-07-27,0,0,0
6720,Alameda,2020-07-27,198,51,249
6721,Riverside,2020-07-27,487,122,609
6722,Butte,2020-07-27,25,1,26
6723,Inyo,2020-07-27,1,0,1
6724,Tuolumne,2020-07-27,1,0,1
6725,Placer,2020-07-27,57,40,97
6726,El Dorado,2020-07-27,3,0,3
6727,Lassen,2020-07-27,0,0,0
6728,Sacramento,2020-07-27,253,50,303
6729,Modoc,2020-07-27,0,0,0
6730,Marin,2020-07-27,22,3,25
6731,Santa Clara,2020-07-27,175,48,223
6732,Kings,2020-07-27,85,1,86
6733,Colusa,2020-07-27,0,0,0
6734,San Benito,2020-07-27,6,0,6
6735,San Joaquin,2020-07-27,233,27,260
6736,San Luis Obispo,2020-07-27,13,2,15
6737,San Mateo,2020-07-27,71,15,86
6738,Nevada,2020-07-27,1,0,1
6739,Lake,2020-07-27,1,1,2
6740,Yolo,2020-07-27,13,0,13
6741,Trinity,2020-07-27,0,0,0
6742,Stanislaus,2020-07-27,204,46,250
6743,San Francisco,2020-07-27,101,17,118
6744,Merced,2020-07-27,64,0,64
6745,Sutter,2020-07-27,0,0,0
6746,Tehama,2020-07-27,0,0,0
6747,Yuba,2020-07-27,24,3,27
6748,Fresno,2020-07-27,297,48,345
6749,Orange,2020-07-27,640,45,685
6750,Santa Cruz,2020-07-27,14,19,33
6751,Monterey,2020-07-27,39,0,39
6752,Mono,2020-07-27,2,0,2
6753,Sonoma,2020-07-27,42,17,59
6754,Napa,2020-07-27,11,2,13
6755,Kern,2020-07-27,255,20,275
6756,Shasta,2020-07-27,8,0,8
6757,Solano,2020-07-27,46,19,65
6758,Contra Costa,2020-07-27,105,31,136
6759,Calaveras,2020-07-27,1,1,2
6760,San Diego,2020-07-27,343,89,432
6761,Mendocino,2020-07-27,6,2,8
6762,Plumas,2020-07-27,0,1,1
6763,Ventura,2020-07-27,86,29,115
6764,Tulare,2020-07-27,104,3,107
6765,Madera,2020-07-27,55,5,60
6766,Glenn,2020-07-27,0,2,2
6767,Los Angeles,2020-07-27,2045,554,2599
6768,Amador,2020-07-27,3,0,3
6769,Imperial,2020-07-27,81,1,82
6770,Santa Barbara,2020-07-27,79,8,87
6771,Siskiyou,2020-07-27,1,2,3
6772,Humboldt,2020-07-27,0,3,3
6773,Lassen,2020-07-28,0,0,0
6774,San Bernardino,2020-07-28,608,102,710
6775,San Diego,2020-07-28,392,110,502
6776,San Benito,2020-07-28,7,0,7
6777,Yolo,2020-07-28,12,0,12
6778,Plumas,2020-07-28,0,1,1
6779,Sacramento,2020-07-28,265,49,314
6780,Del Norte,2020-07-28,0,0,0
6781,Merced,2020-07-28,52,1,53
6782,Yuba,2020-07-28,20,0,20
6783,Kern,2020-07-28,265,14,279
6784,Shasta,2020-07-28,10,0,10
6785,San Luis Obispo,2020-07-28,13,4,17
6786,Madera,2020-07-28,49,4,53
6787,Mendocino,2020-07-28,5,1,6
6788,Solano,2020-07-28,48,12,60
6789,Lake,2020-07-28,0,1,1
6790,Kings,2020-07-28,75,0,75
6791,Sutter,2020-07-28,0,0,0
6792,Fresno,2020-07-28,284,49,333
6793,Inyo,2020-07-28,1,0,1
6794,Napa,2020-07-28,11,2,13
6795,San Francisco,2020-07-28,107,16,123
6796,Siskiyou,2020-07-28,1,0,1
6797,Glenn,2020-07-28,0,2,2
6798,Tuolumne,2020-07-28,1,0,1
6799,Orange,2020-07-28,626,81,707
6800,Mono,2020-07-28,1,0,1
6801,Ventura,2020-07-28,87,45,132
6802,Riverside,2020-07-28,490,142,632
6803,El Dorado,2020-07-28,1,0,1
6804,Calaveras,2020-07-28,1,0,1
6805,Santa Clara,2020-07-28,181,43,224
6806,Modoc,2020-07-28,0,0,0
6807,Marin,2020-07-28,23,0,23
6808,Butte,2020-07-28,26,2,28
6809,Mariposa,2020-07-28,0,0,0
6810,Santa Cruz,2020-07-28,10,9,19
6811,Imperial,2020-07-28,77,0,77
6812,Tehama,2020-07-28,0,0,0
6813,Los Angeles,2020-07-28,2022,575,2597
6814,Santa Barbara,2020-07-28,89,7,96
6815,Placer,2020-07-28,59,32,91
6816,Humboldt,2020-07-28,0,5,5
6817,Nevada,2020-07-28,1,1,2
6818,Sonoma,2020-07-28,60,11,71
6819,Tulare,2020-07-28,105,7,112
6820,San Joaquin,2020-07-28,231,40,271
6821,Alameda,2020-07-28,213,43,256
6822,Colusa,2020-07-28,0,0,0
6823,Contra Costa,2020-07-28,108,39,147
6824,Amador,2020-07-28,3,1,4
6825,San Mateo,2020-07-28,64,10,74
6826,Trinity,2020-07-28,0,0,0
6827,Stanislaus,2020-07-28,192,38,230
6828,Monterey,2020-07-28,43,1,44
6829,Santa Barbara,2020-07-29,85,7,92
6830,Mendocino,2020-07-29,5,1,6
6831,Riverside,2020-07-29,475,104,579
6832,Contra Costa,2020-07-29,110,35,145
6833,Lassen,2020-07-29,0,0,0
6834,San Luis Obispo,2020-07-29,18,3,21
6835,Modoc,2020-07-29,0,0,0
6836,San Benito,2020-07-29,3,1,4
6837,Sonoma,2020-07-29,56,15,71
6838,Fresno,2020-07-29,292,36,328
6839,Glenn,2020-07-29,0,2,2
6840,San Diego,2020-07-29,366,82,448
6841,Napa,2020-07-29,10,0,10
6842,Placer,2020-07-29,59,28,87
6843,Marin,2020-07-29,23,0,23
6844,San Francisco,2020-07-29,109,14,123
6845,Kings,2020-07-29,71,0,71
6846,Lake,2020-07-29,0,0,0
6847,Inyo,2020-07-29,1,0,1
6848,Merced,2020-07-29,49,1,50
6849,Del Norte,2020-07-29,0,0,0
6850,Colusa,2020-07-29,0,1,1
6851,El Dorado,2020-07-29,3,0,3
6852,Mono,2020-07-29,1,0,1
6853,Humboldt,2020-07-29,0,3,3
6854,Sutter,2020-07-29,0,0,0
6855,Trinity,2020-07-29,0,0,0
6856,Imperial,2020-07-29,67,0,67
6857,Stanislaus,2020-07-29,198,50,248
6858,Siskiyou,2020-07-29,1,0,1
6859,Los Angeles,2020-07-29,2002,566,2568
6860,Tehama,2020-07-29,0,0,0
6861,Plumas,2020-07-29,0,0,0
6862,Santa Clara,2020-07-29,187,54,241
6863,Tuolumne,2020-07-29,1,0,1
6864,Orange,2020-07-29,592,85,677
6865,Calaveras,2020-07-29,1,0,1
6866,San Mateo,2020-07-29,64,15,79
6867,Yolo,2020-07-29,11,0,11
6868,Solano,2020-07-29,44,17,61
6869,Amador,2020-07-29,5,0,5
6870,Butte,2020-07-29,27,0,27
6871,Sacramento,2020-07-29,277,62,339
6872,Alameda,2020-07-29,204,58,262
6873,Santa Cruz,2020-07-29,14,8,22
6874,Tulare,2020-07-29,97,10,107
6875,Madera,2020-07-29,54,6,60
6876,Ventura,2020-07-29,78,35,113
6877,Yuba,2020-07-29,19,0,19
6878,Mariposa,2020-07-29,0,0,0
6879,San Joaquin,2020-07-29,233,41,274
6880,Kern,2020-07-29,215,15,230
6881,Nevada,2020-07-29,1,1,2
6882,San Bernardino,2020-07-29,562,88,650
6883,Shasta,2020-07-29,10,0,10
6884,Monterey,2020-07-29,53,1,54
6885,San Joaquin,2020-07-30,215,52,267
6886,Stanislaus,2020-07-30,211,37,248
6887,Butte,2020-07-30,30,1,31
6888,Tulare,2020-07-30,95,4,99
6889,Merced,2020-07-30,49,3,52
6890,Fresno,2020-07-30,313,40,353
6891,Modoc,2020-07-30,0,0,0
6892,San Mateo,2020-07-30,58,10,68
6893,Inyo,2020-07-30,0,0,0
6894,Sutter,2020-07-30,0,0,0
6895,Nevada,2020-07-30,1,1,2
6896,Mono,2020-07-30,1,0,1
6897,Glenn,2020-07-30,0,2,2
6898,Del Norte,2020-07-30,0,0,0
6899,Calaveras,2020-07-30,0,0,0
6900,Imperial,2020-07-30,51,5,56
6901,Plumas,2020-07-30,0,0,0
6902,Sonoma,2020-07-30,50,10,60
6903,San Francisco,2020-07-30,101,18,119
6904,Lassen,2020-07-30,0,0,0
6905,Mendocino,2020-07-30,5,0,5
6906,Tuolumne,2020-07-30,2,1,3
6907,Yolo,2020-07-30,11,0,11
6908,Tehama,2020-07-30,0,0,0
6909,Los Angeles,2020-07-30,1904,553,2457
6910,Santa Clara,2020-07-30,180,44,224
6911,Amador,2020-07-30,4,1,5
6912,Marin,2020-07-30,23,2,25
6913,Kern,2020-07-30,230,17,247
6914,Trinity,2020-07-30,0,1,1
6915,Orange,2020-07-30,593,62,655
6916,Colusa,2020-07-30,0,3,3
6917,Mariposa,2020-07-30,0,0,0
6918,Santa Barbara,2020-07-30,87,3,90
6919,Solano,2020-07-30,38,16,54
6920,Alameda,2020-07-30,198,47,245
6921,San Luis Obispo,2020-07-30,16,2,18
6922,Monterey,2020-07-30,53,3,56
6923,Madera,2020-07-30,56,5,61
6924,Santa Cruz,2020-07-30,15,12,27
6925,Contra Costa,2020-07-30,106,38,144
6926,Sacramento,2020-07-30,281,48,329
6927,San Bernardino,2020-07-30,596,81,677
6928,Humboldt,2020-07-30,0,1,1
6929,Riverside,2020-07-30,452,93,545
6930,Siskiyou,2020-07-30,1,3,4
6931,Placer,2020-07-30,59,37,96
6932,Ventura,2020-07-30,80,39,119
6933,Napa,2020-07-30,12,0,12
6934,El Dorado,2020-07-30,1,0,1
6935,San Benito,2020-07-30,3,0,3
6936,San Diego,2020-07-30,348,72,420
6937,Shasta,2020-07-30,10,0,10
6938,Kings,2020-07-30,74,0,74
6939,Yuba,2020-07-30,17,0,17
6940,Lake,2020-07-30,0,0,0
6941,Orange,2020-07-31,546,38,584
6942,Kern,2020-07-31,239,17,256
6943,San Francisco,2020-07-31,102,19,121
6944,Shasta,2020-07-31,8,0,8
6945,Trinity,2020-07-31,0,2,2
6946,Siskiyou,2020-07-31,1,3,4
6947,Solano,2020-07-31,41,18,59
6948,Santa Clara,2020-07-31,196,35,231
6949,Fresno,2020-07-31,309,34,343
6950,San Joaquin,2020-07-31,221,39,260
6951,El Dorado,2020-07-31,2,2,4
6952,Sacramento,2020-07-31,265,41,306
6953,Riverside,2020-07-31,447,94,541
6954,Humboldt,2020-07-31,0,4,4
6955,Santa Cruz,2020-07-31,12,9,21
6956,Sonoma,2020-07-31,39,14,53
6957,San Mateo,2020-07-31,55,9,64
6958,Mendocino,2020-07-31,8,0,8
6959,Plumas,2020-07-31,0,0,0
6960,Imperial,2020-07-31,50,0,50
6961,Mariposa,2020-07-31,0,0,0
6962,Colusa,2020-07-31,1,1,2
6963,Alameda,2020-07-31,202,49,251
6964,Placer,2020-07-31,60,29,89
6965,San Diego,2020-07-31,315,66,381
6966,Tulare,2020-07-31,98,7,105
6967,Butte,2020-07-31,25,1,26
6968,Glenn,2020-07-31,0,2,2
6969,Yuba,2020-07-31,20,1,21
6970,Monterey,2020-07-31,45,2,47
6971,Santa Barbara,2020-07-31,86,3,89
6972,Nevada,2020-07-31,2,3,5
6973,Yolo,2020-07-31,6,1,7
6974,Modoc,2020-07-31,0,0,0
6975,Marin,2020-07-31,27,3,30
6976,Del Norte,2020-07-31,0,1,1
6977,Napa,2020-07-31,13,1,14
6978,San Benito,2020-07-31,1,0,1
6979,Los Angeles,2020-07-31,1856,516,2372
6980,Madera,2020-07-31,55,12,67
6981,Ventura,2020-07-31,85,40,125
6982,Kings,2020-07-31,72,0,72
6983,Stanislaus,2020-07-31,221,42,263
6984,Sutter,2020-07-31,0,0,0
6985,Inyo,2020-07-31,0,0,0
6986,Contra Costa,2020-07-31,107,45,152
6987,San Bernardino,2020-07-31,568,82,650
6988,Tehama,2020-07-31,0,1,1
6989,Lassen,2020-07-31,0,2,2
6990,Lake,2020-07-31,0,2,2
6991,Calaveras,2020-07-31,0,0,0
6992,San Luis Obispo,2020-07-31,12,5,17
6993,Merced,2020-07-31,51,0,51
6994,Tuolumne,2020-07-31,2,0,2
6995,Amador,2020-07-31,5,0,5
6996,Mono,2020-07-31,1,0,1
6997,Monterey,2020-08-01,43,1,44
6998,Sacramento,2020-08-01,267,35,302
6999,Placer,2020-08-01,58,34,92
7000,Mono,2020-08-01,1,0,1
7001,Del Norte,2020-08-01,0,0,0
7002,El Dorado,2020-08-01,2,2,4
7003,San Mateo,2020-08-01,55,9,64
7004,Sonoma,2020-08-01,43,13,56
7005,San Joaquin,2020-08-01,216,53,269
7006,Tuolumne,2020-08-01,2,0,2
7007,San Luis Obispo,2020-08-01,13,5,18
7008,Kern,2020-08-01,232,17,249
7009,Trinity,2020-08-01,0,2,2
7010,Nevada,2020-08-01,1,4,5
7011,Alameda,2020-08-01,198,50,248
7012,Napa,2020-08-01,10,0,10
7013,Madera,2020-08-01,54,7,61
7014,Fresno,2020-08-01,293,39,332
7015,Lassen,2020-08-01,0,2,2
7016,Sutter,2020-08-01,0,0,0
7017,Glenn,2020-08-01,0,2,2
7018,Tulare,2020-08-01,108,9,117
7019,Humboldt,2020-08-01,0,4,4
7020,Siskiyou,2020-08-01,1,2,3
7021,Inyo,2020-08-01,0,0,0
7022,Riverside,2020-08-01,435,111,546
7023,Yuba,2020-08-01,20,1,21
7024,San Francisco,2020-08-01,105,14,119
7025,Marin,2020-08-01,28,6,34
7026,Lake,2020-08-01,1,0,1
7027,Los Angeles,2020-08-01,1784,557,2341
7028,Santa Barbara,2020-08-01,82,5,87
7029,Solano,2020-08-01,48,18,66
7030,Plumas,2020-08-01,0,0,0
7031,Yolo,2020-08-01,8,1,9
7032,San Benito,2020-08-01,4,0,4
7033,Shasta,2020-08-01,8,0,8
7034,San Bernardino,2020-08-01,567,85,652
7035,Imperial,2020-08-01,47,1,48
7036,Contra Costa,2020-08-01,100,48,148
7037,Ventura,2020-08-01,83,42,125
7038,Butte,2020-08-01,29,2,31
7039,Amador,2020-08-01,6,0,6
7040,Calaveras,2020-08-01,0,0,0
7041,Stanislaus,2020-08-01,216,37,253
7042,Merced,2020-08-01,52,0,52
7043,Santa Clara,2020-08-01,183,33,216
7044,Modoc,2020-08-01,0,0,0
7045,Tehama,2020-08-01,0,1,1
7046,Mendocino,2020-08-01,8,0,8
7047,San Diego,2020-08-01,312,72,384
7048,Colusa,2020-08-01,1,2,3
7049,Kings,2020-08-01,72,0,72
7050,Santa Cruz,2020-08-01,12,9,21
7051,Orange,2020-08-01,554,64,618
7052,Mariposa,2020-08-01,0,0,0
7053,Solano,2020-08-02,50,11,61
7054,El Dorado,2020-08-02,2,0,2
7055,San Diego,2020-08-02,305,70,375
7056,Los Angeles,2020-08-02,1757,506,2263
7057,Alameda,2020-08-02,194,42,236
7058,Sonoma,2020-08-02,42,17,59
7059,Humboldt,2020-08-02,0,4,4
7060,Contra Costa,2020-08-02,101,39,140
7061,Merced,2020-08-02,52,3,55
7062,Colusa,2020-08-02,1,0,1
7063,Madera,2020-08-02,48,7,55
7064,San Joaquin,2020-08-02,213,45,258
7065,San Benito,2020-08-02,3,0,3
7066,San Francisco,2020-08-02,98,11,109
7067,San Mateo,2020-08-02,55,12,67
7068,Butte,2020-08-02,27,1,28
7069,Imperial,2020-08-02,53,0,53
7070,Mendocino,2020-08-02,12,0,12
7071,Kings,2020-08-02,73,1,74
7072,Lassen,2020-08-02,0,1,1
7073,Ventura,2020-08-02,82,37,119
7074,Orange,2020-08-02,555,50,605
7075,Siskiyou,2020-08-02,1,2,3
7076,Sacramento,2020-08-02,262,33,295
7077,Santa Clara,2020-08-02,185,36,221
7078,Riverside,2020-08-02,425,87,512
7079,Mono,2020-08-02,1,0,1
7080,Glenn,2020-08-02,0,2,2
7081,Lake,2020-08-02,2,0,2
7082,Santa Barbara,2020-08-02,88,6,94
7083,Yolo,2020-08-02,8,0,8
7084,Fresno,2020-08-02,295,33,328
7085,Amador,2020-08-02,12,0,12
7086,Plumas,2020-08-02,0,0,0
7087,Monterey,2020-08-02,44,3,47
7088,Trinity,2020-08-02,0,0,0
7089,Inyo,2020-08-02,3,0,3
7090,Kern,2020-08-02,321,12,333
7091,Tulare,2020-08-02,101,7,108
7092,Del Norte,2020-08-02,0,0,0
7093,Yuba,2020-08-02,23,0,23
7094,Marin,2020-08-02,26,3,29
7095,Napa,2020-08-02,7,0,7
7096,Sutter,2020-08-02,0,0,0
7097,Tehama,2020-08-02,0,0,0
7098,Mariposa,2020-08-02,0,0,0
7099,Modoc,2020-08-02,0,0,0
7100,Shasta,2020-08-02,8,0,8
7101,Placer,2020-08-02,57,39,96
7102,San Luis Obispo,2020-08-02,13,3,16
7103,Calaveras,2020-08-02,0,0,0
7104,Stanislaus,2020-08-02,205,47,252
7105,San Bernardino,2020-08-02,575,67,642
7106,Santa Cruz,2020-08-02,12,9,21
7107,Nevada,2020-08-02,0,0,0
7108,Tuolumne,2020-08-02,2,0,2
7109,Sacramento,2020-08-03,274,34,308
7110,Stanislaus,2020-08-03,215,43,258
7111,San Benito,2020-08-03,3,0,3
7112,Solano,2020-08-03,44,12,56
7113,Colusa,2020-08-03,1,0,1
7114,Fresno,2020-08-03,297,39,336
7115,Mendocino,2020-08-03,10,0,10
7116,Placer,2020-08-03,62,28,90
7117,Tuolumne,2020-08-03,2,1,3
7118,Alameda,2020-08-03,193,49,242
7119,Mariposa,2020-08-03,0,0,0
7120,Modoc,2020-08-03,0,0,0
7121,Mono,2020-08-03,0,0,0
7122,Trinity,2020-08-03,0,1,1
7123,Tulare,2020-08-03,105,5,110
7124,Orange,2020-08-03,539,66,605
7125,Sonoma,2020-08-03,41,17,58
7126,Santa Clara,2020-08-03,171,31,202
7127,Riverside,2020-08-03,450,93,543
7128,El Dorado,2020-08-03,3,0,3
7129,Contra Costa,2020-08-03,99,40,139
7130,San Luis Obispo,2020-08-03,11,1,12
7131,Napa,2020-08-03,9,7,16
7132,Lassen,2020-08-03,0,1,1
7133,Plumas,2020-08-03,0,0,0
7134,Lake,2020-08-03,0,0,0
7135,Del Norte,2020-08-03,0,1,1
7136,Humboldt,2020-08-03,0,2,2
7137,Madera,2020-08-03,46,14,60
7138,Amador,2020-08-03,10,1,11
7139,Inyo,2020-08-03,3,0,3
7140,Ventura,2020-08-03,88,41,129
7141,Marin,2020-08-03,23,5,28
7142,San Bernardino,2020-08-03,561,76,637
7143,Los Angeles,2020-08-03,1768,541,2309
7144,Calaveras,2020-08-03,0,0,0
7145,Monterey,2020-08-03,47,3,50
7146,Kern,2020-08-03,222,24,246
7147,Kings,2020-08-03,71,0,71
7148,San Francisco,2020-08-03,89,15,104
7149,Sutter,2020-08-03,0,0,0
7150,Yuba,2020-08-03,21,0,21
7151,Shasta,2020-08-03,7,0,7
7152,Glenn,2020-08-03,0,2,2
7153,Santa Barbara,2020-08-03,82,7,89
7154,Tehama,2020-08-03,0,0,0
7155,San Joaquin,2020-08-03,222,31,253
7156,Santa Cruz,2020-08-03,15,11,26
7157,Merced,2020-08-03,56,2,58
7158,Nevada,2020-08-03,0,2,2
7159,Siskiyou,2020-08-03,1,0,1
7160,Yolo,2020-08-03,7,0,7
7161,Imperial,2020-08-03,56,0,56
7162,San Mateo,2020-08-03,58,15,73
7163,San Diego,2020-08-03,294,67,361
7164,Butte,2020-08-03,26,0,26
7165,San Diego,2020-08-04,311,93,404
7166,Napa,2020-08-04,9,1,10
7167,Los Angeles,2020-08-04,1741,556,2297
7168,Fresno,2020-08-04,295,41,336
7169,Sacramento,2020-08-04,262,48,310
7170,San Joaquin,2020-08-04,214,67,281
7171,Monterey,2020-08-04,51,1,52
7172,San Luis Obispo,2020-08-04,12,4,16
7173,Modoc,2020-08-04,0,0,0
7174,Del Norte,2020-08-04,0,0,0
7175,Solano,2020-08-04,42,11,53
7176,Amador,2020-08-04,10,0,10
7177,Stanislaus,2020-08-04,219,52,271
7178,San Bernardino,2020-08-04,541,58,599
7179,San Mateo,2020-08-04,54,12,66
7180,San Benito,2020-08-04,3,0,3
7181,Kern,2020-08-04,212,21,233
7182,Butte,2020-08-04,23,0,23
7183,Colusa,2020-08-04,2,3,5
7184,Marin,2020-08-04,21,5,26
7185,Yuba,2020-08-04,22,0,22
7186,Mono,2020-08-04,0,0,0
7187,Santa Clara,2020-08-04,171,29,200
7188,Glenn,2020-08-04,0,2,2
7189,Ventura,2020-08-04,81,29,110
7190,Merced,2020-08-04,50,1,51
7191,Sutter,2020-08-04,0,0,0
7192,Inyo,2020-08-04,1,0,1
7193,Contra Costa,2020-08-04,95,41,136
7194,Orange,2020-08-04,536,44,580
7195,Kings,2020-08-04,70,0,70
7196,Alameda,2020-08-04,196,54,250
7197,Placer,2020-08-04,65,38,103
7198,Santa Cruz,2020-08-04,12,9,21
7199,Nevada,2020-08-04,1,1,2
7200,Mendocino,2020-08-04,12,0,12
7201,Plumas,2020-08-04,0,0,0
7202,Tulare,2020-08-04,114,4,118
7203,Calaveras,2020-08-04,1,1,2
7204,Yolo,2020-08-04,5,1,6
7205,Mariposa,2020-08-04,0,0,0
7206,Madera,2020-08-04,46,3,49
7207,Lake,2020-08-04,0,1,1
7208,Siskiyou,2020-08-04,1,0,1
7209,El Dorado,2020-08-04,2,1,3
7210,Trinity,2020-08-04,0,4,4
7211,Imperial,2020-08-04,47,0,47
7212,Humboldt,2020-08-04,0,2,2
7213,Sonoma,2020-08-04,42,15,57
7214,Lassen,2020-08-04,0,0,0
7215,Santa Barbara,2020-08-04,81,3,84
7216,Riverside,2020-08-04,411,100,511
7217,San Francisco,2020-08-04,92,12,104
7218,Tehama,2020-08-04,0,0,0
7219,Tuolumne,2020-08-04,3,0,3
7220,Shasta,2020-08-04,5,0,5
7221,Nevada,2020-08-05,1,2,3
7222,San Francisco,2020-08-05,80,14,94
7223,San Joaquin,2020-08-05,206,48,254
7224,Kings,2020-08-05,73,1,74
7225,Marin,2020-08-05,21,2,23
7226,Glenn,2020-08-05,0,2,2
7227,Los Angeles,2020-08-05,1680,602,2282
7228,Orange,2020-08-05,517,75,592
7229,Alameda,2020-08-05,190,56,246
7230,San Diego,2020-08-05,295,76,371
7231,San Mateo,2020-08-05,49,13,62
7232,Tehama,2020-08-05,0,0,0
7233,Lake,2020-08-05,1,1,2
7234,Imperial,2020-08-05,47,0,47
7235,Humboldt,2020-08-05,0,1,1
7236,Santa Barbara,2020-08-05,84,0,84
7237,Sutter,2020-08-05,0,0,0
7238,Santa Clara,2020-08-05,168,31,199
7239,Fresno,2020-08-05,296,40,336
7240,Mono,2020-08-05,1,0,1
7241,Placer,2020-08-05,67,39,106
7242,Contra Costa,2020-08-05,89,37,126
7243,Madera,2020-08-05,45,5,50
7244,Riverside,2020-08-05,415,93,508
7245,Lassen,2020-08-05,0,0,0
7246,Inyo,2020-08-05,1,0,1
7247,San Bernardino,2020-08-05,541,76,617
7248,Yolo,2020-08-05,10,0,10
7249,Monterey,2020-08-05,52,1,53
7250,Mariposa,2020-08-05,0,0,0
7251,Shasta,2020-08-05,7,0,7
7252,San Luis Obispo,2020-08-05,12,5,17
7253,Stanislaus,2020-08-05,223,57,280
7254,San Benito,2020-08-05,2,0,2
7255,Calaveras,2020-08-05,1,3,4
7256,Merced,2020-08-05,51,0,51
7257,Ventura,2020-08-05,79,38,117
7258,Modoc,2020-08-05,0,0,0
7259,Tuolumne,2020-08-05,2,1,3
7260,Plumas,2020-08-05,0,0,0
7261,Sacramento,2020-08-05,262,48,310
7262,Butte,2020-08-05,26,3,29
7263,Tulare,2020-08-05,98,6,104
7264,Trinity,2020-08-05,0,2,2
7265,Solano,2020-08-05,45,15,60
7266,El Dorado,2020-08-05,2,1,3
7267,Sonoma,2020-08-05,43,5,48
7268,Colusa,2020-08-05,1,4,5
7269,Siskiyou,2020-08-05,0,0,0
7270,Kern,2020-08-05,222,7,229
7271,Amador,2020-08-05,6,0,6
7272,Santa Cruz,2020-08-05,12,6,18
7273,Del Norte,2020-08-05,0,0,0
7274,Napa,2020-08-05,8,0,8
7275,Yuba,2020-08-05,25,0,25
7276,Mendocino,2020-08-05,13,0,13
7277,San Francisco,2020-08-06,85,9,94
7278,Los Angeles,2020-08-06,1610,581,2191
7279,Orange,2020-08-06,511,47,558
7280,Mono,2020-08-06,1,0,1
7281,Yolo,2020-08-06,10,0,10
7282,Sacramento,2020-08-06,250,59,309
7283,Santa Barbara,2020-08-06,82,6,88
7284,San Luis Obispo,2020-08-06,11,3,14
7285,Tehama,2020-08-06,2,0,2
7286,Kern,2020-08-06,217,12,229
7287,Tulare,2020-08-06,98,3,101
7288,Alameda,2020-08-06,175,50,225
7289,San Joaquin,2020-08-06,196,26,222
7290,Mariposa,2020-08-06,0,0,0
7291,Trinity,2020-08-06,0,0,0
7292,Modoc,2020-08-06,0,0,0
7293,Calaveras,2020-08-06,2,1,3
7294,Mendocino,2020-08-06,14,0,14
7295,San Diego,2020-08-06,283,59,342
7296,Placer,2020-08-06,63,36,99
7297,Del Norte,2020-08-06,0,5,5
7298,Siskiyou,2020-08-06,0,1,1
7299,Lassen,2020-08-06,0,0,0
7300,Sutter,2020-08-06,0,0,0
7301,Glenn,2020-08-06,0,2,2
7302,San Bernardino,2020-08-06,530,71,601
7303,Monterey,2020-08-06,51,1,52
7304,Plumas,2020-08-06,0,0,0
7305,Lake,2020-08-06,1,1,2
7306,Marin,2020-08-06,24,3,27
7307,Shasta,2020-08-06,7,0,7
7308,Humboldt,2020-08-06,1,1,2
7309,San Mateo,2020-08-06,45,16,61
7310,Yuba,2020-08-06,28,0,28
7311,Sonoma,2020-08-06,37,14,51
7312,Napa,2020-08-06,8,1,9
7313,Ventura,2020-08-06,81,33,114
7314,Nevada,2020-08-06,2,0,2
7315,Colusa,2020-08-06,3,2,5
7316,Fresno,2020-08-06,292,43,335
7317,Contra Costa,2020-08-06,98,35,133
7318,Merced,2020-08-06,55,3,58
7319,Riverside,2020-08-06,409,106,515
7320,Tuolumne,2020-08-06,2,2,4
7321,El Dorado,2020-08-06,3,0,3
7322,Stanislaus,2020-08-06,216,58,274
7323,Santa Cruz,2020-08-06,12,13,25
7324,Kings,2020-08-06,73,0,73
7325,Inyo,2020-08-06,1,0,1
7326,Madera,2020-08-06,46,4,50
7327,Butte,2020-08-06,23,1,24
7328,Amador,2020-08-06,8,0,8
7329,Imperial,2020-08-06,49,0,49
7330,Santa Clara,2020-08-06,175,21,196
7331,Solano,2020-08-06,40,15,55
7332,San Benito,2020-08-06,2,1,3
7333,Merced,2020-08-07,59,0,59
7334,San Luis Obispo,2020-08-07,12,4,16
7335,San Diego,2020-08-07,279,67,346
7336,Tulare,2020-08-07,102,3,105
7337,Del Norte,2020-08-07,1,4,5
7338,Contra Costa,2020-08-07,99,28,127
7339,Mono,2020-08-07,1,0,1
7340,Mendocino,2020-08-07,17,0,17
7341,Placer,2020-08-07,63,39,102
7342,Alameda,2020-08-07,167,47,214
7343,Lake,2020-08-07,4,0,4
7344,Calaveras,2020-08-07,2,0,2
7345,Nevada,2020-08-07,2,0,2
7346,Humboldt,2020-08-07,1,6,7
7347,Tehama,2020-08-07,2,0,2
7348,Butte,2020-08-07,20,0,20
7349,Monterey,2020-08-07,48,3,51
7350,San Benito,2020-08-07,2,0,2
7351,San Mateo,2020-08-07,42,16,58
7352,Inyo,2020-08-07,2,0,2
7353,Napa,2020-08-07,7,3,10
7354,Riverside,2020-08-07,382,105,487
7355,Santa Clara,2020-08-07,170,20,190
7356,Lassen,2020-08-07,0,0,0
7357,Santa Cruz,2020-08-07,13,5,18
7358,Amador,2020-08-07,7,0,7
7359,Plumas,2020-08-07,0,0,0
7360,Orange,2020-08-07,491,51,542
7361,San Bernardino,2020-08-07,493,60,553
7362,Colusa,2020-08-07,5,2,7
7363,San Francisco,2020-08-07,79,11,90
7364,Trinity,2020-08-07,0,0,0
7365,Imperial,2020-08-07,48,0,48
7366,Santa Barbara,2020-08-07,80,6,86
7367,Madera,2020-08-07,41,9,50
7368,El Dorado,2020-08-07,3,0,3
7369,Solano,2020-08-07,39,18,57
7370,Fresno,2020-08-07,279,45,324
7371,Sacramento,2020-08-07,259,74,333
7372,Kings,2020-08-07,71,0,71
7373,Tuolumne,2020-08-07,6,4,10
7374,Marin,2020-08-07,24,2,26
7375,Modoc,2020-08-07,0,0,0
7376,Glenn,2020-08-07,0,2,2
7377,Stanislaus,2020-08-07,211,44,255
7378,Mariposa,2020-08-07,0,0,0
7379,Ventura,2020-08-07,82,22,104
7380,Siskiyou,2020-08-07,0,1,1
7381,Yolo,2020-08-07,6,0,6
7382,Yuba,2020-08-07,30,0,30
7383,San Joaquin,2020-08-07,171,14,185
7384,Los Angeles,2020-08-07,1568,478,2046
7385,Sutter,2020-08-07,0,0,0
7386,Kern,2020-08-07,214,15,229
7387,Shasta,2020-08-07,6,0,6
7388,Sonoma,2020-08-07,36,2,38
7389,Tehama,2020-08-08,2,0,2
7390,San Luis Obispo,2020-08-08,12,4,16
7391,Nevada,2020-08-08,3,0,3
7392,Monterey,2020-08-08,48,0,48
7393,Sonoma,2020-08-08,36,13,49
7394,Madera,2020-08-08,46,19,65
7395,Butte,2020-08-08,23,0,23
7396,Contra Costa,2020-08-08,98,21,119
7397,Mariposa,2020-08-08,1,0,1
7398,Ventura,2020-08-08,78,27,105
7399,Modoc,2020-08-08,0,0,0
7400,Colusa,2020-08-08,6,2,8
7401,Solano,2020-08-08,37,20,57
7402,Lake,2020-08-08,0,1,1
7403,Calaveras,2020-08-08,2,1,3
7404,Inyo,2020-08-08,1,0,1
7405,Marin,2020-08-08,19,0,19
7406,Orange,2020-08-08,487,63,550
7407,Humboldt,2020-08-08,1,5,6
7408,Los Angeles,2020-08-08,1514,513,2027
7409,Riverside,2020-08-08,373,77,450
7410,Shasta,2020-08-08,4,0,4
7411,San Francisco,2020-08-08,77,11,88
7412,Plumas,2020-08-08,0,0,0
7413,Santa Cruz,2020-08-08,13,7,20
7414,Alameda,2020-08-08,163,45,208
7415,San Bernardino,2020-08-08,485,69,554
7416,Fresno,2020-08-08,287,40,327
7417,Yuba,2020-08-08,26,0,26
7418,Tuolumne,2020-08-08,1,3,4
7419,Kings,2020-08-08,63,0,63
7420,Mendocino,2020-08-08,13,0,13
7421,El Dorado,2020-08-08,4,1,5
7422,Imperial,2020-08-08,48,0,48
7423,San Benito,2020-08-08,3,0,3
7424,Napa,2020-08-08,6,0,6
7425,Santa Clara,2020-08-08,176,27,203
7426,Tulare,2020-08-08,94,1,95
7427,Siskiyou,2020-08-08,0,1,1
7428,Merced,2020-08-08,57,0,57
7429,Lassen,2020-08-08,0,0,0
7430,San Diego,2020-08-08,267,56,323
7431,San Mateo,2020-08-08,45,16,61
7432,Trinity,2020-08-08,0,0,0
7433,Santa Barbara,2020-08-08,84,8,92
7434,Yolo,2020-08-08,8,0,8
7435,Sutter,2020-08-08,0,0,0
7436,Amador,2020-08-08,8,0,8
7437,Del Norte,2020-08-08,1,1,2
7438,Kern,2020-08-08,219,14,233
7439,San Joaquin,2020-08-08,167,11,178
7440,Placer,2020-08-08,66,27,93
7441,Sacramento,2020-08-08,263,62,325
7442,Stanislaus,2020-08-08,200,45,245
7443,Glenn,2020-08-08,0,2,2
7444,Mono,2020-08-08,1,0,1
7445,Sonoma,2020-08-09,36,8,44
7446,Santa Clara,2020-08-09,184,27,211
7447,Sutter,2020-08-09,0,0,0
7448,Sacramento,2020-08-09,261,65,326
7449,Plumas,2020-08-09,0,0,0
7450,Calaveras,2020-08-09,2,2,4
7451,San Luis Obispo,2020-08-09,17,4,21
7452,San Joaquin,2020-08-09,176,12,188
7453,Trinity,2020-08-09,0,0,0
7454,Tulare,2020-08-09,86,3,89
7455,Marin,2020-08-09,16,1,17
7456,San Diego,2020-08-09,265,59,324
7457,Yuba,2020-08-09,27,1,28
7458,Colusa,2020-08-09,6,1,7
7459,Placer,2020-08-09,65,25,90
7460,Solano,2020-08-09,42,15,57
7461,Napa,2020-08-09,8,2,10
7462,Kings,2020-08-09,59,0,59
7463,Tehama,2020-08-09,2,0,2
7464,Santa Barbara,2020-08-09,77,5,82
7465,Merced,2020-08-09,52,0,52
7466,San Mateo,2020-08-09,39,17,56
7467,Nevada,2020-08-09,3,0,3
7468,Butte,2020-08-09,20,1,21
7469,Alameda,2020-08-09,169,45,214
7470,Lake,2020-08-09,0,2,2
7471,Orange,2020-08-09,468,53,521
7472,Los Angeles,2020-08-09,1524,468,1992
7473,El Dorado,2020-08-09,3,0,3
7474,San Francisco,2020-08-09,82,16,98
7475,Del Norte,2020-08-09,1,0,1
7476,Madera,2020-08-09,46,8,54
7477,Riverside,2020-08-09,359,95,454
7478,Kern,2020-08-09,212,17,229
7479,Stanislaus,2020-08-09,191,35,226
7480,Imperial,2020-08-09,44,4,48
7481,Ventura,2020-08-09,77,25,102
7482,San Benito,2020-08-09,4,0,4
7483,Amador,2020-08-09,8,1,9
7484,Yolo,2020-08-09,9,0,9
7485,Tuolumne,2020-08-09,0,0,0
7486,Modoc,2020-08-09,0,0,0
7487,Glenn,2020-08-09,0,2,2
7488,Siskiyou,2020-08-09,0,1,1
7489,Shasta,2020-08-09,4,0,4
7490,Contra Costa,2020-08-09,104,37,141
7491,Mariposa,2020-08-09,1,0,1
7492,Santa Cruz,2020-08-09,13,10,23
7493,San Bernardino,2020-08-09,486,67,553
7494,Humboldt,2020-08-09,1,6,7
7495,Mono,2020-08-09,1,0,1
7496,Lassen,2020-08-09,0,0,0
7497,Fresno,2020-08-09,286,29,315
7498,Monterey,2020-08-09,45,4,49
7499,Inyo,2020-08-09,1,1,2
7500,Mendocino,2020-08-09,14,0,14
7501,Trinity,2020-08-10,0,0,0
7502,Mendocino,2020-08-10,15,0,15
7503,Imperial,2020-08-10,39,0,39
7504,Santa Barbara,2020-08-10,79,8,87
7505,Calaveras,2020-08-10,3,1,4
7506,Tulare,2020-08-10,98,7,105
7507,Marin,2020-08-10,18,2,20
7508,Santa Clara,2020-08-10,187,18,205
7509,Merced,2020-08-10,50,1,51
7510,San Bernardino,2020-08-10,468,81,549
7511,Placer,2020-08-10,65,34,99
7512,San Diego,2020-08-10,262,62,324
7513,Shasta,2020-08-10,3,0,3
7514,Colusa,2020-08-10,5,2,7
7515,Siskiyou,2020-08-10,0,1,1
7516,Alameda,2020-08-10,166,38,204
7517,Glenn,2020-08-10,0,2,2
7518,San Francisco,2020-08-10,84,12,96
7519,Fresno,2020-08-10,273,37,310
7520,Los Angeles,2020-08-10,1538,446,1984
7521,Kern,2020-08-10,202,24,226
7522,Amador,2020-08-10,7,1,8
7523,Mono,2020-08-10,1,0,1
7524,Nevada,2020-08-10,4,1,5
7525,Plumas,2020-08-10,0,0,0
7526,Orange,2020-08-10,441,71,512
7527,Mariposa,2020-08-10,0,0,0
7528,Stanislaus,2020-08-10,205,65,270
7529,El Dorado,2020-08-10,4,0,4
7530,Kings,2020-08-10,58,0,58
7531,San Luis Obispo,2020-08-10,19,3,22
7532,San Mateo,2020-08-10,41,19,60
7533,Ventura,2020-08-10,79,33,112
7534,Del Norte,2020-08-10,1,1,2
7535,Riverside,2020-08-10,358,92,450
7536,Inyo,2020-08-10,2,2,4
7537,Yuba,2020-08-10,24,1,25
7538,Napa,2020-08-10,8,2,10
7539,Humboldt,2020-08-10,2,6,8
7540,Monterey,2020-08-10,44,5,49
7541,San Joaquin,2020-08-10,171,7,178
7542,Lake,2020-08-10,0,2,2
7543,Sonoma,2020-08-10,35,8,43
7544,Tehama,2020-08-10,2,0,2
7545,Modoc,2020-08-10,0,0,0
7546,Sutter,2020-08-10,0,0,0
7547,Lassen,2020-08-10,0,0,0
7548,Madera,2020-08-10,38,15,53
7549,Butte,2020-08-10,19,0,19
7550,Contra Costa,2020-08-10,99,30,129
7551,Sacramento,2020-08-10,265,48,313
7552,Tuolumne,2020-08-10,1,0,1
7553,Solano,2020-08-10,38,15,53
7554,Yolo,2020-08-10,8,0,8
7555,Santa Cruz,2020-08-10,14,7,21
7556,San Benito,2020-08-10,6,0,6
7557,Sutter,2020-08-11,0,0,0
7558,Nevada,2020-08-11,2,2,4
7559,Amador,2020-08-11,7,2,9
7560,San Joaquin,2020-08-11,165,16,181
7561,Placer,2020-08-11,67,24,91
7562,Colusa,2020-08-11,5,2,7
7563,Calaveras,2020-08-11,3,0,3
7564,Butte,2020-08-11,18,0,18
7565,Marin,2020-08-11,14,0,14
7566,Fresno,2020-08-11,273,31,304
7567,Kings,2020-08-11,59,0,59
7568,Los Angeles,2020-08-11,1481,470,1951
7569,Trinity,2020-08-11,0,0,0
7570,Kern,2020-08-11,204,11,215
7571,San Diego,2020-08-11,263,73,336
7572,Napa,2020-08-11,8,0,8
7573,San Francisco,2020-08-11,88,14,102
7574,Sacramento,2020-08-11,260,31,291
7575,Riverside,2020-08-11,335,101,436
7576,Lassen,2020-08-11,0,0,0
7577,Merced,2020-08-11,44,1,45
7578,Mono,2020-08-11,1,0,1
7579,San Luis Obispo,2020-08-11,17,4,21
7580,Sonoma,2020-08-11,43,10,53
7581,San Benito,2020-08-11,5,0,5
7582,San Mateo,2020-08-11,47,14,61
7583,Shasta,2020-08-11,2,2,4
7584,Orange,2020-08-11,440,66,506
7585,Alameda,2020-08-11,170,53,223
7586,Siskiyou,2020-08-11,0,0,0
7587,San Bernardino,2020-08-11,472,56,528
7588,Inyo,2020-08-11,1,2,3
7589,Humboldt,2020-08-11,2,3,5
7590,Mariposa,2020-08-11,0,0,0
7591,Santa Barbara,2020-08-11,75,14,89
7592,Tulare,2020-08-11,86,8,94
7593,Contra Costa,2020-08-11,95,27,122
7594,Modoc,2020-08-11,0,0,0
7595,Plumas,2020-08-11,0,1,1
7596,Mendocino,2020-08-11,14,0,14
7597,Yolo,2020-08-11,9,0,9
7598,Monterey,2020-08-11,54,5,59
7599,Santa Clara,2020-08-11,170,25,195
7600,Stanislaus,2020-08-11,197,65,262
7601,El Dorado,2020-08-11,2,0,2
7602,Tuolumne,2020-08-11,1,0,1
7603,Yuba,2020-08-11,26,0,26
7604,Lake,2020-08-11,0,2,2
7605,Tehama,2020-08-11,2,2,4
7606,Madera,2020-08-11,44,11,55
7607,Ventura,2020-08-11,79,34,113
7608,Santa Cruz,2020-08-11,13,8,21
7609,Del Norte,2020-08-11,2,1,3
7610,Glenn,2020-08-11,0,2,2
7611,Imperial,2020-08-11,36,1,37
7612,Solano,2020-08-11,41,11,52
7613,Sutter,2020-08-12,0,0,0
7614,San Francisco,2020-08-12,92,21,113
7615,Colusa,2020-08-12,5,2,7
7616,Madera,2020-08-12,37,9,46
7617,Yuba,2020-08-12,26,1,27
7618,Lake,2020-08-12,0,1,1
7619,San Diego,2020-08-12,244,76,320
7620,Orange,2020-08-12,438,42,480
7621,San Joaquin,2020-08-12,155,17,172
7622,San Mateo,2020-08-12,49,14,63
7623,Riverside,2020-08-12,307,84,391
7624,Trinity,2020-08-12,0,0,0
7625,San Bernardino,2020-08-12,468,81,549
7626,Butte,2020-08-12,18,0,18
7627,Santa Cruz,2020-08-12,12,12,24
7628,Kern,2020-08-12,187,15,202
7629,Tuolumne,2020-08-12,2,0,2
7630,Marin,2020-08-12,11,4,15
7631,Placer,2020-08-12,62,34,96
7632,Mendocino,2020-08-12,16,0,16
7633,Tehama,2020-08-12,2,0,2
7634,Alameda,2020-08-12,172,46,218
7635,Lassen,2020-08-12,0,0,0
7636,Glenn,2020-08-12,0,2,2
7637,Shasta,2020-08-12,4,0,4
7638,Stanislaus,2020-08-12,186,48,234
7639,Los Angeles,2020-08-12,1415,472,1887
7640,Humboldt,2020-08-12,3,2,5
7641,Modoc,2020-08-12,0,0,0
7642,Inyo,2020-08-12,1,2,3
7643,Siskiyou,2020-08-12,0,1,1
7644,Imperial,2020-08-12,41,0,41
7645,Napa,2020-08-12,6,0,6
7646,Kings,2020-08-12,51,0,51
7647,Contra Costa,2020-08-12,100,28,128
7648,Santa Barbara,2020-08-12,73,6,79
7649,Mariposa,2020-08-12,0,0,0
7650,Amador,2020-08-12,5,0,5
7651,Fresno,2020-08-12,260,39,299
7652,Yolo,2020-08-12,8,0,8
7653,Merced,2020-08-12,43,1,44
7654,El Dorado,2020-08-12,2,0,2
7655,Sacramento,2020-08-12,253,38,291
7656,Santa Clara,2020-08-12,167,25,192
7657,Tulare,2020-08-12,84,6,90
7658,San Luis Obispo,2020-08-12,17,6,23
7659,Ventura,2020-08-12,76,29,105
7660,Solano,2020-08-12,37,9,46
7661,Del Norte,2020-08-12,2,0,2
7662,Mono,2020-08-12,1,0,1
7663,Nevada,2020-08-12,6,1,7
7664,Plumas,2020-08-12,0,0,0
7665,Sonoma,2020-08-12,38,10,48
7666,Monterey,2020-08-12,46,4,50
7667,Calaveras,2020-08-12,2,0,2
7668,San Benito,2020-08-12,6,0,6
7669,Contra Costa,2020-08-13,97,15,112
7670,Mariposa,2020-08-13,0,0,0
7671,San Joaquin,2020-08-13,145,14,159
7672,Trinity,2020-08-13,0,0,0
7673,Butte,2020-08-13,21,0,21
7674,Madera,2020-08-13,31,9,40
7675,Stanislaus,2020-08-13,197,65,262
7676,Santa Clara,2020-08-13,171,20,191
7677,Sutter,2020-08-13,0,0,0
7678,Monterey,2020-08-13,54,3,57
7679,Humboldt,2020-08-13,2,4,6
7680,Glenn,2020-08-13,0,2,2
7681,Mono,2020-08-13,1,0,1
7682,San Francisco,2020-08-13,97,13,110
7683,Inyo,2020-08-13,4,1,5
7684,Nevada,2020-08-13,3,2,5
7685,San Bernardino,2020-08-13,481,70,551
7686,Alameda,2020-08-13,165,40,205
7687,San Diego,2020-08-13,244,65,309
7688,Fresno,2020-08-13,250,37,287
7689,Kern,2020-08-13,172,16,188
7690,Mendocino,2020-08-13,15,0,15
7691,Solano,2020-08-13,41,8,49
7692,Shasta,2020-08-13,6,0,6
7693,Imperial,2020-08-13,35,0,35
7694,Tehama,2020-08-13,0,0,0
7695,Riverside,2020-08-13,314,89,403
7696,Marin,2020-08-13,9,1,10
7697,Lake,2020-08-13,0,0,0
7698,Santa Cruz,2020-08-13,11,12,23
7699,Merced,2020-08-13,44,1,45
7700,Kings,2020-08-13,49,2,51
7701,Amador,2020-08-13,7,0,7
7702,Los Angeles,2020-08-13,1393,520,1913
7703,Santa Barbara,2020-08-13,68,4,72
7704,Yolo,2020-08-13,5,0,5
7705,Siskiyou,2020-08-13,0,1,1
7706,Napa,2020-08-13,6,0,6
7707,San Mateo,2020-08-13,49,17,66
7708,Lassen,2020-08-13,0,0,0
7709,El Dorado,2020-08-13,2,0,2
7710,Plumas,2020-08-13,0,0,0
7711,Ventura,2020-08-13,75,30,105
7712,Tuolumne,2020-08-13,2,0,2
7713,Calaveras,2020-08-13,12,1,13
7714,Modoc,2020-08-13,0,0,0
7715,Del Norte,2020-08-13,1,0,1
7716,San Benito,2020-08-13,8,0,8
7717,Sonoma,2020-08-13,42,4,46
7718,Tulare,2020-08-13,86,4,90
7719,Sacramento,2020-08-13,240,29,269
7720,Placer,2020-08-13,53,23,76
7721,Colusa,2020-08-13,5,0,5
7722,Orange,2020-08-13,436,50,486
7723,Yuba,2020-08-13,25,0,25
7724,San Luis Obispo,2020-08-13,15,3,18
7725,Del Norte,2020-08-14,0,4,4
7726,Stanislaus,2020-08-14,192,51,243
7727,Humboldt,2020-08-14,2,4,6
7728,Shasta,2020-08-14,7,0,7
7729,Calaveras,2020-08-14,3,1,4
7730,El Dorado,2020-08-14,1,0,1
7731,Merced,2020-08-14,41,3,44
7732,Trinity,2020-08-14,0,0,0
7733,Santa Barbara,2020-08-14,63,4,67
7734,San Joaquin,2020-08-14,149,17,166
7735,Santa Cruz,2020-08-14,9,12,21
7736,Inyo,2020-08-14,4,0,4
7737,Sutter,2020-08-14,0,0,0
7738,Placer,2020-08-14,53,22,75
7739,Amador,2020-08-14,7,1,8
7740,Kern,2020-08-14,172,14,186
7741,Contra Costa,2020-08-14,93,23,116
7742,San Francisco,2020-08-14,94,13,107
7743,Nevada,2020-08-14,2,0,2
7744,Butte,2020-08-14,20,0,20
7745,Plumas,2020-08-14,0,0,0
7746,Mono,2020-08-14,1,0,1
7747,Colusa,2020-08-14,5,1,6
7748,Tehama,2020-08-14,1,0,1
7749,San Diego,2020-08-14,227,73,300
7750,Alameda,2020-08-14,172,38,210
7751,Imperial,2020-08-14,36,1,37
7752,Lake,2020-08-14,0,0,0
7753,Tulare,2020-08-14,77,5,82
7754,Tuolumne,2020-08-14,2,1,3
7755,Sacramento,2020-08-14,249,31,280
7756,San Benito,2020-08-14,9,0,9
7757,Santa Clara,2020-08-14,164,16,180
7758,Marin,2020-08-14,13,6,19
7759,Madera,2020-08-14,30,17,47
7760,San Luis Obispo,2020-08-14,17,3,20
7761,Napa,2020-08-14,5,3,8
7762,Fresno,2020-08-14,249,23,272
7763,Ventura,2020-08-14,78,22,100
7764,Monterey,2020-08-14,48,2,50
7765,Yolo,2020-08-14,4,0,4
7766,Sonoma,2020-08-14,45,9,54
7767,Los Angeles,2020-08-14,1357,556,1913
7768,Glenn,2020-08-14,0,2,2
7769,Modoc,2020-08-14,0,0,0
7770,Orange,2020-08-14,434,60,494
7771,Yuba,2020-08-14,27,1,28
7772,Solano,2020-08-14,49,6,55
7773,Lassen,2020-08-14,0,1,1
7774,Mendocino,2020-08-14,13,0,13
7775,Siskiyou,2020-08-14,0,1,1
7776,San Mateo,2020-08-14,58,10,68
7777,San Bernardino,2020-08-14,475,61,536
7778,Kings,2020-08-14,40,2,42
7779,Riverside,2020-08-14,315,95,410
7780,Mariposa,2020-08-14,0,0,0
7781,Humboldt,2020-08-15,2,6,8
7782,Tehama,2020-08-15,1,0,1
7783,Sacramento,2020-08-15,249,45,294
7784,Plumas,2020-08-15,0,0,0
7785,Mendocino,2020-08-15,10,1,11
7786,Mono,2020-08-15,1,0,1
7787,San Diego,2020-08-15,221,52,273
7788,Tuolumne,2020-08-15,2,1,3
7789,Tulare,2020-08-15,68,3,71
7790,Napa,2020-08-15,6,4,10
7791,Inyo,2020-08-15,3,0,3
7792,Colusa,2020-08-15,2,0,2
7793,Shasta,2020-08-15,9,0,9
7794,Calaveras,2020-08-15,2,0,2
7795,Orange,2020-08-15,422,73,495
7796,Kern,2020-08-15,175,11,186
7797,San Mateo,2020-08-15,57,17,74
7798,Del Norte,2020-08-15,0,1,1
7799,Nevada,2020-08-15,2,0,2
7800,Stanislaus,2020-08-15,198,49,247
7801,Merced,2020-08-15,34,0,34
7802,Siskiyou,2020-08-15,0,0,0
7803,San Francisco,2020-08-15,94,24,118
7804,Glenn,2020-08-15,0,2,2
7805,Sonoma,2020-08-15,48,3,51
7806,Los Angeles,2020-08-15,1341,573,1914
7807,Modoc,2020-08-15,0,0,0
7808,Yolo,2020-08-15,4,0,4
7809,Amador,2020-08-15,7,0,7
7810,Madera,2020-08-15,28,26,54
7811,San Luis Obispo,2020-08-15,18,3,21
7812,Santa Barbara,2020-08-15,62,4,66
7813,Santa Cruz,2020-08-15,9,9,18
7814,Monterey,2020-08-15,52,1,53
7815,San Joaquin,2020-08-15,140,24,164
7816,El Dorado,2020-08-15,2,0,2
7817,Mariposa,2020-08-15,0,0,0
7818,Kings,2020-08-15,42,3,45
7819,Riverside,2020-08-15,302,82,384
7820,Placer,2020-08-15,58,22,80
7821,Alameda,2020-08-15,181,48,229
7822,Contra Costa,2020-08-15,95,24,119
7823,Butte,2020-08-15,20,0,20
7824,Santa Clara,2020-08-15,170,8,178
7825,Lassen,2020-08-15,0,1,1
7826,Yuba,2020-08-15,27,0,27
7827,Sutter,2020-08-15,0,0,0
7828,Lake,2020-08-15,0,1,1
7829,Marin,2020-08-15,15,4,19
7830,Fresno,2020-08-15,245,30,275
7831,Ventura,2020-08-15,71,27,98
7832,San Bernardino,2020-08-15,445,96,541
7833,Imperial,2020-08-15,36,1,37
7834,San Benito,2020-08-15,9,0,9
7835,Trinity,2020-08-15,0,0,0
7836,Solano,2020-08-15,42,3,45
7837,Butte,2020-08-16,21,0,21
7838,Shasta,2020-08-16,9,0,9
7839,Kern,2020-08-16,171,10,181
7840,Inyo,2020-08-16,3,0,3
7841,San Francisco,2020-08-16,85,23,108
7842,Glenn,2020-08-16,0,2,2
7843,El Dorado,2020-08-16,2,0,2
7844,Marin,2020-08-16,13,5,18
7845,Sonoma,2020-08-16,47,8,55
7846,Santa Cruz,2020-08-16,10,12,22
7847,Trinity,2020-08-16,0,0,0
7848,Plumas,2020-08-16,0,0,0
7849,Fresno,2020-08-16,235,39,274
7850,Humboldt,2020-08-16,2,4,6
7851,Kings,2020-08-16,45,0,45
7852,San Mateo,2020-08-16,58,13,71
7853,Madera,2020-08-16,31,19,50
7854,Siskiyou,2020-08-16,0,0,0
7855,San Bernardino,2020-08-16,437,90,527
7856,Ventura,2020-08-16,71,28,99
7857,Mariposa,2020-08-16,0,0,0
7858,Imperial,2020-08-16,35,1,36
7859,San Luis Obispo,2020-08-16,22,3,25
7860,Amador,2020-08-16,7,0,7
7861,Lassen,2020-08-16,0,0,0
7862,Merced,2020-08-16,0,36,36
7863,Modoc,2020-08-16,0,0,0
7864,Contra Costa,2020-08-16,98,31,129
7865,Tehama,2020-08-16,1,0,1
7866,Monterey,2020-08-16,54,2,56
7867,Calaveras,2020-08-16,2,1,3
7868,Alameda,2020-08-16,188,56,244
7869,Riverside,2020-08-16,296,97,393
7870,Placer,2020-08-16,63,20,83
7871,Napa,2020-08-16,8,0,8
7872,Tuolumne,2020-08-16,1,2,3
7873,Yuba,2020-08-16,27,1,28
7874,Mono,2020-08-16,0,0,0
7875,Colusa,2020-08-16,2,1,3
7876,San Diego,2020-08-16,216,74,290
7877,Yolo,2020-08-16,5,0,5
7878,Sacramento,2020-08-16,251,48,299
7879,Nevada,2020-08-16,1,1,2
7880,Orange,2020-08-16,414,64,478
7881,Lake,2020-08-16,0,1,1
7882,Mendocino,2020-08-16,9,0,9
7883,Sutter,2020-08-16,0,0,0
7884,Tulare,2020-08-16,68,2,70
7885,Santa Barbara,2020-08-16,59,1,60
7886,San Joaquin,2020-08-16,146,26,172
7887,San Benito,2020-08-16,9,0,9
7888,Solano,2020-08-16,40,6,46
7889,Santa Clara,2020-08-16,173,11,184
7890,Stanislaus,2020-08-16,188,63,251
7891,Los Angeles,2020-08-16,1352,555,1907
7892,Del Norte,2020-08-16,0,1,1
7893,Inyo,2020-08-17,4,0,4
7894,Santa Cruz,2020-08-17,12,15,27
7895,Alameda,2020-08-17,205,52,257
7896,Glenn,2020-08-17,0,2,2
7897,Lake,2020-08-17,0,1,1
7898,Santa Barbara,2020-08-17,59,3,62
7899,San Bernardino,2020-08-17,441,80,521
7900,Stanislaus,2020-08-17,196,65,261
7901,Madera,2020-08-17,25,13,38
7902,Merced,2020-08-17,33,1,34
7903,Imperial,2020-08-17,36,1,37
7904,Butte,2020-08-17,22,0,22
7905,Riverside,2020-08-17,300,100,400
7906,Kern,2020-08-17,170,13,183
7907,Sutter,2020-08-17,0,0,0
7908,Kings,2020-08-17,44,1,45
7909,Calaveras,2020-08-17,2,1,3
7910,Fresno,2020-08-17,235,40,275
7911,Siskiyou,2020-08-17,0,0,0
7912,Solano,2020-08-17,39,6,45
7913,Lassen,2020-08-17,0,0,0
7914,San Luis Obispo,2020-08-17,20,3,23
7915,San Mateo,2020-08-17,57,14,71
7916,Yolo,2020-08-17,6,0,6
7917,Nevada,2020-08-17,1,2,3
7918,Trinity,2020-08-17,0,0,0
7919,Tehama,2020-08-17,1,0,1
7920,Placer,2020-08-17,65,25,90
7921,Colusa,2020-08-17,2,0,2
7922,Santa Clara,2020-08-17,170,18,188
7923,Contra Costa,2020-08-17,97,29,126
7924,Tuolumne,2020-08-17,1,0,1
7925,Modoc,2020-08-17,0,0,0
7926,San Francisco,2020-08-17,83,26,109
7927,Del Norte,2020-08-17,0,0,0
7928,Mariposa,2020-08-17,0,0,0
7929,Napa,2020-08-17,6,0,6
7930,Humboldt,2020-08-17,2,2,4
7931,Sacramento,2020-08-17,250,44,294
7932,Los Angeles,2020-08-17,1378,518,1896
7933,El Dorado,2020-08-17,0,0,0
7934,Mono,2020-08-17,0,0,0
7935,Ventura,2020-08-17,70,26,96
7936,Plumas,2020-08-17,0,0,0
7937,San Joaquin,2020-08-17,144,25,169
7938,Monterey,2020-08-17,62,1,63
7939,San Benito,2020-08-17,9,0,9
7940,Mendocino,2020-08-17,9,0,9
7941,Tulare,2020-08-17,68,3,71
7942,Marin,2020-08-17,13,4,17
7943,Amador,2020-08-17,7,0,7
7944,Sonoma,2020-08-17,44,8,52
7945,Yuba,2020-08-17,27,1,28
7946,Orange,2020-08-17,409,82,491
7947,Shasta,2020-08-17,8,0,8
7948,San Diego,2020-08-17,229,74,303
7949,Monterey,2020-08-18,58,1,59
7950,Santa Clara,2020-08-18,173,11,184
7951,Lassen,2020-08-18,0,0,0
7952,Amador,2020-08-18,6,0,6
7953,Contra Costa,2020-08-18,96,34,130
7954,Butte,2020-08-18,24,0,24
7955,San Luis Obispo,2020-08-18,15,2,17
7956,Mendocino,2020-08-18,9,0,9
7957,Riverside,2020-08-18,301,108,409
7958,Merced,2020-08-18,36,3,39
7959,Shasta,2020-08-18,6,0,6
7960,Humboldt,2020-08-18,0,7,7
7961,Santa Cruz,2020-08-18,10,10,20
7962,Yuba,2020-08-18,26,0,26
7963,Modoc,2020-08-18,0,0,0
7964,Alameda,2020-08-18,200,50,250
7965,Sonoma,2020-08-18,43,5,48
7966,Del Norte,2020-08-18,0,0,0
7967,Madera,2020-08-18,29,11,40
7968,Imperial,2020-08-18,35,0,35
7969,Calaveras,2020-08-18,3,2,5
7970,Plumas,2020-08-18,0,0,0
7971,Orange,2020-08-18,419,76,495
7972,San Bernardino,2020-08-18,440,89,529
7973,Glenn,2020-08-18,0,2,2
7974,San Diego,2020-08-18,238,87,325
7975,Sacramento,2020-08-18,248,57,305
7976,San Benito,2020-08-18,10,1,11
7977,Tuolumne,2020-08-18,1,0,1
7978,San Mateo,2020-08-18,53,15,68
7979,Stanislaus,2020-08-18,183,58,241
7980,Los Angeles,2020-08-18,1378,591,1969
7981,Mariposa,2020-08-18,0,0,0
7982,El Dorado,2020-08-18,1,0,1
7983,San Francisco,2020-08-18,96,36,132
7984,Marin,2020-08-18,13,6,19
7985,Siskiyou,2020-08-18,0,0,0
7986,Trinity,2020-08-18,0,0,0
7987,Mono,2020-08-18,0,0,0
7988,Tulare,2020-08-18,59,4,63
7989,Sutter,2020-08-18,0,0,0
7990,Lake,2020-08-18,0,2,2
7991,Kings,2020-08-18,41,2,43
7992,Yolo,2020-08-18,7,1,8
7993,Placer,2020-08-18,64,34,98
7994,Colusa,2020-08-18,2,1,3
7995,Nevada,2020-08-18,0,2,2
7996,Solano,2020-08-18,43,6,49
7997,Ventura,2020-08-18,79,37,116
7998,San Joaquin,2020-08-18,150,22,172
7999,Tehama,2020-08-18,1,0,1
8000,Fresno,2020-08-18,233,27,260
8001,Inyo,2020-08-18,3,2,5
8002,Santa Barbara,2020-08-18,62,8,70
8003,Napa,2020-08-18,6,0,6
8004,Kern,2020-08-18,158,11,169
8005,San Bernardino,2020-08-19,418,82,500
8006,San Mateo,2020-08-19,53,7,60
8007,Nevada,2020-08-19,0,1,1
8008,Los Angeles,2020-08-19,1347,551,1898
8009,Madera,2020-08-19,27,9,36
8010,Mono,2020-08-19,0,0,0
8011,Contra Costa,2020-08-19,93,24,117
8012,Lassen,2020-08-19,0,0,0
8013,Santa Clara,2020-08-19,164,20,184
8014,Kern,2020-08-19,167,12,179
8015,Glenn,2020-08-19,0,2,2
8016,Ventura,2020-08-19,77,48,125
8017,Mariposa,2020-08-19,0,0,0
8018,Orange,2020-08-19,400,59,459
8019,Modoc,2020-08-19,0,0,0
8020,Mendocino,2020-08-19,6,0,6
8021,Yuba,2020-08-19,26,0,26
8022,Sutter,2020-08-19,0,0,0
8023,Kings,2020-08-19,40,2,42
8024,El Dorado,2020-08-19,1,0,1
8025,Solano,2020-08-19,41,5,46
8026,Calaveras,2020-08-19,3,1,4
8027,Sonoma,2020-08-19,40,6,46
8028,Monterey,2020-08-19,51,0,51
8029,San Benito,2020-08-19,9,0,9
8030,Placer,2020-08-19,61,33,94
8031,Siskiyou,2020-08-19,0,0,0
8032,Trinity,2020-08-19,0,0,0
8033,Tulare,2020-08-19,60,3,63
8034,Riverside,2020-08-19,267,121,388
8035,Shasta,2020-08-19,6,0,6
8036,San Joaquin,2020-08-19,149,25,174
8037,Butte,2020-08-19,23,0,23
8038,Yolo,2020-08-19,7,0,7
8039,Colusa,2020-08-19,2,2,4
8040,Santa Barbara,2020-08-19,54,7,61
8041,Tuolumne,2020-08-19,1,0,1
8042,San Diego,2020-08-19,232,48,280
8043,Del Norte,2020-08-19,0,0,0
8044,Imperial,2020-08-19,28,0,28
8045,San Luis Obispo,2020-08-19,15,4,19
8046,Tehama,2020-08-19,2,0,2
8047,Napa,2020-08-19,5,1,6
8048,Humboldt,2020-08-19,0,2,2
8049,Lake,2020-08-19,1,0,1
8050,Inyo,2020-08-19,2,2,4
8051,Stanislaus,2020-08-19,177,45,222
8052,San Francisco,2020-08-19,95,38,133
8053,Alameda,2020-08-19,202,56,258
8054,Merced,2020-08-19,36,3,39
8055,Sacramento,2020-08-19,229,57,286
8056,Amador,2020-08-19,4,0,4
8057,Fresno,2020-08-19,245,28,273
8058,Marin,2020-08-19,12,5,17
8059,Plumas,2020-08-19,0,0,0
8060,Santa Cruz,2020-08-19,12,13,25
8061,Amador,2020-08-20,4,0,4
8062,Del Norte,2020-08-20,0,3,3
8063,Lassen,2020-08-20,0,0,0
8064,Tulare,2020-08-20,63,3,66
8065,Alameda,2020-08-20,204,50,254
8066,Inyo,2020-08-20,2,0,2
8067,Contra Costa,2020-08-20,91,29,120
8068,Orange,2020-08-20,397,46,443
8069,Modoc,2020-08-20,0,0,0
8070,Trinity,2020-08-20,0,0,0
8071,Riverside,2020-08-20,252,123,375
8072,Kings,2020-08-20,43,1,44
8073,Madera,2020-08-20,27,11,38
8074,Yuba,2020-08-20,25,0,25
8075,Lake,2020-08-20,0,0,0
8076,Humboldt,2020-08-20,0,2,2
8077,Sonoma,2020-08-20,40,6,46
8078,San Joaquin,2020-08-20,141,37,178
8079,Butte,2020-08-20,25,0,25
8080,Yolo,2020-08-20,10,0,10
8081,Santa Clara,2020-08-20,155,30,185
8082,San Luis Obispo,2020-08-20,17,2,19
8083,Shasta,2020-08-20,5,0,5
8084,San Benito,2020-08-20,8,0,8
8085,Mariposa,2020-08-20,1,0,1
8086,San Francisco,2020-08-20,106,19,125
8087,Mendocino,2020-08-20,5,0,5
8088,Marin,2020-08-20,11,8,19
8089,Solano,2020-08-20,43,5,48
8090,Imperial,2020-08-20,29,0,29
8091,Monterey,2020-08-20,45,1,46
8092,Santa Barbara,2020-08-20,54,9,63
8093,Tuolumne,2020-08-20,1,0,1
8094,San Diego,2020-08-20,220,64,284
8095,Los Angeles,2020-08-20,1280,509,1789
8096,Sutter,2020-08-20,0,0,0
8097,Kern,2020-08-20,171,12,183
8098,San Bernardino,2020-08-20,386,75,461
8099,El Dorado,2020-08-20,2,1,3
8100,Siskiyou,2020-08-20,0,0,0
8101,Sacramento,2020-08-20,232,46,278
8102,Fresno,2020-08-20,246,27,273
8103,Placer,2020-08-20,64,28,92
8104,Santa Cruz,2020-08-20,12,6,18
8105,Colusa,2020-08-20,3,2,5
8106,Plumas,2020-08-20,0,0,0
8107,Mono,2020-08-20,0,0,0
8108,Stanislaus,2020-08-20,180,40,220
8109,Glenn,2020-08-20,0,2,2
8110,Calaveras,2020-08-20,4,1,5
8111,Ventura,2020-08-20,73,57,130
8112,San Mateo,2020-08-20,56,9,65
8113,Tehama,2020-08-20,2,0,2
8114,Nevada,2020-08-20,2,1,3
8115,Napa,2020-08-20,2,1,3
8116,Merced,2020-08-20,33,1,34
8117,Stanislaus,2020-08-21,178,56,234
8118,Del Norte,2020-08-21,0,3,3
8119,Contra Costa,2020-08-21,100,16,116
8120,Modoc,2020-08-21,0,0,0
8121,Trinity,2020-08-21,0,0,0
8122,Lake,2020-08-21,0,2,2
8123,Amador,2020-08-21,4,0,4
8124,Tuolumne,2020-08-21,1,1,2
8125,Solano,2020-08-21,42,4,46
8126,Sacramento,2020-08-21,224,45,269
8127,Alameda,2020-08-21,207,53,260
8128,Plumas,2020-08-21,0,0,0
8129,Placer,2020-08-21,53,24,77
8130,San Joaquin,2020-08-21,140,24,164
8131,Merced,2020-08-21,33,0,33
8132,Kern,2020-08-21,152,11,163
8133,Calaveras,2020-08-21,4,2,6
8134,Sonoma,2020-08-21,39,5,44
8135,San Mateo,2020-08-21,58,8,66
8136,Riverside,2020-08-21,247,105,352
8137,Butte,2020-08-21,19,0,19
8138,Siskiyou,2020-08-21,0,0,0
8139,Monterey,2020-08-21,49,1,50
8140,El Dorado,2020-08-21,2,1,3
8141,Santa Cruz,2020-08-21,11,7,18
8142,San Francisco,2020-08-21,98,20,118
8143,San Diego,2020-08-21,220,66,286
8144,Imperial,2020-08-21,29,0,29
8145,Yolo,2020-08-21,9,1,10
8146,Yuba,2020-08-21,26,0,26
8147,San Bernardino,2020-08-21,365,81,446
8148,Santa Barbara,2020-08-21,52,7,59
8149,San Luis Obispo,2020-08-21,15,1,16
8150,Santa Clara,2020-08-21,155,23,178
8151,Humboldt,2020-08-21,1,6,7
8152,Colusa,2020-08-21,1,3,4
8153,Ventura,2020-08-21,74,44,118
8154,San Benito,2020-08-21,8,0,8
8155,Inyo,2020-08-21,1,0,1
8156,Tulare,2020-08-21,58,3,61
8157,Madera,2020-08-21,30,12,42
8158,Shasta,2020-08-21,5,0,5
8159,Lassen,2020-08-21,0,0,0
8160,Fresno,2020-08-21,246,37,283
8161,Mono,2020-08-21,0,0,0
8162,Tehama,2020-08-21,1,0,1
8163,Glenn,2020-08-21,0,2,2
8164,Marin,2020-08-21,13,3,16
8165,Sutter,2020-08-21,0,0,0
8166,Mendocino,2020-08-21,5,0,5
8167,Napa,2020-08-21,3,0,3
8168,Orange,2020-08-21,392,56,448
8169,Nevada,2020-08-21,3,1,4
8170,Kings,2020-08-21,38,1,39
8171,Mariposa,2020-08-21,1,0,1
8172,Los Angeles,2020-08-21,1247,479,1726
8173,Lassen,2020-08-22,0,0,0
8174,Glenn,2020-08-22,0,2,2
8175,Ventura,2020-08-22,81,36,117
8176,Contra Costa,2020-08-22,99,19,118
8177,Yuba,2020-08-22,17,1,18
8178,Santa Cruz,2020-08-22,11,3,14
8179,Del Norte,2020-08-22,0,2,2
8180,Amador,2020-08-22,3,1,4
8181,Lake,2020-08-22,0,0,0
8182,San Joaquin,2020-08-22,135,15,150
8183,San Bernardino,2020-08-22,351,68,419
8184,Marin,2020-08-22,15,4,19
8185,Mariposa,2020-08-22,0,0,0
8186,San Benito,2020-08-22,7,0,7
8187,Siskiyou,2020-08-22,0,0,0
8188,Fresno,2020-08-22,246,29,275
8189,Los Angeles,2020-08-22,1219,482,1701
8190,San Mateo,2020-08-22,56,11,67
8191,Inyo,2020-08-22,0,0,0
8192,Stanislaus,2020-08-22,171,52,223
8193,Merced,2020-08-22,32,1,33
8194,Kings,2020-08-22,36,3,39
8195,Trinity,2020-08-22,0,0,0
8196,Kern,2020-08-22,155,8,163
8197,San Diego,2020-08-22,222,49,271
8198,Santa Clara,2020-08-22,152,18,170
8199,Tuolumne,2020-08-22,1,0,1
8200,Sutter,2020-08-22,0,0,0
8201,Orange,2020-08-22,380,46,426
8202,Riverside,2020-08-22,233,86,319
8203,Mono,2020-08-22,0,0,0
8204,Yolo,2020-08-22,6,0,6
8205,Colusa,2020-08-22,2,0,2
8206,Sacramento,2020-08-22,230,40,270
8207,Alameda,2020-08-22,196,52,248
8208,Tulare,2020-08-22,61,5,66
8209,Nevada,2020-08-22,3,2,5
8210,Placer,2020-08-22,49,19,68
8211,Santa Barbara,2020-08-22,54,4,58
8212,Calaveras,2020-08-22,4,2,6
8213,Modoc,2020-08-22,0,0,0
8214,Mendocino,2020-08-22,3,0,3
8215,Monterey,2020-08-22,46,1,47
8216,Madera,2020-08-22,31,6,37
8217,Humboldt,2020-08-22,1,4,5
8218,San Luis Obispo,2020-08-22,16,0,16
8219,El Dorado,2020-08-22,2,0,2
8220,Tehama,2020-08-22,1,0,1
8221,Imperial,2020-08-22,31,0,31
8222,Napa,2020-08-22,4,1,5
8223,Butte,2020-08-22,24,0,24
8224,San Francisco,2020-08-22,90,19,109
8225,Plumas,2020-08-22,0,0,0
8226,Shasta,2020-08-22,7,1,8
8227,Solano,2020-08-22,39,2,41
8228,Sonoma,2020-08-22,39,10,49
8229,Sacramento,2020-08-23,218,33,251
8230,Sutter,2020-08-23,0,0,0
8231,Monterey,2020-08-23,42,1,43
8232,Santa Cruz,2020-08-23,11,2,13
8233,Modoc,2020-08-23,0,0,0
8234,Napa,2020-08-23,5,0,5
8235,Sonoma,2020-08-23,40,9,49
8236,San Diego,2020-08-23,211,78,289
8237,Santa Barbara,2020-08-23,51,9,60
8238,Orange,2020-08-23,388,58,446
8239,Ventura,2020-08-23,79,32,111
8240,Los Angeles,2020-08-23,1200,467,1667
8241,San Benito,2020-08-23,6,0,6
8242,Merced,2020-08-23,30,1,31
8243,San Joaquin,2020-08-23,133,27,160
8244,Butte,2020-08-23,21,0,21
8245,Nevada,2020-08-23,3,2,5
8246,Inyo,2020-08-23,0,0,0
8247,Fresno,2020-08-23,246,27,273
8248,Placer,2020-08-23,47,15,62
8249,Yolo,2020-08-23,7,0,7
8250,Humboldt,2020-08-23,1,4,5
8251,Solano,2020-08-23,43,2,45
8252,Tuolumne,2020-08-23,1,0,1
8253,San Luis Obispo,2020-08-23,15,1,16
8254,Riverside,2020-08-23,224,116,340
8255,San Francisco,2020-08-23,92,17,109
8256,Contra Costa,2020-08-23,95,16,111
8257,Tulare,2020-08-23,51,6,57
8258,Imperial,2020-08-23,33,1,34
8259,Mariposa,2020-08-23,0,0,0
8260,Lassen,2020-08-23,0,0,0
8261,Calaveras,2020-08-23,5,2,7
8262,El Dorado,2020-08-23,1,0,1
8263,Stanislaus,2020-08-23,157,50,207
8264,Lake,2020-08-23,0,1,1
8265,Alameda,2020-08-23,187,46,233
8266,Colusa,2020-08-23,1,0,1
8267,Yuba,2020-08-23,18,1,19
8268,San Mateo,2020-08-23,57,8,65
8269,Plumas,2020-08-23,0,0,0
8270,Shasta,2020-08-23,7,0,7
8271,Siskiyou,2020-08-23,0,0,0
8272,Del Norte,2020-08-23,0,0,0
8273,Tehama,2020-08-23,1,0,1
8274,Marin,2020-08-23,14,5,19
8275,Madera,2020-08-23,27,17,44
8276,Kings,2020-08-23,35,3,38
8277,Mendocino,2020-08-23,3,0,3
8278,Santa Clara,2020-08-23,154,15,169
8279,Amador,2020-08-23,3,0,3
8280,San Bernardino,2020-08-23,356,71,427
8281,Mono,2020-08-23,0,0,0
8282,Kern,2020-08-23,148,6,154
8283,Trinity,2020-08-23,0,0,0
8284,Glenn,2020-08-23,0,2,2
8285,Trinity,2020-08-24,0,0,0
8286,Riverside,2020-08-24,222,96,318
8287,Butte,2020-08-24,24,0,24
8288,Lassen,2020-08-24,0,0,0
8289,Modoc,2020-08-24,0,0,0
8290,Siskiyou,2020-08-24,0,0,0
8291,Inyo,2020-08-24,0,0,0
8292,Del Norte,2020-08-24,0,2,2
8293,San Diego,2020-08-24,228,81,309
8294,San Benito,2020-08-24,7,0,7
8295,Yuba,2020-08-24,17,1,18
8296,Los Angeles,2020-08-24,1186,450,1636
8297,Fresno,2020-08-24,244,28,272
8298,Stanislaus,2020-08-24,161,52,213
8299,Tuolumne,2020-08-24,1,1,2
8300,Merced,2020-08-24,29,1,30
8301,Kings,2020-08-24,33,2,35
8302,San Luis Obispo,2020-08-24,11,2,13
8303,San Mateo,2020-08-24,61,9,70
8304,Kern,2020-08-24,154,7,161
8305,Contra Costa,2020-08-24,91,19,110
8306,Santa Cruz,2020-08-24,11,10,21
8307,Marin,2020-08-24,13,4,17
8308,Mendocino,2020-08-24,2,0,2
8309,Alameda,2020-08-24,179,48,227
8310,San Francisco,2020-08-24,95,22,117
8311,Sutter,2020-08-24,0,0,0
8312,Humboldt,2020-08-24,1,4,5
8313,El Dorado,2020-08-24,1,0,1
8314,Mariposa,2020-08-24,0,0,0
8315,Colusa,2020-08-24,1,0,1
8316,Sonoma,2020-08-24,42,4,46
8317,Santa Barbara,2020-08-24,54,4,58
8318,Ventura,2020-08-24,76,25,101
8319,San Joaquin,2020-08-24,131,22,153
8320,Napa,2020-08-24,5,1,6
8321,Mono,2020-08-24,0,0,0
8322,Shasta,2020-08-24,7,0,7
8323,Glenn,2020-08-24,0,2,2
8324,Tulare,2020-08-24,49,8,57
8325,Lake,2020-08-24,0,0,0
8326,San Bernardino,2020-08-24,335,67,402
8327,Nevada,2020-08-24,3,2,5
8328,Sacramento,2020-08-24,221,35,256
8329,Imperial,2020-08-24,33,0,33
8330,Santa Clara,2020-08-24,147,16,163
8331,Monterey,2020-08-24,40,1,41
8332,Placer,2020-08-24,44,28,72
8333,Calaveras,2020-08-24,5,1,6
8334,Madera,2020-08-24,24,6,30
8335,Amador,2020-08-24,4,0,4
8336,Solano,2020-08-24,39,2,41
8337,Yolo,2020-08-24,8,0,8
8338,Orange,2020-08-24,385,74,459
8339,Tehama,2020-08-24,0,0,0
8340,Plumas,2020-08-24,0,0,0
8341,Kern,2020-08-25,155,3,158
8342,Humboldt,2020-08-25,1,0,1
8343,Tehama,2020-08-25,0,0,0
8344,Kings,2020-08-25,34,1,35
8345,Mono,2020-08-25,0,0,0
8346,Ventura,2020-08-25,72,30,102
8347,Sacramento,2020-08-25,222,33,255
8348,Colusa,2020-08-25,1,3,4
8349,Butte,2020-08-25,17,1,18
8350,Trinity,2020-08-25,0,0,0
8351,Napa,2020-08-25,5,1,6
8352,San Joaquin,2020-08-25,131,22,153
8353,San Francisco,2020-08-25,89,19,108
8354,San Diego,2020-08-25,235,88,323
8355,Madera,2020-08-25,24,7,31
8356,Merced,2020-08-25,25,0,25
8357,Mariposa,2020-08-25,0,0,0
8358,Calaveras,2020-08-25,4,4,8
8359,Alameda,2020-08-25,179,50,229
8360,Marin,2020-08-25,15,4,19
8361,Lake,2020-08-25,1,1,2
8362,Shasta,2020-08-25,5,0,5
8363,San Benito,2020-08-25,6,0,6
8364,Monterey,2020-08-25,42,0,42
8365,Tuolumne,2020-08-25,2,0,2
8366,Lassen,2020-08-25,0,0,0
8367,Stanislaus,2020-08-25,159,52,211
8368,San Luis Obispo,2020-08-25,12,1,13
8369,Siskiyou,2020-08-25,0,0,0
8370,San Bernardino,2020-08-25,321,59,380
8371,Placer,2020-08-25,41,26,67
8372,Orange,2020-08-25,399,68,467
8373,Los Angeles,2020-08-25,1168,517,1685
8374,Contra Costa,2020-08-25,89,14,103
8375,Glenn,2020-08-25,0,2,2
8376,Yuba,2020-08-25,20,0,20
8377,Riverside,2020-08-25,225,84,309
8378,Fresno,2020-08-25,230,26,256
8379,Amador,2020-08-25,3,0,3
8380,Inyo,2020-08-25,0,0,0
8381,Modoc,2020-08-25,0,0,0
8382,Plumas,2020-08-25,0,0,0
8383,Santa Cruz,2020-08-25,8,9,17
8384,Tulare,2020-08-25,51,5,56
8385,Mendocino,2020-08-25,3,0,3
8386,Santa Clara,2020-08-25,148,12,160
8387,Sonoma,2020-08-25,43,6,49
8388,El Dorado,2020-08-25,1,1,2
8389,Sutter,2020-08-25,0,0,0
8390,Solano,2020-08-25,34,3,37
8391,Del Norte,2020-08-25,0,0,0
8392,San Mateo,2020-08-25,50,11,61
8393,Nevada,2020-08-25,2,0,2
8394,Imperial,2020-08-25,34,1,35
8395,Yolo,2020-08-25,7,0,7
8396,Santa Barbara,2020-08-25,52,8,60
8397,Tulare,2020-08-26,61,6,67
8398,Napa,2020-08-26,6,1,7
8399,San Joaquin,2020-08-26,137,24,161
8400,Yolo,2020-08-26,7,0,7
8401,Los Angeles,2020-08-26,1168,466,1634
8402,San Bernardino,2020-08-26,318,49,367
8403,Glenn,2020-08-26,0,2,2
8404,San Mateo,2020-08-26,51,10,61
8405,San Francisco,2020-08-26,87,12,99
8406,Contra Costa,2020-08-26,88,21,109
8407,San Diego,2020-08-26,228,88,316
8408,Madera,2020-08-26,23,12,35
8409,Merced,2020-08-26,24,3,27
8410,Fresno,2020-08-26,218,39,257
8411,Modoc,2020-08-26,0,0,0
8412,Sacramento,2020-08-26,215,39,254
8413,Trinity,2020-08-26,0,0,0
8414,Orange,2020-08-26,372,51,423
8415,Del Norte,2020-08-26,0,0,0
8416,Yuba,2020-08-26,19,1,20
8417,Sutter,2020-08-26,0,0,0
8418,Shasta,2020-08-26,4,0,4
8419,Butte,2020-08-26,20,1,21
8420,Mariposa,2020-08-26,0,0,0
8421,Tuolumne,2020-08-26,2,0,2
8422,El Dorado,2020-08-26,1,1,2
8423,Amador,2020-08-26,2,0,2
8424,Plumas,2020-08-26,0,0,0
8425,Monterey,2020-08-26,39,1,40
8426,Santa Clara,2020-08-26,142,19,161
8427,Santa Cruz,2020-08-26,8,10,18
8428,Ventura,2020-08-26,74,31,105
8429,Imperial,2020-08-26,31,2,33
8430,San Luis Obispo,2020-08-26,13,5,18
8431,Calaveras,2020-08-26,4,1,5
8432,San Benito,2020-08-26,4,0,4
8433,Nevada,2020-08-26,1,1,2
8434,Colusa,2020-08-26,1,2,3
8435,Lassen,2020-08-26,0,0,0
8436,Kings,2020-08-26,34,1,35
8437,Kern,2020-08-26,140,2,142
8438,Marin,2020-08-26,17,2,19
8439,Lake,2020-08-26,1,1,2
8440,Solano,2020-08-26,37,2,39
8441,Sonoma,2020-08-26,39,4,43
8442,Alameda,2020-08-26,190,48,238
8443,Santa Barbara,2020-08-26,40,3,43
8444,Inyo,2020-08-26,0,0,0
8445,Stanislaus,2020-08-26,159,31,190
8446,Mono,2020-08-26,0,0,0
8447,Humboldt,2020-08-26,1,1,2
8448,Mendocino,2020-08-26,3,0,3
8449,Placer,2020-08-26,38,16,54
8450,Riverside,2020-08-26,226,95,321
8451,Tehama,2020-08-26,0,0,0
8452,Siskiyou,2020-08-26,0,0,0
8453,Yolo,2020-08-27,6,0,6
8454,Plumas,2020-08-27,0,0,0
8455,Yuba,2020-08-27,18,3,21
8456,Mariposa,2020-08-27,0,0,0
8457,San Diego,2020-08-27,227,72,299
8458,Riverside,2020-08-27,223,87,310
8459,Shasta,2020-08-27,4,0,4
8460,Solano,2020-08-27,33,2,35
8461,Monterey,2020-08-27,38,1,39
8462,Santa Barbara,2020-08-27,40,2,42
8463,Glenn,2020-08-27,0,2,2
8464,Fresno,2020-08-27,215,34,249
8465,Ventura,2020-08-27,78,24,102
8466,Sonoma,2020-08-27,40,4,44
8467,Tulare,2020-08-27,51,3,54
8468,Butte,2020-08-27,19,0,19
8469,Tehama,2020-08-27,0,0,0
8470,San Mateo,2020-08-27,52,8,60
8471,Marin,2020-08-27,10,9,19
8472,Lake,2020-08-27,1,1,2
8473,Modoc,2020-08-27,0,0,0
8474,Amador,2020-08-27,4,0,4
8475,Nevada,2020-08-27,2,0,2
8476,Inyo,2020-08-27,0,0,0
8477,Kern,2020-08-27,147,3,150
8478,Siskiyou,2020-08-27,0,0,0
8479,Napa,2020-08-27,5,1,6
8480,Trinity,2020-08-27,0,0,0
8481,Colusa,2020-08-27,10,0,10
8482,Mono,2020-08-27,0,0,0
8483,Santa Clara,2020-08-27,140,18,158
8484,Lassen,2020-08-27,0,0,0
8485,Imperial,2020-08-27,32,1,33
8486,Los Angeles,2020-08-27,1116,449,1565
8487,Sutter,2020-08-27,0,0,0
8488,Tuolumne,2020-08-27,2,0,2
8489,Stanislaus,2020-08-27,166,39,205
8490,El Dorado,2020-08-27,1,2,3
8491,Merced,2020-08-27,22,4,26
8492,San Bernardino,2020-08-27,306,55,361
8493,San Luis Obispo,2020-08-27,12,5,17
8494,Alameda,2020-08-27,198,47,245
8495,Placer,2020-08-27,38,21,59
8496,Sacramento,2020-08-27,207,30,237
8497,San Benito,2020-08-27,3,0,3
8498,Calaveras,2020-08-27,3,1,4
8499,Contra Costa,2020-08-27,99,22,121
8500,Kings,2020-08-27,33,0,33
8501,Madera,2020-08-27,24,20,44
8502,Orange,2020-08-27,351,49,400
8503,San Joaquin,2020-08-27,137,21,158
8504,Del Norte,2020-08-27,0,0,0
8505,Humboldt,2020-08-27,1,2,3
8506,Santa Cruz,2020-08-27,7,8,15
8507,Mendocino,2020-08-27,5,0,5
8508,San Francisco,2020-08-27,79,12,91
8509,Tuolumne,2020-08-28,2,0,2
8510,San Bernardino,2020-08-28,305,49,354
8511,Santa Barbara,2020-08-28,44,9,53
8512,Riverside,2020-08-28,216,81,297
8513,Solano,2020-08-28,31,5,36
8514,Yolo,2020-08-28,6,0,6
8515,Alameda,2020-08-28,202,46,248
8516,San Luis Obispo,2020-08-28,14,2,16
8517,San Diego,2020-08-28,223,59,282
8518,Humboldt,2020-08-28,1,1,2
8519,Santa Clara,2020-08-28,139,15,154
8520,Modoc,2020-08-28,0,0,0
8521,Madera,2020-08-28,25,12,37
8522,Lassen,2020-08-28,0,0,0
8523,Kern,2020-08-28,130,4,134
8524,Los Angeles,2020-08-28,1089,423,1512
8525,El Dorado,2020-08-28,0,0,0
8526,Merced,2020-08-28,24,2,26
8527,Santa Cruz,2020-08-28,9,6,15
8528,Imperial,2020-08-28,32,0,32
8529,Shasta,2020-08-28,3,0,3
8530,Placer,2020-08-28,41,21,62
8531,Ventura,2020-08-28,71,24,95
8532,Yuba,2020-08-28,18,2,20
8533,Mendocino,2020-08-28,5,0,5
8534,Del Norte,2020-08-28,0,0,0
8535,Napa,2020-08-28,3,0,3
8536,Siskiyou,2020-08-28,0,0,0
8537,Contra Costa,2020-08-28,92,28,120
8538,Butte,2020-08-28,19,0,19
8539,Mono,2020-08-28,0,0,0
8540,Sacramento,2020-08-28,202,28,230
8541,Amador,2020-08-28,4,0,4
8542,Lake,2020-08-28,1,2,3
8543,Kings,2020-08-28,32,0,32
8544,Marin,2020-08-28,14,1,15
8545,San Francisco,2020-08-28,74,18,92
8546,Glenn,2020-08-28,0,0,0
8547,Colusa,2020-08-28,11,1,12
8548,San Joaquin,2020-08-28,124,20,144
8549,Inyo,2020-08-28,0,0,0
8550,Fresno,2020-08-28,201,27,228
8551,San Mateo,2020-08-28,41,12,53
8552,Mariposa,2020-08-28,0,0,0
8553,Monterey,2020-08-28,31,0,31
8554,Calaveras,2020-08-28,2,0,2
8555,Trinity,2020-08-28,0,0,0
8556,Plumas,2020-08-28,0,0,0
8557,Sutter,2020-08-28,0,0,0
8558,Nevada,2020-08-28,2,0,2
8559,Sonoma,2020-08-28,38,9,47
8560,San Benito,2020-08-28,2,0,2
8561,Tehama,2020-08-28,1,0,1
8562,Stanislaus,2020-08-28,156,34,190
8563,Orange,2020-08-28,341,46,387
8564,Tulare,2020-08-28,51,4,55
8565,Nevada,2020-08-29,2,0,2
8566,San Bernardino,2020-08-29,292,42,334
8567,Yolo,2020-08-29,5,0,5
8568,Solano,2020-08-29,34,6,40
8569,Stanislaus,2020-08-29,145,39,184
8570,Lassen,2020-08-29,0,0,0
8571,Mariposa,2020-08-29,0,0,0
8572,Santa Barbara,2020-08-29,43,5,48
8573,San Luis Obispo,2020-08-29,12,3,15
8574,Sutter,2020-08-29,0,0,0
8575,Sonoma,2020-08-29,34,5,39
8576,San Mateo,2020-08-29,41,12,53
8577,Shasta,2020-08-29,4,0,4
8578,Glenn,2020-08-29,0,0,0
8579,Mendocino,2020-08-29,2,0,2
8580,Monterey,2020-08-29,31,0,31
8581,Orange,2020-08-29,329,48,377
8582,Tulare,2020-08-29,51,2,53
8583,El Dorado,2020-08-29,1,0,1
8584,San Francisco,2020-08-29,74,11,85
8585,Butte,2020-08-29,17,0,17
8586,Plumas,2020-08-29,0,0,0
8587,Yuba,2020-08-29,20,0,20
8588,Contra Costa,2020-08-29,95,10,105
8589,Napa,2020-08-29,2,1,3
8590,Kings,2020-08-29,32,0,32
8591,Inyo,2020-08-29,0,0,0
8592,Trinity,2020-08-29,0,0,0
8593,Siskiyou,2020-08-29,0,0,0
8594,Modoc,2020-08-29,0,0,0
8595,Marin,2020-08-29,11,3,14
8596,Humboldt,2020-08-29,1,1,2
8597,Del Norte,2020-08-29,0,1,1
8598,Amador,2020-08-29,1,0,1
8599,Calaveras,2020-08-29,2,1,3
8600,Tuolumne,2020-08-29,2,0,2
8601,Santa Clara,2020-08-29,144,22,166
8602,San Benito,2020-08-29,2,0,2
8603,Lake,2020-08-29,1,0,1
8604,Kern,2020-08-29,118,6,124
8605,San Diego,2020-08-29,230,73,303
8606,Merced,2020-08-29,25,2,27
8607,Alameda,2020-08-29,188,44,232
8608,Colusa,2020-08-29,10,1,11
8609,Riverside,2020-08-29,217,88,305
8610,Madera,2020-08-29,27,9,36
8611,Santa Cruz,2020-08-29,8,9,17
8612,San Joaquin,2020-08-29,109,24,133
8613,Los Angeles,2020-08-29,1043,415,1458
8614,Imperial,2020-08-29,31,0,31
8615,Ventura,2020-08-29,69,23,92
8616,Fresno,2020-08-29,196,29,225
8617,Placer,2020-08-29,38,23,61
8618,Sacramento,2020-08-29,200,45,245
8619,Tehama,2020-08-29,1,0,1
8620,Mono,2020-08-29,0,0,0
8621,Tehama,2020-08-30,1,0,1
8622,Los Angeles,2020-08-30,1057,386,1443
8623,Tulare,2020-08-30,49,3,52
8624,Orange,2020-08-30,317,61,378
8625,Santa Barbara,2020-08-30,36,4,40
8626,Mono,2020-08-30,0,0,0
8627,Nevada,2020-08-30,2,2,4
8628,Yolo,2020-08-30,5,0,5
8629,Placer,2020-08-30,39,20,59
8630,Glenn,2020-08-30,0,0,0
8631,Madera,2020-08-30,28,9,37
8632,El Dorado,2020-08-30,1,0,1
8633,Mendocino,2020-08-30,2,0,2
8634,Fresno,2020-08-30,190,34,224
8635,Mariposa,2020-08-30,0,0,0
8636,San Luis Obispo,2020-08-30,10,3,13
8637,Santa Clara,2020-08-30,139,25,164
8638,Alameda,2020-08-30,183,37,220
8639,Contra Costa,2020-08-30,91,14,105
8640,Kings,2020-08-30,32,0,32
8641,Yuba,2020-08-30,13,0,13
8642,Marin,2020-08-30,12,3,15
8643,Humboldt,2020-08-30,1,1,2
8644,San Benito,2020-08-30,2,0,2
8645,Sonoma,2020-08-30,33,3,36
8646,Ventura,2020-08-30,72,30,102
8647,San Joaquin,2020-08-30,102,14,116
8648,Sacramento,2020-08-30,196,31,227
8649,Inyo,2020-08-30,0,0,0
8650,Siskiyou,2020-08-30,0,0,0
8651,Amador,2020-08-30,1,0,1
8652,Calaveras,2020-08-30,2,2,4
8653,Stanislaus,2020-08-30,140,31,171
8654,Napa,2020-08-30,3,1,4
8655,Colusa,2020-08-30,10,1,11
8656,Monterey,2020-08-30,35,0,35
8657,San Diego,2020-08-30,234,71,305
8658,Del Norte,2020-08-30,0,0,0
8659,Butte,2020-08-30,18,0,18
8660,San Bernardino,2020-08-30,283,54,337
8661,Trinity,2020-08-30,0,0,0
8662,Lassen,2020-08-30,0,0,0
8663,San Francisco,2020-08-30,70,10,80
8664,Kern,2020-08-30,115,4,119
8665,Merced,2020-08-30,25,1,26
8666,Solano,2020-08-30,33,7,40
8667,Tuolumne,2020-08-30,2,0,2
8668,Santa Cruz,2020-08-30,8,6,14
8669,Imperial,2020-08-30,28,0,28
8670,Lake,2020-08-30,0,0,0
8671,San Mateo,2020-08-30,45,12,57
8672,Plumas,2020-08-30,0,0,0
8673,Shasta,2020-08-30,3,0,3
8674,Modoc,2020-08-30,0,0,0
8675,Sutter,2020-08-30,0,0,0
8676,Riverside,2020-08-30,210,71,281
8677,Yolo,2020-08-31,6,0,6
8678,Madera,2020-08-31,29,12,41
8679,Tuolumne,2020-08-31,1,0,1
8680,Modoc,2020-08-31,0,0,0
8681,Santa Barbara,2020-08-31,41,6,47
8682,Mariposa,2020-08-31,0,0,0
8683,Orange,2020-08-31,307,61,368
8684,Contra Costa,2020-08-31,81,28,109
8685,Glenn,2020-08-31,0,0,0
8686,Monterey,2020-08-31,30,0,30
8687,Humboldt,2020-08-31,1,0,1
8688,Colusa,2020-08-31,10,1,11
8689,Yuba,2020-08-31,12,0,12
8690,Stanislaus,2020-08-31,143,46,189
8691,Mendocino,2020-08-31,2,0,2
8692,Placer,2020-08-31,39,22,61
8693,Del Norte,2020-08-31,0,0,0
8694,Siskiyou,2020-08-31,0,0,0
8695,Nevada,2020-08-31,2,4,6
8696,San Bernardino,2020-08-31,292,63,355
8697,San Mateo,2020-08-31,41,14,55
8698,San Francisco,2020-08-31,74,12,86
8699,Alameda,2020-08-31,173,46,219
8700,Santa Cruz,2020-08-31,9,4,13
8701,Marin,2020-08-31,14,1,15
8702,San Joaquin,2020-08-31,102,14,116
8703,Riverside,2020-08-31,216,54,270
8704,Merced,2020-08-31,27,1,28
8705,Inyo,2020-08-31,0,0,0
8706,San Benito,2020-08-31,2,0,2
8707,Kern,2020-08-31,122,6,128
8708,San Luis Obispo,2020-08-31,10,4,14
8709,Solano,2020-08-31,32,6,38
8710,San Diego,2020-08-31,233,73,306
8711,Fresno,2020-08-31,184,25,209
8712,Los Angeles,2020-08-31,1048,415,1463
8713,Santa Clara,2020-08-31,134,26,160
8714,Sonoma,2020-08-31,31,10,41
8715,Plumas,2020-08-31,0,0,0
8716,Lassen,2020-08-31,0,0,0
8717,Trinity,2020-08-31,0,0,0
8718,Butte,2020-08-31,17,1,18
8719,Kings,2020-08-31,39,1,40
8720,Sutter,2020-08-31,0,0,0
8721,Mono,2020-08-31,0,0,0
8722,Tehama,2020-08-31,1,0,1
8723,Napa,2020-08-31,1,0,1
8724,Sacramento,2020-08-31,196,47,243
8725,Imperial,2020-08-31,27,0,27
8726,Ventura,2020-08-31,65,15,80
8727,Shasta,2020-08-31,2,0,2
8728,Tulare,2020-08-31,50,1,51
8729,Calaveras,2020-08-31,2,1,3
8730,Lake,2020-08-31,0,0,0
8731,El Dorado,2020-08-31,0,0,0
8732,Amador,2020-08-31,1,0,1
8733,Tehama,2020-09-01,2,0,2
8734,Lassen,2020-09-01,0,0,0
8735,Humboldt,2020-09-01,1,2,3
8736,Napa,2020-09-01,2,1,3
8737,Stanislaus,2020-09-01,135,43,178
8738,Merced,2020-09-01,26,1,27
8739,San Joaquin,2020-09-01,102,13,115
8740,Marin,2020-09-01,12,2,14
8741,Mendocino,2020-09-01,4,0,4
8742,Madera,2020-09-01,27,10,37
8743,Orange,2020-09-01,295,64,359
8744,Yolo,2020-09-01,7,0,7
8745,San Francisco,2020-09-01,77,16,93
8746,San Mateo,2020-09-01,37,15,52
8747,Monterey,2020-09-01,28,1,29
8748,Tuolumne,2020-09-01,2,0,2
8749,Amador,2020-09-01,2,0,2
8750,Nevada,2020-09-01,1,1,2
8751,Modoc,2020-09-01,0,0,0
8752,Solano,2020-09-01,31,7,38
8753,San Luis Obispo,2020-09-01,9,4,13
8754,Placer,2020-09-01,37,26,63
8755,Kings,2020-09-01,38,0,38
8756,Siskiyou,2020-09-01,0,0,0
8757,Trinity,2020-09-01,0,0,0
8758,Glenn,2020-09-01,0,0,0
8759,Butte,2020-09-01,17,0,17
8760,Alameda,2020-09-01,162,48,210
8761,Kern,2020-09-01,117,10,127
8762,Santa Cruz,2020-09-01,10,6,16
8763,Plumas,2020-09-01,0,0,0
8764,Santa Barbara,2020-09-01,38,5,43
8765,Riverside,2020-09-01,207,57,264
8766,Los Angeles,2020-09-01,1062,426,1488
8767,Yuba,2020-09-01,13,0,13
8768,Colusa,2020-09-01,6,1,7
8769,Del Norte,2020-09-01,0,0,0
8770,San Diego,2020-09-01,231,76,307
8771,El Dorado,2020-09-01,0,2,2
8772,Contra Costa,2020-09-01,76,22,98
8773,Tulare,2020-09-01,50,2,52
8774,San Benito,2020-09-01,4,0,4
8775,Sutter,2020-09-01,0,0,0
8776,Inyo,2020-09-01,0,1,1
8777,Mono,2020-09-01,0,0,0
8778,Shasta,2020-09-01,3,0,3
8779,Santa Clara,2020-09-01,132,27,159
8780,Mariposa,2020-09-01,0,0,0
8781,Sacramento,2020-09-01,187,47,234
8782,Ventura,2020-09-01,68,31,99
8783,Lake,2020-09-01,0,1,1
8784,Calaveras,2020-09-01,2,2,4
8785,Fresno,2020-09-01,172,34,206
8786,Imperial,2020-09-01,29,0,29
8787,San Bernardino,2020-09-01,283,66,349
8788,Sonoma,2020-09-01,29,8,37
8789,Tehama,2020-09-02,2,0,2
8790,Ventura,2020-09-02,61,30,91
8791,Butte,2020-09-02,17,1,18
8792,Contra Costa,2020-09-02,77,17,94
8793,Tulare,2020-09-02,53,1,54
8794,Santa Clara,2020-09-02,130,28,158
8795,Santa Barbara,2020-09-02,39,5,44
8796,Mendocino,2020-09-02,4,0,4
8797,Fresno,2020-09-02,161,27,188
8798,Los Angeles,2020-09-02,992,386,1378
8799,Mariposa,2020-09-02,0,0,0
8800,San Joaquin,2020-09-02,103,22,125
8801,Placer,2020-09-02,38,20,58
8802,Monterey,2020-09-02,29,1,30
8803,Madera,2020-09-02,25,9,34
8804,Yuba,2020-09-02,17,0,17
8805,Siskiyou,2020-09-02,0,0,0
8806,San Bernardino,2020-09-02,264,59,323
8807,Imperial,2020-09-02,29,0,29
8808,San Diego,2020-09-02,220,70,290
8809,San Luis Obispo,2020-09-02,9,5,14
8810,El Dorado,2020-09-02,0,1,1
8811,Kern,2020-09-02,120,6,126
8812,Glenn,2020-09-02,0,0,0
8813,Calaveras,2020-09-02,4,2,6
8814,Shasta,2020-09-02,4,0,4
8815,Sutter,2020-09-02,0,0,0
8816,San Mateo,2020-09-02,36,11,47
8817,San Francisco,2020-09-02,70,12,82
8818,Mono,2020-09-02,0,0,0
8819,Amador,2020-09-02,3,0,3
8820,Kings,2020-09-02,31,0,31
8821,Plumas,2020-09-02,0,0,0
8822,Lassen,2020-09-02,0,0,0
8823,Tuolumne,2020-09-02,2,1,3
8824,Alameda,2020-09-02,150,41,191
8825,Merced,2020-09-02,27,1,28
8826,Solano,2020-09-02,32,6,38
8827,Humboldt,2020-09-02,1,2,3
8828,Del Norte,2020-09-02,0,0,0
8829,Marin,2020-09-02,14,1,15
8830,Santa Cruz,2020-09-02,11,4,15
8831,Trinity,2020-09-02,0,0,0
8832,Napa,2020-09-02,1,0,1
8833,Sonoma,2020-09-02,31,6,37
8834,Riverside,2020-09-02,189,67,256
8835,Colusa,2020-09-02,1,0,1
8836,Lake,2020-09-02,0,0,0
8837,Nevada,2020-09-02,1,1,2
8838,San Benito,2020-09-02,2,0,2
8839,Modoc,2020-09-02,0,0,0
8840,Orange,2020-09-02,272,60,332
8841,Stanislaus,2020-09-02,131,34,165
8842,Yolo,2020-09-02,8,0,8
8843,Sacramento,2020-09-02,193,29,222
8844,Inyo,2020-09-02,0,1,1
8845,Humboldt,2020-09-03,1,0,1
8846,Solano,2020-09-03,32,13,45
8847,Mono,2020-09-03,0,0,0
8848,Glenn,2020-09-03,0,0,0
8849,Sonoma,2020-09-03,33,2,35
8850,Mariposa,2020-09-03,0,0,0
8851,Santa Clara,2020-09-03,125,27,152
8852,San Bernardino,2020-09-03,252,43,295
8853,Imperial,2020-09-03,27,0,27
8854,Riverside,2020-09-03,185,37,222
8855,Calaveras,2020-09-03,5,0,5
8856,Marin,2020-09-03,16,3,19
8857,Yolo,2020-09-03,8,0,8
8858,Stanislaus,2020-09-03,124,34,158
8859,Yuba,2020-09-03,13,0,13
8860,San Joaquin,2020-09-03,93,19,112
8861,Inyo,2020-09-03,0,0,0
8862,Ventura,2020-09-03,57,19,76
8863,Tehama,2020-09-03,2,0,2
8864,El Dorado,2020-09-03,0,2,2
8865,Sutter,2020-09-03,0,0,0
8866,Santa Cruz,2020-09-03,9,7,16
8867,Contra Costa,2020-09-03,71,13,84
8868,Napa,2020-09-03,3,2,5
8869,Lassen,2020-09-03,0,0,0
8870,Alameda,2020-09-03,147,54,201
8871,Colusa,2020-09-03,1,0,1
8872,Del Norte,2020-09-03,0,0,0
8873,Orange,2020-09-03,264,44,308
8874,Santa Barbara,2020-09-03,40,7,47
8875,Sacramento,2020-09-03,190,32,222
8876,Madera,2020-09-03,25,12,37
8877,Amador,2020-09-03,2,0,2
8878,Nevada,2020-09-03,1,0,1
8879,Trinity,2020-09-03,0,0,0
8880,Butte,2020-09-03,20,1,21
8881,San Luis Obispo,2020-09-03,9,1,10
8882,Monterey,2020-09-03,27,1,28
8883,Modoc,2020-09-03,0,0,0
8884,Tulare,2020-09-03,46,5,51
8885,Lake,2020-09-03,0,0,0
8886,San Benito,2020-09-03,2,0,2
8887,Tuolumne,2020-09-03,2,0,2
8888,Siskiyou,2020-09-03,0,0,0
8889,San Francisco,2020-09-03,63,11,74
8890,Kings,2020-09-03,32,0,32
8891,Los Angeles,2020-09-03,984,362,1346
8892,Merced,2020-09-03,27,3,30
8893,Fresno,2020-09-03,156,25,181
8894,Placer,2020-09-03,41,24,65
8895,Plumas,2020-09-03,0,0,0
8896,San Diego,2020-09-03,218,71,289
8897,Mendocino,2020-09-03,4,0,4
8898,San Mateo,2020-09-03,33,8,41
8899,Kern,2020-09-03,119,6,125
8900,Shasta,2020-09-03,4,0,4
8901,San Bernardino,2020-09-04,239,44,283
8902,Nevada,2020-09-04,1,2,3
8903,Colusa,2020-09-04,1,1,2
8904,Mendocino,2020-09-04,4,0,4
8905,Sonoma,2020-09-04,37,6,43
8906,Plumas,2020-09-04,0,0,0
8907,Mariposa,2020-09-04,0,0,0
8908,Placer,2020-09-04,41,16,57
8909,El Dorado,2020-09-04,0,1,1
8910,Kings,2020-09-04,35,0,35
8911,Santa Cruz,2020-09-04,8,2,10
8912,Amador,2020-09-04,2,0,2
8913,San Mateo,2020-09-04,37,5,42
8914,San Francisco,2020-09-04,58,7,65
8915,Los Angeles,2020-09-04,966,355,1321
8916,Imperial,2020-09-04,25,0,25
8917,Yolo,2020-09-04,8,0,8
8918,Del Norte,2020-09-04,0,0,0
8919,Riverside,2020-09-04,177,39,216
8920,Merced,2020-09-04,23,0,23
8921,Tehama,2020-09-04,2,0,2
8922,Tulare,2020-09-04,44,4,48
8923,Shasta,2020-09-04,3,3,6
8924,Sacramento,2020-09-04,177,33,210
8925,Sutter,2020-09-04,0,0,0
8926,Alameda,2020-09-04,142,35,177
8927,Napa,2020-09-04,3,1,4
8928,Santa Clara,2020-09-04,122,11,133
8929,Solano,2020-09-04,32,8,40
8930,Humboldt,2020-09-04,1,1,2
8931,Marin,2020-09-04,12,3,15
8932,Kern,2020-09-04,98,1,99
8933,San Benito,2020-09-04,3,0,3
8934,Mono,2020-09-04,0,0,0
8935,Butte,2020-09-04,15,0,15
8936,Stanislaus,2020-09-04,126,33,159
8937,Tuolumne,2020-09-04,1,0,1
8938,Monterey,2020-09-04,26,3,29
8939,Contra Costa,2020-09-04,73,14,87
8940,San Diego,2020-09-04,219,59,278
8941,Madera,2020-09-04,25,8,33
8942,Trinity,2020-09-04,0,0,0
8943,Fresno,2020-09-04,153,23,176
8944,Orange,2020-09-04,274,54,328
8945,San Joaquin,2020-09-04,86,15,101
8946,Lake,2020-09-04,0,1,1
8947,Calaveras,2020-09-04,4,1,5
8948,Siskiyou,2020-09-04,0,0,0
8949,San Luis Obispo,2020-09-04,7,3,10
8950,Lassen,2020-09-04,0,0,0
8951,Inyo,2020-09-04,0,1,1
8952,Ventura,2020-09-04,50,30,80
8953,Modoc,2020-09-04,0,0,0
8954,Yuba,2020-09-04,16,0,16
8955,Glenn,2020-09-04,0,0,0
8956,Santa Barbara,2020-09-04,37,6,43
8957,Tehama,2020-09-05,2,0,2
8958,Butte,2020-09-05,15,1,16
8959,Inyo,2020-09-05,0,0,0
8960,Tuolumne,2020-09-05,1,0,1
8961,Los Angeles,2020-09-05,943,361,1304
8962,Monterey,2020-09-05,27,2,29
8963,San Francisco,2020-09-05,51,6,57
8964,Imperial,2020-09-05,26,1,27
8965,Tulare,2020-09-05,52,4,56
8966,Nevada,2020-09-05,0,0,0
8967,Glenn,2020-09-05,0,0,0
8968,Lassen,2020-09-05,0,0,0
8969,Alameda,2020-09-05,145,42,187
8970,Del Norte,2020-09-05,0,1,1
8971,San Mateo,2020-09-05,35,8,43
8972,Colusa,2020-09-05,1,0,1
8973,Fresno,2020-09-05,153,20,173
8974,Lake,2020-09-05,1,0,1
8975,Shasta,2020-09-05,3,1,4
8976,San Diego,2020-09-05,193,67,260
8977,Orange,2020-09-05,253,54,307
8978,Yolo,2020-09-05,10,0,10
8979,San Joaquin,2020-09-05,88,16,104
8980,Placer,2020-09-05,42,21,63
8981,San Bernardino,2020-09-05,243,39,282
8982,Sonoma,2020-09-05,34,7,41
8983,Stanislaus,2020-09-05,131,31,162
8984,San Benito,2020-09-05,1,0,1
8985,Amador,2020-09-05,1,0,1
8986,Santa Clara,2020-09-05,124,17,141
8987,Kern,2020-09-05,83,4,87
8988,Humboldt,2020-09-05,1,1,2
8989,Sacramento,2020-09-05,168,36,204
8990,Madera,2020-09-05,23,13,36
8991,Siskiyou,2020-09-05,0,0,0
8992,Santa Barbara,2020-09-05,41,7,48
8993,Ventura,2020-09-05,50,27,77
8994,Merced,2020-09-05,26,3,29
8995,Trinity,2020-09-05,0,0,0
8996,El Dorado,2020-09-05,0,0,0
8997,Solano,2020-09-05,37,8,45
8998,Kings,2020-09-05,32,1,33
8999,Santa Cruz,2020-09-05,8,3,11
9000,San Luis Obispo,2020-09-05,6,1,7
9001,Mendocino,2020-09-05,4,0,4
9002,Marin,2020-09-05,13,7,20
9003,Plumas,2020-09-05,0,0,0
9004,Mono,2020-09-05,0,0,0
9005,Yuba,2020-09-05,19,0,19
9006,Napa,2020-09-05,3,2,5
9007,Contra Costa,2020-09-05,73,26,99
9008,Calaveras,2020-09-05,3,3,6
9009,Modoc,2020-09-05,0,0,0
9010,Sutter,2020-09-05,0,0,0
9011,Mariposa,2020-09-05,0,0,0
9012,Riverside,2020-09-05,171,49,220
9013,Yuba,2020-09-06,19,0,19
9014,Trinity,2020-09-06,0,0,0
9015,Shasta,2020-09-06,2,1,3
9016,Glenn,2020-09-06,0,0,0
9017,Sonoma,2020-09-06,37,14,51
9018,Lake,2020-09-06,0,1,1
9019,Marin,2020-09-06,13,8,21
9020,San Francisco,2020-09-06,57,17,74
9021,Imperial,2020-09-06,30,1,31
9022,Inyo,2020-09-06,0,0,0
9023,Colusa,2020-09-06,0,1,1
9024,Sacramento,2020-09-06,161,42,203
9025,Stanislaus,2020-09-06,134,31,165
9026,Humboldt,2020-09-06,1,1,2
9027,Del Norte,2020-09-06,0,1,1
9028,Siskiyou,2020-09-06,0,0,0
9029,Sutter,2020-09-06,0,0,0
9030,San Bernardino,2020-09-06,228,39,267
9031,Mono,2020-09-06,0,0,0
9032,Calaveras,2020-09-06,2,2,4
9033,Mariposa,2020-09-06,0,0,0
9034,Tehama,2020-09-06,2,0,2
9035,Modoc,2020-09-06,0,0,0
9036,Lassen,2020-09-06,0,0,0
9037,Merced,2020-09-06,27,6,33
9038,Amador,2020-09-06,2,0,2
9039,Santa Barbara,2020-09-06,44,7,51
9040,Fresno,2020-09-06,152,18,170
9041,Yolo,2020-09-06,9,1,10
9042,Solano,2020-09-06,32,8,40
9043,San Mateo,2020-09-06,30,16,46
9044,Nevada,2020-09-06,2,0,2
9045,San Diego,2020-09-06,195,71,266
9046,Monterey,2020-09-06,28,1,29
9047,Los Angeles,2020-09-06,942,372,1314
9048,San Luis Obispo,2020-09-06,7,3,10
9049,Madera,2020-09-06,25,11,36
9050,El Dorado,2020-09-06,0,0,0
9051,Placer,2020-09-06,41,26,67
9052,Plumas,2020-09-06,0,0,0
9053,Butte,2020-09-06,20,1,21
9054,Tulare,2020-09-06,55,4,59
9055,Kings,2020-09-06,35,1,36
9056,San Benito,2020-09-06,1,0,1
9057,Napa,2020-09-06,4,5,9
9058,Riverside,2020-09-06,171,59,230
9059,Mendocino,2020-09-06,5,0,5
9060,Ventura,2020-09-06,52,33,85
9061,Contra Costa,2020-09-06,68,24,92
9062,Alameda,2020-09-06,146,43,189
9063,Kern,2020-09-06,80,12,92
9064,Tuolumne,2020-09-06,0,0,0
9065,Santa Cruz,2020-09-06,9,5,14
9066,Santa Clara,2020-09-06,116,18,134
9067,Orange,2020-09-06,238,64,302
9068,San Joaquin,2020-09-06,86,9,95
9069,Placer,2020-09-07,37,28,65
9070,Stanislaus,2020-09-07,142,38,180
9071,Mariposa,2020-09-07,0,0,0
9072,Alameda,2020-09-07,148,57,205
9073,Siskiyou,2020-09-07,0,0,0
9074,Solano,2020-09-07,27,9,36
9075,Imperial,2020-09-07,29,1,30
9076,Ventura,2020-09-07,58,21,79
9077,Shasta,2020-09-07,2,1,3
9078,Colusa,2020-09-07,0,0,0
9079,Inyo,2020-09-07,0,0,0
9080,Sutter,2020-09-07,0,0,0
9081,San Diego,2020-09-07,211,72,283
9082,Kings,2020-09-07,32,2,34
9083,Sacramento,2020-09-07,141,41,182
9084,San Bernardino,2020-09-07,224,42,266
9085,Santa Cruz,2020-09-07,10,5,15
9086,San Mateo,2020-09-07,39,15,54
9087,Yuba,2020-09-07,18,0,18
9088,Tehama,2020-09-07,1,0,1
9089,Glenn,2020-09-07,0,0,0
9090,Lake,2020-09-07,0,0,0
9091,Sonoma,2020-09-07,38,9,47
9092,Nevada,2020-09-07,2,0,2
9093,San Francisco,2020-09-07,63,15,78
9094,Merced,2020-09-07,22,6,28
9095,San Luis Obispo,2020-09-07,10,2,12
9096,Amador,2020-09-07,2,0,2
9097,Calaveras,2020-09-07,1,1,2
9098,San Benito,2020-09-07,1,0,1
9099,Monterey,2020-09-07,28,0,28
9100,Los Angeles,2020-09-07,936,414,1350
9101,Fresno,2020-09-07,153,16,169
9102,El Dorado,2020-09-07,0,0,0
9103,Marin,2020-09-07,14,3,17
9104,Yolo,2020-09-07,8,0,8
9105,Tuolumne,2020-09-07,0,0,0
9106,Humboldt,2020-09-07,1,1,2
9107,Orange,2020-09-07,242,47,289
9108,Mendocino,2020-09-07,4,0,4
9109,Tulare,2020-09-07,57,2,59
9110,Del Norte,2020-09-07,0,0,0
9111,San Joaquin,2020-09-07,87,12,99
9112,Trinity,2020-09-07,0,0,0
9113,Plumas,2020-09-07,0,0,0
9114,Riverside,2020-09-07,175,68,243
9115,Mono,2020-09-07,0,0,0
9116,Modoc,2020-09-07,0,0,0
9117,Lassen,2020-09-07,0,0,0
9118,Santa Barbara,2020-09-07,39,4,43
9119,Santa Clara,2020-09-07,118,15,133
9120,Napa,2020-09-07,5,2,7
9121,Butte,2020-09-07,23,0,23
9122,Madera,2020-09-07,25,6,31
9123,Kern,2020-09-07,84,13,97
9124,Contra Costa,2020-09-07,64,18,82
9125,Contra Costa,2020-09-08,62,29,91
9126,Marin,2020-09-08,14,3,17
9127,San Luis Obispo,2020-09-08,10,5,15
9128,Ventura,2020-09-08,55,25,80
9129,Inyo,2020-09-08,0,0,0
9130,Santa Cruz,2020-09-08,14,2,16
9131,Calaveras,2020-09-08,1,5,6
9132,El Dorado,2020-09-08,0,0,0
9133,Sacramento,2020-09-08,157,46,203
9134,Tulare,2020-09-08,60,6,66
9135,Siskiyou,2020-09-08,0,0,0
9136,Fresno,2020-09-08,145,23,168
9137,Madera,2020-09-08,22,11,33
9138,Alameda,2020-09-08,154,50,204
9139,Yuba,2020-09-08,17,0,17
9140,Mono,2020-09-08,0,0,0
9141,Sutter,2020-09-08,0,0,0
9142,Kings,2020-09-08,36,2,38
9143,Los Angeles,2020-09-08,940,415,1355
9144,Glenn,2020-09-08,0,0,0
9145,San Francisco,2020-09-08,64,18,82
9146,Del Norte,2020-09-08,0,0,0
9147,Santa Barbara,2020-09-08,37,2,39
9148,Napa,2020-09-08,4,0,4
9149,Lake,2020-09-08,1,1,2
9150,Colusa,2020-09-08,0,2,2
9151,Lassen,2020-09-08,0,0,0
9152,Kern,2020-09-08,89,9,98
9153,Santa Clara,2020-09-08,121,16,137
9154,Shasta,2020-09-08,2,1,3
9155,San Bernardino,2020-09-08,214,61,275
9156,Stanislaus,2020-09-08,144,50,194
9157,San Diego,2020-09-08,219,59,278
9158,Mendocino,2020-09-08,4,1,5
9159,Modoc,2020-09-08,0,0,0
9160,Nevada,2020-09-08,2,0,2
9161,Amador,2020-09-08,1,0,1
9162,San Joaquin,2020-09-08,89,18,107
9163,Butte,2020-09-08,24,1,25
9164,Humboldt,2020-09-08,3,1,4
9165,Merced,2020-09-08,20,2,22
9166,Tuolumne,2020-09-08,0,1,1
9167,Yolo,2020-09-08,8,0,8
9168,Imperial,2020-09-08,22,0,22
9169,Riverside,2020-09-08,185,76,261
9170,Trinity,2020-09-08,0,0,0
9171,Tehama,2020-09-08,1,0,1
9172,Plumas,2020-09-08,0,0,0
9173,Solano,2020-09-08,33,10,43
9174,Placer,2020-09-08,37,25,62
9175,Mariposa,2020-09-08,0,0,0
9176,Orange,2020-09-08,234,60,294
9177,San Mateo,2020-09-08,43,27,70
9178,Sonoma,2020-09-08,36,6,42
9179,Monterey,2020-09-08,30,2,32
9180,San Benito,2020-09-08,0,0,0
9181,Kern,2020-09-09,94,8,102
9182,Alameda,2020-09-09,149,40,189
9183,Ventura,2020-09-09,55,32,87
9184,Amador,2020-09-09,2,0,2
9185,Napa,2020-09-09,5,1,6
9186,Yolo,2020-09-09,7,2,9
9187,Tehama,2020-09-09,1,0,1
9188,San Joaquin,2020-09-09,83,10,93
9189,San Francisco,2020-09-09,66,18,84
9190,Tulare,2020-09-09,58,7,65
9191,San Benito,2020-09-09,0,0,0
9192,San Mateo,2020-09-09,47,29,76
9193,Inyo,2020-09-09,0,0,0
9194,Kings,2020-09-09,36,1,37
9195,Modoc,2020-09-09,0,0,0
9196,Sutter,2020-09-09,0,0,0
9197,Tuolumne,2020-09-09,1,0,1
9198,Santa Cruz,2020-09-09,12,3,15
9199,Santa Clara,2020-09-09,127,14,141
9200,Monterey,2020-09-09,27,1,28
9201,Santa Barbara,2020-09-09,38,1,39
9202,Orange,2020-09-09,239,70,309
9203,Los Angeles,2020-09-09,889,365,1254
9204,Humboldt,2020-09-09,4,0,4
9205,El Dorado,2020-09-09,0,0,0
9206,Shasta,2020-09-09,3,0,3
9207,Nevada,2020-09-09,2,0,2
9208,Madera,2020-09-09,20,8,28
9209,Sacramento,2020-09-09,155,35,190
9210,Colusa,2020-09-09,0,4,4
9211,Yuba,2020-09-09,20,0,20
9212,Lake,2020-09-09,1,0,1
9213,Stanislaus,2020-09-09,136,23,159
9214,Riverside,2020-09-09,189,49,238
9215,Imperial,2020-09-09,24,0,24
9216,Mono,2020-09-09,0,0,0
9217,San Bernardino,2020-09-09,210,60,270
9218,Lassen,2020-09-09,0,0,0
9219,Sonoma,2020-09-09,31,3,34
9220,Del Norte,2020-09-09,0,0,0
9221,Plumas,2020-09-09,0,0,0
9222,Placer,2020-09-09,36,14,50
9223,San Luis Obispo,2020-09-09,8,1,9
9224,Mariposa,2020-09-09,0,0,0
9225,Butte,2020-09-09,21,0,21
9226,Glenn,2020-09-09,0,0,0
9227,Calaveras,2020-09-09,2,3,5
9228,Contra Costa,2020-09-09,62,19,81
9229,Siskiyou,2020-09-09,0,0,0
9230,Fresno,2020-09-09,133,24,157
9231,Mendocino,2020-09-09,1,0,1
9232,Solano,2020-09-09,29,10,39
9233,Merced,2020-09-09,18,1,19
9234,Marin,2020-09-09,13,6,19
9235,Trinity,2020-09-09,0,0,0
9236,San Diego,2020-09-09,234,75,309
9237,Yolo,2020-09-10,7,1,8
9238,Amador,2020-09-10,2,0,2
9239,Santa Barbara,2020-09-10,36,3,39
9240,Lake,2020-09-10,0,2,2
9241,Trinity,2020-09-10,0,0,0
9242,Humboldt,2020-09-10,4,1,5
9243,Contra Costa,2020-09-10,66,17,83
9244,San Francisco,2020-09-10,67,22,89
9245,Sutter,2020-09-10,0,0,0
9246,Kings,2020-09-10,31,1,32
9247,Mono,2020-09-10,0,0,0
9248,Mariposa,2020-09-10,0,0,0
9249,Del Norte,2020-09-10,0,0,0
9250,San Benito,2020-09-10,0,0,0
9251,San Luis Obispo,2020-09-10,7,3,10
9252,Santa Clara,2020-09-10,114,18,132
9253,Colusa,2020-09-10,0,2,2
9254,Kern,2020-09-10,82,3,85
9255,Lassen,2020-09-10,0,0,0
9256,Napa,2020-09-10,4,1,5
9257,Modoc,2020-09-10,0,0,0
9258,Marin,2020-09-10,10,6,16
9259,Placer,2020-09-10,34,25,59
9260,San Mateo,2020-09-10,34,17,51
9261,Ventura,2020-09-10,55,35,90
9262,San Joaquin,2020-09-10,75,9,84
9263,Mendocino,2020-09-10,2,0,2
9264,Sacramento,2020-09-10,151,32,183
9265,El Dorado,2020-09-10,1,0,1
9266,Santa Cruz,2020-09-10,14,1,15
9267,Los Angeles,2020-09-10,877,342,1219
9268,Nevada,2020-09-10,3,0,3
9269,Madera,2020-09-10,19,5,24
9270,Sonoma,2020-09-10,31,3,34
9271,San Bernardino,2020-09-10,205,54,259
9272,Orange,2020-09-10,223,54,277
9273,Fresno,2020-09-10,122,21,143
9274,Tulare,2020-09-10,53,6,59
9275,Imperial,2020-09-10,22,0,22
9276,Monterey,2020-09-10,28,0,28
9277,Yuba,2020-09-10,19,0,19
9278,Solano,2020-09-10,27,8,35
9279,Glenn,2020-09-10,0,0,0
9280,Stanislaus,2020-09-10,125,30,155
9281,Tehama,2020-09-10,1,0,1
9282,Alameda,2020-09-10,142,41,183
9283,Inyo,2020-09-10,0,0,0
9284,Shasta,2020-09-10,3,0,3
9285,Butte,2020-09-10,17,0,17
9286,Tuolumne,2020-09-10,1,0,1
9287,San Diego,2020-09-10,232,53,285
9288,Siskiyou,2020-09-10,1,0,1
9289,Calaveras,2020-09-10,2,5,7
9290,Merced,2020-09-10,13,9,22
9291,Riverside,2020-09-10,180,51,231
9292,Plumas,2020-09-10,0,0,0
9293,Yolo,2020-09-11,5,0,5
9294,Inyo,2020-09-11,0,0,0
9295,San Bernardino,2020-09-11,201,49,250
9296,Calaveras,2020-09-11,2,1,3
9297,Colusa,2020-09-11,0,3,3
9298,Amador,2020-09-11,2,0,2
9299,Stanislaus,2020-09-11,119,44,163
9300,Kern,2020-09-11,66,17,83
9301,Fresno,2020-09-11,112,15,127
9302,Contra Costa,2020-09-11,73,20,93
9303,Santa Cruz,2020-09-11,16,0,16
9304,Del Norte,2020-09-11,0,0,0
9305,Monterey,2020-09-11,28,1,29
9306,Alameda,2020-09-11,131,47,178
9307,San Diego,2020-09-11,227,60,287
9308,Los Angeles,2020-09-11,813,345,1158
9309,Merced,2020-09-11,15,1,16
9310,San Francisco,2020-09-11,74,18,92
9311,Humboldt,2020-09-11,2,1,3
9312,Butte,2020-09-11,11,0,11
9313,Trinity,2020-09-11,0,0,0
9314,Placer,2020-09-11,34,18,52
9315,Modoc,2020-09-11,0,0,0
9316,San Benito,2020-09-11,0,0,0
9317,Glenn,2020-09-11,0,0,0
9318,Shasta,2020-09-11,3,0,3
9319,Mariposa,2020-09-11,0,0,0
9320,Riverside,2020-09-11,171,61,232
9321,Sacramento,2020-09-11,135,26,161
9322,Marin,2020-09-11,9,2,11
9323,Tulare,2020-09-11,47,3,50
9324,Plumas,2020-09-11,0,0,0
9325,Santa Clara,2020-09-11,112,20,132
9326,San Mateo,2020-09-11,38,10,48
9327,Madera,2020-09-11,18,7,25
9328,Solano,2020-09-11,25,8,33
9329,Siskiyou,2020-09-11,1,0,1
9330,Nevada,2020-09-11,2,1,3
9331,Tehama,2020-09-11,2,0,2
9332,Sutter,2020-09-11,0,0,0
9333,Imperial,2020-09-11,25,0,25
9334,Mendocino,2020-09-11,3,0,3
9335,Mono,2020-09-11,0,0,0
9336,San Luis Obispo,2020-09-11,7,3,10
9337,Santa Barbara,2020-09-11,33,4,37
9338,El Dorado,2020-09-11,1,1,2
9339,Yuba,2020-09-11,20,1,21
9340,Napa,2020-09-11,5,0,5
9341,Tuolumne,2020-09-11,1,0,1
9342,Kings,2020-09-11,31,0,31
9343,Lassen,2020-09-11,0,0,0
9344,Sonoma,2020-09-11,32,3,35
9345,San Joaquin,2020-09-11,68,15,83
9346,Ventura,2020-09-11,55,25,80
9347,Orange,2020-09-11,215,47,262
9348,Lake,2020-09-11,0,1,1
9349,Shasta,2020-09-12,2,1,3
9350,Plumas,2020-09-12,0,0,0
9351,Mendocino,2020-09-12,4,0,4
9352,Napa,2020-09-12,5,1,6
9353,San Benito,2020-09-12,1,0,1
9354,El Dorado,2020-09-12,2,0,2
9355,Nevada,2020-09-12,3,0,3
9356,Merced,2020-09-12,15,1,16
9357,Madera,2020-09-12,17,11,28
9358,San Francisco,2020-09-12,72,15,87
9359,Inyo,2020-09-12,0,0,0
9360,Mono,2020-09-12,0,0,0
9361,Tuolumne,2020-09-12,2,0,2
9362,Santa Clara,2020-09-12,107,19,126
9363,Ventura,2020-09-12,50,13,63
9364,Glenn,2020-09-12,0,0,0
9365,Marin,2020-09-12,10,1,11
9366,Tulare,2020-09-12,46,3,49
9367,Modoc,2020-09-12,0,0,0
9368,Tehama,2020-09-12,2,0,2
9369,Del Norte,2020-09-12,0,0,0
9370,Monterey,2020-09-12,27,1,28
9371,Kern,2020-09-12,70,11,81
9372,Solano,2020-09-12,27,7,34
9373,Santa Cruz,2020-09-12,16,0,16
9374,Sonoma,2020-09-12,36,1,37
9375,Siskiyou,2020-09-12,1,0,1
9376,Los Angeles,2020-09-12,775,375,1150
9377,Sacramento,2020-09-12,128,47,175
9378,Mariposa,2020-09-12,0,0,0
9379,Lassen,2020-09-12,0,0,0
9380,Sutter,2020-09-12,0,0,0
9381,San Diego,2020-09-12,218,59,277
9382,Riverside,2020-09-12,157,43,200
9383,Stanislaus,2020-09-12,114,34,148
9384,San Luis Obispo,2020-09-12,8,2,10
9385,Orange,2020-09-12,196,42,238
9386,Contra Costa,2020-09-12,69,19,88
9387,San Mateo,2020-09-12,39,17,56
9388,San Joaquin,2020-09-12,70,6,76
9389,Placer,2020-09-12,38,22,60
9390,Santa Barbara,2020-09-12,30,1,31
9391,Butte,2020-09-12,12,0,12
9392,Trinity,2020-09-12,0,0,0
9393,Colusa,2020-09-12,0,3,3
9394,Yuba,2020-09-12,20,2,22
9395,Kings,2020-09-12,23,0,23
9396,Amador,2020-09-12,0,1,1
9397,Calaveras,2020-09-12,2,3,5
9398,Imperial,2020-09-12,27,0,27
9399,Fresno,2020-09-12,111,26,137
9400,Humboldt,2020-09-12,2,1,3
9401,Yolo,2020-09-12,4,0,4
9402,Alameda,2020-09-12,121,47,168
9403,San Bernardino,2020-09-12,190,36,226
9404,Lake,2020-09-12,0,1,1
9405,Mono,2020-09-13,0,0,0
9406,Mendocino,2020-09-13,3,0,3
9407,Santa Clara,2020-09-13,111,18,129
9408,Riverside,2020-09-13,151,49,200
9409,San Francisco,2020-09-13,76,18,94
9410,Butte,2020-09-13,15,0,15
9411,Amador,2020-09-13,0,0,0
9412,Sutter,2020-09-13,0,0,0
9413,Kings,2020-09-13,27,0,27
9414,Lassen,2020-09-13,0,0,0
9415,Fresno,2020-09-13,101,21,122
9416,Yuba,2020-09-13,18,1,19
9417,Marin,2020-09-13,11,5,16
9418,Colusa,2020-09-13,0,3,3
9419,Siskiyou,2020-09-13,1,0,1
9420,Imperial,2020-09-13,21,1,22
9421,Kern,2020-09-13,69,4,73
9422,Humboldt,2020-09-13,1,1,2
9423,Tehama,2020-09-13,2,0,2
9424,Ventura,2020-09-13,42,17,59
9425,San Benito,2020-09-13,2,0,2
9426,Orange,2020-09-13,193,45,238
9427,San Luis Obispo,2020-09-13,8,0,8
9428,Napa,2020-09-13,7,1,8
9429,Mariposa,2020-09-13,0,0,0
9430,Madera,2020-09-13,19,6,25
9431,Plumas,2020-09-13,0,0,0
9432,San Joaquin,2020-09-13,66,21,87
9433,Contra Costa,2020-09-13,70,21,91
9434,Tuolumne,2020-09-13,1,0,1
9435,Lake,2020-09-13,0,1,1
9436,Stanislaus,2020-09-13,114,32,146
9437,Sonoma,2020-09-13,36,3,39
9438,Merced,2020-09-13,12,2,14
9439,Inyo,2020-09-13,0,0,0
9440,San Bernardino,2020-09-13,183,34,217
9441,San Diego,2020-09-13,225,61,286
9442,Monterey,2020-09-13,28,0,28
9443,Santa Barbara,2020-09-13,32,1,33
9444,Shasta,2020-09-13,2,1,3
9445,Calaveras,2020-09-13,2,0,2
9446,Placer,2020-09-13,33,16,49
9447,Modoc,2020-09-13,0,0,0
9448,Yolo,2020-09-13,4,0,4
9449,Glenn,2020-09-13,0,0,0
9450,Alameda,2020-09-13,115,47,162
9451,Sacramento,2020-09-13,129,38,167
9452,Solano,2020-09-13,31,7,38
9453,Santa Cruz,2020-09-13,17,0,17
9454,Trinity,2020-09-13,0,0,0
9455,El Dorado,2020-09-13,2,0,2
9456,Nevada,2020-09-13,4,0,4
9457,San Mateo,2020-09-13,43,12,55
9458,Los Angeles,2020-09-13,772,330,1102
9459,Tulare,2020-09-13,42,5,47
9460,Del Norte,2020-09-13,0,2,2
9461,Mendocino,2020-09-14,5,0,5
9462,Sacramento,2020-09-14,116,39,155
9463,Glenn,2020-09-14,0,0,0
9464,Napa,2020-09-14,7,2,9
9465,Kings,2020-09-14,26,0,26
9466,Alameda,2020-09-14,118,37,155
9467,Orange,2020-09-14,201,51,252
9468,Ventura,2020-09-14,47,17,64
9469,Solano,2020-09-14,36,5,41
9470,Mono,2020-09-14,0,0,0
9471,Amador,2020-09-14,0,0,0
9472,Humboldt,2020-09-14,1,3,4
9473,Tuolumne,2020-09-14,1,0,1
9474,Calaveras,2020-09-14,2,0,2
9475,Tehama,2020-09-14,2,0,2
9476,San Mateo,2020-09-14,38,12,50
9477,Del Norte,2020-09-14,0,1,1
9478,Yuba,2020-09-14,18,1,19
9479,Inyo,2020-09-14,1,0,1
9480,Lake,2020-09-14,0,1,1
9481,Imperial,2020-09-14,20,1,21
9482,Nevada,2020-09-14,4,1,5
9483,San Luis Obispo,2020-09-14,9,0,9
9484,Sonoma,2020-09-14,34,4,38
9485,San Diego,2020-09-14,225,48,273
9486,Plumas,2020-09-14,0,0,0
9487,Colusa,2020-09-14,0,3,3
9488,San Benito,2020-09-14,1,0,1
9489,Monterey,2020-09-14,28,0,28
9490,Contra Costa,2020-09-14,67,25,92
9491,Santa Barbara,2020-09-14,30,2,32
9492,Los Angeles,2020-09-14,804,343,1147
9493,Mariposa,2020-09-14,0,0,0
9494,Fresno,2020-09-14,118,28,146
9495,Siskiyou,2020-09-14,0,0,0
9496,Modoc,2020-09-14,0,0,0
9497,Santa Cruz,2020-09-14,18,0,18
9498,Riverside,2020-09-14,155,49,204
9499,San Francisco,2020-09-14,78,12,90
9500,Santa Clara,2020-09-14,108,15,123
9501,Stanislaus,2020-09-14,113,30,143
9502,Placer,2020-09-14,31,20,51
9503,Yolo,2020-09-14,4,0,4
9504,El Dorado,2020-09-14,1,0,1
9505,Sutter,2020-09-14,0,0,0
9506,Shasta,2020-09-14,2,0,2
9507,Lassen,2020-09-14,0,0,0
9508,Tulare,2020-09-14,39,7,46
9509,Kern,2020-09-14,76,5,81
9510,San Joaquin,2020-09-14,61,21,82
9511,Merced,2020-09-14,11,1,12
9512,San Bernardino,2020-09-14,186,53,239
9513,Butte,2020-09-14,14,0,14
9514,Trinity,2020-09-14,0,0,0
9515,Madera,2020-09-14,21,4,25
9516,Marin,2020-09-14,10,7,17
9517,Kern,2020-09-15,71,6,77
9518,Orange,2020-09-15,202,56,258
9519,Inyo,2020-09-15,0,0,0
9520,Napa,2020-09-15,6,0,6
9521,Alameda,2020-09-15,110,44,154
9522,Placer,2020-09-15,30,13,43
9523,Amador,2020-09-15,0,0,0
9524,El Dorado,2020-09-15,0,0,0
9525,Modoc,2020-09-15,0,0,0
9526,Lassen,2020-09-15,0,0,0
9527,Tuolumne,2020-09-15,1,0,1
9528,Nevada,2020-09-15,3,1,4
9529,Contra Costa,2020-09-15,60,17,77
9530,Butte,2020-09-15,10,0,10
9531,Madera,2020-09-15,21,9,30
9532,Mariposa,2020-09-15,0,0,0
9533,San Francisco,2020-09-15,68,13,81
9534,Imperial,2020-09-15,21,1,22
9535,Colusa,2020-09-15,3,0,3
9536,Yuba,2020-09-15,19,0,19
9537,Trinity,2020-09-15,0,0,0
9538,Marin,2020-09-15,9,2,11
9539,Ventura,2020-09-15,52,15,67
9540,Lake,2020-09-15,0,0,0
9541,Merced,2020-09-15,11,5,16
9542,Santa Cruz,2020-09-15,19,0,19
9543,Monterey,2020-09-15,26,3,29
9544,Siskiyou,2020-09-15,0,1,1
9545,San Bernardino,2020-09-15,180,57,237
9546,Yolo,2020-09-15,3,0,3
9547,Humboldt,2020-09-15,1,2,3
9548,Stanislaus,2020-09-15,109,29,138
9549,Plumas,2020-09-15,0,0,0
9550,Calaveras,2020-09-15,1,1,2
9551,Los Angeles,2020-09-15,780,348,1128
9552,San Luis Obispo,2020-09-15,10,3,13
9553,Tulare,2020-09-15,40,13,53
9554,Santa Clara,2020-09-15,103,15,118
9555,Mendocino,2020-09-15,5,0,5
9556,San Mateo,2020-09-15,40,12,52
9557,San Diego,2020-09-15,220,55,275
9558,Riverside,2020-09-15,155,62,217
9559,Sonoma,2020-09-15,33,2,35
9560,Del Norte,2020-09-15,0,0,0
9561,Mono,2020-09-15,0,0,0
9562,Tehama,2020-09-15,1,0,1
9563,Sutter,2020-09-15,0,0,0
9564,Shasta,2020-09-15,2,0,2
9565,Santa Barbara,2020-09-15,28,3,31
9566,Fresno,2020-09-15,117,20,137
9567,San Benito,2020-09-15,1,0,1
9568,Sacramento,2020-09-15,127,34,161
9569,San Joaquin,2020-09-15,62,18,80
9570,Kings,2020-09-15,26,0,26
9571,Glenn,2020-09-15,0,0,0
9572,Solano,2020-09-15,35,4,39
9573,Lassen,2020-09-16,0,0,0
9574,Nevada,2020-09-16,3,0,3
9575,Sonoma,2020-09-16,32,2,34
9576,Del Norte,2020-09-16,0,0,0
9577,Sutter,2020-09-16,0,0,0
9578,El Dorado,2020-09-16,0,0,0
9579,Tehama,2020-09-16,1,0,1
9580,San Joaquin,2020-09-16,58,14,72
9581,San Benito,2020-09-16,1,0,1
9582,Santa Barbara,2020-09-16,23,2,25
9583,Santa Cruz,2020-09-16,18,0,18
9584,Butte,2020-09-16,10,1,11
9585,Yuba,2020-09-16,20,1,21
9586,San Mateo,2020-09-16,39,14,53
9587,Merced,2020-09-16,14,1,15
9588,Alameda,2020-09-16,101,46,147
9589,Kern,2020-09-16,70,3,73
9590,Monterey,2020-09-16,31,0,31
9591,Mariposa,2020-09-16,0,0,0
9592,Orange,2020-09-16,198,53,251
9593,San Bernardino,2020-09-16,186,59,245
9594,Ventura,2020-09-16,48,13,61
9595,San Luis Obispo,2020-09-16,11,1,12
9596,Sacramento,2020-09-16,108,35,143
9597,Lake,2020-09-16,0,0,0
9598,Amador,2020-09-16,0,0,0
9599,Imperial,2020-09-16,22,1,23
9600,Siskiyou,2020-09-16,1,0,1
9601,Trinity,2020-09-16,0,0,0
9602,Stanislaus,2020-09-16,99,32,131
9603,Santa Clara,2020-09-16,103,15,118
9604,Fresno,2020-09-16,100,26,126
9605,Inyo,2020-09-16,0,0,0
9606,Madera,2020-09-16,18,11,29
9607,Calaveras,2020-09-16,1,0,1
9608,Colusa,2020-09-16,2,1,3
9609,Contra Costa,2020-09-16,53,28,81
9610,Los Angeles,2020-09-16,739,379,1118
9611,Modoc,2020-09-16,0,0,0
9612,Mono,2020-09-16,0,0,0
9613,Kings,2020-09-16,20,0,20
9614,Riverside,2020-09-16,158,60,218
9615,Solano,2020-09-16,32,6,38
9616,Tuolumne,2020-09-16,1,0,1
9617,Mendocino,2020-09-16,6,1,7
9618,Plumas,2020-09-16,0,0,0
9619,Humboldt,2020-09-16,1,2,3
9620,Marin,2020-09-16,11,5,16
9621,Tulare,2020-09-16,43,10,53
9622,San Diego,2020-09-16,224,60,284
9623,Glenn,2020-09-16,0,0,0
9624,Yolo,2020-09-16,3,0,3
9625,Napa,2020-09-16,4,2,6
9626,Placer,2020-09-16,29,15,44
9627,San Francisco,2020-09-16,64,14,78
9628,Shasta,2020-09-16,2,0,2
9629,Napa,2020-09-17,4,3,7
9630,Nevada,2020-09-17,2,0,2
9631,Colusa,2020-09-17,2,2,4
9632,Solano,2020-09-17,29,17,46
9633,Plumas,2020-09-17,0,0,0
9634,Amador,2020-09-17,0,0,0
9635,Del Norte,2020-09-17,0,0,0
9636,Santa Cruz,2020-09-17,18,0,18
9637,Santa Clara,2020-09-17,114,16,130
9638,Marin,2020-09-17,10,9,19
9639,Sonoma,2020-09-17,30,1,31
9640,Shasta,2020-09-17,2,0,2
9641,Glenn,2020-09-17,0,0,0
9642,Tuolumne,2020-09-17,1,0,1
9643,Mariposa,2020-09-17,0,0,0
9644,Imperial,2020-09-17,20,0,20
9645,Lake,2020-09-17,0,2,2
9646,Modoc,2020-09-17,0,0,0
9647,Kern,2020-09-17,74,2,76
9648,Merced,2020-09-17,11,0,11
9649,Stanislaus,2020-09-17,98,21,119
9650,Calaveras,2020-09-17,0,0,0
9651,Mendocino,2020-09-17,6,1,7
9652,Butte,2020-09-17,9,0,9
9653,Santa Barbara,2020-09-17,27,3,30
9654,Riverside,2020-09-17,143,67,210
9655,Ventura,2020-09-17,46,20,66
9656,Yuba,2020-09-17,23,1,24
9657,Fresno,2020-09-17,98,33,131
9658,Los Angeles,2020-09-17,732,340,1072
9659,Tulare,2020-09-17,38,9,47
9660,San Diego,2020-09-17,217,59,276
9661,Tehama,2020-09-17,1,0,1
9662,San Joaquin,2020-09-17,60,13,73
9663,Orange,2020-09-17,201,59,260
9664,Sacramento,2020-09-17,109,32,141
9665,San Benito,2020-09-17,2,0,2
9666,San Mateo,2020-09-17,39,10,49
9667,Alameda,2020-09-17,98,37,135
9668,Monterey,2020-09-17,30,0,30
9669,San Francisco,2020-09-17,67,19,86
9670,Trinity,2020-09-17,0,0,0
9671,Kings,2020-09-17,23,0,23
9672,Yolo,2020-09-17,5,0,5
9673,El Dorado,2020-09-17,0,0,0
9674,San Bernardino,2020-09-17,172,51,223
9675,Inyo,2020-09-17,0,0,0
9676,Mono,2020-09-17,0,0,0
9677,Placer,2020-09-17,26,28,54
9678,Madera,2020-09-17,19,10,29
9679,Humboldt,2020-09-17,1,3,4
9680,Sutter,2020-09-17,0,0,0
9681,San Luis Obispo,2020-09-17,13,1,14
9682,Contra Costa,2020-09-17,55,25,80
9683,Lassen,2020-09-17,0,0,0
9684,Siskiyou,2020-09-17,1,0,1
9685,Alameda,2020-09-18,99,39,138
9686,Del Norte,2020-09-18,0,0,0
9687,Sutter,2020-09-18,0,0,0
9688,Nevada,2020-09-18,3,0,3
9689,Merced,2020-09-18,9,2,11
9690,Madera,2020-09-18,13,12,25
9691,Santa Clara,2020-09-18,114,19,133
9692,Shasta,2020-09-18,4,0,4
9693,Riverside,2020-09-18,148,51,199
9694,Monterey,2020-09-18,34,1,35
9695,Sonoma,2020-09-18,23,4,27
9696,Tulare,2020-09-18,38,6,44
9697,Tehama,2020-09-18,1,0,1
9698,San Bernardino,2020-09-18,169,47,216
9699,Orange,2020-09-18,202,50,252
9700,Mariposa,2020-09-18,0,0,0
9701,San Diego,2020-09-18,208,41,249
9702,Tuolumne,2020-09-18,1,0,1
9703,Inyo,2020-09-18,0,0,0
9704,Kings,2020-09-18,24,0,24
9705,Sacramento,2020-09-18,110,41,151
9706,Lassen,2020-09-18,0,0,0
9707,Glenn,2020-09-18,0,0,0
9708,Santa Cruz,2020-09-18,17,0,17
9709,Imperial,2020-09-18,19,0,19
9710,Modoc,2020-09-18,0,0,0
9711,San Francisco,2020-09-18,64,12,76
9712,San Mateo,2020-09-18,39,9,48
9713,Lake,2020-09-18,0,1,1
9714,Ventura,2020-09-18,48,13,61
9715,Placer,2020-09-18,26,28,54
9716,Calaveras,2020-09-18,0,1,1
9717,Kern,2020-09-18,66,4,70
9718,Stanislaus,2020-09-18,95,25,120
9719,San Luis Obispo,2020-09-18,11,1,12
9720,Plumas,2020-09-18,0,0,0
9721,El Dorado,2020-09-18,0,0,0
9722,Los Angeles,2020-09-18,765,363,1128
9723,San Joaquin,2020-09-18,55,9,64
9724,Trinity,2020-09-18,0,0,0
9725,Siskiyou,2020-09-18,1,0,1
9726,Santa Barbara,2020-09-18,26,2,28
9727,Marin,2020-09-18,7,4,11
9728,Humboldt,2020-09-18,2,2,4
9729,Solano,2020-09-18,27,10,37
9730,Yolo,2020-09-18,4,0,4
9731,Yuba,2020-09-18,21,1,22
9732,Fresno,2020-09-18,96,18,114
9733,Mono,2020-09-18,0,0,0
9734,Colusa,2020-09-18,2,1,3
9735,Mendocino,2020-09-18,5,0,5
9736,San Benito,2020-09-18,3,0,3
9737,Napa,2020-09-18,5,0,5
9738,Amador,2020-09-18,0,0,0
9739,Contra Costa,2020-09-18,45,29,74
9740,Butte,2020-09-18,14,1,15
9741,Kern,2020-09-19,72,4,76
9742,Amador,2020-09-19,0,0,0
9743,Orange,2020-09-19,185,52,237
9744,Marin,2020-09-19,7,5,12
9745,Shasta,2020-09-19,3,0,3
9746,Tuolumne,2020-09-19,1,0,1
9747,Sacramento,2020-09-19,114,34,148
9748,Glenn,2020-09-19,0,0,0
9749,Sutter,2020-09-19,0,0,0
9750,Riverside,2020-09-19,138,54,192
9751,Napa,2020-09-19,4,0,4
9752,Plumas,2020-09-19,0,0,0
9753,Santa Clara,2020-09-19,111,20,131
9754,San Francisco,2020-09-19,58,9,67
9755,Solano,2020-09-19,26,11,37
9756,Del Norte,2020-09-19,0,0,0
9757,Nevada,2020-09-19,3,0,3
9758,San Benito,2020-09-19,3,0,3
9759,San Mateo,2020-09-19,39,6,45
9760,Butte,2020-09-19,16,1,17
9761,San Luis Obispo,2020-09-19,10,2,12
9762,Ventura,2020-09-19,48,11,59
9763,Inyo,2020-09-19,0,0,0
9764,San Bernardino,2020-09-19,167,54,221
9765,Trinity,2020-09-19,0,0,0
9766,San Joaquin,2020-09-19,57,10,67
9767,Sonoma,2020-09-19,22,6,28
9768,Humboldt,2020-09-19,2,2,4
9769,Yolo,2020-09-19,5,0,5
9770,Alameda,2020-09-19,95,48,143
9771,Kings,2020-09-19,20,0,20
9772,Siskiyou,2020-09-19,0,1,1
9773,Monterey,2020-09-19,32,2,34
9774,Santa Barbara,2020-09-19,23,3,26
9775,El Dorado,2020-09-19,0,0,0
9776,Yuba,2020-09-19,21,1,22
9777,Stanislaus,2020-09-19,94,18,112
9778,Fresno,2020-09-19,92,23,115
9779,Los Angeles,2020-09-19,749,328,1077
9780,San Diego,2020-09-19,203,50,253
9781,Imperial,2020-09-19,18,0,18
9782,Lassen,2020-09-19,0,0,0
9783,Mono,2020-09-19,0,0,0
9784,Colusa,2020-09-19,2,3,5
9785,Merced,2020-09-19,9,0,9
9786,Contra Costa,2020-09-19,51,25,76
9787,Tulare,2020-09-19,36,8,44
9788,Tehama,2020-09-19,2,0,2
9789,Placer,2020-09-19,24,30,54
9790,Mariposa,2020-09-19,0,0,0
9791,Calaveras,2020-09-19,0,0,0
9792,Madera,2020-09-19,14,11,25
9793,Santa Cruz,2020-09-19,17,0,17
9794,Modoc,2020-09-19,0,0,0
9795,Mendocino,2020-09-19,5,0,5
9796,Lake,2020-09-19,0,2,2
9797,Santa Barbara,2020-09-20,23,3,26
9798,Solano,2020-09-20,26,10,36
9799,Mono,2020-09-20,0,0,0
9800,Kern,2020-09-20,67,4,71
9801,Fresno,2020-09-20,92,13,105
9802,Shasta,2020-09-20,3,0,3
9803,Sacramento,2020-09-20,120,30,150
9804,Del Norte,2020-09-20,0,1,1
9805,Sonoma,2020-09-20,21,6,27
9806,Imperial,2020-09-20,20,0,20
9807,Placer,2020-09-20,22,28,50
9808,El Dorado,2020-09-20,0,0,0
9809,Mariposa,2020-09-20,0,0,0
9810,Colusa,2020-09-20,3,3,6
9811,Kings,2020-09-20,19,0,19
9812,Alameda,2020-09-20,98,46,144
9813,Inyo,2020-09-20,0,0,0
9814,Humboldt,2020-09-20,2,2,4
9815,Plumas,2020-09-20,0,0,0
9816,Siskiyou,2020-09-20,0,1,1
9817,Trinity,2020-09-20,0,0,0
9818,San Diego,2020-09-20,211,56,267
9819,Modoc,2020-09-20,0,0,0
9820,Marin,2020-09-20,8,4,12
9821,Santa Cruz,2020-09-20,17,0,17
9822,Calaveras,2020-09-20,0,0,0
9823,San Joaquin,2020-09-20,58,6,64
9824,Merced,2020-09-20,9,0,9
9825,Nevada,2020-09-20,3,1,4
9826,Amador,2020-09-20,1,0,1
9827,Tehama,2020-09-20,3,0,3
9828,San Luis Obispo,2020-09-20,7,0,7
9829,Los Angeles,2020-09-20,745,368,1113
9830,Orange,2020-09-20,178,59,237
9831,Ventura,2020-09-20,44,13,57
9832,Contra Costa,2020-09-20,50,26,76
9833,Lassen,2020-09-20,0,0,0
9834,Santa Clara,2020-09-20,113,22,135
9835,San Mateo,2020-09-20,34,8,42
9836,Madera,2020-09-20,15,12,27
9837,Glenn,2020-09-20,0,0,0
9838,Riverside,2020-09-20,131,55,186
9839,Mendocino,2020-09-20,4,0,4
9840,San Benito,2020-09-20,4,0,4
9841,Monterey,2020-09-20,33,2,35
9842,San Bernardino,2020-09-20,156,62,218
9843,Stanislaus,2020-09-20,92,21,113
9844,Butte,2020-09-20,13,0,13
9845,San Francisco,2020-09-20,65,8,73
9846,Tuolumne,2020-09-20,0,0,0
9847,Yuba,2020-09-20,19,1,20
9848,Sutter,2020-09-20,0,0,0
9849,Tulare,2020-09-20,37,10,47
9850,Yolo,2020-09-20,6,0,6
9851,Lake,2020-09-20,0,2,2
9852,Napa,2020-09-20,1,3,4
9853,Inyo,2020-09-21,0,0,0
9854,Lassen,2020-09-21,0,0,0
9855,Nevada,2020-09-21,3,1,4
9856,Monterey,2020-09-21,33,2,35
9857,Orange,2020-09-21,170,64,234
9858,Kern,2020-09-21,69,2,71
9859,San Francisco,2020-09-21,68,2,70
9860,Glenn,2020-09-21,0,0,0
9861,Napa,2020-09-21,2,4,6
9862,Colusa,2020-09-21,3,3,6
9863,Contra Costa,2020-09-21,52,22,74
9864,San Luis Obispo,2020-09-21,5,0,5
9865,Humboldt,2020-09-21,4,3,7
9866,Stanislaus,2020-09-21,93,24,117
9867,Placer,2020-09-21,30,20,50
9868,Madera,2020-09-21,13,14,27
9869,Alameda,2020-09-21,96,34,130
9870,Santa Clara,2020-09-21,111,18,129
9871,Santa Barbara,2020-09-21,26,8,34
9872,Amador,2020-09-21,1,0,1
9873,San Mateo,2020-09-21,35,12,47
9874,Butte,2020-09-21,12,1,13
9875,Tehama,2020-09-21,3,0,3
9876,Kings,2020-09-21,21,0,21
9877,Yolo,2020-09-21,5,0,5
9878,Modoc,2020-09-21,0,0,0
9879,San Benito,2020-09-21,3,0,3
9880,Riverside,2020-09-21,146,52,198
9881,Santa Cruz,2020-09-21,15,0,15
9882,Sonoma,2020-09-21,15,4,19
9883,Lake,2020-09-21,0,1,1
9884,San Diego,2020-09-21,209,54,263
9885,San Bernardino,2020-09-21,164,71,235
9886,Plumas,2020-09-21,0,0,0
9887,Imperial,2020-09-21,23,0,23
9888,Shasta,2020-09-21,2,0,2
9889,Yuba,2020-09-21,19,1,20
9890,Mono,2020-09-21,0,0,0
9891,Calaveras,2020-09-21,0,0,0
9892,Del Norte,2020-09-21,0,0,0
9893,Sacramento,2020-09-21,132,29,161
9894,Marin,2020-09-21,8,5,13
9895,Siskiyou,2020-09-21,0,1,1
9896,Tuolumne,2020-09-21,0,0,0
9897,Mendocino,2020-09-21,5,0,5
9898,San Joaquin,2020-09-21,60,18,78
9899,Mariposa,2020-09-21,0,0,0
9900,El Dorado,2020-09-21,0,0,0
9901,Merced,2020-09-21,11,0,11
9902,Sutter,2020-09-21,0,0,0
9903,Fresno,2020-09-21,89,17,106
9904,Trinity,2020-09-21,0,0,0
9905,Los Angeles,2020-09-21,779,365,1144
9906,Ventura,2020-09-21,39,11,50
9907,Solano,2020-09-21,21,13,34
9908,Tulare,2020-09-21,37,12,49
9909,Mariposa,2020-09-22,0,0,0
9910,Shasta,2020-09-22,4,1,5
9911,Stanislaus,2020-09-22,92,26,118
9912,San Diego,2020-09-22,210,50,260
9913,Ventura,2020-09-22,45,14,59
9914,Sutter,2020-09-22,0,0,0
9915,Alameda,2020-09-22,91,36,127
9916,Sonoma,2020-09-22,18,2,20
9917,Nevada,2020-09-22,3,2,5
9918,Placer,2020-09-22,27,24,51
9919,Lake,2020-09-22,0,1,1
9920,Inyo,2020-09-22,0,1,1
9921,Fresno,2020-09-22,82,23,105
9922,Plumas,2020-09-22,0,0,0
9923,San Francisco,2020-09-22,72,8,80
9924,Yolo,2020-09-22,6,0,6
9925,Mendocino,2020-09-22,6,0,6
9926,Modoc,2020-09-22,0,0,0
9927,San Bernardino,2020-09-22,162,72,234
9928,Sacramento,2020-09-22,138,33,171
9929,Orange,2020-09-22,175,64,239
9930,Kern,2020-09-22,69,1,70
9931,Contra Costa,2020-09-22,49,25,74
9932,San Luis Obispo,2020-09-22,4,0,4
9933,Colusa,2020-09-22,3,2,5
9934,Glenn,2020-09-22,0,0,0
9935,Mono,2020-09-22,0,0,0
9936,Lassen,2020-09-22,0,0,0
9937,Trinity,2020-09-22,0,0,0
9938,Tuolumne,2020-09-22,0,0,0
9939,Solano,2020-09-22,22,20,42
9940,Humboldt,2020-09-22,4,3,7
9941,Madera,2020-09-22,15,15,30
9942,San Joaquin,2020-09-22,56,18,74
9943,San Benito,2020-09-22,2,0,2
9944,El Dorado,2020-09-22,0,0,0
9945,Siskiyou,2020-09-22,0,1,1
9946,Santa Barbara,2020-09-22,21,6,27
9947,Napa,2020-09-22,3,1,4
9948,Tulare,2020-09-22,41,9,50
9949,Merced,2020-09-22,9,0,9
9950,Kings,2020-09-22,22,0,22
9951,Amador,2020-09-22,1,0,1
9952,Riverside,2020-09-22,150,64,214
9953,Los Angeles,2020-09-22,753,392,1145
9954,Butte,2020-09-22,13,0,13
9955,Santa Cruz,2020-09-22,17,0,17
9956,San Mateo,2020-09-22,36,8,44
9957,Santa Clara,2020-09-22,114,8,122
9958,Calaveras,2020-09-22,0,0,0
9959,Monterey,2020-09-22,34,2,36
9960,Del Norte,2020-09-22,0,1,1
9961,Marin,2020-09-22,7,5,12
9962,Imperial,2020-09-22,26,0,26
9963,Tehama,2020-09-22,1,0,1
9964,Yuba,2020-09-22,14,2,16
9965,Modoc,2020-09-23,0,0,0
9966,Tehama,2020-09-23,2,0,2
9967,Mariposa,2020-09-23,0,0,0
9968,Yuba,2020-09-23,12,0,12
9969,Trinity,2020-09-23,0,0,0
9970,San Benito,2020-09-23,1,0,1
9971,Solano,2020-09-23,24,24,48
9972,Inyo,2020-09-23,0,0,0
9973,Humboldt,2020-09-23,5,4,9
9974,Sonoma,2020-09-23,18,8,26
9975,Plumas,2020-09-23,0,0,0
9976,Lassen,2020-09-23,0,0,0
9977,Napa,2020-09-23,3,0,3
9978,Marin,2020-09-23,7,3,10
9979,Shasta,2020-09-23,5,1,6
9980,Glenn,2020-09-23,0,0,0
9981,Kern,2020-09-23,75,2,77
9982,Los Angeles,2020-09-23,760,378,1138
9983,Siskiyou,2020-09-23,1,0,1
9984,Amador,2020-09-23,1,0,1
9985,Santa Clara,2020-09-23,109,11,120
9986,Tulare,2020-09-23,39,13,52
9987,Nevada,2020-09-23,2,0,2
9988,Merced,2020-09-23,8,0,8
9989,Colusa,2020-09-23,1,0,1
9990,Butte,2020-09-23,12,0,12
9991,San Francisco,2020-09-23,65,9,74
9992,San Mateo,2020-09-23,37,10,47
9993,San Luis Obispo,2020-09-23,3,0,3
9994,Yolo,2020-09-23,6,0,6
9995,Mendocino,2020-09-23,8,0,8
9996,Madera,2020-09-23,13,17,30
9997,Kings,2020-09-23,15,0,15
9998,Calaveras,2020-09-23,0,0,0
9999,Stanislaus,2020-09-23,91,24,115
10000,Alameda,2020-09-23,92,43,135
10001,Santa Cruz,2020-09-23,17,0,17
10002,Riverside,2020-09-23,141,56,197
10003,Mono,2020-09-23,0,0,0
10004,San Diego,2020-09-23,200,53,253
10005,El Dorado,2020-09-23,0,0,0
10006,San Bernardino,2020-09-23,160,52,212
10007,Imperial,2020-09-23,27,0,27
10008,Ventura,2020-09-23,44,20,64
10009,Sutter,2020-09-23,0,0,0
10010,Orange,2020-09-23,168,57,225
10011,Fresno,2020-09-23,84,24,108
10012,San Joaquin,2020-09-23,54,16,70
10013,Santa Barbara,2020-09-23,20,4,24
10014,Del Norte,2020-09-23,0,0,0
10015,Contra Costa,2020-09-23,45,21,66
10016,Placer,2020-09-23,29,28,57
10017,Monterey,2020-09-23,27,0,27
10018,Lake,2020-09-23,0,1,1
10019,Tuolumne,2020-09-23,0,0,0
10020,Sacramento,2020-09-23,147,27,174
10021,Nevada,2020-09-24,2,1,3
10022,Kings,2020-09-24,18,0,18
10023,Fresno,2020-09-24,80,23,103
10024,Lassen,2020-09-24,0,0,0
10025,Los Angeles,2020-09-24,715,319,1034
10026,Tuolumne,2020-09-24,0,0,0
10027,Orange,2020-09-24,157,69,226
10028,Mariposa,2020-09-24,0,0,0
10029,El Dorado,2020-09-24,1,0,1
10030,San Benito,2020-09-24,2,0,2
10031,Amador,2020-09-24,1,0,1
10032,Yuba,2020-09-24,12,0,12
10033,Sacramento,2020-09-24,139,31,170
10034,Mono,2020-09-24,0,0,0
10035,Glenn,2020-09-24,0,0,0
10036,Yolo,2020-09-24,3,0,3
10037,Tehama,2020-09-24,4,0,4
10038,Sonoma,2020-09-24,16,5,21
10039,Lake,2020-09-24,0,0,0
10040,Del Norte,2020-09-24,0,0,0
10041,Stanislaus,2020-09-24,82,32,114
10042,Shasta,2020-09-24,5,0,5
10043,San Joaquin,2020-09-24,49,7,56
10044,San Diego,2020-09-24,196,45,241
10045,Trinity,2020-09-24,0,0,0
10046,Monterey,2020-09-24,28,0,28
10047,Butte,2020-09-24,11,0,11
10048,Humboldt,2020-09-24,4,1,5
10049,Marin,2020-09-24,5,3,8
10050,Merced,2020-09-24,11,0,11
10051,Alameda,2020-09-24,87,36,123
10052,Solano,2020-09-24,24,24,48
10053,Contra Costa,2020-09-24,39,20,59
10054,Santa Clara,2020-09-24,111,10,121
10055,San Mateo,2020-09-24,35,12,47
10056,Imperial,2020-09-24,28,0,28
10057,San Bernardino,2020-09-24,152,42,194
10058,San Luis Obispo,2020-09-24,3,1,4
10059,Riverside,2020-09-24,142,62,204
10060,San Francisco,2020-09-24,60,9,69
10061,Colusa,2020-09-24,1,0,1
10062,Sutter,2020-09-24,0,0,0
10063,Placer,2020-09-24,30,30,60
10064,Madera,2020-09-24,11,12,23
10065,Ventura,2020-09-24,44,23,67
10066,Siskiyou,2020-09-24,1,0,1
10067,Kern,2020-09-24,72,2,74
10068,Modoc,2020-09-24,0,0,0
10069,Mendocino,2020-09-24,8,0,8
10070,Calaveras,2020-09-24,0,0,0
10071,Tulare,2020-09-24,41,8,49
10072,Santa Cruz,2020-09-24,18,0,18
10073,Napa,2020-09-24,3,2,5
10074,Plumas,2020-09-24,0,0,0
10075,Inyo,2020-09-24,0,0,0
10076,Santa Barbara,2020-09-24,23,4,27
10077,Santa Cruz,2020-09-25,20,0,20
10078,Butte,2020-09-25,12,0,12
10079,San Luis Obispo,2020-09-25,3,0,3
10080,Imperial,2020-09-25,25,0,25
10081,Orange,2020-09-25,156,51,207
10082,Tuolumne,2020-09-25,0,0,0
10083,Stanislaus,2020-09-25,76,28,104
10084,Yuba,2020-09-25,13,0,13
10085,Santa Clara,2020-09-25,108,12,120
10086,San Bernardino,2020-09-25,148,50,198
10087,Colusa,2020-09-25,1,0,1
10088,Merced,2020-09-25,10,0,10
10089,Napa,2020-09-25,3,2,5
10090,Plumas,2020-09-25,0,0,0
10091,Monterey,2020-09-25,28,0,28
10092,San Mateo,2020-09-25,32,13,45
10093,Kern,2020-09-25,70,2,72
10094,Madera,2020-09-25,13,19,32
10095,Tehama,2020-09-25,5,0,5
10096,Sacramento,2020-09-25,134,28,162
10097,Sonoma,2020-09-25,18,8,26
10098,Inyo,2020-09-25,0,0,0
10099,Del Norte,2020-09-25,0,0,0
10100,Yolo,2020-09-25,3,0,3
10101,Mendocino,2020-09-25,9,0,9
10102,Mono,2020-09-25,0,0,0
10103,Siskiyou,2020-09-25,1,0,1
10104,Amador,2020-09-25,0,0,0
10105,Marin,2020-09-25,5,2,7
10106,Lake,2020-09-25,0,2,2
10107,El Dorado,2020-09-25,1,0,1
10108,Los Angeles,2020-09-25,692,336,1028
10109,Sutter,2020-09-25,0,0,0
10110,Alameda,2020-09-25,86,27,113
10111,Nevada,2020-09-25,2,1,3
10112,Riverside,2020-09-25,129,67,196
10113,Calaveras,2020-09-25,0,0,0
10114,Modoc,2020-09-25,0,0,0
10115,Fresno,2020-09-25,78,23,101
10116,San Benito,2020-09-25,2,0,2
10117,San Diego,2020-09-25,196,39,235
10118,Shasta,2020-09-25,6,0,6
10119,Glenn,2020-09-25,0,0,0
10120,Trinity,2020-09-25,0,0,0
10121,Mariposa,2020-09-25,0,0,0
10122,Santa Barbara,2020-09-25,24,4,28
10123,Ventura,2020-09-25,44,22,66
10124,Humboldt,2020-09-25,5,0,5
10125,San Francisco,2020-09-25,61,11,72
10126,Kings,2020-09-25,13,0,13
10127,San Joaquin,2020-09-25,44,8,52
10128,Lassen,2020-09-25,0,0,0
10129,Placer,2020-09-25,25,20,45
10130,Tulare,2020-09-25,36,9,45
10131,Solano,2020-09-25,18,15,33
10132,Contra Costa,2020-09-25,30,19,49
10133,Contra Costa,2020-09-26,30,11,41
10134,Yolo,2020-09-26,3,0,3
10135,Humboldt,2020-09-26,3,0,3
10136,El Dorado,2020-09-26,1,0,1
10137,Sacramento,2020-09-26,131,25,156
10138,Del Norte,2020-09-26,0,0,0
10139,Mendocino,2020-09-26,9,0,9
10140,Ventura,2020-09-26,46,18,64
10141,Amador,2020-09-26,0,0,0
10142,Kings,2020-09-26,10,0,10
10143,Tulare,2020-09-26,32,10,42
10144,Yuba,2020-09-26,13,0,13
10145,Santa Barbara,2020-09-26,21,5,26
10146,Alameda,2020-09-26,75,36,111
10147,Plumas,2020-09-26,0,0,0
10148,Stanislaus,2020-09-26,69,19,88
10149,Santa Cruz,2020-09-26,19,0,19
10150,Shasta,2020-09-26,8,1,9
10151,San Luis Obispo,2020-09-26,3,1,4
10152,Mono,2020-09-26,0,0,0
10153,Sutter,2020-09-26,0,0,0
10154,Modoc,2020-09-26,0,0,0
10155,Tehama,2020-09-26,4,0,4
10156,San Bernardino,2020-09-26,152,44,196
10157,San Francisco,2020-09-26,56,8,64
10158,Marin,2020-09-26,5,8,13
10159,Inyo,2020-09-26,0,0,0
10160,San Joaquin,2020-09-26,38,11,49
10161,Colusa,2020-09-26,1,0,1
10162,Butte,2020-09-26,13,0,13
10163,San Benito,2020-09-26,2,0,2
10164,Madera,2020-09-26,13,3,16
10165,Trinity,2020-09-26,0,0,0
10166,Tuolumne,2020-09-26,1,0,1
10167,San Mateo,2020-09-26,29,12,41
10168,Siskiyou,2020-09-26,1,0,1
10169,Sonoma,2020-09-26,18,7,25
10170,Santa Clara,2020-09-26,93,11,104
10171,Riverside,2020-09-26,135,46,181
10172,Kern,2020-09-26,66,4,70
10173,San Diego,2020-09-26,197,42,239
10174,Placer,2020-09-26,25,25,50
10175,Calaveras,2020-09-26,0,0,0
10176,Lake,2020-09-26,0,1,1
10177,Nevada,2020-09-26,1,0,1
10178,Orange,2020-09-26,164,36,200
10179,Imperial,2020-09-26,25,0,25
10180,Los Angeles,2020-09-26,687,371,1058
10181,Solano,2020-09-26,18,19,37
10182,Mariposa,2020-09-26,0,0,0
10183,Merced,2020-09-26,9,0,9
10184,Glenn,2020-09-26,0,0,0
10185,Monterey,2020-09-26,29,0,29
10186,Fresno,2020-09-26,73,24,97
10187,Napa,2020-09-26,3,0,3
10188,Lassen,2020-09-26,0,0,0
10189,Humboldt,2020-09-27,3,0,3
10190,Placer,2020-09-27,22,28,50
10191,Tulare,2020-09-27,33,8,41
10192,Plumas,2020-09-27,0,0,0
10193,Lassen,2020-09-27,0,0,0
10194,San Joaquin,2020-09-27,32,20,52
10195,Glenn,2020-09-27,0,0,0
10196,Napa,2020-09-27,3,0,3
10197,El Dorado,2020-09-27,1,0,1
10198,Santa Clara,2020-09-27,94,13,107
10199,Inyo,2020-09-27,0,1,1
10200,Yolo,2020-09-27,3,0,3
10201,Monterey,2020-09-27,29,0,29
10202,Imperial,2020-09-27,20,0,20
10203,Santa Barbara,2020-09-27,21,1,22
10204,Butte,2020-09-27,13,0,13
10205,Kings,2020-09-27,14,0,14
10206,Trinity,2020-09-27,0,0,0
10207,Calaveras,2020-09-27,0,0,0
10208,Contra Costa,2020-09-27,31,13,44
10209,Madera,2020-09-27,12,9,21
10210,Los Angeles,2020-09-27,714,356,1070
10211,San Diego,2020-09-27,184,48,232
10212,Alameda,2020-09-27,76,37,113
10213,Kern,2020-09-27,67,3,70
10214,Ventura,2020-09-27,48,11,59
10215,Mariposa,2020-09-27,0,0,0
10216,Fresno,2020-09-27,74,22,96
10217,San Bernardino,2020-09-27,160,50,210
10218,Lake,2020-09-27,1,0,1
10219,San Luis Obispo,2020-09-27,2,1,3
10220,Solano,2020-09-27,17,22,39
10221,Mono,2020-09-27,0,0,0
10222,Santa Cruz,2020-09-27,24,0,24
10223,Colusa,2020-09-27,1,0,1
10224,Tuolumne,2020-09-27,1,0,1
10225,San Benito,2020-09-27,2,0,2
10226,Sutter,2020-09-27,0,0,0
10227,San Francisco,2020-09-27,54,6,60
10228,Marin,2020-09-27,7,7,14
10229,Amador,2020-09-27,0,0,0
10230,Sacramento,2020-09-27,119,35,154
10231,Siskiyou,2020-09-27,1,0,1
10232,Tehama,2020-09-27,4,0,4
10233,Modoc,2020-09-27,0,0,0
10234,Yuba,2020-09-27,14,0,14
10235,Merced,2020-09-27,9,1,10
10236,Del Norte,2020-09-27,0,0,0
10237,Shasta,2020-09-27,1,6,7
10238,Sonoma,2020-09-27,20,4,24
10239,San Mateo,2020-09-27,29,9,38
10240,Orange,2020-09-27,161,63,224
10241,Nevada,2020-09-27,2,0,2
10242,Stanislaus,2020-09-27,59,20,79
10243,Mendocino,2020-09-27,7,0,7
10244,Riverside,2020-09-27,128,49,177
10245,Plumas,2020-09-28,0,0,0
10246,Yuba,2020-09-28,13,0,13
10247,San Mateo,2020-09-28,29,11,40
10248,Colusa,2020-09-28,1,0,1
10249,San Luis Obispo,2020-09-28,3,0,3
10250,Tuolumne,2020-09-28,1,0,1
10251,Kern,2020-09-28,71,3,74
10252,Shasta,2020-09-28,6,1,7
10253,Sutter,2020-09-28,0,0,0
10254,Sonoma,2020-09-28,20,8,28
10255,Sacramento,2020-09-28,125,35,160
10256,Monterey,2020-09-28,30,0,30
10257,San Francisco,2020-09-28,60,5,65
10258,San Bernardino,2020-09-28,165,58,223
10259,Solano,2020-09-28,19,19,38
10260,Lassen,2020-09-28,0,0,0
10261,Kings,2020-09-28,16,0,16
10262,Siskiyou,2020-09-28,0,1,1
10263,Mono,2020-09-28,0,0,0
10264,Santa Barbara,2020-09-28,26,1,27
10265,Del Norte,2020-09-28,0,1,1
10266,Trinity,2020-09-28,0,0,0
10267,Amador,2020-09-28,0,0,0
10268,Inyo,2020-09-28,0,1,1
10269,Napa,2020-09-28,4,2,6
10270,Merced,2020-09-28,10,10,20
10271,Mariposa,2020-09-28,0,0,0
10272,Los Angeles,2020-09-28,734,291,1025
10273,Placer,2020-09-28,24,28,52
10274,Imperial,2020-09-28,22,0,22
10275,Modoc,2020-09-28,0,0,0
10276,Marin,2020-09-28,8,6,14
10277,Mendocino,2020-09-28,6,0,6
10278,San Benito,2020-09-28,2,0,2
10279,Santa Clara,2020-09-28,93,18,111
10280,Glenn,2020-09-28,0,0,0
10281,El Dorado,2020-09-28,1,0,1
10282,Santa Cruz,2020-09-28,25,0,25
10283,Ventura,2020-09-28,46,7,53
10284,Calaveras,2020-09-28,0,0,0
10285,Riverside,2020-09-28,125,57,182
10286,Contra Costa,2020-09-28,30,15,45
10287,Fresno,2020-09-28,76,14,90
10288,San Joaquin,2020-09-28,35,18,53
10289,Lake,2020-09-28,1,1,2
10290,Orange,2020-09-28,162,78,240
10291,Butte,2020-09-28,13,0,13
10292,Humboldt,2020-09-28,2,3,5
10293,San Diego,2020-09-28,199,58,257
10294,Tehama,2020-09-28,5,0,5
10295,Yolo,2020-09-28,3,0,3
10296,Stanislaus,2020-09-28,54,24,78
10297,Madera,2020-09-28,12,14,26
10298,Alameda,2020-09-28,79,35,114
10299,Nevada,2020-09-28,2,0,2
10300,Tulare,2020-09-28,34,8,42
10301,Butte,2020-09-29,13,0,13
10302,Santa Clara,2020-09-29,90,15,105
10303,Orange,2020-09-29,172,52,224
10304,Mono,2020-09-29,0,0,0
10305,Sacramento,2020-09-29,122,38,160
10306,Solano,2020-09-29,18,21,39
10307,Mariposa,2020-09-29,0,0,0
10308,Modoc,2020-09-29,0,0,0
10309,Madera,2020-09-29,9,13,22
10310,Amador,2020-09-29,1,0,1
10311,Napa,2020-09-29,6,1,7
10312,Siskiyou,2020-09-29,0,1,1
10313,Contra Costa,2020-09-29,32,17,49
10314,Inyo,2020-09-29,0,0,0
10315,Glenn,2020-09-29,0,0,0
10316,Imperial,2020-09-29,23,0,23
10317,Ventura,2020-09-29,48,14,62
10318,Marin,2020-09-29,7,8,15
10319,Mendocino,2020-09-29,5,0,5
10320,Stanislaus,2020-09-29,50,30,80
10321,Yolo,2020-09-29,4,0,4
10322,Nevada,2020-09-29,3,0,3
10323,Humboldt,2020-09-29,2,3,5
10324,Shasta,2020-09-29,5,1,6
10325,Riverside,2020-09-29,130,52,182
10326,Santa Cruz,2020-09-29,23,0,23
10327,San Luis Obispo,2020-09-29,3,0,3
10328,Kings,2020-09-29,20,1,21
10329,Tuolumne,2020-09-29,1,0,1
10330,San Mateo,2020-09-29,26,17,43
10331,El Dorado,2020-09-29,1,0,1
10332,Lake,2020-09-29,1,1,2
10333,San Francisco,2020-09-29,61,5,66
10334,San Diego,2020-09-29,182,56,238
10335,Del Norte,2020-09-29,0,0,0
10336,Yuba,2020-09-29,13,1,14
10337,Los Angeles,2020-09-29,746,340,1086
10338,Monterey,2020-09-29,30,0,30
10339,Santa Barbara,2020-09-29,23,0,23
10340,Sutter,2020-09-29,0,0,0
10341,Kern,2020-09-29,73,5,78
10342,San Benito,2020-09-29,1,0,1
10343,Sonoma,2020-09-29,17,4,21
10344,Placer,2020-09-29,22,22,44
10345,Fresno,2020-09-29,80,14,94
10346,Merced,2020-09-29,9,11,20
10347,Lassen,2020-09-29,0,0,0
10348,Trinity,2020-09-29,0,0,0
10349,Alameda,2020-09-29,78,47,125
10350,San Joaquin,2020-09-29,33,20,53
10351,San Bernardino,2020-09-29,170,55,225
10352,Colusa,2020-09-29,1,0,1
10353,Tulare,2020-09-29,34,9,43
10354,Plumas,2020-09-29,0,0,0
10355,Calaveras,2020-09-29,0,0,0
10356,Tehama,2020-09-29,5,0,5
10357,Imperial,2020-09-30,26,0,26
10358,Santa Clara,2020-09-30,93,17,110
10359,Napa,2020-09-30,6,0,6
10360,Madera,2020-09-30,10,9,19
10361,Ventura,2020-09-30,46,10,56
10362,Plumas,2020-09-30,0,0,0
10363,El Dorado,2020-09-30,0,0,0
10364,Merced,2020-09-30,11,0,11
10365,Yuba,2020-09-30,13,0,13
10366,Del Norte,2020-09-30,0,0,0
10367,Orange,2020-09-30,173,55,228
10368,Sutter,2020-09-30,0,0,0
10369,Inyo,2020-09-30,0,1,1
10370,Fresno,2020-09-30,80,26,106
10371,Shasta,2020-09-30,8,1,9
10372,San Bernardino,2020-09-30,165,58,223
10373,Marin,2020-09-30,7,4,11
10374,Humboldt,2020-09-30,2,0,2
10375,Butte,2020-09-30,9,0,9
10376,Mendocino,2020-09-30,6,1,7
10377,Glenn,2020-09-30,0,0,0
10378,Alameda,2020-09-30,84,32,116
10379,Tehama,2020-09-30,6,0,6
10380,Lake,2020-09-30,1,2,3
10381,Contra Costa,2020-09-30,31,15,46
10382,Amador,2020-09-30,1,0,1
10383,San Luis Obispo,2020-09-30,1,0,1
10384,Placer,2020-09-30,17,18,35
10385,Trinity,2020-09-30,0,0,0
10386,Lassen,2020-09-30,0,0,0
10387,Mariposa,2020-09-30,0,0,0
10388,Tulare,2020-09-30,39,9,48
10389,Sonoma,2020-09-30,15,5,20
10390,Solano,2020-09-30,14,18,32
10391,Colusa,2020-09-30,5,0,5
10392,Calaveras,2020-09-30,0,0,0
10393,Los Angeles,2020-09-30,730,371,1101
10394,San Benito,2020-09-30,1,0,1
10395,Sacramento,2020-09-30,119,27,146
10396,Mono,2020-09-30,0,0,0
10397,Nevada,2020-09-30,3,0,3
10398,Riverside,2020-09-30,119,45,164
10399,Santa Cruz,2020-09-30,20,0,20
10400,Siskiyou,2020-09-30,0,0,0
10401,Kings,2020-09-30,15,0,15
10402,San Francisco,2020-09-30,64,10,74
10403,San Mateo,2020-09-30,26,16,42
10404,Stanislaus,2020-09-30,58,21,79
10405,San Diego,2020-09-30,187,43,230
10406,Yolo,2020-09-30,6,0,6
10407,Santa Barbara,2020-09-30,18,1,19
10408,Modoc,2020-09-30,0,0,0
10409,San Joaquin,2020-09-30,35,16,51
10410,Monterey,2020-09-30,27,0,27
10411,Kern,2020-09-30,70,5,75
10412,Tuolumne,2020-09-30,2,0,2
10413,Lassen,2020-10-01,0,0,0
10414,Contra Costa,2020-10-01,31,17,48
10415,Madera,2020-10-01,9,14,23
10416,Tuolumne,2020-10-01,0,0,0
10417,Fresno,2020-10-01,94,19,113
10418,Yuba,2020-10-01,10,1,11
10419,Santa Clara,2020-10-01,84,17,101
10420,Santa Cruz,2020-10-01,20,0,20
10421,Colusa,2020-10-01,0,0,0
10422,Orange,2020-10-01,175,34,209
10423,Tulare,2020-10-01,39,7,46
10424,San Benito,2020-10-01,1,0,1
10425,San Luis Obispo,2020-10-01,2,1,3
10426,Riverside,2020-10-01,130,59,189
10427,Shasta,2020-10-01,7,1,8
10428,Marin,2020-10-01,6,5,11
10429,Merced,2020-10-01,9,0,9
10430,Modoc,2020-10-01,0,0,0
10431,Lake,2020-10-01,1,0,1
10432,San Joaquin,2020-10-01,35,18,53
10433,Kern,2020-10-01,58,4,62
10434,El Dorado,2020-10-01,1,1,2
10435,Sutter,2020-10-01,0,0,0
10436,Nevada,2020-10-01,3,1,4
10437,Butte,2020-10-01,6,0,6
10438,Mariposa,2020-10-01,0,0,0
10439,Calaveras,2020-10-01,0,0,0
10440,San Diego,2020-10-01,186,54,240
10441,Sacramento,2020-10-01,108,26,134
10442,San Bernardino,2020-10-01,173,47,220
10443,Los Angeles,2020-10-01,698,371,1069
10444,Glenn,2020-10-01,0,0,0
10445,Amador,2020-10-01,1,0,1
10446,Imperial,2020-10-01,23,0,23
10447,Humboldt,2020-10-01,2,0,2
10448,Mono,2020-10-01,1,0,1
10449,Del Norte,2020-10-01,0,1,1
10450,Yolo,2020-10-01,4,0,4
10451,Alameda,2020-10-01,94,36,130
10452,Stanislaus,2020-10-01,55,24,79
10453,Solano,2020-10-01,18,13,31
10454,Mendocino,2020-10-01,8,1,9
10455,Sonoma,2020-10-01,17,1,18
10456,Siskiyou,2020-10-01,0,0,0
10457,Tehama,2020-10-01,7,0,7
10458,Inyo,2020-10-01,0,1,1
10459,Plumas,2020-10-01,0,0,0
10460,Napa,2020-10-01,8,1,9
10461,Kings,2020-10-01,16,0,16
10462,San Mateo,2020-10-01,29,13,42
10463,Ventura,2020-10-01,43,9,52
10464,San Francisco,2020-10-01,59,9,68
10465,Monterey,2020-10-01,29,0,29
10466,Trinity,2020-10-01,0,0,0
10467,Santa Barbara,2020-10-01,20,1,21
10468,Placer,2020-10-01,19,20,39
10469,Contra Costa,2020-10-02,31,7,38
10470,Stanislaus,2020-10-02,55,19,74
10471,San Luis Obispo,2020-10-02,2,0,2
10472,Orange,2020-10-02,160,53,213
10473,San Bernardino,2020-10-02,164,48,212
10474,Napa,2020-10-02,8,1,9
10475,Plumas,2020-10-02,0,0,0
10476,Lassen,2020-10-02,0,0,0
10477,Yolo,2020-10-02,4,0,4
10478,Siskiyou,2020-10-02,0,0,0
10479,Santa Barbara,2020-10-02,19,1,20
10480,San Benito,2020-10-02,1,0,1
10481,Colusa,2020-10-02,4,1,5
10482,Fresno,2020-10-02,97,18,115
10483,Nevada,2020-10-02,3,0,3
10484,Amador,2020-10-02,1,0,1
10485,Solano,2020-10-02,22,13,35
10486,Placer,2020-10-02,18,24,42
10487,Yuba,2020-10-02,7,0,7
10488,Monterey,2020-10-02,30,0,30
10489,Glenn,2020-10-02,0,0,0
10490,El Dorado,2020-10-02,1,0,1
10491,Tuolumne,2020-10-02,0,0,0
10492,Inyo,2020-10-02,0,1,1
10493,Mendocino,2020-10-02,8,0,8
10494,Lake,2020-10-02,1,0,1
10495,San Joaquin,2020-10-02,39,19,58
10496,Humboldt,2020-10-02,2,0,2
10497,Tulare,2020-10-02,35,7,42
10498,San Diego,2020-10-02,203,56,259
10499,Riverside,2020-10-02,135,66,201
10500,Ventura,2020-10-02,39,13,52
10501,Del Norte,2020-10-02,0,0,0
10502,Sonoma,2020-10-02,21,6,27
10503,Mariposa,2020-10-02,0,0,0
10504,Imperial,2020-10-02,26,0,26
10505,Los Angeles,2020-10-02,673,324,997
10506,Shasta,2020-10-02,7,1,8
10507,Santa Clara,2020-10-02,82,19,101
10508,Tehama,2020-10-02,5,0,5
10509,Sutter,2020-10-02,0,0,0
10510,Madera,2020-10-02,7,6,13
10511,Butte,2020-10-02,7,0,7
10512,Kings,2020-10-02,13,0,13
10513,Mono,2020-10-02,0,0,0
10514,Marin,2020-10-02,7,5,12
10515,Alameda,2020-10-02,76,34,110
10516,San Mateo,2020-10-02,29,13,42
10517,Trinity,2020-10-02,0,0,0
10518,Sacramento,2020-10-02,96,23,119
10519,Santa Cruz,2020-10-02,22,0,22
10520,Merced,2020-10-02,9,1,10
10521,Modoc,2020-10-02,0,0,0
10522,Kern,2020-10-02,63,3,66
10523,Calaveras,2020-10-02,0,0,0
10524,San Francisco,2020-10-02,55,10,65
10525,Shasta,2020-10-03,6,1,7
10526,Butte,2020-10-03,12,0,12
10527,Santa Barbara,2020-10-03,23,1,24
10528,Glenn,2020-10-03,0,0,0
10529,Solano,2020-10-03,21,13,34
10530,Plumas,2020-10-03,0,0,0
10531,San Mateo,2020-10-03,29,11,40
10532,Stanislaus,2020-10-03,55,17,72
10533,San Joaquin,2020-10-03,38,16,54
10534,Nevada,2020-10-03,3,0,3
10535,Napa,2020-10-03,6,0,6
10536,Sutter,2020-10-03,0,0,0
10537,Mendocino,2020-10-03,6,0,6
10538,Colusa,2020-10-03,2,4,6
10539,Imperial,2020-10-03,26,1,27
10540,Sonoma,2020-10-03,26,7,33
10541,Madera,2020-10-03,7,6,13
10542,Orange,2020-10-03,155,52,207
10543,San Francisco,2020-10-03,50,7,57
10544,Kern,2020-10-03,63,4,67
10545,Fresno,2020-10-03,102,16,118
10546,Tuolumne,2020-10-03,0,0,0
10547,Yolo,2020-10-03,2,0,2
10548,Amador,2020-10-03,0,0,0
10549,San Benito,2020-10-03,1,0,1
10550,Siskiyou,2020-10-03,0,0,0
10551,Sacramento,2020-10-03,87,29,116
10552,Santa Cruz,2020-10-03,21,0,21
10553,Trinity,2020-10-03,0,0,0
10554,Mariposa,2020-10-03,0,0,0
10555,Monterey,2020-10-03,29,0,29
10556,Lake,2020-10-03,0,3,3
10557,El Dorado,2020-10-03,1,0,1
10558,Del Norte,2020-10-03,0,0,0
10559,Lassen,2020-10-03,0,0,0
10560,Kings,2020-10-03,15,0,15
10561,Tulare,2020-10-03,36,9,45
10562,Santa Clara,2020-10-03,82,23,105
10563,San Luis Obispo,2020-10-03,2,0,2
10564,Modoc,2020-10-03,0,0,0
10565,Placer,2020-10-03,18,24,42
10566,Yuba,2020-10-03,6,0,6
10567,Merced,2020-10-03,6,0,6
10568,San Bernardino,2020-10-03,170,54,224
10569,Inyo,2020-10-03,0,0,0
10570,Marin,2020-10-03,8,6,14
10571,Humboldt,2020-10-03,2,0,2
10572,Contra Costa,2020-10-03,31,10,41
10573,San Diego,2020-10-03,207,60,267
10574,Alameda,2020-10-03,78,41,119
10575,Ventura,2020-10-03,38,11,49
10576,Tehama,2020-10-03,4,0,4
10577,Mono,2020-10-03,0,0,0
10578,Los Angeles,2020-10-03,674,353,1027
10579,Riverside,2020-10-03,135,67,202
10580,Calaveras,2020-10-03,0,0,0
10581,Modoc,2020-10-04,0,0,0
10582,Tuolumne,2020-10-04,1,1,2
10583,Kern,2020-10-04,61,1,62
10584,Humboldt,2020-10-04,2,1,3
10585,Orange,2020-10-04,168,42,210
10586,Napa,2020-10-04,6,1,7
10587,Madera,2020-10-04,8,7,15
10588,Butte,2020-10-04,8,0,8
10589,Alameda,2020-10-04,71,29,100
10590,Monterey,2020-10-04,27,2,29
10591,Solano,2020-10-04,21,17,38
10592,San Benito,2020-10-04,1,0,1
10593,San Joaquin,2020-10-04,35,11,46
10594,San Diego,2020-10-04,203,53,256
10595,San Luis Obispo,2020-10-04,4,0,4
10596,Contra Costa,2020-10-04,34,19,53
10597,Siskiyou,2020-10-04,0,0,0
10598,Glenn,2020-10-04,0,0,0
10599,Fresno,2020-10-04,103,13,116
10600,Del Norte,2020-10-04,0,0,0
10601,Santa Cruz,2020-10-04,16,0,16
10602,Merced,2020-10-04,7,0,7
10603,San Mateo,2020-10-04,28,12,40
10604,Kings,2020-10-04,14,0,14
10605,Imperial,2020-10-04,24,0,24
10606,Sonoma,2020-10-04,28,7,35
10607,San Francisco,2020-10-04,52,9,61
10608,Santa Clara,2020-10-04,87,20,107
10609,Trinity,2020-10-04,0,0,0
10610,Tulare,2020-10-04,35,9,44
10611,Tehama,2020-10-04,4,0,4
10612,Shasta,2020-10-04,4,1,5
10613,Lake,2020-10-04,0,0,0
10614,Nevada,2020-10-04,4,0,4
10615,Placer,2020-10-04,22,34,56
10616,El Dorado,2020-10-04,2,0,2
10617,Ventura,2020-10-04,31,11,42
10618,Inyo,2020-10-04,0,0,0
10619,Lassen,2020-10-04,0,0,0
10620,Riverside,2020-10-04,133,68,201
10621,Mariposa,2020-10-04,0,0,0
10622,Santa Barbara,2020-10-04,22,0,22
10623,Yolo,2020-10-04,1,0,1
10624,San Bernardino,2020-10-04,175,59,234
10625,Calaveras,2020-10-04,0,0,0
10626,Sutter,2020-10-04,0,0,0
10627,Marin,2020-10-04,4,10,14
10628,Plumas,2020-10-04,0,0,0
10629,Mendocino,2020-10-04,7,1,8
10630,Colusa,2020-10-04,2,4,6
10631,Amador,2020-10-04,0,0,0
10632,Yuba,2020-10-04,4,0,4
10633,Los Angeles,2020-10-04,685,373,1058
10634,Stanislaus,2020-10-04,54,11,65
10635,Sacramento,2020-10-04,93,29,122
10636,Mono,2020-10-04,0,0,0
10637,El Dorado,2020-10-05,1,0,1
10638,Plumas,2020-10-05,0,0,0
10639,Santa Clara,2020-10-05,83,23,106
10640,Mendocino,2020-10-05,5,0,5
10641,Trinity,2020-10-05,0,0,0
10642,Yuba,2020-10-05,4,0,4
10643,Kings,2020-10-05,15,0,15
10644,Sacramento,2020-10-05,96,29,125
10645,Fresno,2020-10-05,107,18,125
10646,Marin,2020-10-05,5,4,9
10647,Lake,2020-10-05,0,3,3
10648,Tuolumne,2020-10-05,0,0,0
10649,Amador,2020-10-05,0,0,0
10650,Lassen,2020-10-05,0,0,0
10651,Kern,2020-10-05,66,0,66
10652,Sutter,2020-10-05,0,0,0
10653,Butte,2020-10-05,8,0,8
10654,Shasta,2020-10-05,10,1,11
10655,San Joaquin,2020-10-05,30,13,43
10656,Solano,2020-10-05,20,10,30
10657,Riverside,2020-10-05,142,67,209
10658,Calaveras,2020-10-05,0,0,0
10659,Mariposa,2020-10-05,0,0,0
10660,San Luis Obispo,2020-10-05,3,0,3
10661,Merced,2020-10-05,5,1,6
10662,Santa Cruz,2020-10-05,14,0,14
10663,San Mateo,2020-10-05,26,12,38
10664,San Francisco,2020-10-05,50,9,59
10665,Alameda,2020-10-05,73,37,110
10666,Santa Barbara,2020-10-05,19,0,19
10667,Placer,2020-10-05,20,25,45
10668,San Diego,2020-10-05,217,56,273
10669,Del Norte,2020-10-05,0,0,0
10670,Humboldt,2020-10-05,2,3,5
10671,Orange,2020-10-05,176,52,228
10672,Glenn,2020-10-05,0,0,0
10673,San Benito,2020-10-05,0,0,0
10674,Mono,2020-10-05,0,0,0
10675,Modoc,2020-10-05,0,0,0
10676,Stanislaus,2020-10-05,53,21,74
10677,Ventura,2020-10-05,33,12,45
10678,San Bernardino,2020-10-05,186,53,239
10679,Los Angeles,2020-10-05,696,339,1035
10680,Sonoma,2020-10-05,28,7,35
10681,Imperial,2020-10-05,27,0,27
10682,Contra Costa,2020-10-05,37,20,57
10683,Siskiyou,2020-10-05,0,0,0
10684,Tulare,2020-10-05,34,8,42
10685,Inyo,2020-10-05,1,0,1
10686,Tehama,2020-10-05,5,0,5
10687,Colusa,2020-10-05,4,0,4
10688,Monterey,2020-10-05,24,1,25
10689,Yolo,2020-10-05,1,0,1
10690,Madera,2020-10-05,8,6,14
10691,Napa,2020-10-05,6,1,7
10692,Nevada,2020-10-05,4,0,4
10693,Inyo,2020-10-06,2,1,3
10694,Siskiyou,2020-10-06,0,0,0
10695,Del Norte,2020-10-06,0,0,0
10696,Calaveras,2020-10-06,0,0,0
10697,Plumas,2020-10-06,0,0,0
10698,Placer,2020-10-06,20,31,51
10699,Los Angeles,2020-10-06,709,351,1060
10700,Santa Cruz,2020-10-06,15,0,15
10701,Monterey,2020-10-06,25,1,26
10702,Colusa,2020-10-06,0,4,4
10703,San Bernardino,2020-10-06,200,39,239
10704,Mendocino,2020-10-06,5,0,5
10705,Humboldt,2020-10-06,2,3,5
10706,Mariposa,2020-10-06,0,0,0
10707,Tuolumne,2020-10-06,0,0,0
10708,Yolo,2020-10-06,1,0,1
10709,Shasta,2020-10-06,7,0,7
10710,Orange,2020-10-06,183,52,235
10711,Mono,2020-10-06,0,0,0
10712,Lake,2020-10-06,0,3,3
10713,Madera,2020-10-06,4,8,12
10714,Sonoma,2020-10-06,34,6,40
10715,Solano,2020-10-06,20,15,35
10716,Lassen,2020-10-06,0,0,0
10717,Sacramento,2020-10-06,89,30,119
10718,Riverside,2020-10-06,135,83,218
10719,San Diego,2020-10-06,214,66,280
10720,Amador,2020-10-06,0,0,0
10721,Tulare,2020-10-06,28,8,36
10722,San Benito,2020-10-06,0,0,0
10723,Modoc,2020-10-06,0,0,0
10724,San Joaquin,2020-10-06,26,17,43
10725,Contra Costa,2020-10-06,32,25,57
10726,Imperial,2020-10-06,30,0,30
10727,Alameda,2020-10-06,75,40,115
10728,San Luis Obispo,2020-10-06,2,0,2
10729,Santa Barbara,2020-10-06,19,0,19
10730,Stanislaus,2020-10-06,45,15,60
10731,Kern,2020-10-06,65,3,68
10732,Santa Clara,2020-10-06,77,23,100
10733,Merced,2020-10-06,4,0,4
10734,Nevada,2020-10-06,3,0,3
10735,Sutter,2020-10-06,0,0,0
10736,Marin,2020-10-06,6,6,12
10737,El Dorado,2020-10-06,0,0,0
10738,Kings,2020-10-06,16,0,16
10739,Glenn,2020-10-06,0,0,0
10740,Trinity,2020-10-06,0,0,0
10741,Fresno,2020-10-06,100,22,122
10742,San Francisco,2020-10-06,47,7,54
10743,Butte,2020-10-06,8,0,8
10744,Ventura,2020-10-06,34,9,43
10745,Tehama,2020-10-06,5,0,5
10746,Yuba,2020-10-06,6,1,7
10747,Napa,2020-10-06,6,2,8
10748,San Mateo,2020-10-06,24,10,34
10749,Contra Costa,2020-10-07,32,27,59
10750,San Luis Obispo,2020-10-07,3,4,7
10751,Amador,2020-10-07,0,0,0
10752,Santa Cruz,2020-10-07,15,0,15
10753,Santa Clara,2020-10-07,77,25,102
10754,San Benito,2020-10-07,0,0,0
10755,San Joaquin,2020-10-07,30,15,45
10756,Napa,2020-10-07,5,4,9
10757,Nevada,2020-10-07,2,1,3
10758,Shasta,2020-10-07,4,1,5
10759,San Bernardino,2020-10-07,205,44,249
10760,Humboldt,2020-10-07,3,1,4
10761,Butte,2020-10-07,7,0,7
10762,Colusa,2020-10-07,0,2,2
10763,Lake,2020-10-07,0,1,1
10764,Calaveras,2020-10-07,0,1,1
10765,Solano,2020-10-07,19,21,40
10766,Plumas,2020-10-07,0,0,0
10767,Kings,2020-10-07,19,0,19
10768,Sutter,2020-10-07,0,0,0
10769,Trinity,2020-10-07,0,0,0
10770,Mono,2020-10-07,0,0,0
10771,Mendocino,2020-10-07,3,0,3
10772,Mariposa,2020-10-07,0,0,0
10773,San Francisco,2020-10-07,44,11,55
10774,Tuolumne,2020-10-07,0,0,0
10775,Glenn,2020-10-07,0,0,0
10776,Fresno,2020-10-07,104,23,127
10777,Orange,2020-10-07,172,38,210
10778,Modoc,2020-10-07,0,2,2
10779,Merced,2020-10-07,4,1,5
10780,San Mateo,2020-10-07,22,10,32
10781,Kern,2020-10-07,62,3,65
10782,Imperial,2020-10-07,26,0,26
10783,Yolo,2020-10-07,3,0,3
10784,Inyo,2020-10-07,1,1,2
10785,Tulare,2020-10-07,37,6,43
10786,Riverside,2020-10-07,135,74,209
10787,Sonoma,2020-10-07,31,8,39
10788,San Diego,2020-10-07,217,44,261
10789,Marin,2020-10-07,6,4,10
10790,Monterey,2020-10-07,25,0,25
10791,Del Norte,2020-10-07,0,0,0
10792,Siskiyou,2020-10-07,0,0,0
10793,Ventura,2020-10-07,35,11,46
10794,El Dorado,2020-10-07,1,0,1
10795,Los Angeles,2020-10-07,724,353,1077
10796,Lassen,2020-10-07,0,0,0
10797,Santa Barbara,2020-10-07,20,0,20
10798,Madera,2020-10-07,7,4,11
10799,Placer,2020-10-07,16,33,49
10800,Tehama,2020-10-07,6,0,6
10801,Stanislaus,2020-10-07,46,14,60
10802,Yuba,2020-10-07,7,0,7
10803,Alameda,2020-10-07,66,34,100
10804,Sacramento,2020-10-07,87,37,124
10805,Mendocino,2020-10-08,4,0,4
10806,San Francisco,2020-10-08,39,5,44
10807,Sonoma,2020-10-08,30,8,38
10808,Tehama,2020-10-08,3,0,3
10809,San Joaquin,2020-10-08,31,11,42
10810,Imperial,2020-10-08,26,0,26
10811,Fresno,2020-10-08,102,26,128
10812,Kern,2020-10-08,59,4,63
10813,Contra Costa,2020-10-08,29,12,41
10814,Sutter,2020-10-08,0,0,0
10815,Sacramento,2020-10-08,85,45,130
10816,Siskiyou,2020-10-08,0,0,0
10817,Mariposa,2020-10-08,0,0,0
10818,Plumas,2020-10-08,0,0,0
10819,Ventura,2020-10-08,33,13,46
10820,Alameda,2020-10-08,61,44,105
10821,El Dorado,2020-10-08,1,0,1
10822,Calaveras,2020-10-08,0,0,0
10823,Colusa,2020-10-08,0,1,1
10824,Tuolumne,2020-10-08,0,0,0
10825,Riverside,2020-10-08,145,70,215
10826,Humboldt,2020-10-08,3,6,9
10827,Yolo,2020-10-08,5,0,5
10828,Shasta,2020-10-08,4,0,4
10829,Solano,2020-10-08,21,23,44
10830,Lake,2020-10-08,0,1,1
10831,San Bernardino,2020-10-08,207,51,258
10832,Modoc,2020-10-08,0,0,0
10833,Los Angeles,2020-10-08,701,358,1059
10834,Placer,2020-10-08,18,24,42
10835,Marin,2020-10-08,7,2,9
10836,San Luis Obispo,2020-10-08,3,0,3
10837,Glenn,2020-10-08,0,0,0
10838,Napa,2020-10-08,2,0,2
10839,Santa Cruz,2020-10-08,13,0,13
10840,Del Norte,2020-10-08,0,0,0
10841,San Benito,2020-10-08,0,0,0
10842,Kings,2020-10-08,16,0,16
10843,Yuba,2020-10-08,9,1,10
10844,Nevada,2020-10-08,1,1,2
10845,Mono,2020-10-08,0,0,0
10846,San Diego,2020-10-08,215,47,262
10847,Tulare,2020-10-08,36,6,42
10848,Trinity,2020-10-08,0,0,0
10849,Lassen,2020-10-08,0,0,0
10850,Inyo,2020-10-08,2,0,2
10851,Amador,2020-10-08,0,0,0
10852,Monterey,2020-10-08,25,0,25
10853,Merced,2020-10-08,7,6,13
10854,Santa Barbara,2020-10-08,24,0,24
10855,Santa Clara,2020-10-08,79,19,98
10856,Orange,2020-10-08,176,44,220
10857,Stanislaus,2020-10-08,50,27,77
10858,Butte,2020-10-08,7,0,7
10859,San Mateo,2020-10-08,23,10,33
10860,Madera,2020-10-08,8,11,19
10861,Mono,2020-10-09,0,0,0
10862,Los Angeles,2020-10-09,715,329,1044
10863,San Bernardino,2020-10-09,209,49,258
10864,Mariposa,2020-10-09,0,0,0
10865,Lassen,2020-10-09,0,0,0
10866,Placer,2020-10-09,18,22,40
10867,Fresno,2020-10-09,93,23,116
10868,Sutter,2020-10-09,0,0,0
10869,Merced,2020-10-09,7,3,10
10870,Amador,2020-10-09,0,0,0
10871,Sacramento,2020-10-09,75,37,112
10872,Solano,2020-10-09,23,18,41
10873,Monterey,2020-10-09,27,3,30
10874,Glenn,2020-10-09,0,0,0
10875,Santa Clara,2020-10-09,69,23,92
10876,Alameda,2020-10-09,59,41,100
10877,Santa Cruz,2020-10-09,13,0,13
10878,San Luis Obispo,2020-10-09,3,1,4
10879,Santa Barbara,2020-10-09,23,1,24
10880,Kern,2020-10-09,57,2,59
10881,San Joaquin,2020-10-09,25,7,32
10882,Madera,2020-10-09,9,8,17
10883,Yuba,2020-10-09,7,0,7
10884,San Francisco,2020-10-09,33,8,41
10885,Humboldt,2020-10-09,3,2,5
10886,Riverside,2020-10-09,146,57,203
10887,Ventura,2020-10-09,34,17,51
10888,Colusa,2020-10-09,0,0,0
10889,El Dorado,2020-10-09,1,0,1
10890,Trinity,2020-10-09,0,0,0
10891,Inyo,2020-10-09,1,0,1
10892,Plumas,2020-10-09,0,0,0
10893,San Diego,2020-10-09,197,47,244
10894,Siskiyou,2020-10-09,0,0,0
10895,Kings,2020-10-09,17,0,17
10896,Imperial,2020-10-09,28,0,28
10897,Marin,2020-10-09,10,2,12
10898,Butte,2020-10-09,6,0,6
10899,Mendocino,2020-10-09,4,0,4
10900,Shasta,2020-10-09,3,0,3
10901,Modoc,2020-10-09,0,0,0
10902,Sonoma,2020-10-09,30,6,36
10903,San Benito,2020-10-09,0,0,0
10904,Tulare,2020-10-09,31,6,37
10905,Yolo,2020-10-09,3,0,3
10906,Orange,2020-10-09,169,52,221
10907,San Mateo,2020-10-09,29,10,39
10908,Del Norte,2020-10-09,0,0,0
10909,Napa,2020-10-09,2,1,3
10910,Nevada,2020-10-09,1,0,1
10911,Stanislaus,2020-10-09,51,31,82
10912,Calaveras,2020-10-09,0,0,0
10913,Contra Costa,2020-10-09,30,14,44
10914,Tehama,2020-10-09,3,0,3
10915,Tuolumne,2020-10-09,0,0,0
10916,Lake,2020-10-09,0,0,0
10917,Trinity,2020-10-10,0,0,0
10918,Riverside,2020-10-10,135,56,191
10919,Stanislaus,2020-10-10,52,27,79
10920,Nevada,2020-10-10,2,0,2
10921,Tehama,2020-10-10,3,0,3
10922,Napa,2020-10-10,2,2,4
10923,Calaveras,2020-10-10,0,0,0
10924,Humboldt,2020-10-10,3,0,3
10925,Madera,2020-10-10,11,8,19
10926,Contra Costa,2020-10-10,30,18,48
10927,San Francisco,2020-10-10,33,4,37
10928,Shasta,2020-10-10,5,2,7
10929,Orange,2020-10-10,164,49,213
10930,San Diego,2020-10-10,195,52,247
10931,Imperial,2020-10-10,31,0,31
10932,Kern,2020-10-10,46,2,48
10933,Colusa,2020-10-10,0,0,0
10934,Mendocino,2020-10-10,3,0,3
10935,San Bernardino,2020-10-10,192,52,244
10936,Santa Clara,2020-10-10,71,24,95
10937,Solano,2020-10-10,21,16,37
10938,Merced,2020-10-10,6,3,9
10939,Monterey,2020-10-10,26,2,28
10940,Santa Cruz,2020-10-10,17,0,17
10941,Placer,2020-10-10,17,40,57
10942,Marin,2020-10-10,8,7,15
10943,Lake,2020-10-10,0,1,1
10944,Los Angeles,2020-10-10,693,360,1053
10945,Sacramento,2020-10-10,78,56,134
10946,San Luis Obispo,2020-10-10,2,0,2
10947,Fresno,2020-10-10,85,19,104
10948,Mariposa,2020-10-10,0,0,0
10949,San Benito,2020-10-10,0,0,0
10950,El Dorado,2020-10-10,1,0,1
10951,Amador,2020-10-10,0,0,0
10952,Modoc,2020-10-10,0,0,0
10953,Del Norte,2020-10-10,0,0,0
10954,Tulare,2020-10-10,32,8,40
10955,Tuolumne,2020-10-10,1,0,1
10956,Inyo,2020-10-10,1,0,1
10957,Mono,2020-10-10,0,0,0
10958,Sutter,2020-10-10,0,0,0
10959,Siskiyou,2020-10-10,0,0,0
10960,Santa Barbara,2020-10-10,24,0,24
10961,Kings,2020-10-10,18,0,18
10962,Lassen,2020-10-10,0,0,0
10963,Alameda,2020-10-10,64,46,110
10964,Sonoma,2020-10-10,32,6,38
10965,Glenn,2020-10-10,0,0,0
10966,Butte,2020-10-10,6,0,6
10967,Plumas,2020-10-10,0,0,0
10968,Ventura,2020-10-10,37,11,48
10969,San Joaquin,2020-10-10,22,14,36
10970,San Mateo,2020-10-10,29,9,38
10971,Yolo,2020-10-10,2,0,2
10972,Yuba,2020-10-10,9,0,9
10973,Sacramento,2020-10-11,77,54,131
10974,Del Norte,2020-10-11,0,0,0
10975,Siskiyou,2020-10-11,0,0,0
10976,San Diego,2020-10-11,173,51,224
10977,Santa Barbara,2020-10-11,19,0,19
10978,Ventura,2020-10-11,31,12,43
10979,San Bernardino,2020-10-11,183,53,236
10980,San Francisco,2020-10-11,27,3,30
10981,Santa Clara,2020-10-11,78,30,108
10982,San Luis Obispo,2020-10-11,1,0,1
10983,Modoc,2020-10-11,0,0,0
10984,Nevada,2020-10-11,2,1,3
10985,Merced,2020-10-11,6,2,8
10986,Mendocino,2020-10-11,3,0,3
10987,Lake,2020-10-11,1,0,1
10988,Lassen,2020-10-11,0,0,0
10989,Calaveras,2020-10-11,0,0,0
10990,Solano,2020-10-11,26,17,43
10991,Imperial,2020-10-11,34,2,36
10992,Madera,2020-10-11,10,9,19
10993,San Mateo,2020-10-11,29,8,37
10994,Plumas,2020-10-11,0,0,0
10995,Placer,2020-10-11,19,35,54
10996,Kern,2020-10-11,51,2,53
10997,El Dorado,2020-10-11,2,0,2
10998,Fresno,2020-10-11,98,14,112
10999,Mariposa,2020-10-11,0,0,0
11000,Napa,2020-10-11,2,4,6
11001,Los Angeles,2020-10-11,692,353,1045
11002,Sutter,2020-10-11,0,0,0
11003,Tulare,2020-10-11,28,7,35
11004,Yuba,2020-10-11,10,0,10
11005,Glenn,2020-10-11,0,0,0
11006,Marin,2020-10-11,6,3,9
11007,Orange,2020-10-11,167,43,210
11008,Santa Cruz,2020-10-11,20,0,20
11009,San Benito,2020-10-11,0,0,0
11010,Sonoma,2020-10-11,26,6,32
11011,Riverside,2020-10-11,131,62,193
11012,Tehama,2020-10-11,2,0,2
11013,Shasta,2020-10-11,4,1,5
11014,San Joaquin,2020-10-11,22,6,28
11015,Contra Costa,2020-10-11,38,23,61
11016,Monterey,2020-10-11,27,2,29
11017,Yolo,2020-10-11,5,0,5
11018,Inyo,2020-10-11,1,0,1
11019,Mono,2020-10-11,0,0,0
11020,Kings,2020-10-11,19,0,19
11021,Amador,2020-10-11,1,0,1
11022,Colusa,2020-10-11,0,0,0
11023,Stanislaus,2020-10-11,54,25,79
11024,Alameda,2020-10-11,61,44,105
11025,Butte,2020-10-11,6,0,6
11026,Trinity,2020-10-11,0,0,0
11027,Tuolumne,2020-10-11,1,0,1
11028,Humboldt,2020-10-11,3,2,5
11029,Inyo,2020-10-12,1,0,1
11030,San Diego,2020-10-12,178,52,230
11031,Colusa,2020-10-12,0,0,0
11032,Ventura,2020-10-12,32,9,41
11033,El Dorado,2020-10-12,1,0,1
11034,Mono,2020-10-12,0,0,0
11035,San Luis Obispo,2020-10-12,1,0,1
11036,Tehama,2020-10-12,2,0,2
11037,Sutter,2020-10-12,0,0,0
11038,Mariposa,2020-10-12,0,0,0
11039,San Benito,2020-10-12,0,0,0
11040,Siskiyou,2020-10-12,0,0,0
11041,Butte,2020-10-12,6,0,6
11042,Merced,2020-10-12,10,0,10
11043,Lassen,2020-10-12,0,0,0
11044,Tuolumne,2020-10-12,1,0,1
11045,Humboldt,2020-10-12,4,1,5
11046,Tulare,2020-10-12,26,4,30
11047,Monterey,2020-10-12,28,0,28
11048,San Joaquin,2020-10-12,25,11,36
11049,San Bernardino,2020-10-12,186,50,236
11050,Nevada,2020-10-12,1,0,1
11051,San Mateo,2020-10-12,29,11,40
11052,Madera,2020-10-12,8,11,19
11053,Stanislaus,2020-10-12,54,9,63
11054,Sonoma,2020-10-12,23,6,29
11055,Alameda,2020-10-12,61,45,106
11056,Yolo,2020-10-12,4,0,4
11057,Riverside,2020-10-12,146,55,201
11058,Marin,2020-10-12,5,3,8
11059,Modoc,2020-10-12,0,1,1
11060,Contra Costa,2020-10-12,26,19,45
11061,Santa Cruz,2020-10-12,20,0,20
11062,Los Angeles,2020-10-12,720,356,1076
11063,Napa,2020-10-12,1,1,2
11064,San Francisco,2020-10-12,28,2,30
11065,Solano,2020-10-12,29,16,45
11066,Mendocino,2020-10-12,3,0,3
11067,Plumas,2020-10-12,0,0,0
11068,Sacramento,2020-10-12,77,47,124
11069,Lake,2020-10-12,2,0,2
11070,Imperial,2020-10-12,31,0,31
11071,Del Norte,2020-10-12,0,0,0
11072,Kings,2020-10-12,19,0,19
11073,Placer,2020-10-12,16,34,50
11074,Kern,2020-10-12,53,3,56
11075,Yuba,2020-10-12,11,1,12
11076,Shasta,2020-10-12,7,1,8
11077,Santa Barbara,2020-10-12,21,5,26
11078,Santa Clara,2020-10-12,80,20,100
11079,Calaveras,2020-10-12,0,0,0
11080,Orange,2020-10-12,160,49,209
11081,Trinity,2020-10-12,0,0,0
11082,Fresno,2020-10-12,89,12,101
11083,Amador,2020-10-12,1,0,1
11084,Glenn,2020-10-12,0,0,0
11085,Ventura,2020-10-13,35,10,45
11086,Solano,2020-10-13,31,15,46
11087,Lake,2020-10-13,2,1,3
11088,San Bernardino,2020-10-13,179,49,228
11089,Siskiyou,2020-10-13,0,0,0
11090,San Diego,2020-10-13,187,56,243
11091,Tuolumne,2020-10-13,1,0,1
11092,Humboldt,2020-10-13,4,1,5
11093,Mendocino,2020-10-13,1,0,1
11094,Modoc,2020-10-13,0,2,2
11095,Fresno,2020-10-13,91,14,105
11096,Inyo,2020-10-13,1,0,1
11097,Mariposa,2020-10-13,0,0,0
11098,San Luis Obispo,2020-10-13,2,1,3
11099,Kern,2020-10-13,59,2,61
11100,Merced,2020-10-13,10,2,12
11101,Sonoma,2020-10-13,23,4,27
11102,Marin,2020-10-13,6,8,14
11103,Santa Barbara,2020-10-13,18,2,20
11104,Calaveras,2020-10-13,0,0,0
11105,Kings,2020-10-13,14,2,16
11106,Mono,2020-10-13,0,0,0
11107,Contra Costa,2020-10-13,21,18,39
11108,Del Norte,2020-10-13,0,0,0
11109,Santa Cruz,2020-10-13,17,0,17
11110,Napa,2020-10-13,1,3,4
11111,El Dorado,2020-10-13,1,2,3
11112,Riverside,2020-10-13,149,59,208
11113,Glenn,2020-10-13,0,0,0
11114,Stanislaus,2020-10-13,51,16,67
11115,Los Angeles,2020-10-13,723,382,1105
11116,Butte,2020-10-13,6,0,6
11117,Sutter,2020-10-13,0,0,0
11118,Santa Clara,2020-10-13,80,22,102
11119,San Joaquin,2020-10-13,28,13,41
11120,San Francisco,2020-10-13,27,4,31
11121,Orange,2020-10-13,165,48,213
11122,Shasta,2020-10-13,1,5,6
11123,Monterey,2020-10-13,28,1,29
11124,Plumas,2020-10-13,0,0,0
11125,Nevada,2020-10-13,2,0,2
11126,San Benito,2020-10-13,0,0,0
11127,Colusa,2020-10-13,0,0,0
11128,Placer,2020-10-13,18,34,52
11129,Tulare,2020-10-13,28,9,37
11130,Sacramento,2020-10-13,74,46,120
11131,Alameda,2020-10-13,63,32,95
11132,Lassen,2020-10-13,0,0,0
11133,Trinity,2020-10-13,0,0,0
11134,Imperial,2020-10-13,30,0,30
11135,Madera,2020-10-13,7,13,20
11136,Amador,2020-10-13,0,1,1
11137,Tehama,2020-10-13,3,0,3
11138,San Mateo,2020-10-13,28,9,37
11139,Yolo,2020-10-13,3,0,3
11140,Yuba,2020-10-13,11,0,11
11141,Marin,2020-10-14,8,9,17
11142,Sacramento,2020-10-14,75,36,111
11143,San Mateo,2020-10-14,24,6,30
11144,Lassen,2020-10-14,0,0,0
11145,Riverside,2020-10-14,149,69,218
11146,Tehama,2020-10-14,4,0,4
11147,San Bernardino,2020-10-14,181,52,233
11148,Plumas,2020-10-14,0,0,0
11149,Placer,2020-10-14,13,14,27
11150,Kings,2020-10-14,12,2,14
11151,Los Angeles,2020-10-14,735,372,1107
11152,Monterey,2020-10-14,27,1,28
11153,Siskiyou,2020-10-14,0,0,0
11154,Contra Costa,2020-10-14,17,12,29
11155,Santa Barbara,2020-10-14,19,3,22
11156,Kern,2020-10-14,67,0,67
11157,Mendocino,2020-10-14,0,0,0
11158,Del Norte,2020-10-14,0,0,0
11159,Imperial,2020-10-14,34,0,34
11160,Sutter,2020-10-14,0,0,0
11161,Yuba,2020-10-14,8,0,8
11162,Nevada,2020-10-14,2,0,2
11163,Lake,2020-10-14,1,0,1
11164,Ventura,2020-10-14,29,13,42
11165,Tulare,2020-10-14,29,9,38
11166,Yolo,2020-10-14,1,0,1
11167,San Francisco,2020-10-14,26,6,32
11168,Solano,2020-10-14,28,16,44
11169,Modoc,2020-10-14,0,0,0
11170,Madera,2020-10-14,7,6,13
11171,Mariposa,2020-10-14,0,0,0
11172,San Joaquin,2020-10-14,29,7,36
11173,Colusa,2020-10-14,0,0,0
11174,Alameda,2020-10-14,59,40,99
11175,San Diego,2020-10-14,181,43,224
11176,Merced,2020-10-14,10,0,10
11177,Santa Clara,2020-10-14,87,20,107
11178,Humboldt,2020-10-14,4,2,6
11179,Santa Cruz,2020-10-14,17,1,18
11180,Inyo,2020-10-14,1,0,1
11181,El Dorado,2020-10-14,0,1,1
11182,Napa,2020-10-14,2,3,5
11183,Fresno,2020-10-14,94,22,116
11184,Trinity,2020-10-14,0,0,0
11185,Sonoma,2020-10-14,25,4,29
11186,San Luis Obispo,2020-10-14,4,2,6
11187,Stanislaus,2020-10-14,55,19,74
11188,Mono,2020-10-14,0,0,0
11189,Tuolumne,2020-10-14,1,0,1
11190,Shasta,2020-10-14,7,1,8
11191,Butte,2020-10-14,3,0,3
11192,Glenn,2020-10-14,0,0,0
11193,Orange,2020-10-14,164,48,212
11194,Calaveras,2020-10-14,0,0,0
11195,San Benito,2020-10-14,0,0,0
11196,Amador,2020-10-14,0,0,0
11197,Tulare,2020-10-15,27,8,35
11198,Sutter,2020-10-15,0,0,0
11199,Shasta,2020-10-15,8,1,9
11200,Orange,2020-10-15,170,33,203
11201,Calaveras,2020-10-15,0,0,0
11202,Sacramento,2020-10-15,79,34,113
11203,Tuolumne,2020-10-15,1,0,1
11204,Modoc,2020-10-15,0,0,0
11205,San Luis Obispo,2020-10-15,5,0,5
11206,San Francisco,2020-10-15,21,8,29
11207,Merced,2020-10-15,11,2,13
11208,Napa,2020-10-15,2,3,5
11209,Contra Costa,2020-10-15,20,14,34
11210,Siskiyou,2020-10-15,0,1,1
11211,Riverside,2020-10-15,148,57,205
11212,Monterey,2020-10-15,24,1,25
11213,Kern,2020-10-15,59,1,60
11214,Amador,2020-10-15,0,0,0
11215,Butte,2020-10-15,2,0,2
11216,Sonoma,2020-10-15,26,4,30
11217,Mono,2020-10-15,0,0,0
11218,Santa Barbara,2020-10-15,16,2,18
11219,Imperial,2020-10-15,32,2,34
11220,Glenn,2020-10-15,0,0,0
11221,Inyo,2020-10-15,2,0,2
11222,Solano,2020-10-15,24,16,40
11223,San Benito,2020-10-15,0,0,0
11224,San Joaquin,2020-10-15,28,10,38
11225,Lassen,2020-10-15,0,0,0
11226,Tehama,2020-10-15,3,0,3
11227,Mendocino,2020-10-15,0,0,0
11228,Placer,2020-10-15,12,12,24
11229,Yolo,2020-10-15,5,0,5
11230,San Bernardino,2020-10-15,186,53,239
11231,Fresno,2020-10-15,95,15,110
11232,Del Norte,2020-10-15,0,0,0
11233,Santa Clara,2020-10-15,84,19,103
11234,Lake,2020-10-15,1,4,5
11235,Trinity,2020-10-15,0,0,0
11236,San Mateo,2020-10-15,25,8,33
11237,Humboldt,2020-10-15,4,1,5
11238,Los Angeles,2020-10-15,746,340,1086
11239,Plumas,2020-10-15,0,0,0
11240,Alameda,2020-10-15,57,42,99
11241,Colusa,2020-10-15,0,0,0
11242,Mariposa,2020-10-15,0,0,0
11243,El Dorado,2020-10-15,0,0,0
11244,Nevada,2020-10-15,1,0,1
11245,Kings,2020-10-15,13,1,14
11246,Marin,2020-10-15,8,8,16
11247,Madera,2020-10-15,8,9,17
11248,Ventura,2020-10-15,29,11,40
11249,Yuba,2020-10-15,8,0,8
11250,Santa Cruz,2020-10-15,15,0,15
11251,Stanislaus,2020-10-15,56,19,75
11252,San Diego,2020-10-15,184,51,235
11253,San Mateo,2020-10-16,27,12,39
11254,Riverside,2020-10-16,136,67,203
11255,Modoc,2020-10-16,0,0,0
11256,Solano,2020-10-16,21,17,38
11257,Humboldt,2020-10-16,4,4,8
11258,El Dorado,2020-10-16,0,0,0
11259,Mariposa,2020-10-16,0,0,0
11260,Inyo,2020-10-16,2,1,3
11261,Colusa,2020-10-16,0,0,0
11262,Stanislaus,2020-10-16,55,12,67
11263,Shasta,2020-10-16,6,0,6
11264,Glenn,2020-10-16,0,0,0
11265,Siskiyou,2020-10-16,0,0,0
11266,Tuolumne,2020-10-16,0,0,0
11267,Santa Cruz,2020-10-16,14,0,14
11268,San Francisco,2020-10-16,20,4,24
11269,San Benito,2020-10-16,0,0,0
11270,Santa Barbara,2020-10-16,13,3,16
11271,Nevada,2020-10-16,0,0,0
11272,Imperial,2020-10-16,33,2,35
11273,Monterey,2020-10-16,25,0,25
11274,Tehama,2020-10-16,4,0,4
11275,Orange,2020-10-16,159,40,199
11276,Yuba,2020-10-16,9,1,10
11277,Napa,2020-10-16,2,1,3
11278,Placer,2020-10-16,11,22,33
11279,Del Norte,2020-10-16,0,0,0
11280,Trinity,2020-10-16,0,0,0
11281,San Diego,2020-10-16,189,46,235
11282,Butte,2020-10-16,2,0,2
11283,Merced,2020-10-16,9,1,10
11284,Alameda,2020-10-16,52,43,95
11285,Sutter,2020-10-16,0,0,0
11286,Amador,2020-10-16,0,0,0
11287,Santa Clara,2020-10-16,89,16,105
11288,San Bernardino,2020-10-16,189,44,233
11289,Sonoma,2020-10-16,25,6,31
11290,Plumas,2020-10-16,0,0,0
11291,Calaveras,2020-10-16,0,0,0
11292,Fresno,2020-10-16,92,17,109
11293,Lake,2020-10-16,1,0,1
11294,Ventura,2020-10-16,29,4,33
11295,Lassen,2020-10-16,0,0,0
11296,Madera,2020-10-16,8,8,16
11297,San Luis Obispo,2020-10-16,3,1,4
11298,Kern,2020-10-16,58,1,59
11299,Sacramento,2020-10-16,84,33,117
11300,San Joaquin,2020-10-16,30,10,40
11301,Contra Costa,2020-10-16,21,13,34
11302,Los Angeles,2020-10-16,752,324,1076
11303,Yolo,2020-10-16,6,0,6
11304,Tulare,2020-10-16,31,5,36
11305,Marin,2020-10-16,9,3,12
11306,Mono,2020-10-16,0,0,0
11307,Kings,2020-10-16,14,0,14
11308,Mendocino,2020-10-16,0,0,0
11309,Tuolumne,2020-10-17,0,0,0
11310,Del Norte,2020-10-17,0,0,0
11311,Trinity,2020-10-17,0,0,0
11312,Madera,2020-10-17,7,7,14
11313,San Francisco,2020-10-17,23,3,26
11314,Solano,2020-10-17,22,19,41
11315,Sonoma,2020-10-17,23,4,27
11316,Sutter,2020-10-17,0,0,0
11317,San Joaquin,2020-10-17,25,8,33
11318,Siskiyou,2020-10-17,0,0,0
11319,Mariposa,2020-10-17,0,0,0
11320,Kings,2020-10-17,15,0,15
11321,Nevada,2020-10-17,0,0,0
11322,Tehama,2020-10-17,5,0,5
11323,Ventura,2020-10-17,30,10,40
11324,Plumas,2020-10-17,0,0,0
11325,Contra Costa,2020-10-17,26,17,43
11326,Mendocino,2020-10-17,0,0,0
11327,Yolo,2020-10-17,6,0,6
11328,Merced,2020-10-17,7,0,7
11329,Butte,2020-10-17,2,0,2
11330,Marin,2020-10-17,9,4,13
11331,Tulare,2020-10-17,32,0,32
11332,Riverside,2020-10-17,153,65,218
11333,El Dorado,2020-10-17,0,0,0
11334,Modoc,2020-10-17,0,0,0
11335,Stanislaus,2020-10-17,60,8,68
11336,San Mateo,2020-10-17,21,7,28
11337,Placer,2020-10-17,24,21,45
11338,Lake,2020-10-17,1,0,1
11339,Amador,2020-10-17,0,0,0
11340,Santa Cruz,2020-10-17,12,0,12
11341,Lassen,2020-10-17,0,0,0
11342,Yuba,2020-10-17,9,1,10
11343,Napa,2020-10-17,2,0,2
11344,San Benito,2020-10-17,0,0,0
11345,Colusa,2020-10-17,0,0,0
11346,Glenn,2020-10-17,0,0,0
11347,Alameda,2020-10-17,54,36,90
11348,Monterey,2020-10-17,25,0,25
11349,Humboldt,2020-10-17,3,2,5
11350,Los Angeles,2020-10-17,722,297,1019
11351,Calaveras,2020-10-17,0,0,0
11352,San Luis Obispo,2020-10-17,2,0,2
11353,Santa Barbara,2020-10-17,12,2,14
11354,Imperial,2020-10-17,34,2,36
11355,Santa Clara,2020-10-17,84,17,101
11356,Inyo,2020-10-17,1,0,1
11357,Kern,2020-10-17,59,5,64
11358,Sacramento,2020-10-17,78,33,111
11359,Orange,2020-10-17,162,42,204
11360,Shasta,2020-10-17,0,5,5
11361,Fresno,2020-10-17,86,23,109
11362,San Diego,2020-10-17,185,51,236
11363,San Bernardino,2020-10-17,265,45,310
11364,Mono,2020-10-17,0,0,0
11365,San Joaquin,2020-10-18,23,5,28
11366,San Benito,2020-10-18,0,0,0
11367,San Francisco,2020-10-18,25,3,28
11368,Humboldt,2020-10-18,3,1,4
11369,Sonoma,2020-10-18,22,9,31
11370,Santa Cruz,2020-10-18,11,0,11
11371,Orange,2020-10-18,168,42,210
11372,San Mateo,2020-10-18,20,7,27
11373,Kings,2020-10-18,19,0,19
11374,Nevada,2020-10-18,1,0,1
11375,Del Norte,2020-10-18,1,0,1
11376,Mariposa,2020-10-18,0,0,0
11377,Riverside,2020-10-18,153,55,208
11378,Modoc,2020-10-18,0,0,0
11379,Tehama,2020-10-18,6,1,7
11380,Los Angeles,2020-10-18,730,312,1042
11381,Shasta,2020-10-18,7,1,8
11382,Trinity,2020-10-18,0,0,0
11383,Tuolumne,2020-10-18,0,1,1
11384,Glenn,2020-10-18,0,0,0
11385,Calaveras,2020-10-18,0,0,0
11386,Kern,2020-10-18,55,3,58
11387,Santa Clara,2020-10-18,90,19,109
11388,Yuba,2020-10-18,9,0,9
11389,Mendocino,2020-10-18,1,0,1
11390,Yolo,2020-10-18,6,0,6
11391,Lake,2020-10-18,2,0,2
11392,Tulare,2020-10-18,30,5,35
11393,Ventura,2020-10-18,30,10,40
11394,Monterey,2020-10-18,20,0,20
11395,Siskiyou,2020-10-18,0,0,0
11396,San Bernardino,2020-10-18,181,47,228
11397,Butte,2020-10-18,2,0,2
11398,San Luis Obispo,2020-10-18,1,0,1
11399,Inyo,2020-10-18,1,0,1
11400,Marin,2020-10-18,6,4,10
11401,Plumas,2020-10-18,0,0,0
11402,Imperial,2020-10-18,33,1,34
11403,Madera,2020-10-18,8,5,13
11404,Santa Barbara,2020-10-18,16,1,17
11405,Sutter,2020-10-18,0,0,0
11406,Sacramento,2020-10-18,81,43,124
11407,Stanislaus,2020-10-18,61,12,73
11408,Contra Costa,2020-10-18,32,12,44
11409,Mono,2020-10-18,0,0,0
11410,Merced,2020-10-18,6,1,7
11411,El Dorado,2020-10-18,0,0,0
11412,Lassen,2020-10-18,0,0,0
11413,Colusa,2020-10-18,0,2,2
11414,Amador,2020-10-18,0,0,0
11415,Placer,2020-10-18,20,18,38
11416,Fresno,2020-10-18,96,20,116
11417,Solano,2020-10-18,20,20,40
11418,San Diego,2020-10-18,189,54,243
11419,Alameda,2020-10-18,54,42,96
11420,Napa,2020-10-18,2,5,7
11421,Modoc,2020-10-19,0,0,0
11422,San Mateo,2020-10-19,23,9,32
11423,San Luis Obispo,2020-10-19,2,0,2
11424,Tuolumne,2020-10-19,1,0,1
11425,San Joaquin,2020-10-19,23,5,28
11426,Monterey,2020-10-19,22,1,23
11427,Santa Barbara,2020-10-19,18,0,18
11428,Orange,2020-10-19,168,44,212
11429,Imperial,2020-10-19,41,0,41
11430,Amador,2020-10-19,0,0,0
11431,Contra Costa,2020-10-19,25,14,39
11432,Mendocino,2020-10-19,1,0,1
11433,Yuba,2020-10-19,10,0,10
11434,Calaveras,2020-10-19,0,0,0
11435,Fresno,2020-10-19,100,17,117
11436,Trinity,2020-10-19,0,0,0
11437,Yolo,2020-10-19,6,0,6
11438,Ventura,2020-10-19,30,4,34
11439,Tehama,2020-10-19,6,1,7
11440,Butte,2020-10-19,2,0,2
11441,San Diego,2020-10-19,191,48,239
11442,Tulare,2020-10-19,28,7,35
11443,El Dorado,2020-10-19,0,0,0
11444,Stanislaus,2020-10-19,59,17,76
11445,Los Angeles,2020-10-19,758,364,1122
11446,Nevada,2020-10-19,1,1,2
11447,Del Norte,2020-10-19,1,0,1
11448,Lake,2020-10-19,2,1,3
11449,San Francisco,2020-10-19,25,5,30
11450,Napa,2020-10-19,3,5,8
11451,Sonoma,2020-10-19,20,5,25
11452,Shasta,2020-10-19,8,1,9
11453,San Benito,2020-10-19,0,0,0
11454,Inyo,2020-10-19,1,0,1
11455,Santa Cruz,2020-10-19,9,0,9
11456,Santa Clara,2020-10-19,91,20,111
11457,Kings,2020-10-19,20,0,20
11458,Marin,2020-10-19,5,7,12
11459,Humboldt,2020-10-19,3,3,6
11460,Mariposa,2020-10-19,0,0,0
11461,Placer,2020-10-19,19,21,40
11462,Alameda,2020-10-19,53,48,101
11463,Riverside,2020-10-19,157,60,217
11464,Sutter,2020-10-19,0,0,0
11465,Colusa,2020-10-19,0,2,2
11466,Lassen,2020-10-19,0,0,0
11467,Kern,2020-10-19,56,3,59
11468,Siskiyou,2020-10-19,0,0,0
11469,Sacramento,2020-10-19,80,29,109
11470,Plumas,2020-10-19,0,0,0
11471,Mono,2020-10-19,0,0,0
11472,Glenn,2020-10-19,0,0,0
11473,Madera,2020-10-19,8,8,16
11474,Solano,2020-10-19,22,18,40
11475,San Bernardino,2020-10-19,187,44,231
11476,Merced,2020-10-19,6,1,7
11477,San Luis Obispo,2020-10-20,3,0,3
11478,Monterey,2020-10-20,21,0,21
11479,Shasta,2020-10-20,8,0,8
11480,Contra Costa,2020-10-20,23,18,41
11481,Alameda,2020-10-20,58,37,95
11482,Santa Barbara,2020-10-20,18,0,18
11483,Butte,2020-10-20,6,0,6
11484,Trinity,2020-10-20,0,0,0
11485,Colusa,2020-10-20,0,0,0
11486,Kern,2020-10-20,55,2,57
11487,Madera,2020-10-20,6,8,14
11488,San Benito,2020-10-20,0,0,0
11489,Ventura,2020-10-20,28,10,38
11490,El Dorado,2020-10-20,0,0,0
11491,Sacramento,2020-10-20,82,25,107
11492,San Joaquin,2020-10-20,22,8,30
11493,Los Angeles,2020-10-20,777,322,1099
11494,Mendocino,2020-10-20,0,0,0
11495,Napa,2020-10-20,0,2,2
11496,Yolo,2020-10-20,7,0,7
11497,Tuolumne,2020-10-20,1,0,1
11498,Solano,2020-10-20,26,18,44
11499,Del Norte,2020-10-20,1,0,1
11500,Marin,2020-10-20,5,4,9
11501,San Francisco,2020-10-20,21,4,25
11502,Calaveras,2020-10-20,0,0,0
11503,Placer,2020-10-20,17,21,38
11504,Inyo,2020-10-20,0,0,0
11505,Yuba,2020-10-20,7,0,7
11506,Stanislaus,2020-10-20,52,26,78
11507,Tehama,2020-10-20,5,1,6
11508,Modoc,2020-10-20,0,0,0
11509,Plumas,2020-10-20,0,0,0
11510,San Mateo,2020-10-20,20,7,27
11511,Tulare,2020-10-20,26,10,36
11512,Mariposa,2020-10-20,0,0,0
11513,Humboldt,2020-10-20,3,4,7
11514,Fresno,2020-10-20,114,20,134
11515,Kings,2020-10-20,22,0,22
11516,San Bernardino,2020-10-20,198,31,229
11517,Nevada,2020-10-20,1,0,1
11518,San Diego,2020-10-20,199,34,233
11519,Santa Cruz,2020-10-20,8,0,8
11520,Orange,2020-10-20,174,52,226
11521,Imperial,2020-10-20,40,0,40
11522,Sonoma,2020-10-20,19,1,20
11523,Lake,2020-10-20,2,0,2
11524,Amador,2020-10-20,0,0,0
11525,Merced,2020-10-20,7,0,7
11526,Santa Clara,2020-10-20,99,18,117
11527,Glenn,2020-10-20,0,0,0
11528,Lassen,2020-10-20,0,0,0
11529,Sutter,2020-10-20,0,0,0
11530,Mono,2020-10-20,0,0,0
11531,Riverside,2020-10-20,167,46,213
11532,Siskiyou,2020-10-20,0,0,0
11533,Colusa,2020-10-21,0,0,0
11534,Placer,2020-10-21,16,11,27
11535,Monterey,2020-10-21,20,1,21
11536,Ventura,2020-10-21,29,14,43
11537,Sacramento,2020-10-21,81,30,111
11538,Imperial,2020-10-21,45,0,45
11539,Santa Barbara,2020-10-21,17,1,18
11540,Yolo,2020-10-21,6,0,6
11541,San Joaquin,2020-10-21,26,10,36
11542,El Dorado,2020-10-21,0,0,0
11543,Kings,2020-10-21,21,0,21
11544,Fresno,2020-10-21,110,19,129
11545,Plumas,2020-10-21,0,0,0
11546,Madera,2020-10-21,4,13,17
11547,Orange,2020-10-21,168,50,218
11548,Mono,2020-10-21,0,0,0
11549,Tuolumne,2020-10-21,1,0,1
11550,Glenn,2020-10-21,0,0,0
11551,Kern,2020-10-21,53,3,56
11552,Santa Cruz,2020-10-21,10,0,10
11553,Solano,2020-10-21,23,10,33
11554,Amador,2020-10-21,0,0,0
11555,Humboldt,2020-10-21,3,1,4
11556,San Benito,2020-10-21,0,0,0
11557,Los Angeles,2020-10-21,769,290,1059
11558,Stanislaus,2020-10-21,54,20,74
11559,Riverside,2020-10-21,176,51,227
11560,San Luis Obispo,2020-10-21,6,1,7
11561,Merced,2020-10-21,6,0,6
11562,Sutter,2020-10-21,0,0,0
11563,Calaveras,2020-10-21,0,0,0
11564,Lassen,2020-10-21,0,0,0
11565,San Mateo,2020-10-21,22,3,25
11566,Mariposa,2020-10-21,0,0,0
11567,Shasta,2020-10-21,7,0,7
11568,Alameda,2020-10-21,61,37,98
11569,Mendocino,2020-10-21,1,0,1
11570,Tulare,2020-10-21,27,6,33
11571,San Diego,2020-10-21,187,44,231
11572,Yuba,2020-10-21,8,0,8
11573,Modoc,2020-10-21,0,0,0
11574,Siskiyou,2020-10-21,0,0,0
11575,Trinity,2020-10-21,0,0,0
11576,San Bernardino,2020-10-21,208,37,245
11577,San Francisco,2020-10-21,23,10,33
11578,Del Norte,2020-10-21,1,0,1
11579,Inyo,2020-10-21,0,0,0
11580,Contra Costa,2020-10-21,22,13,35
11581,Napa,2020-10-21,1,3,4
11582,Sonoma,2020-10-21,23,0,23
11583,Santa Clara,2020-10-21,94,17,111
11584,Lake,2020-10-21,2,0,2
11585,Marin,2020-10-21,5,5,10
11586,Nevada,2020-10-21,1,0,1
11587,Tehama,2020-10-21,7,0,7
11588,Butte,2020-10-21,7,0,7
11589,Santa Clara,2020-10-22,89,20,109
11590,Humboldt,2020-10-22,4,0,4
11591,Ventura,2020-10-22,31,14,45
11592,Monterey,2020-10-22,22,0,22
11593,Solano,2020-10-22,21,12,33
11594,Mendocino,2020-10-22,0,0,0
11595,San Diego,2020-10-22,188,47,235
11596,Sonoma,2020-10-22,23,3,26
11597,Sutter,2020-10-22,0,0,0
11598,Del Norte,2020-10-22,1,1,2
11599,Mariposa,2020-10-22,0,0,0
11600,Riverside,2020-10-22,161,57,218
11601,Tulare,2020-10-22,28,1,29
11602,Trinity,2020-10-22,0,0,0
11603,Siskiyou,2020-10-22,0,0,0
11604,Amador,2020-10-22,1,0,1
11605,Glenn,2020-10-22,0,0,0
11606,Shasta,2020-10-22,9,1,10
11607,Kings,2020-10-22,22,1,23
11608,Mono,2020-10-22,0,0,0
11609,Colusa,2020-10-22,0,1,1
11610,Imperial,2020-10-22,43,0,43
11611,Nevada,2020-10-22,2,3,5
11612,Fresno,2020-10-22,100,13,113
11613,Tehama,2020-10-22,6,0,6
11614,Lassen,2020-10-22,0,0,0
11615,Kern,2020-10-22,55,5,60
11616,El Dorado,2020-10-22,0,0,0
11617,Los Angeles,2020-10-22,770,262,1032
11618,Merced,2020-10-22,7,2,9
11619,Madera,2020-10-22,5,8,13
11620,San Luis Obispo,2020-10-22,5,0,5
11621,San Francisco,2020-10-22,23,3,26
11622,Calaveras,2020-10-22,0,0,0
11623,Sacramento,2020-10-22,90,27,117
11624,Yolo,2020-10-22,6,0,6
11625,Tuolumne,2020-10-22,2,0,2
11626,Napa,2020-10-22,2,0,2
11627,Santa Barbara,2020-10-22,13,0,13
11628,San Joaquin,2020-10-22,30,7,37
11629,Butte,2020-10-22,7,0,7
11630,Santa Cruz,2020-10-22,10,0,10
11631,Placer,2020-10-22,12,14,26
11632,Stanislaus,2020-10-22,53,20,73
11633,Orange,2020-10-22,162,41,203
11634,San Benito,2020-10-22,0,0,0
11635,Lake,2020-10-22,2,0,2
11636,Yuba,2020-10-22,8,0,8
11637,Alameda,2020-10-22,61,43,104
11638,Marin,2020-10-22,6,6,12
11639,Modoc,2020-10-22,0,0,0
11640,San Mateo,2020-10-22,19,7,26
11641,San Bernardino,2020-10-22,215,48,263
11642,Plumas,2020-10-22,0,0,0
11643,Contra Costa,2020-10-22,24,6,30
11644,Inyo,2020-10-22,0,0,0
11645,Glenn,2020-10-23,0,0,0
11646,Lassen,2020-10-23,0,0,0
11647,Sacramento,2020-10-23,92,26,118
11648,San Joaquin,2020-10-23,30,4,34
11649,San Luis Obispo,2020-10-23,8,0,8
11650,Inyo,2020-10-23,0,0,0
11651,Fresno,2020-10-23,100,15,115
11652,Santa Barbara,2020-10-23,11,0,11
11653,Tulare,2020-10-23,29,1,30
11654,Kern,2020-10-23,56,3,59
11655,Imperial,2020-10-23,42,1,43
11656,Santa Clara,2020-10-23,88,21,109
11657,Amador,2020-10-23,1,0,1
11658,Orange,2020-10-23,159,42,201
11659,Yuba,2020-10-23,9,1,10
11660,San Benito,2020-10-23,0,0,0
11661,Trinity,2020-10-23,0,0,0
11662,Shasta,2020-10-23,10,2,12
11663,Butte,2020-10-23,7,0,7
11664,San Francisco,2020-10-23,24,4,28
11665,Ventura,2020-10-23,31,13,44
11666,Kings,2020-10-23,19,1,20
11667,Sutter,2020-10-23,0,0,0
11668,Tuolumne,2020-10-23,2,0,2
11669,Yolo,2020-10-23,10,0,10
11670,Mendocino,2020-10-23,0,0,0
11671,Solano,2020-10-23,20,11,31
11672,Mono,2020-10-23,0,0,0
11673,Riverside,2020-10-23,151,58,209
11674,Marin,2020-10-23,4,6,10
11675,El Dorado,2020-10-23,0,0,0
11676,Modoc,2020-10-23,0,0,0
11677,Los Angeles,2020-10-23,785,254,1039
11678,Humboldt,2020-10-23,4,1,5
11679,Napa,2020-10-23,1,0,1
11680,Sonoma,2020-10-23,20,0,20
11681,Nevada,2020-10-23,2,1,3
11682,San Bernardino,2020-10-23,212,51,263
11683,Colusa,2020-10-23,0,1,1
11684,Siskiyou,2020-10-23,1,0,1
11685,Stanislaus,2020-10-23,53,21,74
11686,Plumas,2020-10-23,0,0,0
11687,Mariposa,2020-10-23,0,0,0
11688,Merced,2020-10-23,7,2,9
11689,Del Norte,2020-10-23,1,0,1
11690,Santa Cruz,2020-10-23,11,0,11
11691,Calaveras,2020-10-23,0,0,0
11692,Placer,2020-10-23,15,10,25
11693,Madera,2020-10-23,6,5,11
11694,Monterey,2020-10-23,21,0,21
11695,San Mateo,2020-10-23,22,10,32
11696,Lake,2020-10-23,2,1,3
11697,Alameda,2020-10-23,55,46,101
11698,Contra Costa,2020-10-23,24,9,33
11699,Tehama,2020-10-23,6,0,6
11700,San Diego,2020-10-23,185,50,235
11701,Napa,2020-10-24,1,0,1
11702,El Dorado,2020-10-24,0,0,0
11703,Alameda,2020-10-24,54,27,81
11704,Tulare,2020-10-24,27,1,28
11705,Monterey,2020-10-24,22,1,23
11706,Santa Barbara,2020-10-24,9,0,9
11707,Ventura,2020-10-24,27,14,41
11708,Mariposa,2020-10-24,0,0,0
11709,Contra Costa,2020-10-24,23,13,36
11710,Marin,2020-10-24,3,9,12
11711,San Benito,2020-10-24,0,0,0
11712,Mono,2020-10-24,0,0,0
11713,Riverside,2020-10-24,151,53,204
11714,Plumas,2020-10-24,0,0,0
11715,Glenn,2020-10-24,0,0,0
11716,Kings,2020-10-24,20,0,20
11717,Trinity,2020-10-24,0,0,0
11718,Solano,2020-10-24,21,7,28
11719,Fresno,2020-10-24,96,21,117
11720,Colusa,2020-10-24,0,0,0
11721,Placer,2020-10-24,13,12,25
11722,Tuolumne,2020-10-24,2,0,2
11723,Yolo,2020-10-24,9,0,9
11724,San Francisco,2020-10-24,23,5,28
11725,Sutter,2020-10-24,0,0,0
11726,Stanislaus,2020-10-24,46,15,61
11727,Sonoma,2020-10-24,24,4,28
11728,Del Norte,2020-10-24,1,0,1
11729,Orange,2020-10-24,150,33,183
11730,Lake,2020-10-24,2,3,5
11731,San Joaquin,2020-10-24,33,4,37
11732,Los Angeles,2020-10-24,767,294,1061
11733,San Diego,2020-10-24,166,42,208
11734,Humboldt,2020-10-24,4,2,6
11735,Kern,2020-10-24,53,3,56
11736,Calaveras,2020-10-24,0,0,0
11737,Madera,2020-10-24,7,12,19
11738,San Luis Obispo,2020-10-24,7,4,11
11739,Imperial,2020-10-24,43,0,43
11740,Modoc,2020-10-24,1,0,1
11741,Tehama,2020-10-24,6,0,6
11742,San Bernardino,2020-10-24,203,60,263
11743,Inyo,2020-10-24,0,0,0
11744,Nevada,2020-10-24,2,2,4
11745,Santa Cruz,2020-10-24,10,0,10
11746,Siskiyou,2020-10-24,0,0,0
11747,San Mateo,2020-10-24,21,12,33
11748,Mendocino,2020-10-24,1,0,1
11749,Santa Clara,2020-10-24,84,29,113
11750,Butte,2020-10-24,5,0,5
11751,Lassen,2020-10-24,0,0,0
11752,Shasta,2020-10-24,10,1,11
11753,Yuba,2020-10-24,6,1,7
11754,Amador,2020-10-24,3,0,3
11755,Merced,2020-10-24,7,2,9
11756,Sacramento,2020-10-24,91,29,120
11757,Siskiyou,2020-10-25,0,0,0
11758,Tulare,2020-10-25,30,3,33
11759,Yuba,2020-10-25,5,0,5
11760,Riverside,2020-10-25,164,60,224
11761,Orange,2020-10-25,162,46,208
11762,Imperial,2020-10-25,41,0,41
11763,Plumas,2020-10-25,0,0,0
11764,Fresno,2020-10-25,88,11,99
11765,San Benito,2020-10-25,0,0,0
11766,Butte,2020-10-25,6,0,6
11767,Merced,2020-10-25,6,2,8
11768,Glenn,2020-10-25,0,0,0
11769,Mono,2020-10-25,0,1,1
11770,Inyo,2020-10-25,0,0,0
11771,Kings,2020-10-25,21,0,21
11772,San Mateo,2020-10-25,21,9,30
11773,Amador,2020-10-25,3,0,3
11774,Tuolumne,2020-10-25,1,0,1
11775,San Bernardino,2020-10-25,219,42,261
11776,Marin,2020-10-25,6,3,9
11777,Contra Costa,2020-10-25,24,12,36
11778,Madera,2020-10-25,11,10,21
11779,Calaveras,2020-10-25,0,0,0
11780,San Joaquin,2020-10-25,29,3,32
11781,Shasta,2020-10-25,10,2,12
11782,Tehama,2020-10-25,6,0,6
11783,Colusa,2020-10-25,0,0,0
11784,Nevada,2020-10-25,2,1,3
11785,Sutter,2020-10-25,0,0,0
11786,Santa Clara,2020-10-25,85,29,114
11787,San Luis Obispo,2020-10-25,7,1,8
11788,Lake,2020-10-25,2,4,6
11789,Mariposa,2020-10-25,0,0,0
11790,Santa Cruz,2020-10-25,10,0,10
11791,Santa Barbara,2020-10-25,11,1,12
11792,Los Angeles,2020-10-25,747,291,1038
11793,Alameda,2020-10-25,56,38,94
11794,Sonoma,2020-10-25,26,2,28
11795,Placer,2020-10-25,13,16,29
11796,Kern,2020-10-25,48,1,49
11797,El Dorado,2020-10-25,1,1,2
11798,San Diego,2020-10-25,162,45,207
11799,Trinity,2020-10-25,0,0,0
11800,Ventura,2020-10-25,21,12,33
11801,Humboldt,2020-10-25,4,2,6
11802,Del Norte,2020-10-25,1,0,1
11803,Modoc,2020-10-25,0,1,1
11804,Solano,2020-10-25,23,11,34
11805,Yolo,2020-10-25,7,0,7
11806,Stanislaus,2020-10-25,53,21,74
11807,Monterey,2020-10-25,30,3,33
11808,Mendocino,2020-10-25,2,0,2
11809,Lassen,2020-10-25,0,0,0
11810,Sacramento,2020-10-25,88,24,112
11811,San Francisco,2020-10-25,28,2,30
11812,Napa,2020-10-25,1,0,1
11813,Tulare,2020-10-26,32,6,38
11814,Colusa,2020-10-26,0,0,0
11815,San Francisco,2020-10-26,29,3,32
11816,Plumas,2020-10-26,0,0,0
11817,Inyo,2020-10-26,0,0,0
11818,Ventura,2020-10-26,26,11,37
11819,Santa Barbara,2020-10-26,11,1,12
11820,San Benito,2020-10-26,0,0,0
11821,Del Norte,2020-10-26,1,0,1
11822,Tehama,2020-10-26,6,0,6
11823,Kings,2020-10-26,22,0,22
11824,San Bernardino,2020-10-26,217,42,259
11825,Glenn,2020-10-26,0,0,0
11826,Monterey,2020-10-26,29,0,29
11827,Orange,2020-10-26,157,46,203
11828,Madera,2020-10-26,11,4,15
11829,Marin,2020-10-26,5,1,6
11830,Placer,2020-10-26,15,16,31
11831,San Mateo,2020-10-26,20,6,26
11832,Calaveras,2020-10-26,0,0,0
11833,Stanislaus,2020-10-26,54,14,68
11834,San Diego,2020-10-26,176,49,225
11835,Lake,2020-10-26,2,0,2
11836,Modoc,2020-10-26,0,0,0
11837,Tuolumne,2020-10-26,1,0,1
11838,Mono,2020-10-26,0,1,1
11839,Mariposa,2020-10-26,0,0,0
11840,Sacramento,2020-10-26,84,22,106
11841,Lassen,2020-10-26,0,0,0
11842,Alameda,2020-10-26,58,31,89
11843,Sonoma,2020-10-26,30,4,34
11844,Amador,2020-10-26,4,0,4
11845,Fresno,2020-10-26,95,12,107
11846,Contra Costa,2020-10-26,26,12,38
11847,Butte,2020-10-26,8,0,8
11848,Trinity,2020-10-26,0,0,0
11849,Nevada,2020-10-26,1,3,4
11850,Santa Clara,2020-10-26,86,36,122
11851,Riverside,2020-10-26,166,51,217
11852,Imperial,2020-10-26,43,0,43
11853,Sutter,2020-10-26,0,0,0
11854,Siskiyou,2020-10-26,3,0,3
11855,Shasta,2020-10-26,11,0,11
11856,Kern,2020-10-26,47,0,47
11857,Humboldt,2020-10-26,2,2,4
11858,Los Angeles,2020-10-26,755,276,1031
11859,San Luis Obispo,2020-10-26,6,2,8
11860,El Dorado,2020-10-26,1,1,2
11861,Napa,2020-10-26,6,0,6
11862,Yuba,2020-10-26,5,0,5
11863,Solano,2020-10-26,29,11,40
11864,Merced,2020-10-26,8,0,8
11865,Yolo,2020-10-26,7,0,7
11866,Santa Cruz,2020-10-26,10,0,10
11867,San Joaquin,2020-10-26,28,3,31
11868,Mendocino,2020-10-26,1,0,1
11869,Orange,2020-10-27,177,36,213
11870,Butte,2020-10-27,10,0,10
11871,Modoc,2020-10-27,0,0,0
11872,Inyo,2020-10-27,0,0,0
11873,Riverside,2020-10-27,148,48,196
11874,Glenn,2020-10-27,0,0,0
11875,San Mateo,2020-10-27,18,3,21
11876,Mariposa,2020-10-27,0,0,0
11877,San Francisco,2020-10-27,31,1,32
11878,Tehama,2020-10-27,6,1,7
11879,Yuba,2020-10-27,7,0,7
11880,San Bernardino,2020-10-27,233,35,268
11881,Fresno,2020-10-27,96,16,112
11882,Contra Costa,2020-10-27,33,10,43
11883,Imperial,2020-10-27,44,0,44
11884,Madera,2020-10-27,12,10,22
11885,Alameda,2020-10-27,58,34,92
11886,Solano,2020-10-27,27,11,38
11887,San Benito,2020-10-27,0,0,0
11888,Santa Clara,2020-10-27,79,26,105
11889,Trinity,2020-10-27,0,0,0
11890,Tulare,2020-10-27,33,6,39
11891,Lake,2020-10-27,2,0,2
11892,Amador,2020-10-27,2,0,2
11893,Mendocino,2020-10-27,0,0,0
11894,Tuolumne,2020-10-27,1,0,1
11895,Napa,2020-10-27,7,0,7
11896,Merced,2020-10-27,5,1,6
11897,Kern,2020-10-27,46,1,47
11898,Plumas,2020-10-27,0,0,0
11899,Lassen,2020-10-27,0,1,1
11900,San Diego,2020-10-27,182,59,241
11901,Yolo,2020-10-27,8,0,8
11902,Shasta,2020-10-27,9,1,10
11903,Siskiyou,2020-10-27,2,0,2
11904,Sutter,2020-10-27,0,0,0
11905,Colusa,2020-10-27,0,0,0
11906,Humboldt,2020-10-27,2,1,3
11907,Sacramento,2020-10-27,76,20,96
11908,San Joaquin,2020-10-27,26,4,30
11909,Calaveras,2020-10-27,0,0,0
11910,Stanislaus,2020-10-27,59,21,80
11911,San Luis Obispo,2020-10-27,7,0,7
11912,Del Norte,2020-10-27,1,0,1
11913,El Dorado,2020-10-27,1,1,2
11914,Sonoma,2020-10-27,27,8,35
11915,Marin,2020-10-27,5,3,8
11916,Placer,2020-10-27,18,14,32
11917,Nevada,2020-10-27,1,1,2
11918,Ventura,2020-10-27,28,14,42
11919,Santa Cruz,2020-10-27,9,0,9
11920,Santa Barbara,2020-10-27,11,0,11
11921,Mono,2020-10-27,0,1,1
11922,Kings,2020-10-27,19,0,19
11923,Monterey,2020-10-27,26,1,27
11924,Los Angeles,2020-10-27,750,267,1017
11925,Amador,2020-10-28,2,0,2
11926,Glenn,2020-10-28,0,0,0
11927,Plumas,2020-10-28,0,0,0
11928,Humboldt,2020-10-28,2,1,3
11929,Marin,2020-10-28,7,4,11
11930,San Bernardino,2020-10-28,231,43,274
11931,Solano,2020-10-28,22,9,31
11932,Monterey,2020-10-28,29,1,30
11933,Santa Clara,2020-10-28,82,24,106
11934,Madera,2020-10-28,12,9,21
11935,Fresno,2020-10-28,94,12,106
11936,Colusa,2020-10-28,0,0,0
11937,Kings,2020-10-28,13,0,13
11938,San Benito,2020-10-28,0,0,0
11939,San Joaquin,2020-10-28,29,5,34
11940,Merced,2020-10-28,7,0,7
11941,Napa,2020-10-28,4,0,4
11942,San Mateo,2020-10-28,15,9,24
11943,Trinity,2020-10-28,0,0,0
11944,Lassen,2020-10-28,0,0,0
11945,Calaveras,2020-10-28,0,0,0
11946,Santa Barbara,2020-10-28,9,1,10
11947,Lake,2020-10-28,2,0,2
11948,Butte,2020-10-28,10,0,10
11949,Shasta,2020-10-28,8,0,8
11950,Kern,2020-10-28,43,5,48
11951,Tulare,2020-10-28,36,6,42
11952,Imperial,2020-10-28,49,0,49
11953,Sacramento,2020-10-28,83,26,109
11954,Riverside,2020-10-28,149,63,212
11955,Stanislaus,2020-10-28,58,17,75
11956,Tehama,2020-10-28,6,0,6
11957,Sutter,2020-10-28,0,0,0
11958,Modoc,2020-10-28,0,0,0
11959,Contra Costa,2020-10-28,31,12,43
11960,Sonoma,2020-10-28,28,3,31
11961,Nevada,2020-10-28,2,0,2
11962,Los Angeles,2020-10-28,743,290,1033
11963,Siskiyou,2020-10-28,3,0,3
11964,San Diego,2020-10-28,187,48,235
11965,Yuba,2020-10-28,8,0,8
11966,Placer,2020-10-28,22,23,45
11967,Mono,2020-10-28,0,0,0
11968,Del Norte,2020-10-28,1,0,1
11969,Santa Cruz,2020-10-28,8,0,8
11970,San Luis Obispo,2020-10-28,6,0,6
11971,Tuolumne,2020-10-28,5,0,5
11972,El Dorado,2020-10-28,1,1,2
11973,Ventura,2020-10-28,27,15,42
11974,Yolo,2020-10-28,9,0,9
11975,San Francisco,2020-10-28,35,1,36
11976,Mendocino,2020-10-28,0,0,0
11977,Alameda,2020-10-28,58,41,99
11978,Orange,2020-10-28,181,56,237
11979,Inyo,2020-10-28,1,0,1
11980,Mariposa,2020-10-28,0,0,0
11981,Nevada,2020-10-29,2,1,3
11982,Placer,2020-10-29,24,17,41
11983,Marin,2020-10-29,6,12,18
11984,Monterey,2020-10-29,26,0,26
11985,San Luis Obispo,2020-10-29,6,0,6
11986,Trinity,2020-10-29,0,0,0
11987,Fresno,2020-10-29,87,12,99
11988,Tehama,2020-10-29,6,0,6
11989,Amador,2020-10-29,2,0,2
11990,Ventura,2020-10-29,25,14,39
11991,Santa Clara,2020-10-29,79,19,98
11992,Sutter,2020-10-29,0,0,0
11993,Madera,2020-10-29,11,9,20
11994,Butte,2020-10-29,9,0,9
11995,Napa,2020-10-29,6,0,6
11996,Lassen,2020-10-29,0,0,0
11997,Stanislaus,2020-10-29,68,27,95
11998,Lake,2020-10-29,3,2,5
11999,Alameda,2020-10-29,57,34,91
12000,Riverside,2020-10-29,150,64,214
12001,Calaveras,2020-10-29,0,0,0
12002,Humboldt,2020-10-29,3,0,3
12003,San Francisco,2020-10-29,37,2,39
12004,Sonoma,2020-10-29,28,5,33
12005,San Mateo,2020-10-29,22,7,29
12006,Mono,2020-10-29,0,0,0
12007,Santa Cruz,2020-10-29,8,0,8
12008,Mendocino,2020-10-29,0,0,0
12009,Yolo,2020-10-29,10,0,10
12010,Modoc,2020-10-29,0,0,0
12011,Glenn,2020-10-29,0,0,0
12012,Siskiyou,2020-10-29,4,0,4
12013,Shasta,2020-10-29,11,2,13
12014,Yuba,2020-10-29,8,0,8
12015,El Dorado,2020-10-29,1,0,1
12016,Merced,2020-10-29,7,3,10
12017,San Benito,2020-10-29,0,0,0
12018,Kings,2020-10-29,15,1,16
12019,Inyo,2020-10-29,1,0,1
12020,Del Norte,2020-10-29,1,0,1
12021,Orange,2020-10-29,182,51,233
12022,Kern,2020-10-29,44,2,46
12023,Santa Barbara,2020-10-29,9,1,10
12024,Sacramento,2020-10-29,85,21,106
12025,Tuolumne,2020-10-29,6,0,6
12026,Plumas,2020-10-29,0,0,0
12027,Mariposa,2020-10-29,0,0,0
12028,Imperial,2020-10-29,45,1,46
12029,San Bernardino,2020-10-29,233,40,273
12030,Los Angeles,2020-10-29,783,281,1064
12031,Contra Costa,2020-10-29,32,10,42
12032,Solano,2020-10-29,24,10,34
12033,Colusa,2020-10-29,0,0,0
12034,Tulare,2020-10-29,42,9,51
12035,San Joaquin,2020-10-29,25,13,38
12036,San Diego,2020-10-29,197,48,245
12037,Mariposa,2020-10-30,0,0,0
12038,Solano,2020-10-30,29,10,39
12039,Trinity,2020-10-30,0,0,0
12040,Santa Barbara,2020-10-30,9,1,10
12041,Santa Cruz,2020-10-30,12,0,12
12042,Ventura,2020-10-30,27,11,38
12043,Napa,2020-10-30,4,1,5
12044,Tulare,2020-10-30,44,7,51
12045,Mono,2020-10-30,0,0,0
12046,Sacramento,2020-10-30,81,25,106
12047,San Bernardino,2020-10-30,248,51,299
12048,San Francisco,2020-10-30,35,5,40
12049,Marin,2020-10-30,5,5,10
12050,San Benito,2020-10-30,0,0,0
12051,Inyo,2020-10-30,0,0,0
12052,El Dorado,2020-10-30,2,0,2
12053,Yolo,2020-10-30,8,0,8
12054,Lake,2020-10-30,3,1,4
12055,Contra Costa,2020-10-30,34,9,43
12056,Sonoma,2020-10-30,22,4,26
12057,Calaveras,2020-10-30,0,0,0
12058,Lassen,2020-10-30,0,0,0
12059,Sutter,2020-10-30,0,0,0
12060,Siskiyou,2020-10-30,2,0,2
12061,San Joaquin,2020-10-30,28,8,36
12062,Stanislaus,2020-10-30,70,14,84
12063,San Diego,2020-10-30,212,40,252
12064,Kern,2020-10-30,53,5,58
12065,Alameda,2020-10-30,68,42,110
12066,Plumas,2020-10-30,0,0,0
12067,Madera,2020-10-30,10,7,17
12068,Mendocino,2020-10-30,0,0,0
12069,Humboldt,2020-10-30,3,0,3
12070,Glenn,2020-10-30,0,0,0
12071,Tuolumne,2020-10-30,3,0,3
12072,Del Norte,2020-10-30,1,0,1
12073,Los Angeles,2020-10-30,799,295,1094
12074,Modoc,2020-10-30,0,1,1
12075,Butte,2020-10-30,7,0,7
12076,Imperial,2020-10-30,44,0,44
12077,Colusa,2020-10-30,0,0,0
12078,Kings,2020-10-30,17,1,18
12079,Fresno,2020-10-30,94,11,105
12080,Riverside,2020-10-30,157,57,214
12081,Tehama,2020-10-30,5,0,5
12082,Merced,2020-10-30,9,0,9
12083,Nevada,2020-10-30,2,0,2
12084,Shasta,2020-10-30,8,3,11
12085,San Mateo,2020-10-30,24,6,30
12086,Yuba,2020-10-30,8,1,9
12087,San Luis Obispo,2020-10-30,7,2,9
12088,Placer,2020-10-30,27,15,42
12089,Amador,2020-10-30,0,0,0
12090,Monterey,2020-10-30,25,0,25
12091,Santa Clara,2020-10-30,91,13,104
12092,Orange,2020-10-30,188,36,224
12093,Modoc,2020-10-31,0,2,2
12094,Inyo,2020-10-31,0,0,0
12095,Butte,2020-10-31,7,1,8
12096,Santa Clara,2020-10-31,83,9,92
12097,Plumas,2020-10-31,0,0,0
12098,Contra Costa,2020-10-31,35,11,46
12099,San Luis Obispo,2020-10-31,7,2,9
12100,Shasta,2020-10-31,9,0,9
12101,San Benito,2020-10-31,0,0,0
12102,Placer,2020-10-31,30,16,46
12103,Amador,2020-10-31,0,0,0
12104,Monterey,2020-10-31,25,0,25
12105,Kings,2020-10-31,12,3,15
12106,Sutter,2020-10-31,0,0,0
12107,Riverside,2020-10-31,156,56,212
12108,Fresno,2020-10-31,96,14,110
12109,Colusa,2020-10-31,0,2,2
12110,Mendocino,2020-10-31,1,0,1
12111,Yolo,2020-10-31,8,0,8
12112,Mono,2020-10-31,0,0,0
12113,Trinity,2020-10-31,0,0,0
12114,Tehama,2020-10-31,5,0,5
12115,Calaveras,2020-10-31,0,0,0
12116,Humboldt,2020-10-31,2,0,2
12117,Kern,2020-10-31,51,6,57
12118,San Francisco,2020-10-31,34,4,38
12119,Sonoma,2020-10-31,20,6,26
12120,Nevada,2020-10-31,1,1,2
12121,Madera,2020-10-31,8,10,18
12122,San Mateo,2020-10-31,19,12,31
12123,Lassen,2020-10-31,0,0,0
12124,Los Angeles,2020-10-31,777,302,1079
12125,Merced,2020-10-31,5,0,5
12126,Mariposa,2020-10-31,0,0,0
12127,Santa Cruz,2020-10-31,11,0,11
12128,Lake,2020-10-31,3,1,4
12129,Yuba,2020-10-31,5,1,6
12130,Sacramento,2020-10-31,77,25,102
12131,Marin,2020-10-31,6,9,15
12132,San Diego,2020-10-31,244,36,280
12133,Napa,2020-10-31,3,3,6
12134,San Bernardino,2020-10-31,241,47,288
12135,Alameda,2020-10-31,62,49,111
12136,Stanislaus,2020-10-31,66,18,84
12137,Tulare,2020-10-31,40,5,45
12138,Siskiyou,2020-10-31,1,0,1
12139,San Joaquin,2020-10-31,24,6,30
12140,Del Norte,2020-10-31,0,0,0
12141,Glenn,2020-10-31,0,0,0
12142,El Dorado,2020-10-31,2,0,2
12143,Solano,2020-10-31,30,11,41
12144,Santa Barbara,2020-10-31,10,1,11
12145,Imperial,2020-10-31,50,0,50
12146,Tuolumne,2020-10-31,3,0,3
12147,Ventura,2020-10-31,24,14,38
12148,Orange,2020-10-31,181,36,217
12149,Calaveras,2020-11-01,0,0,0
12150,Tehama,2020-11-01,5,0,5
12151,San Joaquin,2020-11-01,30,7,37
12152,Solano,2020-11-01,25,13,38
12153,Merced,2020-11-01,6,0,6
12154,Nevada,2020-11-01,1,1,2
12155,Ventura,2020-11-01,29,14,43
12156,El Dorado,2020-11-01,4,0,4
12157,Shasta,2020-11-01,8,0,8
12158,Kern,2020-11-01,46,4,50
12159,Yuba,2020-11-01,3,0,3
12160,Lake,2020-11-01,3,1,4
12161,Tulare,2020-11-01,37,10,47
12162,Butte,2020-11-01,9,1,10
12163,San Luis Obispo,2020-11-01,7,1,8
12164,San Diego,2020-11-01,239,61,300
12165,San Bernardino,2020-11-01,242,61,303
12166,Los Angeles,2020-11-01,798,258,1056
12167,Santa Barbara,2020-11-01,10,1,11
12168,Sacramento,2020-11-01,85,30,115
12169,Santa Cruz,2020-11-01,12,0,12
12170,Yolo,2020-11-01,5,0,5
12171,Santa Clara,2020-11-01,85,15,100
12172,Mono,2020-11-01,0,0,0
12173,Tuolumne,2020-11-01,3,0,3
12174,Imperial,2020-11-01,49,0,49
12175,Modoc,2020-11-01,0,0,0
12176,Lassen,2020-11-01,0,0,0
12177,Colusa,2020-11-01,0,2,2
12178,Monterey,2020-11-01,25,2,27
12179,Plumas,2020-11-01,0,0,0
12180,Napa,2020-11-01,3,0,3
12181,Contra Costa,2020-11-01,35,17,52
12182,Siskiyou,2020-11-01,1,0,1
12183,San Benito,2020-11-01,0,0,0
12184,Amador,2020-11-01,0,0,0
12185,Inyo,2020-11-01,0,0,0
12186,Del Norte,2020-11-01,0,0,0
12187,Sonoma,2020-11-01,20,4,24
12188,Stanislaus,2020-11-01,71,22,93
12189,Marin,2020-11-01,5,12,17
12190,Trinity,2020-11-01,0,0,0
12191,Fresno,2020-11-01,102,7,109
12192,Orange,2020-11-01,183,18,201
12193,Riverside,2020-11-01,179,52,231
12194,Madera,2020-11-01,8,10,18
12195,Alameda,2020-11-01,63,46,109
12196,Sutter,2020-11-01,0,0,0
12197,San Mateo,2020-11-01,17,10,27
12198,Placer,2020-11-01,31,17,48
12199,San Francisco,2020-11-01,37,3,40
12200,Mendocino,2020-11-01,1,0,1
12201,Kings,2020-11-01,12,3,15
12202,Mariposa,2020-11-01,0,0,0
12203,Glenn,2020-11-01,0,0,0
12204,Humboldt,2020-11-01,3,1,4
12205,Placer,2020-11-02,30,16,46
12206,Monterey,2020-11-02,28,0,28
12207,Fresno,2020-11-02,106,14,120
12208,Trinity,2020-11-02,0,0,0
12209,Lassen,2020-11-02,0,0,0
12210,Mendocino,2020-11-02,1,0,1
12211,Imperial,2020-11-02,48,0,48
12212,Napa,2020-11-02,3,1,4
12213,Yuba,2020-11-02,4,0,4
12214,Kern,2020-11-02,46,2,48
12215,Contra Costa,2020-11-02,40,18,58
12216,Lake,2020-11-02,2,1,3
12217,Santa Clara,2020-11-02,91,21,112
12218,Sonoma,2020-11-02,23,2,25
12219,San Mateo,2020-11-02,17,13,30
12220,Merced,2020-11-02,8,0,8
12221,Madera,2020-11-02,8,8,16
12222,Amador,2020-11-02,0,0,0
12223,Tulare,2020-11-02,39,9,48
12224,Tehama,2020-11-02,3,0,3
12225,Butte,2020-11-02,9,1,10
12226,Ventura,2020-11-02,29,9,38
12227,Glenn,2020-11-02,0,0,0
12228,Santa Barbara,2020-11-02,13,1,14
12229,Del Norte,2020-11-02,0,0,0
12230,Yolo,2020-11-02,7,0,7
12231,San Bernardino,2020-11-02,243,54,297
12232,Modoc,2020-11-02,0,0,0
12233,Riverside,2020-11-02,194,56,250
12234,Orange,2020-11-02,177,37,214
12235,San Diego,2020-11-02,239,52,291
12236,Tuolumne,2020-11-02,3,0,3
12237,San Luis Obispo,2020-11-02,7,0,7
12238,Calaveras,2020-11-02,0,0,0
12239,Marin,2020-11-02,5,9,14
12240,Inyo,2020-11-02,0,0,0
12241,Plumas,2020-11-02,0,0,0
12242,Kings,2020-11-02,11,4,15
12243,San Francisco,2020-11-02,36,2,38
12244,Sutter,2020-11-02,0,0,0
12245,Colusa,2020-11-02,0,2,2
12246,Humboldt,2020-11-02,2,0,2
12247,Siskiyou,2020-11-02,2,0,2
12248,Solano,2020-11-02,27,11,38
12249,Mono,2020-11-02,0,0,0
12250,San Benito,2020-11-02,2,0,2
12251,Sacramento,2020-11-02,86,23,109
12252,Nevada,2020-11-02,2,0,2
12253,Stanislaus,2020-11-02,74,24,98
12254,El Dorado,2020-11-02,2,0,2
12255,Santa Cruz,2020-11-02,12,0,12
12256,Alameda,2020-11-02,69,41,110
12257,Shasta,2020-11-02,9,0,9
12258,Los Angeles,2020-11-02,817,229,1046
12259,Mariposa,2020-11-02,0,0,0
12260,San Joaquin,2020-11-02,28,8,36
12261,Humboldt,2020-11-03,2,0,2
12262,El Dorado,2020-11-03,3,0,3
12263,Fresno,2020-11-03,96,14,110
12264,Stanislaus,2020-11-03,56,17,73
12265,Modoc,2020-11-03,0,0,0
12266,San Benito,2020-11-03,3,0,3
12267,Shasta,2020-11-03,9,0,9
12268,Monterey,2020-11-03,32,0,32
12269,Santa Clara,2020-11-03,102,17,119
12270,San Mateo,2020-11-03,17,11,28
12271,Orange,2020-11-03,182,42,224
12272,San Joaquin,2020-11-03,31,5,36
12273,Marin,2020-11-03,5,7,12
12274,San Francisco,2020-11-03,35,5,40
12275,Plumas,2020-11-03,0,0,0
12276,Santa Barbara,2020-11-03,12,3,15
12277,Contra Costa,2020-11-03,41,10,51
12278,Amador,2020-11-03,0,0,0
12279,Mariposa,2020-11-03,0,0,0
12280,Mendocino,2020-11-03,2,0,2
12281,Ventura,2020-11-03,31,10,41
12282,Del Norte,2020-11-03,0,1,1
12283,Placer,2020-11-03,36,17,53
12284,Inyo,2020-11-03,1,0,1
12285,Lake,2020-11-03,2,0,2
12286,San Luis Obispo,2020-11-03,6,2,8
12287,San Bernardino,2020-11-03,263,52,315
12288,Alameda,2020-11-03,65,51,116
12289,Sonoma,2020-11-03,22,6,28
12290,Tulare,2020-11-03,41,10,51
12291,Sacramento,2020-11-03,92,19,111
12292,Sutter,2020-11-03,0,0,0
12293,Siskiyou,2020-11-03,2,0,2
12294,Madera,2020-11-03,8,13,21
12295,Calaveras,2020-11-03,0,0,0
12296,Yolo,2020-11-03,9,0,9
12297,Mono,2020-11-03,0,0,0
12298,Merced,2020-11-03,9,0,9
12299,Glenn,2020-11-03,0,0,0
12300,Imperial,2020-11-03,49,0,49
12301,San Diego,2020-11-03,243,52,295
12302,Santa Cruz,2020-11-03,13,0,13
12303,Solano,2020-11-03,21,9,30
12304,Tuolumne,2020-11-03,2,0,2
12305,Napa,2020-11-03,3,0,3
12306,Los Angeles,2020-11-03,825,303,1128
12307,Colusa,2020-11-03,0,2,2
12308,Butte,2020-11-03,12,1,13
12309,Nevada,2020-11-03,2,0,2
12310,Trinity,2020-11-03,0,0,0
12311,Riverside,2020-11-03,210,57,267
12312,Tehama,2020-11-03,3,0,3
12313,Kern,2020-11-03,53,2,55
12314,Yuba,2020-11-03,3,0,3
12315,Kings,2020-11-03,15,3,18
12316,Lassen,2020-11-03,0,0,0
12317,Marin,2020-11-04,5,3,8
12318,San Luis Obispo,2020-11-04,8,0,8
12319,San Mateo,2020-11-04,22,6,28
12320,Sacramento,2020-11-04,94,29,123
12321,Sutter,2020-11-04,0,0,0
12322,Los Angeles,2020-11-04,821,322,1143
12323,San Diego,2020-11-04,278,51,329
12324,Humboldt,2020-11-04,2,0,2
12325,Imperial,2020-11-04,50,0,50
12326,Colusa,2020-11-04,0,1,1
12327,Amador,2020-11-04,1,0,1
12328,Plumas,2020-11-04,0,0,0
12329,Shasta,2020-11-04,14,0,14
12330,San Francisco,2020-11-04,34,4,38
12331,Mariposa,2020-11-04,0,0,0
12332,Del Norte,2020-11-04,0,0,0
12333,Santa Cruz,2020-11-04,11,0,11
12334,Sonoma,2020-11-04,25,4,29
12335,Santa Barbara,2020-11-04,12,3,15
12336,Mendocino,2020-11-04,3,0,3
12337,Merced,2020-11-04,8,0,8
12338,Santa Clara,2020-11-04,100,18,118
12339,Fresno,2020-11-04,99,20,119
12340,Orange,2020-11-04,178,49,227
12341,San Benito,2020-11-04,3,0,3
12342,Calaveras,2020-11-04,0,0,0
12343,Tehama,2020-11-04,2,0,2
12344,Lassen,2020-11-04,0,0,0
12345,El Dorado,2020-11-04,2,0,2
12346,Kings,2020-11-04,15,3,18
12347,Tuolumne,2020-11-04,3,1,4
12348,San Bernardino,2020-11-04,281,58,339
12349,Placer,2020-11-04,35,11,46
12350,Napa,2020-11-04,4,0,4
12351,Ventura,2020-11-04,26,9,35
12352,San Joaquin,2020-11-04,32,5,37
12353,Riverside,2020-11-04,201,60,261
12354,Glenn,2020-11-04,0,0,0
12355,Tulare,2020-11-04,36,9,45
12356,Siskiyou,2020-11-04,2,0,2
12357,Solano,2020-11-04,19,9,28
12358,Contra Costa,2020-11-04,39,4,43
12359,Madera,2020-11-04,9,9,18
12360,Trinity,2020-11-04,0,0,0
12361,Mono,2020-11-04,0,0,0
12362,Yuba,2020-11-04,2,0,2
12363,Butte,2020-11-04,11,0,11
12364,Kern,2020-11-04,51,2,53
12365,Yolo,2020-11-04,8,0,8
12366,Stanislaus,2020-11-04,61,15,76
12367,Monterey,2020-11-04,36,0,36
12368,Inyo,2020-11-04,1,0,1
12369,Modoc,2020-11-04,0,0,0
12370,Lake,2020-11-04,2,0,2
12371,Nevada,2020-11-04,3,0,3
12372,Alameda,2020-11-04,63,45,108
12373,San Joaquin,2020-11-05,38,1,39
12374,Napa,2020-11-05,4,0,4
12375,Calaveras,2020-11-05,0,0,0
12376,Butte,2020-11-05,12,0,12
12377,Santa Barbara,2020-11-05,15,0,15
12378,Tuolumne,2020-11-05,2,1,3
12379,Sonoma,2020-11-05,22,3,25
12380,Modoc,2020-11-05,1,0,1
12381,Tulare,2020-11-05,38,11,49
12382,Del Norte,2020-11-05,0,0,0
12383,Glenn,2020-11-05,0,0,0
12384,Stanislaus,2020-11-05,58,15,73
12385,Lake,2020-11-05,1,0,1
12386,Merced,2020-11-05,9,0,9
12387,San Luis Obispo,2020-11-05,8,0,8
12388,Fresno,2020-11-05,103,20,123
12389,Tehama,2020-11-05,2,0,2
12390,Riverside,2020-11-05,208,58,266
12391,Kern,2020-11-05,54,3,57
12392,Shasta,2020-11-05,15,0,15
12393,San Francisco,2020-11-05,33,3,36
12394,Orange,2020-11-05,177,46,223
12395,Monterey,2020-11-05,38,0,38
12396,Mono,2020-11-05,0,0,0
12397,Amador,2020-11-05,1,0,1
12398,San Benito,2020-11-05,3,0,3
12399,Solano,2020-11-05,20,13,33
12400,Los Angeles,2020-11-05,840,292,1132
12401,El Dorado,2020-11-05,3,0,3
12402,San Diego,2020-11-05,286,55,341
12403,Humboldt,2020-11-05,2,0,2
12404,Alameda,2020-11-05,66,43,109
12405,Siskiyou,2020-11-05,1,0,1
12406,Imperial,2020-11-05,45,0,45
12407,Sutter,2020-11-05,0,0,0
12408,Marin,2020-11-05,4,6,10
12409,San Bernardino,2020-11-05,283,49,332
12410,Mendocino,2020-11-05,2,0,2
12411,Yuba,2020-11-05,2,0,2
12412,Inyo,2020-11-05,1,0,1
12413,Kings,2020-11-05,14,0,14
12414,Lassen,2020-11-05,1,0,1
12415,Colusa,2020-11-05,0,0,0
12416,Madera,2020-11-05,7,6,13
12417,Yolo,2020-11-05,7,0,7
12418,Santa Cruz,2020-11-05,11,0,11
12419,Plumas,2020-11-05,0,0,0
12420,Mariposa,2020-11-05,0,0,0
12421,Placer,2020-11-05,40,19,59
12422,Contra Costa,2020-11-05,40,5,45
12423,Santa Clara,2020-11-05,100,21,121
12424,Ventura,2020-11-05,30,5,35
12425,Trinity,2020-11-05,0,0,0
12426,San Mateo,2020-11-05,23,12,35
12427,Sacramento,2020-11-05,90,18,108
12428,Nevada,2020-11-05,5,1,6
12429,Placer,2020-11-06,34,12,46
12430,Fresno,2020-11-06,103,16,119
12431,Tehama,2020-11-06,1,0,1
12432,Sonoma,2020-11-06,26,1,27
12433,El Dorado,2020-11-06,2,0,2
12434,San Diego,2020-11-06,284,54,338
12435,Calaveras,2020-11-06,0,0,0
12436,Siskiyou,2020-11-06,2,0,2
12437,Alameda,2020-11-06,66,41,107
12438,Lassen,2020-11-06,1,0,1
12439,Solano,2020-11-06,25,13,38
12440,Shasta,2020-11-06,15,1,16
12441,Del Norte,2020-11-06,0,0,0
12442,Colusa,2020-11-06,0,1,1
12443,Modoc,2020-11-06,2,0,2
12444,Plumas,2020-11-06,0,0,0
12445,Contra Costa,2020-11-06,39,13,52
12446,San Francisco,2020-11-06,38,4,42
12447,Santa Cruz,2020-11-06,9,0,9
12448,Kern,2020-11-06,59,3,62
12449,Humboldt,2020-11-06,2,3,5
12450,Monterey,2020-11-06,36,0,36
12451,Nevada,2020-11-06,4,1,5
12452,Mendocino,2020-11-06,3,0,3
12453,Yolo,2020-11-06,5,0,5
12454,Amador,2020-11-06,4,0,4
12455,Glenn,2020-11-06,0,0,0
12456,Tulare,2020-11-06,41,3,44
12457,Santa Barbara,2020-11-06,12,1,13
12458,Merced,2020-11-06,12,0,12
12459,Inyo,2020-11-06,0,0,0
12460,Yuba,2020-11-06,1,1,2
12461,Marin,2020-11-06,6,4,10
12462,San Luis Obispo,2020-11-06,7,0,7
12463,Lake,2020-11-06,1,0,1
12464,Riverside,2020-11-06,202,46,248
12465,San Bernardino,2020-11-06,281,43,324
12466,Sacramento,2020-11-06,104,26,130
12467,Butte,2020-11-06,8,0,8
12468,Trinity,2020-11-06,0,0,0
12469,Napa,2020-11-06,4,1,5
12470,Tuolumne,2020-11-06,2,1,3
12471,Santa Clara,2020-11-06,103,14,117
12472,Orange,2020-11-06,199,33,232
12473,San Mateo,2020-11-06,20,11,31
12474,Imperial,2020-11-06,45,0,45
12475,Mono,2020-11-06,0,0,0
12476,Ventura,2020-11-06,33,8,41
12477,San Benito,2020-11-06,3,0,3
12478,Sutter,2020-11-06,0,0,0
12479,Madera,2020-11-06,7,11,18
12480,Stanislaus,2020-11-06,58,9,67
12481,Kings,2020-11-06,17,0,17
12482,Mariposa,2020-11-06,0,0,0
12483,San Joaquin,2020-11-06,44,5,49
12484,Los Angeles,2020-11-06,851,255,1106
12485,Orange,2020-11-07,201,23,224
12486,Fresno,2020-11-07,110,21,131
12487,San Joaquin,2020-11-07,53,4,57
12488,San Francisco,2020-11-07,36,5,41
12489,Placer,2020-11-07,38,16,54
12490,Mono,2020-11-07,0,0,0
12491,Yuba,2020-11-07,1,1,2
12492,Mendocino,2020-11-07,3,0,3
12493,Sonoma,2020-11-07,27,2,29
12494,Tulare,2020-11-07,37,3,40
12495,El Dorado,2020-11-07,2,0,2
12496,Mariposa,2020-11-07,1,0,1
12497,Glenn,2020-11-07,0,0,0
12498,San Luis Obispo,2020-11-07,6,1,7
12499,Tehama,2020-11-07,4,0,4
12500,Amador,2020-11-07,3,0,3
12501,Kern,2020-11-07,61,1,62
12502,Ventura,2020-11-07,39,5,44
12503,Los Angeles,2020-11-07,855,278,1133
12504,Trinity,2020-11-07,0,0,0
12505,Modoc,2020-11-07,2,0,2
12506,Siskiyou,2020-11-07,3,0,3
12507,Humboldt,2020-11-07,2,0,2
12508,Yolo,2020-11-07,4,0,4
12509,Lake,2020-11-07,1,0,1
12510,Santa Barbara,2020-11-07,9,0,9
12511,Butte,2020-11-07,10,1,11
12512,Stanislaus,2020-11-07,61,6,67
12513,Sutter,2020-11-07,0,0,0
12514,Imperial,2020-11-07,47,0,47
12515,Del Norte,2020-11-07,0,0,0
12516,San Benito,2020-11-07,3,0,3
12517,Inyo,2020-11-07,0,0,0
12518,San Mateo,2020-11-07,20,5,25
12519,Contra Costa,2020-11-07,38,12,50
12520,Madera,2020-11-07,6,13,19
12521,Tuolumne,2020-11-07,3,1,4
12522,Merced,2020-11-07,10,0,10
12523,San Diego,2020-11-07,297,57,354
12524,Santa Clara,2020-11-07,105,19,124
12525,Colusa,2020-11-07,0,1,1
12526,Sacramento,2020-11-07,120,24,144
12527,Shasta,2020-11-07,17,1,18
12528,Alameda,2020-11-07,69,37,106
12529,Solano,2020-11-07,28,12,40
12530,Plumas,2020-11-07,0,0,0
12531,Santa Cruz,2020-11-07,7,2,9
12532,Nevada,2020-11-07,4,1,5
12533,Marin,2020-11-07,6,7,13
12534,Kings,2020-11-07,16,0,16
12535,Calaveras,2020-11-07,0,0,0
12536,Monterey,2020-11-07,33,0,33
12537,San Bernardino,2020-11-07,274,38,312
12538,Riverside,2020-11-07,223,55,278
12539,Napa,2020-11-07,6,0,6
12540,Lassen,2020-11-07,1,0,1
12541,Solano,2020-11-08,28,11,39
12542,Humboldt,2020-11-08,2,1,3
12543,Siskiyou,2020-11-08,2,0,2
12544,Mendocino,2020-11-08,4,0,4
12545,Sonoma,2020-11-08,29,3,32
12546,Kings,2020-11-08,14,0,14
12547,San Benito,2020-11-08,3,0,3
12548,Yuba,2020-11-08,4,0,4
12549,Napa,2020-11-08,7,1,8
12550,Lassen,2020-11-08,1,0,1
12551,Plumas,2020-11-08,0,0,0
12552,Shasta,2020-11-08,19,1,20
12553,Del Norte,2020-11-08,1,0,1
12554,Trinity,2020-11-08,0,0,0
12555,Mariposa,2020-11-08,1,0,1
12556,Glenn,2020-11-08,0,0,0
12557,Merced,2020-11-08,11,0,11
12558,San Francisco,2020-11-08,40,2,42
12559,Monterey,2020-11-08,32,0,32
12560,Stanislaus,2020-11-08,64,12,76
12561,Fresno,2020-11-08,109,21,130
12562,Lake,2020-11-08,1,0,1
12563,Amador,2020-11-08,3,2,5
12564,Butte,2020-11-08,10,0,10
12565,Inyo,2020-11-08,0,0,0
12566,Colusa,2020-11-08,0,0,0
12567,Orange,2020-11-08,205,28,233
12568,Marin,2020-11-08,5,6,11
12569,Tehama,2020-11-08,4,0,4
12570,Santa Cruz,2020-11-08,9,0,9
12571,Alameda,2020-11-08,69,48,117
12572,Madera,2020-11-08,5,7,12
12573,Placer,2020-11-08,42,14,56
12574,Imperial,2020-11-08,50,0,50
12575,Sutter,2020-11-08,0,0,0
12576,Calaveras,2020-11-08,0,0,0
12577,Tuolumne,2020-11-08,1,3,4
12578,Riverside,2020-11-08,228,58,286
12579,Santa Barbara,2020-11-08,10,0,10
12580,San Luis Obispo,2020-11-08,6,2,8
12581,San Bernardino,2020-11-08,289,37,326
12582,Modoc,2020-11-08,2,0,2
12583,Kern,2020-11-08,61,1,62
12584,Mono,2020-11-08,0,0,0
12585,San Joaquin,2020-11-08,55,1,56
12586,Sacramento,2020-11-08,136,22,158
12587,Contra Costa,2020-11-08,46,17,63
12588,Santa Clara,2020-11-08,111,27,138
12589,Yolo,2020-11-08,4,0,4
12590,Los Angeles,2020-11-08,888,264,1152
12591,Ventura,2020-11-08,40,8,48
12592,San Mateo,2020-11-08,20,7,27
12593,San Diego,2020-11-08,287,55,342
12594,Tulare,2020-11-08,38,8,46
12595,El Dorado,2020-11-08,2,0,2
12596,Nevada,2020-11-08,3,0,3
12597,Modoc,2020-11-09,2,0,2
12598,Orange,2020-11-09,224,52,276
12599,Merced,2020-11-09,9,0,9
12600,Santa Clara,2020-11-09,110,24,134
12601,Mariposa,2020-11-09,1,0,1
12602,Amador,2020-11-09,2,2,4
12603,Butte,2020-11-09,12,0,12
12604,Yuba,2020-11-09,3,0,3
12605,Yolo,2020-11-09,4,0,4
12606,Riverside,2020-11-09,244,43,287
12607,Kings,2020-11-09,18,0,18
12608,Sonoma,2020-11-09,22,2,24
12609,San Mateo,2020-11-09,19,7,26
12610,El Dorado,2020-11-09,4,1,5
12611,San Benito,2020-11-09,1,0,1
12612,San Joaquin,2020-11-09,55,4,59
12613,Inyo,2020-11-09,0,0,0
12614,Contra Costa,2020-11-09,45,12,57
12615,Imperial,2020-11-09,49,0,49
12616,Santa Cruz,2020-11-09,8,0,8
12617,Mono,2020-11-09,0,0,0
12618,Shasta,2020-11-09,24,2,26
12619,Madera,2020-11-09,7,4,11
12620,Kern,2020-11-09,65,2,67
12621,Fresno,2020-11-09,112,24,136
12622,Alameda,2020-11-09,63,45,108
12623,Napa,2020-11-09,8,0,8
12624,Santa Barbara,2020-11-09,11,0,11
12625,San Diego,2020-11-09,299,53,352
12626,Nevada,2020-11-09,5,0,5
12627,Del Norte,2020-11-09,0,0,0
12628,Glenn,2020-11-09,0,0,0
12629,Sacramento,2020-11-09,148,31,179
12630,Marin,2020-11-09,7,2,9
12631,Colusa,2020-11-09,0,0,0
12632,San Bernardino,2020-11-09,284,47,331
12633,Sutter,2020-11-09,0,0,0
12634,Monterey,2020-11-09,33,0,33
12635,Los Angeles,2020-11-09,903,306,1209
12636,Trinity,2020-11-09,0,0,0
12637,San Francisco,2020-11-09,36,3,39
12638,Siskiyou,2020-11-09,4,0,4
12639,Tulare,2020-11-09,38,8,46
12640,Lassen,2020-11-09,1,0,1
12641,Ventura,2020-11-09,41,9,50
12642,Placer,2020-11-09,44,9,53
12643,Tehama,2020-11-09,3,0,3
12644,Calaveras,2020-11-09,0,0,0
12645,Mendocino,2020-11-09,4,0,4
12646,Plumas,2020-11-09,0,0,0
12647,Stanislaus,2020-11-09,62,9,71
12648,Solano,2020-11-09,33,12,45
12649,Humboldt,2020-11-09,2,3,5
12650,Tuolumne,2020-11-09,5,0,5
12651,Lake,2020-11-09,1,0,1
12652,San Luis Obispo,2020-11-09,8,0,8
12653,Lake,2020-11-10,2,0,2
12654,Ventura,2020-11-10,35,11,46
12655,Trinity,2020-11-10,0,0,0
12656,Kings,2020-11-10,18,0,18
12657,Santa Barbara,2020-11-10,14,0,14
12658,Placer,2020-11-10,49,10,59
12659,Modoc,2020-11-10,2,0,2
12660,San Mateo,2020-11-10,22,11,33
12661,Sutter,2020-11-10,0,0,0
12662,Sacramento,2020-11-10,158,25,183
12663,Madera,2020-11-10,8,9,17
12664,San Benito,2020-11-10,1,0,1
12665,Shasta,2020-11-10,31,0,31
12666,El Dorado,2020-11-10,4,0,4
12667,Fresno,2020-11-10,121,24,145
12668,Nevada,2020-11-10,5,0,5
12669,Tuolumne,2020-11-10,4,0,4
12670,Colusa,2020-11-10,1,0,1
12671,Calaveras,2020-11-10,0,0,0
12672,Merced,2020-11-10,14,0,14
12673,Tehama,2020-11-10,5,0,5
12674,San Francisco,2020-11-10,35,4,39
12675,Los Angeles,2020-11-10,953,317,1270
12676,Marin,2020-11-10,12,7,19
12677,Orange,2020-11-10,244,40,284
12678,Siskiyou,2020-11-10,4,0,4
12679,Solano,2020-11-10,30,12,42
12680,Santa Clara,2020-11-10,109,26,135
12681,Lassen,2020-11-10,0,0,0
12682,Riverside,2020-11-10,263,44,307
12683,Mono,2020-11-10,0,0,0
12684,San Diego,2020-11-10,294,61,355
12685,Contra Costa,2020-11-10,45,14,59
12686,Mariposa,2020-11-10,1,0,1
12687,Monterey,2020-11-10,38,0,38
12688,Mendocino,2020-11-10,4,0,4
12689,Santa Cruz,2020-11-10,9,0,9
12690,Tulare,2020-11-10,42,8,50
12691,Plumas,2020-11-10,0,0,0
12692,Glenn,2020-11-10,0,0,0
12693,Yolo,2020-11-10,3,0,3
12694,Imperial,2020-11-10,51,0,51
12695,Kern,2020-11-10,56,1,57
12696,Del Norte,2020-11-10,0,0,0
12697,San Bernardino,2020-11-10,286,63,349
12698,Sonoma,2020-11-10,21,10,31
12699,Humboldt,2020-11-10,2,1,3
12700,Amador,2020-11-10,3,0,3
12701,Stanislaus,2020-11-10,64,9,73
12702,Inyo,2020-11-10,0,0,0
12703,Yuba,2020-11-10,3,0,3
12704,San Luis Obispo,2020-11-10,6,0,6
12705,Alameda,2020-11-10,70,51,121
12706,Butte,2020-11-10,13,0,13
12707,San Joaquin,2020-11-10,62,5,67
12708,Napa,2020-11-10,7,0,7
12709,Mendocino,2020-11-11,7,0,7
12710,Marin,2020-11-11,13,3,16
12711,Los Angeles,2020-11-11,942,323,1265
12712,Sutter,2020-11-11,0,0,0
12713,Merced,2020-11-11,17,0,17
12714,Alameda,2020-11-11,75,36,111
12715,Amador,2020-11-11,3,0,3
12716,Ventura,2020-11-11,37,6,43
12717,San Benito,2020-11-11,1,0,1
12718,Sacramento,2020-11-11,153,20,173
12719,Kings,2020-11-11,19,0,19
12720,Tuolumne,2020-11-11,6,0,6
12721,Stanislaus,2020-11-11,66,12,78
12722,Modoc,2020-11-11,1,0,1
12723,San Diego,2020-11-11,303,41,344
12724,Santa Clara,2020-11-11,106,15,121
12725,San Luis Obispo,2020-11-11,7,0,7
12726,Colusa,2020-11-11,2,0,2
12727,Calaveras,2020-11-11,0,0,0
12728,Yuba,2020-11-11,6,0,6
12729,Fresno,2020-11-11,123,16,139
12730,Napa,2020-11-11,9,0,9
12731,Lake,2020-11-11,2,0,2
12732,Kern,2020-11-11,59,9,68
12733,Riverside,2020-11-11,271,52,323
12734,Tulare,2020-11-11,43,6,49
12735,Lassen,2020-11-11,0,0,0
12736,San Francisco,2020-11-11,36,7,43
12737,Solano,2020-11-11,30,14,44
12738,Mono,2020-11-11,0,0,0
12739,San Mateo,2020-11-11,21,10,31
12740,Placer,2020-11-11,50,10,60
12741,Siskiyou,2020-11-11,4,0,4
12742,Inyo,2020-11-11,0,0,0
12743,Plumas,2020-11-11,0,0,0
12744,Shasta,2020-11-11,28,1,29
12745,Santa Cruz,2020-11-11,12,0,12
12746,Yolo,2020-11-11,5,0,5
12747,Santa Barbara,2020-11-11,12,0,12
12748,Mariposa,2020-11-11,1,0,1
12749,Glenn,2020-11-11,0,0,0
12750,Orange,2020-11-11,251,43,294
12751,Humboldt,2020-11-11,2,2,4
12752,Del Norte,2020-11-11,0,0,0
12753,El Dorado,2020-11-11,5,1,6
12754,Sonoma,2020-11-11,21,2,23
12755,San Bernardino,2020-11-11,302,50,352
12756,Monterey,2020-11-11,44,0,44
12757,San Joaquin,2020-11-11,69,4,73
12758,Nevada,2020-11-11,4,0,4
12759,Imperial,2020-11-11,53,0,53
12760,Contra Costa,2020-11-11,50,8,58
12761,Madera,2020-11-11,8,11,19
12762,Butte,2020-11-11,16,0,16
12763,Trinity,2020-11-11,0,0,0
12764,Tehama,2020-11-11,5,0,5
12765,San Joaquin,2020-11-12,62,2,64
12766,Los Angeles,2020-11-12,966,314,1280
12767,Santa Clara,2020-11-12,115,20,135
12768,San Diego,2020-11-12,302,35,337
12769,Lassen,2020-11-12,2,0,2
12770,Plumas,2020-11-12,0,0,0
12771,Ventura,2020-11-12,36,9,45
12772,Solano,2020-11-12,36,14,50
12773,Sonoma,2020-11-12,18,9,27
12774,Orange,2020-11-12,244,45,289
12775,Kern,2020-11-12,63,8,71
12776,San Luis Obispo,2020-11-12,7,0,7
12777,Siskiyou,2020-11-12,3,0,3
12778,Butte,2020-11-12,16,0,16
12779,Marin,2020-11-12,11,6,17
12780,Imperial,2020-11-12,60,0,60
12781,Glenn,2020-11-12,0,0,0
12782,Santa Cruz,2020-11-12,16,1,17
12783,El Dorado,2020-11-12,4,0,4
12784,Mariposa,2020-11-12,0,0,0
12785,Sutter,2020-11-12,0,0,0
12786,San Benito,2020-11-12,1,0,1
12787,Madera,2020-11-12,11,14,25
12788,Sacramento,2020-11-12,177,23,200
12789,Shasta,2020-11-12,28,1,29
12790,Mono,2020-11-12,0,0,0
12791,Lake,2020-11-12,2,0,2
12792,Kings,2020-11-12,20,0,20
12793,Amador,2020-11-12,4,0,4
12794,Fresno,2020-11-12,120,19,139
12795,Santa Barbara,2020-11-12,13,2,15
12796,San Mateo,2020-11-12,23,9,32
12797,Humboldt,2020-11-12,3,4,7
12798,Yuba,2020-11-12,7,0,7
12799,Inyo,2020-11-12,0,0,0
12800,Calaveras,2020-11-12,0,0,0
12801,Riverside,2020-11-12,286,57,343
12802,Monterey,2020-11-12,43,2,45
12803,Alameda,2020-11-12,70,39,109
12804,Modoc,2020-11-12,1,0,1
12805,Yolo,2020-11-12,9,0,9
12806,Napa,2020-11-12,9,0,9
12807,Del Norte,2020-11-12,0,0,0
12808,Colusa,2020-11-12,3,1,4
12809,Trinity,2020-11-12,0,0,0
12810,Nevada,2020-11-12,4,0,4
12811,Tulare,2020-11-12,40,7,47
12812,Placer,2020-11-12,46,10,56
12813,Stanislaus,2020-11-12,74,15,89
12814,Contra Costa,2020-11-12,50,7,57
12815,Tehama,2020-11-12,7,0,7
12816,Mendocino,2020-11-12,7,0,7
12817,Tuolumne,2020-11-12,7,0,7
12818,San Bernardino,2020-11-12,318,58,376
12819,San Francisco,2020-11-12,38,8,46
12820,Merced,2020-11-12,17,0,17
12821,Calaveras,2020-11-13,1,0,1
12822,Mono,2020-11-13,0,0,0
12823,Glenn,2020-11-13,0,0,0
12824,Lassen,2020-11-13,0,0,0
12825,Merced,2020-11-13,17,0,17
12826,Placer,2020-11-13,44,9,53
12827,Napa,2020-11-13,8,0,8
12828,Tulare,2020-11-13,44,7,51
12829,El Dorado,2020-11-13,4,0,4
12830,Del Norte,2020-11-13,0,0,0
12831,San Francisco,2020-11-13,36,7,43
12832,Ventura,2020-11-13,36,11,47
12833,Monterey,2020-11-13,44,2,46
12834,Marin,2020-11-13,10,5,15
12835,Mariposa,2020-11-13,0,0,0
12836,Trinity,2020-11-13,0,0,0
12837,Butte,2020-11-13,19,1,20
12838,Santa Barbara,2020-11-13,13,3,16
12839,Amador,2020-11-13,4,1,5
12840,San Bernardino,2020-11-13,334,54,388
12841,Yuba,2020-11-13,7,0,7
12842,Inyo,2020-11-13,1,0,1
12843,Humboldt,2020-11-13,3,4,7
12844,Kings,2020-11-13,26,0,26
12845,Tuolumne,2020-11-13,9,0,9
12846,Nevada,2020-11-13,4,0,4
12847,Fresno,2020-11-13,131,16,147
12848,San Benito,2020-11-13,2,0,2
12849,Contra Costa,2020-11-13,46,10,56
12850,Sacramento,2020-11-13,172,18,190
12851,San Joaquin,2020-11-13,68,6,74
12852,Orange,2020-11-13,235,37,272
12853,Kern,2020-11-13,63,3,66
12854,Los Angeles,2020-11-13,1014,282,1296
12855,San Mateo,2020-11-13,19,6,25
12856,Riverside,2020-11-13,314,50,364
12857,San Diego,2020-11-13,298,51,349
12858,Plumas,2020-11-13,0,0,0
12859,Solano,2020-11-13,41,12,53
12860,Sonoma,2020-11-13,20,5,25
12861,Colusa,2020-11-13,3,1,4
12862,Sutter,2020-11-13,0,0,0
12863,Shasta,2020-11-13,27,1,28
12864,Mendocino,2020-11-13,5,0,5
12865,Imperial,2020-11-13,63,0,63
12866,Modoc,2020-11-13,0,0,0
12867,Stanislaus,2020-11-13,84,16,100
12868,Tehama,2020-11-13,7,0,7
12869,Santa Clara,2020-11-13,131,12,143
12870,Alameda,2020-11-13,74,38,112
12871,San Luis Obispo,2020-11-13,7,2,9
12872,Lake,2020-11-13,2,1,3
12873,Santa Cruz,2020-11-13,17,1,18
12874,Yolo,2020-11-13,10,0,10
12875,Madera,2020-11-13,10,9,19
12876,Siskiyou,2020-11-13,4,0,4
12877,Lake,2020-11-14,2,1,3
12878,Lassen,2020-11-14,0,0,0
12879,San Joaquin,2020-11-14,72,9,81
12880,Mariposa,2020-11-14,0,0,0
12881,El Dorado,2020-11-14,4,0,4
12882,San Mateo,2020-11-14,23,6,29
12883,Santa Cruz,2020-11-14,19,0,19
12884,Yolo,2020-11-14,14,0,14
12885,Santa Barbara,2020-11-14,15,4,19
12886,Stanislaus,2020-11-14,93,13,106
12887,Modoc,2020-11-14,0,0,0
12888,Shasta,2020-11-14,22,22,44
12889,Monterey,2020-11-14,51,1,52
12890,Sacramento,2020-11-14,170,23,193
12891,Humboldt,2020-11-14,3,3,6
12892,Fresno,2020-11-14,146,21,167
12893,Kings,2020-11-14,28,0,28
12894,Nevada,2020-11-14,4,1,5
12895,Imperial,2020-11-14,62,0,62
12896,Solano,2020-11-14,38,8,46
12897,Placer,2020-11-14,50,12,62
12898,Tuolumne,2020-11-14,12,0,12
12899,Butte,2020-11-14,21,0,21
12900,Colusa,2020-11-14,4,2,6
12901,Del Norte,2020-11-14,0,0,0
12902,Madera,2020-11-14,10,6,16
12903,Kern,2020-11-14,70,3,73
12904,Napa,2020-11-14,8,0,8
12905,San Bernardino,2020-11-14,362,57,419
12906,Mono,2020-11-14,0,0,0
12907,Alameda,2020-11-14,69,36,105
12908,Los Angeles,2020-11-14,1049,346,1395
12909,Plumas,2020-11-14,0,0,0
12910,Merced,2020-11-14,13,0,13
12911,Mendocino,2020-11-14,4,0,4
12912,San Luis Obispo,2020-11-14,8,2,10
12913,Sonoma,2020-11-14,19,3,22
12914,Tulare,2020-11-14,54,6,60
12915,Amador,2020-11-14,2,1,3
12916,Inyo,2020-11-14,0,0,0
12917,Ventura,2020-11-14,38,6,44
12918,Siskiyou,2020-11-14,7,0,7
12919,Orange,2020-11-14,242,44,286
12920,Riverside,2020-11-14,310,58,368
12921,Contra Costa,2020-11-14,45,12,57
12922,San Benito,2020-11-14,1,0,1
12923,Santa Clara,2020-11-14,135,12,147
12924,Marin,2020-11-14,9,4,13
12925,Trinity,2020-11-14,0,0,0
12926,Yuba,2020-11-14,9,1,10
12927,Sutter,2020-11-14,0,0,0
12928,Glenn,2020-11-14,0,0,0
12929,San Diego,2020-11-14,317,46,363
12930,San Francisco,2020-11-14,38,2,40
12931,Tehama,2020-11-14,9,0,9
12932,Calaveras,2020-11-14,2,0,2
12933,Napa,2020-11-15,7,0,7
12934,Humboldt,2020-11-15,3,1,4
12935,Placer,2020-11-15,53,13,66
12936,San Joaquin,2020-11-15,76,7,83
12937,Tehama,2020-11-15,8,0,8
12938,Nevada,2020-11-15,4,1,5
12939,Sutter,2020-11-15,0,0,0
12940,San Luis Obispo,2020-11-15,10,0,10
12941,Plumas,2020-11-15,0,0,0
12942,San Diego,2020-11-15,317,53,370
12943,Tulare,2020-11-15,54,5,59
12944,Del Norte,2020-11-15,0,0,0
12945,Lake,2020-11-15,2,0,2
12946,Tuolumne,2020-11-15,6,0,6
12947,Ventura,2020-11-15,40,5,45
12948,Sonoma,2020-11-15,18,2,20
12949,Santa Cruz,2020-11-15,14,0,14
12950,Stanislaus,2020-11-15,94,14,108
12951,San Benito,2020-11-15,2,0,2
12952,San Mateo,2020-11-15,18,6,24
12953,Siskiyou,2020-11-15,7,0,7
12954,Solano,2020-11-15,41,8,49
12955,Yolo,2020-11-15,15,0,15
12956,Orange,2020-11-15,257,45,302
12957,San Bernardino,2020-11-15,378,64,442
12958,El Dorado,2020-11-15,3,0,3
12959,Glenn,2020-11-15,0,0,0
12960,Inyo,2020-11-15,0,0,0
12961,Santa Clara,2020-11-15,150,8,158
12962,Colusa,2020-11-15,3,2,5
12963,Alameda,2020-11-15,71,39,110
12964,Shasta,2020-11-15,26,0,26
12965,Trinity,2020-11-15,0,0,0
12966,Marin,2020-11-15,9,4,13
12967,Los Angeles,2020-11-15,1126,277,1403
12968,San Francisco,2020-11-15,39,3,42
12969,Calaveras,2020-11-15,2,0,2
12970,Monterey,2020-11-15,51,1,52
12971,Sacramento,2020-11-15,172,20,192
12972,Modoc,2020-11-15,0,1,1
12973,Madera,2020-11-15,11,13,24
12974,Mariposa,2020-11-15,1,0,1
12975,Riverside,2020-11-15,320,68,388
12976,Contra Costa,2020-11-15,48,19,67
12977,Yuba,2020-11-15,11,0,11
12978,Butte,2020-11-15,21,0,21
12979,Lassen,2020-11-15,2,0,2
12980,Fresno,2020-11-15,155,12,167
12981,Kings,2020-11-15,28,1,29
12982,Imperial,2020-11-15,62,0,62
12983,Mendocino,2020-11-15,5,1,6
12984,Kern,2020-11-15,80,9,89
12985,Mono,2020-11-15,0,0,0
12986,Merced,2020-11-15,13,0,13
12987,Amador,2020-11-15,2,0,2
12988,Santa Barbara,2020-11-15,17,5,22
12989,Butte,2020-11-16,23,0,23
12990,Yolo,2020-11-16,14,0,14
12991,Lake,2020-11-16,1,0,1
12992,Stanislaus,2020-11-16,102,20,122
12993,Mono,2020-11-16,0,0,0
12994,Yuba,2020-11-16,15,0,15
12995,Santa Barbara,2020-11-16,19,5,24
12996,San Joaquin,2020-11-16,78,8,86
12997,Orange,2020-11-16,270,73,343
12998,Calaveras,2020-11-16,2,0,2
12999,El Dorado,2020-11-16,5,0,5
13000,San Luis Obispo,2020-11-16,7,0,7
13001,Fresno,2020-11-16,151,21,172
13002,Lassen,2020-11-16,1,0,1
13003,Monterey,2020-11-16,43,1,44
13004,San Benito,2020-11-16,2,0,2
13005,Trinity,2020-11-16,0,0,0
13006,Madera,2020-11-16,11,5,16
13007,Siskiyou,2020-11-16,6,0,6
13008,Riverside,2020-11-16,338,59,397
13009,Santa Clara,2020-11-16,153,9,162
13010,Solano,2020-11-16,41,8,49
13011,Alameda,2020-11-16,89,28,117
13012,Mendocino,2020-11-16,6,1,7
13013,San Diego,2020-11-16,345,57,402
13014,San Bernardino,2020-11-16,411,69,480
13015,Humboldt,2020-11-16,2,5,7
13016,Merced,2020-11-16,20,0,20
13017,Placer,2020-11-16,68,18,86
13018,Tuolumne,2020-11-16,6,0,6
13019,Ventura,2020-11-16,49,5,54
13020,Del Norte,2020-11-16,0,0,0
13021,Amador,2020-11-16,3,0,3
13022,San Mateo,2020-11-16,22,5,27
13023,Los Angeles,2020-11-16,1188,286,1474
13024,Inyo,2020-11-16,0,0,0
13025,Contra Costa,2020-11-16,63,21,84
13026,Kern,2020-11-16,86,11,97
13027,Tulare,2020-11-16,60,6,66
13028,Glenn,2020-11-16,0,0,0
13029,San Francisco,2020-11-16,38,6,44
13030,Kings,2020-11-16,33,1,34
13031,Modoc,2020-11-16,0,0,0
13032,Marin,2020-11-16,12,2,14
13033,Shasta,2020-11-16,26,0,26
13034,Nevada,2020-11-16,4,0,4
13035,Colusa,2020-11-16,4,1,5
13036,Napa,2020-11-16,7,0,7
13037,Plumas,2020-11-16,0,0,0
13038,Santa Cruz,2020-11-16,14,0,14
13039,Mariposa,2020-11-16,1,0,1
13040,Sutter,2020-11-16,0,0,0
13041,Tehama,2020-11-16,7,0,7
13042,Imperial,2020-11-16,64,2,66
13043,Sonoma,2020-11-16,17,5,22
13044,Sacramento,2020-11-16,191,29,220
13045,Yuba,2020-11-17,20,0,20
13046,Sacramento,2020-11-17,208,20,228
13047,Orange,2020-11-17,291,71,362
13048,Lassen,2020-11-17,0,0,0
13049,Tehama,2020-11-17,7,0,7
13050,Nevada,2020-11-17,7,1,8
13051,Calaveras,2020-11-17,1,0,1
13052,San Bernardino,2020-11-17,417,67,484
13053,Solano,2020-11-17,48,11,59
13054,Ventura,2020-11-17,50,8,58
13055,Marin,2020-11-17,13,2,15
13056,Humboldt,2020-11-17,3,3,6
13057,Merced,2020-11-17,19,0,19
13058,Fresno,2020-11-17,162,22,184
13059,Placer,2020-11-17,74,21,95
13060,Butte,2020-11-17,23,0,23
13061,Modoc,2020-11-17,0,1,1
13062,San Benito,2020-11-17,2,0,2
13063,Amador,2020-11-17,2,0,2
13064,Shasta,2020-11-17,26,0,26
13065,El Dorado,2020-11-17,5,2,7
13066,Lake,2020-11-17,1,0,1
13067,San Joaquin,2020-11-17,78,4,82
13068,Riverside,2020-11-17,350,59,409
13069,Stanislaus,2020-11-17,101,23,124
13070,Siskiyou,2020-11-17,5,0,5
13071,Santa Barbara,2020-11-17,20,0,20
13072,Colusa,2020-11-17,4,0,4
13073,Del Norte,2020-11-17,0,0,0
13074,Alameda,2020-11-17,95,24,119
13075,Sutter,2020-11-17,0,0,0
13076,Imperial,2020-11-17,62,1,63
13077,Sonoma,2020-11-17,21,2,23
13078,San Francisco,2020-11-17,37,11,48
13079,Trinity,2020-11-17,0,0,0
13080,Tulare,2020-11-17,55,3,58
13081,Kern,2020-11-17,87,9,96
13082,Santa Clara,2020-11-17,163,16,179
13083,San Diego,2020-11-17,367,51,418
13084,Los Angeles,2020-11-17,1238,304,1542
13085,Tuolumne,2020-11-17,7,0,7
13086,San Mateo,2020-11-17,26,9,35
13087,Mono,2020-11-17,1,0,1
13088,Monterey,2020-11-17,48,0,48
13089,Yolo,2020-11-17,14,0,14
13090,Madera,2020-11-17,10,13,23
13091,Mendocino,2020-11-17,3,0,3
13092,San Luis Obispo,2020-11-17,10,2,12
13093,Inyo,2020-11-17,0,0,0
13094,Mariposa,2020-11-17,0,0,0
13095,Napa,2020-11-17,5,0,5
13096,Kings,2020-11-17,39,0,39
13097,Glenn,2020-11-17,0,0,0
13098,Contra Costa,2020-11-17,67,8,75
13099,Santa Cruz,2020-11-17,17,1,18
13100,Plumas,2020-11-17,0,0,0
13101,San Diego,2020-11-18,369,65,434
13102,Santa Clara,2020-11-18,167,17,184
13103,Del Norte,2020-11-18,0,0,0
13104,Tehama,2020-11-18,10,0,10
13105,Glenn,2020-11-18,0,0,0
13106,Riverside,2020-11-18,362,65,427
13107,Alameda,2020-11-18,103,30,133
13108,Monterey,2020-11-18,48,0,48
13109,San Bernardino,2020-11-18,439,57,496
13110,Santa Cruz,2020-11-18,20,1,21
13111,San Luis Obispo,2020-11-18,12,0,12
13112,Trinity,2020-11-18,0,0,0
13113,Napa,2020-11-18,5,0,5
13114,Nevada,2020-11-18,8,0,8
13115,Imperial,2020-11-18,67,3,70
13116,San Joaquin,2020-11-18,83,5,88
13117,Sonoma,2020-11-18,23,4,27
13118,Lassen,2020-11-18,1,0,1
13119,Plumas,2020-11-18,0,1,1
13120,Ventura,2020-11-18,50,7,57
13121,Colusa,2020-11-18,4,0,4
13122,El Dorado,2020-11-18,8,1,9
13123,Placer,2020-11-18,81,27,108
13124,Stanislaus,2020-11-18,111,15,126
13125,Modoc,2020-11-18,0,0,0
13126,Tulare,2020-11-18,57,6,63
13127,Marin,2020-11-18,7,2,9
13128,Tuolumne,2020-11-18,8,0,8
13129,San Mateo,2020-11-18,27,6,33
13130,Sacramento,2020-11-18,227,22,249
13131,Mariposa,2020-11-18,0,0,0
13132,Los Angeles,2020-11-18,1298,330,1628
13133,Calaveras,2020-11-18,1,0,1
13134,Merced,2020-11-18,22,0,22
13135,Mono,2020-11-18,1,0,1
13136,Madera,2020-11-18,12,9,21
13137,San Benito,2020-11-18,2,0,2
13138,Contra Costa,2020-11-18,67,16,83
13139,Fresno,2020-11-18,170,19,189
13140,Sutter,2020-11-18,0,0,0
13141,San Francisco,2020-11-18,39,8,47
13142,Lake,2020-11-18,2,0,2
13143,Butte,2020-11-18,22,0,22
13144,Humboldt,2020-11-18,3,3,6
13145,Yolo,2020-11-18,12,0,12
13146,Solano,2020-11-18,53,12,65
13147,Orange,2020-11-18,304,55,359
13148,Mendocino,2020-11-18,5,0,5
13149,Santa Barbara,2020-11-18,20,2,22
13150,Kern,2020-11-18,95,7,102
13151,Yuba,2020-11-18,22,0,22
13152,Shasta,2020-11-18,29,0,29
13153,Kings,2020-11-18,40,0,40
13154,Inyo,2020-11-18,0,0,0
13155,Amador,2020-11-18,1,1,2
13156,Siskiyou,2020-11-18,6,0,6
13157,San Bernardino,2020-11-19,458,54,512
13158,San Luis Obispo,2020-11-19,9,1,10
13159,Lake,2020-11-19,2,0,2
13160,Monterey,2020-11-19,48,0,48
13161,Siskiyou,2020-11-19,4,0,4
13162,Ventura,2020-11-19,54,1,55
13163,Santa Cruz,2020-11-19,22,1,23
13164,Santa Barbara,2020-11-19,17,3,20
13165,Del Norte,2020-11-19,0,0,0
13166,Tulare,2020-11-19,51,8,59
13167,Placer,2020-11-19,86,23,109
13168,Kings,2020-11-19,45,0,45
13169,Santa Clara,2020-11-19,178,18,196
13170,Nevada,2020-11-19,12,1,13
13171,Amador,2020-11-19,2,0,2
13172,San Benito,2020-11-19,1,0,1
13173,San Mateo,2020-11-19,25,7,32
13174,Mariposa,2020-11-19,0,0,0
13175,Trinity,2020-11-19,0,0,0
13176,Kern,2020-11-19,101,8,109
13177,Orange,2020-11-19,333,41,374
13178,Contra Costa,2020-11-19,68,12,80
13179,Sonoma,2020-11-19,26,5,31
13180,Shasta,2020-11-19,38,1,39
13181,Butte,2020-11-19,24,1,25
13182,San Diego,2020-11-19,393,54,447
13183,Los Angeles,2020-11-19,1391,304,1695
13184,Colusa,2020-11-19,4,0,4
13185,Lassen,2020-11-19,1,0,1
13186,Napa,2020-11-19,7,0,7
13187,Modoc,2020-11-19,0,0,0
13188,Merced,2020-11-19,30,1,31
13189,Mendocino,2020-11-19,5,0,5
13190,Humboldt,2020-11-19,3,3,6
13191,Stanislaus,2020-11-19,112,7,119
13192,Yuba,2020-11-19,22,0,22
13193,Tehama,2020-11-19,11,0,11
13194,El Dorado,2020-11-19,8,0,8
13195,Solano,2020-11-19,54,10,64
13196,Yolo,2020-11-19,13,0,13
13197,Plumas,2020-11-19,0,0,0
13198,San Francisco,2020-11-19,42,4,46
13199,Tuolumne,2020-11-19,8,0,8
13200,Riverside,2020-11-19,375,65,440
13201,Glenn,2020-11-19,0,0,0
13202,Madera,2020-11-19,12,9,21
13203,San Joaquin,2020-11-19,84,6,90
13204,Alameda,2020-11-19,104,30,134
13205,Sacramento,2020-11-19,231,28,259
13206,Mono,2020-11-19,0,0,0
13207,Marin,2020-11-19,7,2,9
13208,Imperial,2020-11-19,61,5,66
13209,Inyo,2020-11-19,1,0,1
13210,Calaveras,2020-11-19,1,0,1
13211,Fresno,2020-11-19,171,29,200
13212,Sutter,2020-11-19,0,0,0
13213,Inyo,2020-11-20,1,0,1
13214,Placer,2020-11-20,88,21,109
13215,Kern,2020-11-20,109,2,111
13216,Tulare,2020-11-20,58,8,66
13217,San Diego,2020-11-20,411,51,462
13218,Kings,2020-11-20,47,0,47
13219,Madera,2020-11-20,14,11,25
13220,Yolo,2020-11-20,14,0,14
13221,Trinity,2020-11-20,0,0,0
13222,Mono,2020-11-20,0,0,0
13223,San Joaquin,2020-11-20,97,8,105
13224,Santa Cruz,2020-11-20,24,2,26
13225,Sonoma,2020-11-20,24,7,31
13226,Mariposa,2020-11-20,0,0,0
13227,Sacramento,2020-11-20,239,27,266
13228,Colusa,2020-11-20,5,2,7
13229,Glenn,2020-11-20,0,0,0
13230,Imperial,2020-11-20,59,5,64
13231,Modoc,2020-11-20,0,0,0
13232,Yuba,2020-11-20,24,0,24
13233,Santa Barbara,2020-11-20,21,3,24
13234,Los Angeles,2020-11-20,1401,317,1718
13235,Lassen,2020-11-20,1,0,1
13236,Marin,2020-11-20,6,2,8
13237,Lake,2020-11-20,2,0,2
13238,Riverside,2020-11-20,385,55,440
13239,Fresno,2020-11-20,190,27,217
13240,Contra Costa,2020-11-20,71,11,82
13241,Ventura,2020-11-20,65,7,72
13242,San Benito,2020-11-20,1,0,1
13243,Humboldt,2020-11-20,3,1,4
13244,San Luis Obispo,2020-11-20,10,2,12
13245,Solano,2020-11-20,57,8,65
13246,Merced,2020-11-20,29,0,29
13247,Calaveras,2020-11-20,0,0,0
13248,Santa Clara,2020-11-20,184,13,197
13249,Plumas,2020-11-20,0,0,0
13250,Mendocino,2020-11-20,5,0,5
13251,El Dorado,2020-11-20,8,0,8
13252,Stanislaus,2020-11-20,127,16,143
13253,Alameda,2020-11-20,97,31,128
13254,Siskiyou,2020-11-20,5,0,5
13255,Del Norte,2020-11-20,0,0,0
13256,Napa,2020-11-20,6,0,6
13257,San Francisco,2020-11-20,49,4,53
13258,Tuolumne,2020-11-20,8,0,8
13259,Sutter,2020-11-20,0,0,0
13260,Orange,2020-11-20,365,47,412
13261,Nevada,2020-11-20,9,0,9
13262,San Bernardino,2020-11-20,509,52,561
13263,Amador,2020-11-20,3,0,3
13264,Butte,2020-11-20,29,1,30
13265,Tehama,2020-11-20,11,0,11
13266,Monterey,2020-11-20,52,0,52
13267,San Mateo,2020-11-20,26,12,38
13268,Shasta,2020-11-20,40,3,43
13269,Orange,2020-11-21,380,39,419
13270,Alameda,2020-11-21,108,24,132
13271,San Bernardino,2020-11-21,495,64,559
13272,Los Angeles,2020-11-21,1482,346,1828
13273,San Diego,2020-11-21,439,46,485
13274,Tehama,2020-11-21,12,0,12
13275,Imperial,2020-11-21,57,0,57
13276,Monterey,2020-11-21,54,0,54
13277,Nevada,2020-11-21,9,0,9
13278,Modoc,2020-11-21,0,0,0
13279,Mariposa,2020-11-21,0,0,0
13280,Merced,2020-11-21,28,1,29
13281,Mono,2020-11-21,1,0,1
13282,Santa Barbara,2020-11-21,21,3,24
13283,Yuba,2020-11-21,21,0,21
13284,Riverside,2020-11-21,409,54,463
13285,Kings,2020-11-21,45,1,46
13286,Solano,2020-11-21,60,7,67
13287,Santa Clara,2020-11-21,190,19,209
13288,Yolo,2020-11-21,14,2,16
13289,Glenn,2020-11-21,0,0,0
13290,Del Norte,2020-11-21,0,0,0
13291,Siskiyou,2020-11-21,4,0,4
13292,Contra Costa,2020-11-21,70,11,81
13293,Placer,2020-11-21,97,24,121
13294,Santa Cruz,2020-11-21,25,0,25
13295,Lassen,2020-11-21,2,0,2
13296,Amador,2020-11-21,2,0,2
13297,Trinity,2020-11-21,0,0,0
13298,Napa,2020-11-21,6,0,6
13299,Marin,2020-11-21,6,2,8
13300,San Benito,2020-11-21,1,0,1
13301,Mendocino,2020-11-21,3,0,3
13302,San Francisco,2020-11-21,52,5,57
13303,Kern,2020-11-21,117,3,120
13304,San Luis Obispo,2020-11-21,11,1,12
13305,Sutter,2020-11-21,0,0,0
13306,Fresno,2020-11-21,203,21,224
13307,Inyo,2020-11-21,1,0,1
13308,San Joaquin,2020-11-21,107,8,115
13309,Sacramento,2020-11-21,255,22,277
13310,Madera,2020-11-21,18,6,24
13311,Lake,2020-11-21,1,0,1
13312,Colusa,2020-11-21,5,3,8
13313,El Dorado,2020-11-21,10,0,10
13314,Humboldt,2020-11-21,4,1,5
13315,Tuolumne,2020-11-21,9,0,9
13316,Tulare,2020-11-21,58,9,67
13317,Ventura,2020-11-21,62,6,68
13318,Stanislaus,2020-11-21,129,6,135
13319,Butte,2020-11-21,23,0,23
13320,Plumas,2020-11-21,0,0,0
13321,Calaveras,2020-11-21,0,0,0
13322,Shasta,2020-11-21,39,4,43
13323,Sonoma,2020-11-21,24,0,24
13324,San Mateo,2020-11-21,30,10,40
13325,Trinity,2020-11-22,0,0,0
13326,Yolo,2020-11-22,15,0,15
13327,Ventura,2020-11-22,63,10,73
13328,San Luis Obispo,2020-11-22,16,1,17
13329,San Mateo,2020-11-22,32,10,42
13330,Butte,2020-11-22,25,0,25
13331,Merced,2020-11-22,19,0,19
13332,Glenn,2020-11-22,0,0,0
13333,Sacramento,2020-11-22,255,22,277
13334,Santa Barbara,2020-11-22,23,2,25
13335,Madera,2020-11-22,20,10,30
13336,Colusa,2020-11-22,5,3,8
13337,Fresno,2020-11-22,232,15,247
13338,San Francisco,2020-11-22,47,2,49
13339,Sutter,2020-11-22,0,0,0
13340,Placer,2020-11-22,93,24,117
13341,Santa Cruz,2020-11-22,24,0,24
13342,Lake,2020-11-22,1,0,1
13343,San Benito,2020-11-22,2,0,2
13344,Shasta,2020-11-22,51,0,51
13345,San Bernardino,2020-11-22,527,53,580
13346,Orange,2020-11-22,428,58,486
13347,Sonoma,2020-11-22,25,6,31
13348,Plumas,2020-11-22,0,0,0
13349,Nevada,2020-11-22,10,0,10
13350,Inyo,2020-11-22,1,0,1
13351,Monterey,2020-11-22,58,1,59
13352,Napa,2020-11-22,5,0,5
13353,Humboldt,2020-11-22,4,2,6
13354,Siskiyou,2020-11-22,8,0,8
13355,San Joaquin,2020-11-22,110,6,116
13356,Amador,2020-11-22,2,0,2
13357,Contra Costa,2020-11-22,79,11,90
13358,Alameda,2020-11-22,115,35,150
13359,Riverside,2020-11-22,409,65,474
13360,Los Angeles,2020-11-22,1575,344,1919
13361,Imperial,2020-11-22,51,0,51
13362,Kern,2020-11-22,120,6,126
13363,Mendocino,2020-11-22,2,0,2
13364,Santa Clara,2020-11-22,197,21,218
13365,Solano,2020-11-22,58,11,69
13366,Tulare,2020-11-22,50,7,57
13367,San Diego,2020-11-22,446,47,493
13368,Tehama,2020-11-22,11,0,11
13369,Calaveras,2020-11-22,2,0,2
13370,Stanislaus,2020-11-22,138,20,158
13371,Lassen,2020-11-22,1,0,1
13372,Mariposa,2020-11-22,0,0,0
13373,Kings,2020-11-22,47,0,47
13374,Mono,2020-11-22,1,0,1
13375,Yuba,2020-11-22,26,0,26
13376,Marin,2020-11-22,8,3,11
13377,Del Norte,2020-11-22,0,0,0
13378,Tuolumne,2020-11-22,12,0,12
13379,Modoc,2020-11-22,0,0,0
13380,El Dorado,2020-11-22,10,0,10
13381,San Diego,2020-11-23,470,56,526
13382,Orange,2020-11-23,463,80,543
13383,Siskiyou,2020-11-23,8,0,8
13384,Nevada,2020-11-23,8,2,10
13385,San Bernardino,2020-11-23,583,75,658
13386,Tuolumne,2020-11-23,14,0,14
13387,Lassen,2020-11-23,4,0,4
13388,Stanislaus,2020-11-23,156,9,165
13389,Imperial,2020-11-23,51,1,52
13390,Sacramento,2020-11-23,253,31,284
13391,Monterey,2020-11-23,64,2,66
13392,Merced,2020-11-23,21,0,21
13393,Mendocino,2020-11-23,12,0,12
13394,San Benito,2020-11-23,3,0,3
13395,Alameda,2020-11-23,123,26,149
13396,Kings,2020-11-23,43,2,45
13397,Del Norte,2020-11-23,1,0,1
13398,Yuba,2020-11-23,31,0,31
13399,Glenn,2020-11-23,0,0,0
13400,Humboldt,2020-11-23,4,5,9
13401,Ventura,2020-11-23,64,6,70
13402,Mono,2020-11-23,1,0,1
13403,San Joaquin,2020-11-23,114,8,122
13404,Riverside,2020-11-23,420,78,498
13405,Tehama,2020-11-23,8,0,8
13406,Plumas,2020-11-23,0,0,0
13407,Santa Cruz,2020-11-23,27,0,27
13408,Modoc,2020-11-23,0,0,0
13409,Inyo,2020-11-23,1,0,1
13410,Fresno,2020-11-23,255,13,268
13411,Santa Barbara,2020-11-23,24,3,27
13412,Los Angeles,2020-11-23,1682,296,1978
13413,Shasta,2020-11-23,48,0,48
13414,Napa,2020-11-23,6,0,6
13415,San Mateo,2020-11-23,40,4,44
13416,San Luis Obispo,2020-11-23,13,3,16
13417,Sutter,2020-11-23,0,0,0
13418,Lake,2020-11-23,1,0,1
13419,Butte,2020-11-23,32,0,32
13420,Sonoma,2020-11-23,29,0,29
13421,Tulare,2020-11-23,56,12,68
13422,Contra Costa,2020-11-23,94,14,108
13423,Yolo,2020-11-23,20,0,20
13424,Calaveras,2020-11-23,2,0,2
13425,Solano,2020-11-23,61,7,68
13426,Kern,2020-11-23,132,1,133
13427,San Francisco,2020-11-23,52,1,53
13428,Santa Clara,2020-11-23,201,24,225
13429,Amador,2020-11-23,3,0,3
13430,Mariposa,2020-11-23,0,0,0
13431,Marin,2020-11-23,8,4,12
13432,El Dorado,2020-11-23,11,0,11
13433,Trinity,2020-11-23,0,0,0
13434,Placer,2020-11-23,101,18,119
13435,Colusa,2020-11-23,5,2,7
13436,Madera,2020-11-23,21,14,35
13437,Fresno,2020-11-24,259,29,288
13438,Santa Cruz,2020-11-24,33,0,33
13439,Mariposa,2020-11-24,0,0,0
13440,Santa Clara,2020-11-24,217,20,237
13441,El Dorado,2020-11-24,11,1,12
13442,San Benito,2020-11-24,3,0,3
13443,Kings,2020-11-24,42,1,43
13444,Mendocino,2020-11-24,12,0,12
13445,Del Norte,2020-11-24,0,0,0
13446,Siskiyou,2020-11-24,10,0,10
13447,Imperial,2020-11-24,59,1,60
13448,San Luis Obispo,2020-11-24,10,3,13
13449,Marin,2020-11-24,7,3,10
13450,Stanislaus,2020-11-24,162,7,169
13451,Modoc,2020-11-24,1,0,1
13452,Solano,2020-11-24,63,11,74
13453,Riverside,2020-11-24,455,72,527
13454,Sutter,2020-11-24,0,0,0
13455,Kern,2020-11-24,126,3,129
13456,Alameda,2020-11-24,138,38,176
13457,Sonoma,2020-11-24,30,6,36
13458,Tuolumne,2020-11-24,9,1,10
13459,Santa Barbara,2020-11-24,26,4,30
13460,Sacramento,2020-11-24,265,30,295
13461,Lassen,2020-11-24,3,0,3
13462,Tehama,2020-11-24,10,0,10
13463,Inyo,2020-11-24,2,0,2
13464,Napa,2020-11-24,8,1,9
13465,Yolo,2020-11-24,16,0,16
13466,Shasta,2020-11-24,51,0,51
13467,Tulare,2020-11-24,72,15,87
13468,Placer,2020-11-24,110,15,125
13469,Humboldt,2020-11-24,3,5,8
13470,San Mateo,2020-11-24,45,6,51
13471,Lake,2020-11-24,2,0,2
13472,Colusa,2020-11-24,3,0,3
13473,Orange,2020-11-24,479,47,526
13474,Merced,2020-11-24,21,0,21
13475,San Francisco,2020-11-24,62,1,63
13476,San Bernardino,2020-11-24,606,67,673
13477,Monterey,2020-11-24,64,2,66
13478,Plumas,2020-11-24,0,0,0
13479,San Joaquin,2020-11-24,109,13,122
13480,San Diego,2020-11-24,510,44,554
13481,Contra Costa,2020-11-24,86,6,92
13482,Ventura,2020-11-24,77,8,85
13483,Butte,2020-11-24,33,0,33
13484,Glenn,2020-11-24,0,0,0
13485,Amador,2020-11-24,4,0,4
13486,Trinity,2020-11-24,0,0,0
13487,Mono,2020-11-24,0,0,0
13488,Los Angeles,2020-11-24,1809,388,2197
13489,Calaveras,2020-11-24,1,0,1
13490,Nevada,2020-11-24,12,1,13
13491,Yuba,2020-11-24,30,0,30
13492,Madera,2020-11-24,22,12,34
13493,Alameda,2020-11-25,143,50,193
13494,Stanislaus,2020-11-25,171,15,186
13495,Riverside,2020-11-25,490,65,555
13496,Butte,2020-11-25,28,0,28
13497,Modoc,2020-11-25,0,0,0
13498,Trinity,2020-11-25,0,0,0
13499,Los Angeles,2020-11-25,1893,301,2194
13500,San Bernardino,2020-11-25,628,66,694
13501,Shasta,2020-11-25,54,0,54
13502,Sonoma,2020-11-25,28,3,31
13503,San Benito,2020-11-25,3,0,3
13504,Lassen,2020-11-25,4,0,4
13505,Mendocino,2020-11-25,10,0,10
13506,Merced,2020-11-25,17,0,17
13507,Solano,2020-11-25,65,13,78
13508,Kings,2020-11-25,44,1,45
13509,Kern,2020-11-25,136,3,139
13510,Sutter,2020-11-25,0,0,0
13511,Tehama,2020-11-25,9,0,9
13512,Contra Costa,2020-11-25,92,8,100
13513,Sacramento,2020-11-25,279,20,299
13514,Tulare,2020-11-25,73,9,82
13515,Orange,2020-11-25,499,38,537
13516,Santa Clara,2020-11-25,229,24,253
13517,Imperial,2020-11-25,59,1,60
13518,El Dorado,2020-11-25,9,2,11
13519,Del Norte,2020-11-25,0,0,0
13520,Lake,2020-11-25,2,0,2
13521,Placer,2020-11-25,106,18,124
13522,Calaveras,2020-11-25,1,0,1
13523,Glenn,2020-11-25,0,0,0
13524,Mariposa,2020-11-25,1,0,1
13525,Marin,2020-11-25,7,5,12
13526,Santa Cruz,2020-11-25,32,0,32
13527,Tuolumne,2020-11-25,11,0,11
13528,Nevada,2020-11-25,13,1,14
13529,Inyo,2020-11-25,1,0,1
13530,Santa Barbara,2020-11-25,32,1,33
13531,Plumas,2020-11-25,1,0,1
13532,Monterey,2020-11-25,67,3,70
13533,Ventura,2020-11-25,84,3,87
13534,Yuba,2020-11-25,30,0,30
13535,Mono,2020-11-25,0,0,0
13536,Yolo,2020-11-25,14,0,14
13537,Colusa,2020-11-25,4,0,4
13538,Siskiyou,2020-11-25,12,0,12
13539,San Mateo,2020-11-25,46,6,52
13540,Amador,2020-11-25,3,0,3
13541,San Joaquin,2020-11-25,110,10,120
13542,Napa,2020-11-25,10,0,10
13543,Humboldt,2020-11-25,1,3,4
13544,Madera,2020-11-25,22,13,35
13545,Fresno,2020-11-25,258,17,275
13546,San Francisco,2020-11-25,64,6,70
13547,San Diego,2020-11-25,545,42,587
13548,San Luis Obispo,2020-11-25,9,1,10
13549,Orange,2020-11-26,506,36,542
13550,San Diego,2020-11-26,563,41,604
13551,Yuba,2020-11-26,25,0,25
13552,San Luis Obispo,2020-11-26,9,1,10
13553,Kern,2020-11-26,143,4,147
13554,Ventura,2020-11-26,81,11,92
13555,Humboldt,2020-11-26,2,1,3
13556,Tulare,2020-11-26,79,6,85
13557,Fresno,2020-11-26,265,15,280
13558,Butte,2020-11-26,32,1,33
13559,San Mateo,2020-11-26,47,5,52
13560,El Dorado,2020-11-26,11,2,13
13561,Sonoma,2020-11-26,30,2,32
13562,Imperial,2020-11-26,62,0,62
13563,Modoc,2020-11-26,0,0,0
13564,San Benito,2020-11-26,3,0,3
13565,Shasta,2020-11-26,60,0,60
13566,Calaveras,2020-11-26,1,0,1
13567,Amador,2020-11-26,4,0,4
13568,San Bernardino,2020-11-26,656,48,704
13569,San Joaquin,2020-11-26,107,14,121
13570,Santa Barbara,2020-11-26,31,0,31
13571,Lassen,2020-11-26,3,0,3
13572,Santa Clara,2020-11-26,230,23,253
13573,Santa Cruz,2020-11-26,32,0,32
13574,Riverside,2020-11-26,498,77,575
13575,Sutter,2020-11-26,0,0,0
13576,Colusa,2020-11-26,4,0,4
13577,Lake,2020-11-26,3,0,3
13578,Mendocino,2020-11-26,12,1,13
13579,Trinity,2020-11-26,0,0,0
13580,Merced,2020-11-26,23,0,23
13581,Kings,2020-11-26,50,0,50
13582,Los Angeles,2020-11-26,1951,301,2252
13583,Inyo,2020-11-26,1,0,1
13584,Tuolumne,2020-11-26,11,0,11
13585,Glenn,2020-11-26,0,0,0
13586,Siskiyou,2020-11-26,13,0,13
13587,San Francisco,2020-11-26,70,4,74
13588,Contra Costa,2020-11-26,90,9,99
13589,Yolo,2020-11-26,13,0,13
13590,Plumas,2020-11-26,1,0,1
13591,Monterey,2020-11-26,71,2,73
13592,Sacramento,2020-11-26,263,22,285
13593,Tehama,2020-11-26,11,0,11
13594,Mariposa,2020-11-26,0,0,0
13595,Placer,2020-11-26,118,22,140
13596,Marin,2020-11-26,6,2,8
13597,Del Norte,2020-11-26,0,0,0
13598,Stanislaus,2020-11-26,186,14,200
13599,Madera,2020-11-26,23,6,29
13600,Nevada,2020-11-26,13,2,15
13601,Alameda,2020-11-26,157,54,211
13602,Solano,2020-11-26,67,15,82
13603,Mono,2020-11-26,0,0,0
13604,Napa,2020-11-26,10,0,10
13605,Madera,2020-11-27,25,10,35
13606,Stanislaus,2020-11-27,181,20,201
13607,Tehama,2020-11-27,12,0,12
13608,Ventura,2020-11-27,84,10,94
13609,San Bernardino,2020-11-27,661,64,725
13610,Mariposa,2020-11-27,0,0,0
13611,San Luis Obispo,2020-11-27,10,0,10
13612,Riverside,2020-11-27,533,47,580
13613,Monterey,2020-11-27,76,2,78
13614,Kings,2020-11-27,52,0,52
13615,Tuolumne,2020-11-27,12,0,12
13616,Amador,2020-11-27,3,0,3
13617,Mendocino,2020-11-27,14,6,20
13618,Nevada,2020-11-27,12,0,12
13619,Lake,2020-11-27,2,0,2
13620,Imperial,2020-11-27,70,0,70
13621,Shasta,2020-11-27,57,0,57
13622,Santa Clara,2020-11-27,246,22,268
13623,Los Angeles,2020-11-27,2049,299,2348
13624,Tulare,2020-11-27,81,3,84
13625,Marin,2020-11-27,7,3,10
13626,Trinity,2020-11-27,0,0,0
13627,Sutter,2020-11-27,0,0,0
13628,San Mateo,2020-11-27,46,6,52
13629,Humboldt,2020-11-27,3,2,5
13630,Yolo,2020-11-27,18,0,18
13631,Sonoma,2020-11-27,31,4,35
13632,Inyo,2020-11-27,1,0,1
13633,Orange,2020-11-27,534,35,569
13634,Glenn,2020-11-27,0,0,0
13635,Santa Cruz,2020-11-27,35,0,35
13636,Fresno,2020-11-27,274,20,294
13637,Siskiyou,2020-11-27,13,0,13
13638,Modoc,2020-11-27,0,0,0
13639,Merced,2020-11-27,22,0,22
13640,Plumas,2020-11-27,0,0,0
13641,Contra Costa,2020-11-27,86,12,98
13642,San Joaquin,2020-11-27,112,14,126
13643,El Dorado,2020-11-27,11,1,12
13644,Colusa,2020-11-27,8,0,8
13645,Napa,2020-11-27,11,0,11
13646,San Diego,2020-11-27,599,38,637
13647,Alameda,2020-11-27,163,41,204
13648,San Francisco,2020-11-27,72,4,76
13649,Butte,2020-11-27,37,2,39
13650,Kern,2020-11-27,165,3,168
13651,Yuba,2020-11-27,28,0,28
13652,Santa Barbara,2020-11-27,33,2,35
13653,Del Norte,2020-11-27,0,0,0
13654,San Benito,2020-11-27,4,0,4
13655,Lassen,2020-11-27,3,0,3
13656,Placer,2020-11-27,128,13,141
13657,Sacramento,2020-11-27,284,18,302
13658,Solano,2020-11-27,62,11,73
13659,Calaveras,2020-11-27,1,0,1
13660,Mono,2020-11-27,1,0,1
13661,Lassen,2020-11-28,5,0,5
13662,Contra Costa,2020-11-28,90,18,108
13663,Mono,2020-11-28,0,1,1
13664,Modoc,2020-11-28,0,0,0
13665,San Bernardino,2020-11-28,728,64,792
13666,Orange,2020-11-28,597,48,645
13667,Ventura,2020-11-28,88,8,96
13668,Madera,2020-11-28,25,7,32
13669,Merced,2020-11-28,19,0,19
13670,Tulare,2020-11-28,90,4,94
13671,Marin,2020-11-28,8,5,13
13672,Humboldt,2020-11-28,2,3,5
13673,Santa Cruz,2020-11-28,40,0,40
13674,Los Angeles,2020-11-28,2185,328,2513
13675,Stanislaus,2020-11-28,186,18,204
13676,Sonoma,2020-11-28,28,4,32
13677,Plumas,2020-11-28,0,0,0
13678,Calaveras,2020-11-28,1,0,1
13679,Trinity,2020-11-28,0,0,0
13680,Siskiyou,2020-11-28,14,0,14
13681,Lake,2020-11-28,2,0,2
13682,Kern,2020-11-28,166,1,167
13683,Placer,2020-11-28,124,15,139
13684,Inyo,2020-11-28,1,0,1
13685,Amador,2020-11-28,1,0,1
13686,San Francisco,2020-11-28,77,3,80
13687,Riverside,2020-11-28,573,63,636
13688,San Diego,2020-11-28,627,46,673
13689,Kings,2020-11-28,56,0,56
13690,Alameda,2020-11-28,168,38,206
13691,Tuolumne,2020-11-28,10,0,10
13692,Colusa,2020-11-28,9,0,9
13693,Sutter,2020-11-28,0,0,0
13694,Solano,2020-11-28,64,11,75
13695,Tehama,2020-11-28,13,0,13
13696,San Joaquin,2020-11-28,125,13,138
13697,Yuba,2020-11-28,32,0,32
13698,Nevada,2020-11-28,15,0,15
13699,El Dorado,2020-11-28,15,2,17
13700,Del Norte,2020-11-28,0,0,0
13701,Imperial,2020-11-28,72,0,72
13702,San Benito,2020-11-28,5,0,5
13703,Sacramento,2020-11-28,303,23,326
13704,Butte,2020-11-28,45,2,47
13705,Monterey,2020-11-28,72,1,73
13706,Mendocino,2020-11-28,12,0,12
13707,Shasta,2020-11-28,55,0,55
13708,Santa Clara,2020-11-28,263,18,281
13709,Glenn,2020-11-28,0,0,0
13710,Santa Barbara,2020-11-28,39,1,40
13711,San Luis Obispo,2020-11-28,6,0,6
13712,Napa,2020-11-28,11,0,11
13713,Fresno,2020-11-28,278,32,310
13714,San Mateo,2020-11-28,50,6,56
13715,Mariposa,2020-11-28,0,0,0
13716,Yolo,2020-11-28,20,0,20
13717,Santa Cruz,2020-11-29,47,0,47
13718,Mariposa,2020-11-29,0,0,0
13719,San Mateo,2020-11-29,58,9,67
13720,Kern,2020-11-29,161,5,166
13721,Inyo,2020-11-29,1,0,1
13722,Tehama,2020-11-29,11,0,11
13723,Sacramento,2020-11-29,316,29,345
13724,Lassen,2020-11-29,3,0,3
13725,Yuba,2020-11-29,38,0,38
13726,San Diego,2020-11-29,658,40,698
13727,Tulare,2020-11-29,96,3,99
13728,San Bernardino,2020-11-29,781,58,839
13729,Merced,2020-11-29,28,0,28
13730,Siskiyou,2020-11-29,10,0,10
13731,Modoc,2020-11-29,0,0,0
13732,Stanislaus,2020-11-29,189,11,200
13733,El Dorado,2020-11-29,16,0,16
13734,Los Angeles,2020-11-29,2316,335,2651
13735,San Luis Obispo,2020-11-29,5,0,5
13736,Monterey,2020-11-29,82,1,83
13737,Calaveras,2020-11-29,3,0,3
13738,Santa Clara,2020-11-29,289,14,303
13739,Sonoma,2020-11-29,34,1,35
13740,Solano,2020-11-29,59,14,73
13741,Marin,2020-11-29,10,3,13
13742,Fresno,2020-11-29,287,25,312
13743,Glenn,2020-11-29,0,0,0
13744,Imperial,2020-11-29,71,1,72
13745,Tuolumne,2020-11-29,10,0,10
13746,Trinity,2020-11-29,0,0,0
13747,Humboldt,2020-11-29,2,2,4
13748,Placer,2020-11-29,125,13,138
13749,Contra Costa,2020-11-29,106,17,123
13750,Mono,2020-11-29,0,1,1
13751,Madera,2020-11-29,24,7,31
13752,Santa Barbara,2020-11-29,42,3,45
13753,Riverside,2020-11-29,585,81,666
13754,San Joaquin,2020-11-29,134,11,145
13755,Colusa,2020-11-29,9,0,9
13756,Shasta,2020-11-29,56,0,56
13757,Mendocino,2020-11-29,11,0,11
13758,Plumas,2020-11-29,0,0,0
13759,Butte,2020-11-29,46,0,46
13760,San Benito,2020-11-29,6,0,6
13761,Alameda,2020-11-29,171,33,204
13762,Napa,2020-11-29,10,0,10
13763,Nevada,2020-11-29,19,1,20
13764,Amador,2020-11-29,1,0,1
13765,Ventura,2020-11-29,92,13,105
13766,Kings,2020-11-29,58,0,58
13767,Sutter,2020-11-29,0,0,0
13768,Del Norte,2020-11-29,0,0,0
13769,Yolo,2020-11-29,21,0,21
13770,San Francisco,2020-11-29,83,1,84
13771,Lake,2020-11-29,2,0,2
13772,Orange,2020-11-29,605,59,664
13773,Sutter,2020-11-30,0,0,0
13774,Yolo,2020-11-30,18,0,18
13775,Monterey,2020-11-30,81,0,81
13776,Madera,2020-11-30,21,13,34
13777,Orange,2020-11-30,648,57,705
13778,Humboldt,2020-11-30,5,2,7
13779,Stanislaus,2020-11-30,200,22,222
13780,Solano,2020-11-30,66,13,79
13781,San Joaquin,2020-11-30,138,8,146
13782,Merced,2020-11-30,31,0,31
13783,Sonoma,2020-11-30,35,9,44
13784,Mendocino,2020-11-30,12,0,12
13785,Santa Barbara,2020-11-30,50,2,52
13786,Mariposa,2020-11-30,1,0,1
13787,Kern,2020-11-30,184,2,186
13788,Sacramento,2020-11-30,344,25,369
13789,San Francisco,2020-11-30,91,0,91
13790,Tuolumne,2020-11-30,13,0,13
13791,Calaveras,2020-11-30,4,0,4
13792,Marin,2020-11-30,11,4,15
13793,Contra Costa,2020-11-30,102,25,127
13794,Imperial,2020-11-30,82,0,82
13795,Lake,2020-11-30,2,0,2
13796,Kings,2020-11-30,52,0,52
13797,San Luis Obispo,2020-11-30,7,2,9
13798,Del Norte,2020-11-30,0,0,0
13799,San Mateo,2020-11-30,65,9,74
13800,Napa,2020-11-30,10,0,10
13801,Tehama,2020-11-30,11,0,11
13802,San Diego,2020-11-30,696,35,731
13803,Riverside,2020-11-30,600,83,683
13804,Plumas,2020-11-30,0,0,0
13805,San Benito,2020-11-30,6,0,6
13806,Yuba,2020-11-30,40,0,40
13807,Los Angeles,2020-11-30,2439,304,2743
13808,Santa Cruz,2020-11-30,41,0,41
13809,Inyo,2020-11-30,1,0,1
13810,Nevada,2020-11-30,19,1,20
13811,Lassen,2020-11-30,5,0,5
13812,Mono,2020-11-30,0,0,0
13813,San Bernardino,2020-11-30,856,78,934
13814,Siskiyou,2020-11-30,12,0,12
13815,Tulare,2020-11-30,99,10,109
13816,Placer,2020-11-30,131,12,143
13817,Glenn,2020-11-30,0,0,0
13818,Amador,2020-11-30,2,1,3
13819,Butte,2020-11-30,45,0,45
13820,Trinity,2020-11-30,0,0,0
13821,Santa Clara,2020-11-30,291,17,308
13822,Alameda,2020-11-30,188,35,223
13823,El Dorado,2020-11-30,15,0,15
13824,Colusa,2020-11-30,9,1,10
13825,Fresno,2020-11-30,305,31,336
13826,Ventura,2020-11-30,94,8,102
13827,Shasta,2020-11-30,62,0,62
13828,Modoc,2020-11-30,0,0,0
13829,San Benito,2020-12-01,8,0,8
13830,Mono,2020-12-01,2,0,2
13831,Los Angeles,2020-12-01,2572,310,2882
13832,Siskiyou,2020-12-01,12,0,12
13833,Tehama,2020-12-01,11,0,11
13834,Kern,2020-12-01,189,1,190
13835,Sutter,2020-12-01,0,0,0
13836,Glenn,2020-12-01,0,0,0
13837,Placer,2020-12-01,130,20,150
13838,Stanislaus,2020-12-01,210,18,228
13839,Sacramento,2020-12-01,363,22,385
13840,Imperial,2020-12-01,73,0,73
13841,Lassen,2020-12-01,5,0,5
13842,Butte,2020-12-01,45,1,46
13843,Marin,2020-12-01,15,2,17
13844,Amador,2020-12-01,2,1,3
13845,Inyo,2020-12-01,1,0,1
13846,Sonoma,2020-12-01,38,5,43
13847,Modoc,2020-12-01,1,0,1
13848,Santa Cruz,2020-12-01,42,0,42
13849,El Dorado,2020-12-01,14,1,15
13850,Calaveras,2020-12-01,6,0,6
13851,Merced,2020-12-01,29,0,29
13852,Plumas,2020-12-01,0,0,0
13853,Humboldt,2020-12-01,5,5,10
13854,San Joaquin,2020-12-01,150,12,162
13855,San Bernardino,2020-12-01,883,82,965
13856,San Diego,2020-12-01,685,48,733
13857,Trinity,2020-12-01,0,0,0
13858,Contra Costa,2020-12-01,112,21,133
13859,Ventura,2020-12-01,98,14,112
13860,Santa Barbara,2020-12-01,47,1,48
13861,Del Norte,2020-12-01,0,0,0
13862,Lake,2020-12-01,2,0,2
13863,Tuolumne,2020-12-01,14,0,14
13864,Madera,2020-12-01,25,13,38
13865,Orange,2020-12-01,689,67,756
13866,Mendocino,2020-12-01,12,0,12
13867,Monterey,2020-12-01,85,1,86
13868,Napa,2020-12-01,11,0,11
13869,Solano,2020-12-01,69,12,81
13870,Kings,2020-12-01,56,0,56
13871,Shasta,2020-12-01,53,0,53
13872,San Luis Obispo,2020-12-01,9,1,10
13873,Colusa,2020-12-01,10,0,10
13874,Santa Clara,2020-12-01,293,19,312
13875,Yuba,2020-12-01,45,0,45
13876,Mariposa,2020-12-01,2,0,2
13877,San Mateo,2020-12-01,72,6,78
13878,San Francisco,2020-12-01,88,3,91
13879,Alameda,2020-12-01,187,47,234
13880,Tulare,2020-12-01,92,11,103
13881,Fresno,2020-12-01,291,27,318
13882,Riverside,2020-12-01,628,76,704
13883,Yolo,2020-12-01,20,0,20
13884,Nevada,2020-12-01,16,1,17
13885,Contra Costa,2020-12-02,116,15,131
13886,Monterey,2020-12-02,82,1,83
13887,Solano,2020-12-02,67,11,78
13888,Orange,2020-12-02,735,49,784
13889,Riverside,2020-12-02,649,72,721
13890,Los Angeles,2020-12-02,2668,336,3004
13891,Tuolumne,2020-12-02,11,0,11
13892,Mariposa,2020-12-02,1,0,1
13893,San Francisco,2020-12-02,93,5,98
13894,Inyo,2020-12-02,2,0,2
13895,Glenn,2020-12-02,0,0,0
13896,Lassen,2020-12-02,7,0,7
13897,Humboldt,2020-12-02,5,6,11
13898,Tehama,2020-12-02,11,0,11
13899,Lake,2020-12-02,0,0,0
13900,Amador,2020-12-02,4,0,4
13901,Fresno,2020-12-02,338,29,367
13902,Alameda,2020-12-02,195,43,238
13903,Sutter,2020-12-02,0,0,0
13904,Ventura,2020-12-02,98,13,111
13905,Yolo,2020-12-02,20,0,20
13906,El Dorado,2020-12-02,13,0,13
13907,Placer,2020-12-02,131,14,145
13908,San Diego,2020-12-02,705,56,761
13909,Imperial,2020-12-02,82,1,83
13910,Shasta,2020-12-02,53,0,53
13911,Kern,2020-12-02,179,5,184
13912,Butte,2020-12-02,44,1,45
13913,Trinity,2020-12-02,0,0,0
13914,Sacramento,2020-12-02,359,29,388
13915,Mendocino,2020-12-02,11,0,11
13916,Modoc,2020-12-02,1,0,1
13917,San Luis Obispo,2020-12-02,8,1,9
13918,Santa Cruz,2020-12-02,47,0,47
13919,Colusa,2020-12-02,11,0,11
13920,San Bernardino,2020-12-02,904,98,1002
13921,Santa Barbara,2020-12-02,57,3,60
13922,Yuba,2020-12-02,37,0,37
13923,Del Norte,2020-12-02,0,0,0
13924,Tulare,2020-12-02,100,10,110
13925,Calaveras,2020-12-02,5,0,5
13926,Marin,2020-12-02,16,4,20
13927,Nevada,2020-12-02,17,0,17
13928,Sonoma,2020-12-02,38,4,42
13929,Siskiyou,2020-12-02,15,0,15
13930,San Mateo,2020-12-02,70,6,76
13931,San Joaquin,2020-12-02,162,7,169
13932,Kings,2020-12-02,58,1,59
13933,San Benito,2020-12-02,9,0,9
13934,Madera,2020-12-02,28,10,38
13935,Santa Clara,2020-12-02,304,23,327
13936,Mono,2020-12-02,2,0,2
13937,Plumas,2020-12-02,0,0,0
13938,Napa,2020-12-02,12,0,12
13939,Merced,2020-12-02,32,0,32
13940,Stanislaus,2020-12-02,219,18,237
13941,Tehama,2020-12-03,11,0,11
13942,Calaveras,2020-12-03,5,0,5
13943,Sacramento,2020-12-03,373,23,396
13944,Amador,2020-12-03,5,0,5
13945,Mariposa,2020-12-03,1,0,1
13946,Yolo,2020-12-03,18,0,18
13947,Del Norte,2020-12-03,0,0,0
13948,Tuolumne,2020-12-03,11,0,11
13949,Alameda,2020-12-03,206,49,255
13950,Ventura,2020-12-03,104,15,119
13951,San Luis Obispo,2020-12-03,13,0,13
13952,Inyo,2020-12-03,2,0,2
13953,Nevada,2020-12-03,16,2,18
13954,Humboldt,2020-12-03,7,0,7
13955,Sonoma,2020-12-03,37,5,42
13956,Santa Cruz,2020-12-03,43,0,43
13957,Butte,2020-12-03,47,1,48
13958,Los Angeles,2020-12-03,2769,328,3097
13959,Marin,2020-12-03,16,3,19
13960,San Joaquin,2020-12-03,160,5,165
13961,Colusa,2020-12-03,10,0,10
13962,Mono,2020-12-03,3,0,3
13963,San Benito,2020-12-03,6,0,6
13964,Imperial,2020-12-03,91,1,92
13965,Plumas,2020-12-03,1,0,1
13966,Lake,2020-12-03,2,0,2
13967,Sutter,2020-12-03,0,0,0
13968,Fresno,2020-12-03,340,38,378
13969,San Francisco,2020-12-03,93,5,98
13970,Glenn,2020-12-03,0,0,0
13971,El Dorado,2020-12-03,15,1,16
13972,Santa Barbara,2020-12-03,59,1,60
13973,Stanislaus,2020-12-03,218,13,231
13974,San Mateo,2020-12-03,76,7,83
13975,Yuba,2020-12-03,39,0,39
13976,Mendocino,2020-12-03,10,0,10
13977,Tulare,2020-12-03,107,10,117
13978,Merced,2020-12-03,38,0,38
13979,Contra Costa,2020-12-03,122,14,136
13980,Monterey,2020-12-03,90,1,91
13981,Kern,2020-12-03,182,6,188
13982,Orange,2020-12-03,746,64,810
13983,Modoc,2020-12-03,1,2,3
13984,Solano,2020-12-03,64,14,78
13985,Lassen,2020-12-03,11,0,11
13986,Santa Clara,2020-12-03,307,23,330
13987,San Diego,2020-12-03,743,54,797
13988,Placer,2020-12-03,144,19,163
13989,Shasta,2020-12-03,51,0,51
13990,Kings,2020-12-03,60,0,60
13991,Napa,2020-12-03,12,1,13
13992,Trinity,2020-12-03,0,0,0
13993,Riverside,2020-12-03,658,81,739
13994,Siskiyou,2020-12-03,13,3,16
13995,San Bernardino,2020-12-03,880,84,964
13996,Madera,2020-12-03,29,10,39
13997,Tuolumne,2020-12-04,11,0,11
13998,Colusa,2020-12-04,9,0,9
13999,Imperial,2020-12-04,90,0,90
14000,Mendocino,2020-12-04,10,0,10
14001,Monterey,2020-12-04,90,2,92
14002,Los Angeles,2020-12-04,2878,319,3197
14003,San Mateo,2020-12-04,78,11,89
14004,Tehama,2020-12-04,9,0,9
14005,Del Norte,2020-12-04,0,0,0
14006,Yuba,2020-12-04,41,0,41
14007,Solano,2020-12-04,69,14,83
14008,Sonoma,2020-12-04,41,3,44
14009,Orange,2020-12-04,842,45,887
14010,Santa Cruz,2020-12-04,46,1,47
14011,Siskiyou,2020-12-04,12,0,12
14012,Nevada,2020-12-04,15,1,16
14013,Alameda,2020-12-04,213,38,251
14014,Kings,2020-12-04,63,0,63
14015,Marin,2020-12-04,15,1,16
14016,Merced,2020-12-04,29,0,29
14017,Fresno,2020-12-04,354,36,390
14018,San Bernardino,2020-12-04,913,85,998
14019,Humboldt,2020-12-04,7,2,9
14020,Lake,2020-12-04,2,0,2
14021,Amador,2020-12-04,6,0,6
14022,Yolo,2020-12-04,18,0,18
14023,Contra Costa,2020-12-04,126,17,143
14024,Santa Barbara,2020-12-04,54,0,54
14025,Madera,2020-12-04,28,10,38
14026,San Luis Obispo,2020-12-04,15,0,15
14027,El Dorado,2020-12-04,19,0,19
14028,Sutter,2020-12-04,0,0,0
14029,Modoc,2020-12-04,0,0,0
14030,Tulare,2020-12-04,104,2,106
14031,Kern,2020-12-04,198,5,203
14032,Sacramento,2020-12-04,378,21,399
14033,San Francisco,2020-12-04,96,3,99
14034,Shasta,2020-12-04,49,0,49
14035,Inyo,2020-12-04,2,0,2
14036,Santa Clara,2020-12-04,332,23,355
14037,Glenn,2020-12-04,1,0,1
14038,San Diego,2020-12-04,772,35,807
14039,Butte,2020-12-04,51,1,52
14040,Napa,2020-12-04,8,0,8
14041,Mono,2020-12-04,1,0,1
14042,Calaveras,2020-12-04,4,0,4
14043,Riverside,2020-12-04,687,101,788
14044,Lassen,2020-12-04,5,0,5
14045,Mariposa,2020-12-04,1,0,1
14046,Ventura,2020-12-04,111,15,126
14047,Placer,2020-12-04,148,15,163
14048,Plumas,2020-12-04,0,0,0
14049,Stanislaus,2020-12-04,225,12,237
14050,San Joaquin,2020-12-04,172,15,187
14051,Trinity,2020-12-04,0,0,0
14052,San Benito,2020-12-04,5,0,5
14053,Marin,2020-12-05,21,0,21
14054,San Mateo,2020-12-05,82,8,90
14055,Solano,2020-12-05,72,13,85
14056,Butte,2020-12-05,57,0,57
14057,Napa,2020-12-05,8,0,8
14058,Tulare,2020-12-05,115,4,119
14059,Placer,2020-12-05,147,23,170
14060,San Joaquin,2020-12-05,187,12,199
14061,Ventura,2020-12-05,117,10,127
14062,San Luis Obispo,2020-12-05,11,0,11
14063,Plumas,2020-12-05,0,0,0
14064,Humboldt,2020-12-05,7,2,9
14065,Yolo,2020-12-05,19,0,19
14066,Amador,2020-12-05,7,0,7
14067,San Bernardino,2020-12-05,958,78,1036
14068,Mariposa,2020-12-05,1,0,1
14069,Santa Cruz,2020-12-05,44,1,45
14070,Inyo,2020-12-05,2,0,2
14071,Trinity,2020-12-05,0,0,0
14072,Siskiyou,2020-12-05,12,0,12
14073,Lake,2020-12-05,2,1,3
14074,Nevada,2020-12-05,16,1,17
14075,Sacramento,2020-12-05,371,30,401
14076,Modoc,2020-12-05,1,0,1
14077,Del Norte,2020-12-05,0,0,0
14078,Colusa,2020-12-05,9,0,9
14079,Yuba,2020-12-05,43,0,43
14080,San Francisco,2020-12-05,111,6,117
14081,Santa Barbara,2020-12-05,50,1,51
14082,Santa Clara,2020-12-05,336,21,357
14083,Calaveras,2020-12-05,2,0,2
14084,El Dorado,2020-12-05,22,0,22
14085,Glenn,2020-12-05,2,4,6
14086,San Diego,2020-12-05,790,45,835
14087,Orange,2020-12-05,848,54,902
14088,Los Angeles,2020-12-05,2988,340,3328
14089,Riverside,2020-12-05,671,116,787
14090,Sutter,2020-12-05,0,0,0
14091,Merced,2020-12-05,33,0,33
14092,Tehama,2020-12-05,10,0,10
14093,Monterey,2020-12-05,87,3,90
14094,Contra Costa,2020-12-05,133,17,150
14095,Sonoma,2020-12-05,41,8,49
14096,Kern,2020-12-05,199,3,202
14097,Madera,2020-12-05,31,11,42
14098,Alameda,2020-12-05,227,32,259
14099,Mono,2020-12-05,1,0,1
14100,Mendocino,2020-12-05,8,1,9
14101,Lassen,2020-12-05,5,0,5
14102,San Benito,2020-12-05,5,0,5
14103,Stanislaus,2020-12-05,217,15,232
14104,Tuolumne,2020-12-05,7,0,7
14105,Fresno,2020-12-05,396,24,420
14106,Shasta,2020-12-05,49,0,49
14107,Kings,2020-12-05,66,0,66
14108,Imperial,2020-12-05,96,0,96
14109,Contra Costa,2020-12-06,138,20,158
14110,San Diego,2020-12-06,817,54,871
14111,Colusa,2020-12-06,9,0,9
14112,Monterey,2020-12-06,97,2,99
14113,Riverside,2020-12-06,700,117,817
14114,Siskiyou,2020-12-06,13,0,13
14115,San Francisco,2020-12-06,110,5,115
14116,Glenn,2020-12-06,2,4,6
14117,Trinity,2020-12-06,0,0,0
14118,Nevada,2020-12-06,17,1,18
14119,Amador,2020-12-06,7,0,7
14120,Sacramento,2020-12-06,374,24,398
14121,Sonoma,2020-12-06,48,9,57
14122,Lake,2020-12-06,2,1,3
14123,Merced,2020-12-06,35,0,35
14124,Imperial,2020-12-06,98,0,98
14125,Kings,2020-12-06,69,0,69
14126,San Luis Obispo,2020-12-06,13,1,14
14127,Shasta,2020-12-06,48,0,48
14128,Fresno,2020-12-06,408,28,436
14129,Del Norte,2020-12-06,0,0,0
14130,Yolo,2020-12-06,20,0,20
14131,Los Angeles,2020-12-06,3113,377,3490
14132,Placer,2020-12-06,154,17,171
14133,San Mateo,2020-12-06,82,10,92
14134,Tulare,2020-12-06,118,8,126
14135,Humboldt,2020-12-06,7,0,7
14136,Napa,2020-12-06,11,1,12
14137,San Benito,2020-12-06,4,0,4
14138,Inyo,2020-12-06,3,0,3
14139,Lassen,2020-12-06,5,0,5
14140,Santa Cruz,2020-12-06,49,0,49
14141,El Dorado,2020-12-06,18,2,20
14142,Solano,2020-12-06,69,10,79
14143,Orange,2020-12-06,877,44,921
14144,San Joaquin,2020-12-06,199,27,226
14145,Ventura,2020-12-06,122,11,133
14146,Stanislaus,2020-12-06,209,12,221
14147,Butte,2020-12-06,51,0,51
14148,Tehama,2020-12-06,10,0,10
14149,Mariposa,2020-12-06,2,0,2
14150,Kern,2020-12-06,207,2,209
14151,Mendocino,2020-12-06,7,0,7
14152,Tuolumne,2020-12-06,9,0,9
14153,Alameda,2020-12-06,226,40,266
14154,Yuba,2020-12-06,46,0,46
14155,Modoc,2020-12-06,1,0,1
14156,Santa Barbara,2020-12-06,59,2,61
14157,Marin,2020-12-06,20,0,20
14158,Santa Clara,2020-12-06,354,14,368
14159,Calaveras,2020-12-06,2,0,2
14160,Plumas,2020-12-06,0,0,0
14161,San Bernardino,2020-12-06,984,76,1060
14162,Sutter,2020-12-06,0,0,0
14163,Madera,2020-12-06,27,9,36
14164,Mono,2020-12-06,0,0,0
14165,Merced,2020-12-07,37,0,37
14166,San Luis Obispo,2020-12-07,12,3,15
14167,Fresno,2020-12-07,420,35,455
14168,Ventura,2020-12-07,128,8,136
14169,Solano,2020-12-07,67,8,75
14170,Nevada,2020-12-07,18,0,18
14171,Mono,2020-12-07,0,0,0
14172,Inyo,2020-12-07,3,0,3
14173,San Joaquin,2020-12-07,199,9,208
14174,Tehama,2020-12-07,12,0,12
14175,Santa Cruz,2020-12-07,49,0,49
14176,Tuolumne,2020-12-07,7,0,7
14177,Los Angeles,2020-12-07,3299,354,3653
14178,Lake,2020-12-07,2,0,2
14179,Modoc,2020-12-07,0,0,0
14180,Amador,2020-12-07,7,0,7
14181,Placer,2020-12-07,149,13,162
14182,Glenn,2020-12-07,5,0,5
14183,Mariposa,2020-12-07,2,0,2
14184,Kings,2020-12-07,75,2,77
14185,Contra Costa,2020-12-07,140,16,156
14186,San Mateo,2020-12-07,83,12,95
14187,Orange,2020-12-07,946,78,1024
14188,Del Norte,2020-12-07,1,0,1
14189,Yuba,2020-12-07,42,0,42
14190,Santa Clara,2020-12-07,376,22,398
14191,Madera,2020-12-07,24,12,36
14192,Alameda,2020-12-07,232,36,268
14193,Butte,2020-12-07,54,1,55
14194,Lassen,2020-12-07,6,0,6
14195,Siskiyou,2020-12-07,13,0,13
14196,Plumas,2020-12-07,0,0,0
14197,Sonoma,2020-12-07,47,3,50
14198,Sutter,2020-12-07,0,0,0
14199,San Benito,2020-12-07,7,0,7
14200,Calaveras,2020-12-07,1,0,1
14201,Tulare,2020-12-07,126,9,135
14202,Yolo,2020-12-07,23,0,23
14203,San Bernardino,2020-12-07,996,104,1100
14204,San Francisco,2020-12-07,117,6,123
14205,Colusa,2020-12-07,8,1,9
14206,Marin,2020-12-07,17,3,20
14207,Santa Barbara,2020-12-07,64,0,64
14208,Shasta,2020-12-07,46,0,46
14209,Riverside,2020-12-07,733,115,848
14210,Sacramento,2020-12-07,385,27,412
14211,Stanislaus,2020-12-07,231,13,244
14212,El Dorado,2020-12-07,20,1,21
14213,Humboldt,2020-12-07,8,1,9
14214,Imperial,2020-12-07,121,1,122
14215,Kern,2020-12-07,216,8,224
14216,San Diego,2020-12-07,867,41,908
14217,Monterey,2020-12-07,105,1,106
14218,Mendocino,2020-12-07,9,0,9
14219,Trinity,2020-12-07,0,0,0
14220,Napa,2020-12-07,12,1,13
14221,San Diego,2020-12-08,874,59,933
14222,Kings,2020-12-08,80,2,82
14223,Santa Barbara,2020-12-08,64,3,67
14224,Stanislaus,2020-12-08,247,13,260
14225,Imperial,2020-12-08,121,1,122
14226,Contra Costa,2020-12-08,143,16,159
14227,Los Angeles,2020-12-08,3433,337,3770
14228,Lassen,2020-12-08,5,0,5
14229,Fresno,2020-12-08,454,38,492
14230,Nevada,2020-12-08,14,0,14
14231,Madera,2020-12-08,27,10,37
14232,Yuba,2020-12-08,45,0,45
14233,Santa Clara,2020-12-08,392,21,413
14234,Mendocino,2020-12-08,7,0,7
14235,Riverside,2020-12-08,768,127,895
14236,Alameda,2020-12-08,242,38,280
14237,Humboldt,2020-12-08,6,1,7
14238,Shasta,2020-12-08,44,2,46
14239,San Bernardino,2020-12-08,1053,87,1140
14240,Sutter,2020-12-08,0,0,0
14241,San Benito,2020-12-08,7,0,7
14242,Monterey,2020-12-08,112,1,113
14243,Modoc,2020-12-08,0,0,0
14244,Lake,2020-12-08,4,0,4
14245,Solano,2020-12-08,74,14,88
14246,Napa,2020-12-08,15,1,16
14247,Placer,2020-12-08,158,17,175
14248,Sonoma,2020-12-08,51,9,60
14249,Plumas,2020-12-08,1,0,1
14250,Calaveras,2020-12-08,1,0,1
14251,Santa Cruz,2020-12-08,48,0,48
14252,Mariposa,2020-12-08,3,0,3
14253,Siskiyou,2020-12-08,13,0,13
14254,Glenn,2020-12-08,5,0,5
14255,Mono,2020-12-08,0,0,0
14256,Del Norte,2020-12-08,3,0,3
14257,Yolo,2020-12-08,26,0,26
14258,Tuolumne,2020-12-08,6,0,6
14259,San Luis Obispo,2020-12-08,15,0,15
14260,San Mateo,2020-12-08,87,10,97
14261,Marin,2020-12-08,20,4,24
14262,Tehama,2020-12-08,17,0,17
14263,Merced,2020-12-08,37,0,37
14264,Trinity,2020-12-08,0,0,0
14265,Inyo,2020-12-08,3,0,3
14266,Sacramento,2020-12-08,398,24,422
14267,Tulare,2020-12-08,128,13,141
14268,San Joaquin,2020-12-08,218,9,227
14269,Kern,2020-12-08,225,4,229
14270,Orange,2020-12-08,974,80,1054
14271,Butte,2020-12-08,63,3,66
14272,El Dorado,2020-12-08,24,0,24
14273,Colusa,2020-12-08,4,0,4
14274,San Francisco,2020-12-08,115,5,120
14275,Ventura,2020-12-08,131,4,135
14276,Amador,2020-12-08,7,0,7
14277,Colusa,2020-12-09,2,1,3
14278,Calaveras,2020-12-09,2,0,2
14279,Ventura,2020-12-09,145,7,152
14280,Yolo,2020-12-09,24,0,24
14281,Del Norte,2020-12-09,3,0,3
14282,Santa Barbara,2020-12-09,72,3,75
14283,Humboldt,2020-12-09,3,1,4
14284,San Mateo,2020-12-09,96,14,110
14285,San Joaquin,2020-12-09,225,13,238
14286,Tuolumne,2020-12-09,7,0,7
14287,Contra Costa,2020-12-09,164,5,169
14288,Lake,2020-12-09,4,0,4
14289,Solano,2020-12-09,82,16,98
14290,Imperial,2020-12-09,127,0,127
14291,Mono,2020-12-09,1,0,1
14292,Plumas,2020-12-09,1,0,1
14293,Merced,2020-12-09,41,0,41
14294,Madera,2020-12-09,31,12,43
14295,Sutter,2020-12-09,0,0,0
14296,San Benito,2020-12-09,6,0,6
14297,Inyo,2020-12-09,3,0,3
14298,Fresno,2020-12-09,460,31,491
14299,Mendocino,2020-12-09,9,0,9
14300,Tulare,2020-12-09,138,12,150
14301,San Bernardino,2020-12-09,1094,92,1186
14302,Mariposa,2020-12-09,2,0,2
14303,Marin,2020-12-09,29,4,33
14304,Orange,2020-12-09,1025,68,1093
14305,San Diego,2020-12-09,905,50,955
14306,Modoc,2020-12-09,0,0,0
14307,Alameda,2020-12-09,254,47,301
14308,Monterey,2020-12-09,114,1,115
14309,Santa Cruz,2020-12-09,47,0,47
14310,Nevada,2020-12-09,13,0,13
14311,Lassen,2020-12-09,2,0,2
14312,Siskiyou,2020-12-09,11,0,11
14313,Los Angeles,2020-12-09,3624,370,3994
14314,Amador,2020-12-09,9,0,9
14315,Riverside,2020-12-09,775,132,907
14316,Placer,2020-12-09,166,17,183
14317,Butte,2020-12-09,62,3,65
14318,Kings,2020-12-09,73,1,74
14319,Sacramento,2020-12-09,398,24,422
14320,El Dorado,2020-12-09,25,0,25
14321,Glenn,2020-12-09,5,0,5
14322,Yuba,2020-12-09,49,0,49
14323,Kern,2020-12-09,229,9,238
14324,Stanislaus,2020-12-09,258,12,270
14325,Sonoma,2020-12-09,60,5,65
14326,Trinity,2020-12-09,0,0,0
14327,Santa Clara,2020-12-09,411,22,433
14328,Tehama,2020-12-09,13,0,13
14329,San Francisco,2020-12-09,121,6,127
14330,Shasta,2020-12-09,46,0,46
14331,San Luis Obispo,2020-12-09,17,1,18
14332,Napa,2020-12-09,14,1,15
14333,Orange,2020-12-10,1122,50,1172
14334,San Benito,2020-12-10,10,0,10
14335,Merced,2020-12-10,39,0,39
14336,Kings,2020-12-10,77,0,77
14337,Sacramento,2020-12-10,422,15,437
14338,El Dorado,2020-12-10,25,0,25
14339,Stanislaus,2020-12-10,268,8,276
14340,San Francisco,2020-12-10,118,1,119
14341,Yuba,2020-12-10,49,0,49
14342,San Mateo,2020-12-10,98,14,112
14343,Trinity,2020-12-10,0,0,0
14344,Shasta,2020-12-10,49,0,49
14345,San Bernardino,2020-12-10,1132,109,1241
14346,Marin,2020-12-10,25,5,30
14347,Inyo,2020-12-10,3,1,4
14348,Glenn,2020-12-10,5,0,5
14349,Colusa,2020-12-10,3,1,4
14350,Alameda,2020-12-10,278,34,312
14351,Sutter,2020-12-10,0,0,0
14352,Calaveras,2020-12-10,3,0,3
14353,Yolo,2020-12-10,24,0,24
14354,Placer,2020-12-10,176,18,194
14355,Siskiyou,2020-12-10,11,0,11
14356,Tuolumne,2020-12-10,8,0,8
14357,Lake,2020-12-10,4,0,4
14358,Santa Clara,2020-12-10,419,19,438
14359,Imperial,2020-12-10,127,0,127
14360,Napa,2020-12-10,14,1,15
14361,Riverside,2020-12-10,809,141,950
14362,Humboldt,2020-12-10,4,1,5
14363,Los Angeles,2020-12-10,3850,323,4173
14364,Mendocino,2020-12-10,7,0,7
14365,Ventura,2020-12-10,146,12,158
14366,Plumas,2020-12-10,2,0,2
14367,Tulare,2020-12-10,136,5,141
14368,San Diego,2020-12-10,902,61,963
14369,Nevada,2020-12-10,18,2,20
14370,Madera,2020-12-10,31,5,36
14371,Contra Costa,2020-12-10,156,8,164
14372,Modoc,2020-12-10,0,0,0
14373,Sonoma,2020-12-10,68,9,77
14374,Mono,2020-12-10,1,0,1
14375,Santa Barbara,2020-12-10,73,3,76
14376,Butte,2020-12-10,61,3,64
14377,Mariposa,2020-12-10,2,0,2
14378,Del Norte,2020-12-10,2,0,2
14379,Amador,2020-12-10,9,0,9
14380,Kern,2020-12-10,236,11,247
14381,Monterey,2020-12-10,119,3,122
14382,Lassen,2020-12-10,2,0,2
14383,Santa Cruz,2020-12-10,45,0,45
14384,Solano,2020-12-10,88,14,102
14385,Fresno,2020-12-10,472,41,513
14386,San Joaquin,2020-12-10,233,8,241
14387,Tehama,2020-12-10,13,0,13
14388,San Luis Obispo,2020-12-10,19,1,20
14389,Madera,2020-12-11,28,4,32
14390,Sacramento,2020-12-11,433,20,453
14391,Riverside,2020-12-11,855,149,1004
14392,Fresno,2020-12-11,462,29,491
14393,Merced,2020-12-11,45,0,45
14394,Yolo,2020-12-11,24,0,24
14395,Butte,2020-12-11,66,3,69
14396,San Luis Obispo,2020-12-11,19,0,19
14397,Mendocino,2020-12-11,7,0,7
14398,Tulare,2020-12-11,174,9,183
14399,Amador,2020-12-11,10,0,10
14400,San Diego,2020-12-11,928,73,1001
14401,Placer,2020-12-11,176,18,194
14402,Shasta,2020-12-11,60,0,60
14403,San Joaquin,2020-12-11,247,9,256
14404,San Benito,2020-12-11,8,0,8
14405,Tuolumne,2020-12-11,8,0,8
14406,Orange,2020-12-11,1150,76,1226
14407,Stanislaus,2020-12-11,287,8,295
14408,Mono,2020-12-11,1,0,1
14409,Monterey,2020-12-11,124,3,127
14410,Imperial,2020-12-11,124,0,124
14411,Colusa,2020-12-11,3,1,4
14412,Trinity,2020-12-11,0,0,0
14413,San Mateo,2020-12-11,103,9,112
14414,Solano,2020-12-11,91,12,103
14415,Lassen,2020-12-11,4,0,4
14416,Marin,2020-12-11,26,4,30
14417,Inyo,2020-12-11,4,1,5
14418,Plumas,2020-12-11,1,0,1
14419,Tehama,2020-12-11,11,0,11
14420,El Dorado,2020-12-11,26,1,27
14421,Alameda,2020-12-11,281,36,317
14422,Santa Clara,2020-12-11,431,19,450
14423,Santa Cruz,2020-12-11,48,0,48
14424,Sutter,2020-12-11,0,0,0
14425,Nevada,2020-12-11,17,2,19
14426,Glenn,2020-12-11,5,0,5
14427,Humboldt,2020-12-11,4,0,4
14428,Santa Barbara,2020-12-11,75,0,75
14429,Contra Costa,2020-12-11,155,11,166
14430,Napa,2020-12-11,18,1,19
14431,Ventura,2020-12-11,152,11,163
14432,Kern,2020-12-11,248,5,253
14433,Siskiyou,2020-12-11,9,0,9
14434,Kings,2020-12-11,73,0,73
14435,San Francisco,2020-12-11,127,8,135
14436,San Bernardino,2020-12-11,1154,86,1240
14437,Lake,2020-12-11,5,0,5
14438,Los Angeles,2020-12-11,4009,353,4362
14439,Mariposa,2020-12-11,2,0,2
14440,Sonoma,2020-12-11,70,5,75
14441,Modoc,2020-12-11,0,0,0
14442,Yuba,2020-12-11,50,0,50
14443,Del Norte,2020-12-11,2,0,2
14444,Calaveras,2020-12-11,4,0,4
14445,Mendocino,2020-12-12,7,0,7
14446,Kings,2020-12-12,77,0,77
14447,Alameda,2020-12-12,286,34,320
14448,Marin,2020-12-12,25,5,30
14449,Contra Costa,2020-12-12,173,13,186
14450,Mariposa,2020-12-12,2,0,2
14451,Inyo,2020-12-12,5,1,6
14452,Stanislaus,2020-12-12,299,8,307
14453,Glenn,2020-12-12,5,0,5
14454,Nevada,2020-12-12,18,2,20
14455,Sutter,2020-12-12,0,0,0
14456,Mono,2020-12-12,1,0,1
14457,Orange,2020-12-12,1236,71,1307
14458,Los Angeles,2020-12-12,4203,365,4568
14459,Tehama,2020-12-12,12,0,12
14460,Ventura,2020-12-12,173,11,184
14461,San Diego,2020-12-12,976,61,1037
14462,Del Norte,2020-12-12,2,0,2
14463,Imperial,2020-12-12,135,0,135
14464,Lassen,2020-12-12,4,0,4
14465,Santa Barbara,2020-12-12,78,1,79
14466,Butte,2020-12-12,65,1,66
14467,Madera,2020-12-12,32,6,38
14468,Calaveras,2020-12-12,5,0,5
14469,Solano,2020-12-12,94,10,104
14470,Siskiyou,2020-12-12,8,0,8
14471,Colusa,2020-12-12,2,0,2
14472,San Mateo,2020-12-12,102,9,111
14473,San Joaquin,2020-12-12,262,8,270
14474,San Francisco,2020-12-12,130,4,134
14475,Modoc,2020-12-12,1,0,1
14476,Santa Cruz,2020-12-12,52,0,52
14477,Tulare,2020-12-12,176,6,182
14478,Monterey,2020-12-12,120,6,126
14479,El Dorado,2020-12-12,25,1,26
14480,San Bernardino,2020-12-12,1234,88,1322
14481,Humboldt,2020-12-12,4,1,5
14482,San Benito,2020-12-12,9,0,9
14483,Napa,2020-12-12,18,0,18
14484,San Luis Obispo,2020-12-12,25,3,28
14485,Kern,2020-12-12,273,9,282
14486,Riverside,2020-12-12,901,95,996
14487,Yolo,2020-12-12,8,0,8
14488,Santa Clara,2020-12-12,451,14,465
14489,Tuolumne,2020-12-12,7,0,7
14490,Plumas,2020-12-12,1,0,1
14491,Shasta,2020-12-12,61,2,63
14492,Sacramento,2020-12-12,456,19,475
14493,Trinity,2020-12-12,0,0,0
14494,Sonoma,2020-12-12,65,6,71
14495,Amador,2020-12-12,11,0,11
14496,Fresno,2020-12-12,450,39,489
14497,Lake,2020-12-12,4,0,4
14498,Yuba,2020-12-12,62,1,63
14499,Merced,2020-12-12,43,0,43
14500,Placer,2020-12-12,173,13,186
14501,Marin,2020-12-13,26,5,31
14502,Sonoma,2020-12-13,70,10,80
14503,Tehama,2020-12-13,11,0,11
14504,Mendocino,2020-12-13,14,0,14
14505,San Joaquin,2020-12-13,277,8,285
14506,El Dorado,2020-12-13,27,2,29
14507,Lassen,2020-12-13,6,0,6
14508,Modoc,2020-12-13,0,0,0
14509,Alameda,2020-12-13,302,47,349
14510,San Luis Obispo,2020-12-13,32,1,33
14511,Siskiyou,2020-12-13,8,0,8
14512,Yuba,2020-12-13,62,2,64
14513,Ventura,2020-12-13,181,11,192
14514,San Diego,2020-12-13,994,40,1034
14515,Kings,2020-12-13,75,0,75
14516,Placer,2020-12-13,182,10,192
14517,Glenn,2020-12-13,5,0,5
14518,Santa Barbara,2020-12-13,89,1,90
14519,Shasta,2020-12-13,65,1,66
14520,San Francisco,2020-12-13,139,4,143
14521,Sutter,2020-12-13,0,0,0
14522,Mariposa,2020-12-13,0,0,0
14523,Riverside,2020-12-13,930,110,1040
14524,Calaveras,2020-12-13,7,0,7
14525,Los Angeles,2020-12-13,4403,372,4775
14526,Solano,2020-12-13,103,10,113
14527,Amador,2020-12-13,13,0,13
14528,Monterey,2020-12-13,127,6,133
14529,Napa,2020-12-13,20,0,20
14530,Merced,2020-12-13,41,0,41
14531,Colusa,2020-12-13,3,0,3
14532,San Bernardino,2020-12-13,1277,87,1364
14533,Humboldt,2020-12-13,4,3,7
14534,Kern,2020-12-13,295,6,301
14535,Nevada,2020-12-13,18,2,20
14536,Stanislaus,2020-12-13,317,13,330
14537,Inyo,2020-12-13,6,1,7
14538,Contra Costa,2020-12-13,177,17,194
14539,Tulare,2020-12-13,178,4,182
14540,Del Norte,2020-12-13,3,0,3
14541,Orange,2020-12-13,1287,71,1358
14542,Santa Cruz,2020-12-13,53,0,53
14543,San Benito,2020-12-13,11,0,11
14544,Lake,2020-12-13,4,0,4
14545,Madera,2020-12-13,34,0,34
14546,San Mateo,2020-12-13,105,10,115
14547,Trinity,2020-12-13,0,0,0
14548,Fresno,2020-12-13,458,49,507
14549,Imperial,2020-12-13,143,0,143
14550,Plumas,2020-12-13,1,0,1
14551,Santa Clara,2020-12-13,480,23,503
14552,Sacramento,2020-12-13,463,17,480
14553,Tuolumne,2020-12-13,7,0,7
14554,Butte,2020-12-13,77,0,77
14555,Yolo,2020-12-13,24,0,24
14556,Mono,2020-12-13,1,0,1
14557,Los Angeles,2020-12-14,4656,314,4970
14558,Marin,2020-12-14,30,3,33
14559,Alameda,2020-12-14,330,44,374
14560,Orange,2020-12-14,1371,89,1460
14561,Kings,2020-12-14,75,0,75
14562,Nevada,2020-12-14,18,1,19
14563,Del Norte,2020-12-14,1,0,1
14564,Merced,2020-12-14,41,0,41
14565,San Benito,2020-12-14,11,0,11
14566,Napa,2020-12-14,19,1,20
14567,San Diego,2020-12-14,1019,63,1082
14568,Tulare,2020-12-14,178,4,182
14569,Kern,2020-12-14,284,4,288
14570,Contra Costa,2020-12-14,185,15,200
14571,San Joaquin,2020-12-14,293,8,301
14572,El Dorado,2020-12-14,29,1,30
14573,Amador,2020-12-14,13,0,13
14574,Lake,2020-12-14,5,0,5
14575,Butte,2020-12-14,77,0,77
14576,San Luis Obispo,2020-12-14,32,0,32
14577,San Bernardino,2020-12-14,1319,96,1415
14578,Sonoma,2020-12-14,76,4,80
14579,Mendocino,2020-12-14,15,0,15
14580,San Mateo,2020-12-14,111,10,121
14581,Mariposa,2020-12-14,0,0,0
14582,Solano,2020-12-14,107,13,120
14583,Ventura,2020-12-14,210,10,220
14584,Trinity,2020-12-14,0,0,0
14585,Santa Cruz,2020-12-14,57,0,57
14586,Glenn,2020-12-14,5,0,5
14587,Santa Barbara,2020-12-14,91,0,91
14588,Santa Clara,2020-12-14,511,27,538
14589,Imperial,2020-12-14,151,0,151
14590,Plumas,2020-12-14,1,0,1
14591,Madera,2020-12-14,35,3,38
14592,San Francisco,2020-12-14,150,3,153
14593,Fresno,2020-12-14,491,37,528
14594,Tuolumne,2020-12-14,4,0,4
14595,Monterey,2020-12-14,133,7,140
14596,Riverside,2020-12-14,972,106,1078
14597,Tehama,2020-12-14,12,0,12
14598,Sutter,2020-12-14,0,0,0
14599,Siskiyou,2020-12-14,4,1,5
14600,Sacramento,2020-12-14,473,21,494
14601,Yolo,2020-12-14,26,0,26
14602,Colusa,2020-12-14,3,0,3
14603,Mono,2020-12-14,1,0,1
14604,Shasta,2020-12-14,60,0,60
14605,Calaveras,2020-12-14,6,0,6
14606,Inyo,2020-12-14,5,1,6
14607,Lassen,2020-12-14,4,0,4
14608,Placer,2020-12-14,184,11,195
14609,Stanislaus,2020-12-14,334,14,348
14610,Modoc,2020-12-14,0,0,0
14611,Yuba,2020-12-14,61,1,62
14612,Humboldt,2020-12-14,4,3,7
14613,Orange,2020-12-15,1486,81,1567
14614,Siskiyou,2020-12-15,6,1,7
14615,San Bernardino,2020-12-15,1413,92,1505
14616,Del Norte,2020-12-15,1,0,1
14617,San Luis Obispo,2020-12-15,34,2,36
14618,Riverside,2020-12-15,1000,116,1116
14619,Placer,2020-12-15,187,11,198
14620,Marin,2020-12-15,34,2,36
14621,Los Angeles,2020-12-15,4864,344,5208
14622,Monterey,2020-12-15,148,4,152
14623,Merced,2020-12-15,46,0,46
14624,Sacramento,2020-12-15,470,22,492
14625,Modoc,2020-12-15,0,0,0
14626,Calaveras,2020-12-15,6,0,6
14627,Lassen,2020-12-15,6,0,6
14628,Amador,2020-12-15,15,0,15
14629,Sutter,2020-12-15,0,0,0
14630,Tehama,2020-12-15,13,0,13
14631,San Diego,2020-12-15,1103,70,1173
14632,Santa Barbara,2020-12-15,90,2,92
14633,Mendocino,2020-12-15,16,0,16
14634,Madera,2020-12-15,36,11,47
14635,Stanislaus,2020-12-15,334,20,354
14636,Santa Clara,2020-12-15,535,18,553
14637,Tulare,2020-12-15,173,7,180
14638,Ventura,2020-12-15,226,7,233
14639,Plumas,2020-12-15,2,0,2
14640,Solano,2020-12-15,121,11,132
14641,Yolo,2020-12-15,27,0,27
14642,Alameda,2020-12-15,332,45,377
14643,Kings,2020-12-15,79,0,79
14644,San Francisco,2020-12-15,141,3,144
14645,Butte,2020-12-15,84,0,84
14646,Sonoma,2020-12-15,66,3,69
14647,Colusa,2020-12-15,4,0,4
14648,Nevada,2020-12-15,20,0,20
14649,Kern,2020-12-15,296,3,299
14650,Imperial,2020-12-15,163,1,164
14651,Napa,2020-12-15,18,0,18
14652,El Dorado,2020-12-15,32,1,33
14653,San Mateo,2020-12-15,110,14,124
14654,Contra Costa,2020-12-15,188,9,197
14655,San Benito,2020-12-15,12,0,12
14656,Inyo,2020-12-15,7,0,7
14657,Glenn,2020-12-15,5,0,5
14658,Fresno,2020-12-15,491,40,531
14659,Lake,2020-12-15,7,0,7
14660,Shasta,2020-12-15,65,0,65
14661,Humboldt,2020-12-15,4,3,7
14662,Santa Cruz,2020-12-15,54,0,54
14663,Trinity,2020-12-15,0,0,0
14664,San Joaquin,2020-12-15,305,4,309
14665,Yuba,2020-12-15,59,0,59
14666,Tuolumne,2020-12-15,3,0,3
14667,Mariposa,2020-12-15,0,0,0
14668,Mono,2020-12-15,2,0,2
14669,Santa Barbara,2020-12-16,97,5,102
14670,Fresno,2020-12-16,527,30,557
14671,Tuolumne,2020-12-16,3,0,3
14672,Humboldt,2020-12-16,6,3,9
14673,Contra Costa,2020-12-16,196,10,206
14674,Riverside,2020-12-16,1054,85,1139
14675,Sonoma,2020-12-16,65,2,67
14676,Glenn,2020-12-16,5,0,5
14677,San Joaquin,2020-12-16,315,8,323
14678,Yolo,2020-12-16,24,0,24
14679,Amador,2020-12-16,13,0,13
14680,Tehama,2020-12-16,11,0,11
14681,Sacramento,2020-12-16,478,31,509
14682,Merced,2020-12-16,59,0,59
14683,Orange,2020-12-16,1519,96,1615
14684,El Dorado,2020-12-16,28,0,28
14685,San Luis Obispo,2020-12-16,34,1,35
14686,San Bernardino,2020-12-16,1458,127,1585
14687,Lake,2020-12-16,4,0,4
14688,Monterey,2020-12-16,145,2,147
14689,Trinity,2020-12-16,0,0,0
14690,Shasta,2020-12-16,72,0,72
14691,Colusa,2020-12-16,5,0,5
14692,Solano,2020-12-16,105,16,121
14693,Del Norte,2020-12-16,1,0,1
14694,Mariposa,2020-12-16,0,0,0
14695,Kern,2020-12-16,303,8,311
14696,Alameda,2020-12-16,336,39,375
14697,Placer,2020-12-16,179,9,188
14698,San Benito,2020-12-16,12,0,12
14699,Napa,2020-12-16,22,1,23
14700,Modoc,2020-12-16,0,0,0
14701,Mono,2020-12-16,2,0,2
14702,Marin,2020-12-16,35,3,38
14703,Plumas,2020-12-16,4,0,4
14704,Calaveras,2020-12-16,4,0,4
14705,Kings,2020-12-16,75,0,75
14706,Siskiyou,2020-12-16,9,0,9
14707,Santa Cruz,2020-12-16,58,0,58
14708,Tulare,2020-12-16,173,9,182
14709,San Mateo,2020-12-16,116,13,129
14710,Madera,2020-12-16,40,9,49
14711,Sutter,2020-12-16,0,0,0
14712,Inyo,2020-12-16,7,0,7
14713,Ventura,2020-12-16,230,11,241
14714,Mendocino,2020-12-16,14,0,14
14715,Butte,2020-12-16,86,1,87
14716,San Diego,2020-12-16,1126,60,1186
14717,Imperial,2020-12-16,165,0,165
14718,Nevada,2020-12-16,18,0,18
14719,Lassen,2020-12-16,7,0,7
14720,Los Angeles,2020-12-16,5100,366,5466
14721,Yuba,2020-12-16,53,1,54
14722,Santa Clara,2020-12-16,559,26,585
14723,San Francisco,2020-12-16,140,3,143
14724,Stanislaus,2020-12-16,334,20,354
14725,Inyo,2020-12-17,9,0,9
14726,Lassen,2020-12-17,6,0,6
14727,Calaveras,2020-12-17,4,0,4
14728,Humboldt,2020-12-17,7,4,11
14729,San Benito,2020-12-17,13,0,13
14730,Placer,2020-12-17,184,11,195
14731,Del Norte,2020-12-17,1,0,1
14732,Ventura,2020-12-17,240,19,259
14733,Tehama,2020-12-17,8,0,8
14734,Sutter,2020-12-17,0,0,0
14735,Monterey,2020-12-17,151,2,153
14736,El Dorado,2020-12-17,25,0,25
14737,Fresno,2020-12-17,553,39,592
14738,San Francisco,2020-12-17,152,9,161
14739,Los Angeles,2020-12-17,5424,339,5763
14740,Mendocino,2020-12-17,13,0,13
14741,Colusa,2020-12-17,5,0,5
14742,Nevada,2020-12-17,17,0,17
14743,Kings,2020-12-17,77,0,77
14744,Solano,2020-12-17,106,19,125
14745,Sonoma,2020-12-17,70,3,73
14746,Yuba,2020-12-17,54,0,54
14747,Trinity,2020-12-17,0,0,0
14748,Santa Clara,2020-12-17,561,27,588
14749,Marin,2020-12-17,31,2,33
14750,Orange,2020-12-17,1557,78,1635
14751,Santa Cruz,2020-12-17,59,0,59
14752,Alameda,2020-12-17,352,50,402
14753,San Bernardino,2020-12-17,1492,100,1592
14754,Glenn,2020-12-17,5,0,5
14755,Shasta,2020-12-17,70,4,74
14756,Santa Barbara,2020-12-17,98,5,103
14757,San Luis Obispo,2020-12-17,35,1,36
14758,Napa,2020-12-17,22,2,24
14759,Lake,2020-12-17,6,0,6
14760,Yolo,2020-12-17,23,0,23
14761,Butte,2020-12-17,84,0,84
14762,Kern,2020-12-17,315,5,320
14763,San Diego,2020-12-17,1164,55,1219
14764,Riverside,2020-12-17,1092,94,1186
14765,Madera,2020-12-17,42,2,44
14766,Mono,2020-12-17,1,0,1
14767,Tulare,2020-12-17,177,6,183
14768,Stanislaus,2020-12-17,340,14,354
14769,San Joaquin,2020-12-17,313,10,323
14770,Mariposa,2020-12-17,0,0,0
14771,Tuolumne,2020-12-17,6,0,6
14772,Merced,2020-12-17,58,0,58
14773,Modoc,2020-12-17,0,0,0
14774,Contra Costa,2020-12-17,197,15,212
14775,Amador,2020-12-17,13,0,13
14776,Siskiyou,2020-12-17,7,0,7
14777,Imperial,2020-12-17,174,0,174
14778,Sacramento,2020-12-17,471,22,493
14779,Plumas,2020-12-17,6,0,6
14780,San Mateo,2020-12-17,129,9,138
14781,San Luis Obispo,2020-12-18,38,1,39
14782,Sonoma,2020-12-18,75,2,77
14783,Plumas,2020-12-18,5,0,5
14784,Santa Clara,2020-12-18,592,25,617
14785,San Joaquin,2020-12-18,323,11,334
14786,Placer,2020-12-18,190,14,204
14787,Glenn,2020-12-18,5,0,5
14788,Amador,2020-12-18,12,0,12
14789,Orange,2020-12-18,1601,74,1675
14790,Kern,2020-12-18,312,5,317
14791,Calaveras,2020-12-18,5,0,5
14792,Mendocino,2020-12-18,13,0,13
14793,Tehama,2020-12-18,8,0,8
14794,Merced,2020-12-18,58,0,58
14795,Lassen,2020-12-18,6,0,6
14796,Inyo,2020-12-18,10,0,10
14797,Sacramento,2020-12-18,486,22,508
14798,Madera,2020-12-18,38,2,40
14799,Alameda,2020-12-18,353,49,402
14800,Santa Cruz,2020-12-18,58,0,58
14801,Shasta,2020-12-18,67,4,71
14802,Nevada,2020-12-18,17,1,18
14803,Marin,2020-12-18,29,2,31
14804,Los Angeles,2020-12-18,5549,323,5872
14805,Solano,2020-12-18,109,16,125
14806,Santa Barbara,2020-12-18,102,5,107
14807,Yuba,2020-12-18,54,0,54
14808,Trinity,2020-12-18,0,0,0
14809,Riverside,2020-12-18,1169,88,1257
14810,Stanislaus,2020-12-18,352,10,362
14811,San Diego,2020-12-18,1204,49,1253
14812,Del Norte,2020-12-18,2,0,2
14813,San Benito,2020-12-18,12,0,12
14814,San Francisco,2020-12-18,153,9,162
14815,Tulare,2020-12-18,185,8,193
14816,Humboldt,2020-12-18,9,1,10
14817,San Mateo,2020-12-18,139,14,153
14818,Lake,2020-12-18,8,0,8
14819,Kings,2020-12-18,77,0,77
14820,Modoc,2020-12-18,0,0,0
14821,Ventura,2020-12-18,243,13,256
14822,Contra Costa,2020-12-18,223,12,235
14823,Fresno,2020-12-18,565,33,598
14824,Mariposa,2020-12-18,0,0,0
14825,San Bernardino,2020-12-18,1508,137,1645
14826,Imperial,2020-12-18,179,0,179
14827,Colusa,2020-12-18,5,0,5
14828,Sutter,2020-12-18,0,0,0
14829,Siskiyou,2020-12-18,6,0,6
14830,Tuolumne,2020-12-18,6,0,6
14831,Yolo,2020-12-18,23,0,23
14832,El Dorado,2020-12-18,22,0,22
14833,Napa,2020-12-18,22,1,23
14834,Butte,2020-12-18,74,0,74
14835,Monterey,2020-12-18,164,2,166
14836,Mono,2020-12-18,0,0,0
14837,Imperial,2020-12-19,199,0,199
14838,Calaveras,2020-12-19,5,0,5
14839,San Diego,2020-12-19,1211,53,1264
14840,San Benito,2020-12-19,12,0,12
14841,Sutter,2020-12-19,0,0,0
14842,San Francisco,2020-12-19,164,6,170
14843,Napa,2020-12-19,19,0,19
14844,Lake,2020-12-19,10,0,10
14845,Santa Clara,2020-12-19,592,22,614
14846,Nevada,2020-12-19,17,3,20
14847,Stanislaus,2020-12-19,343,11,354
14848,Orange,2020-12-19,1682,75,1757
14849,Yolo,2020-12-19,23,1,24
14850,Placer,2020-12-19,189,12,201
14851,Mariposa,2020-12-19,0,0,0
14852,Siskiyou,2020-12-19,8,0,8
14853,Sonoma,2020-12-19,71,3,74
14854,Mendocino,2020-12-19,8,0,8
14855,Santa Cruz,2020-12-19,59,0,59
14856,Merced,2020-12-19,61,0,61
14857,Riverside,2020-12-19,1178,102,1280
14858,Tulare,2020-12-19,184,2,186
14859,Inyo,2020-12-19,10,0,10
14860,San Mateo,2020-12-19,136,11,147
14861,Yuba,2020-12-19,57,0,57
14862,Tehama,2020-12-19,9,0,9
14863,Shasta,2020-12-19,60,1,61
14864,Contra Costa,2020-12-19,228,11,239
14865,Del Norte,2020-12-19,2,0,2
14866,Plumas,2020-12-19,5,0,5
14867,Alameda,2020-12-19,359,42,401
14868,Modoc,2020-12-19,0,0,0
14869,Solano,2020-12-19,114,19,133
14870,San Bernardino,2020-12-19,1508,126,1634
14871,El Dorado,2020-12-19,21,0,21
14872,Santa Barbara,2020-12-19,105,3,108
14873,Butte,2020-12-19,90,0,90
14874,Fresno,2020-12-19,575,30,605
14875,Mono,2020-12-19,0,0,0
14876,Marin,2020-12-19,22,4,26
14877,Sacramento,2020-12-19,477,25,502
14878,Trinity,2020-12-19,0,0,0
14879,Kings,2020-12-19,92,0,92
14880,Madera,2020-12-19,40,4,44
14881,Lassen,2020-12-19,5,0,5
14882,Kern,2020-12-19,331,6,337
14883,Monterey,2020-12-19,171,2,173
14884,Colusa,2020-12-19,6,0,6
14885,Los Angeles,2020-12-19,5709,309,6018
14886,San Joaquin,2020-12-19,338,9,347
14887,Ventura,2020-12-19,265,14,279
14888,Tuolumne,2020-12-19,10,0,10
14889,Humboldt,2020-12-19,7,1,8
14890,Glenn,2020-12-19,5,0,5
14891,San Luis Obispo,2020-12-19,40,0,40
14892,Amador,2020-12-19,11,0,11
14893,San Joaquin,2020-12-20,333,6,339
14894,Butte,2020-12-20,88,1,89
14895,Imperial,2020-12-20,198,0,198
14896,San Benito,2020-12-20,15,0,15
14897,Fresno,2020-12-20,569,29,598
14898,Tehama,2020-12-20,10,0,10
14899,Mono,2020-12-20,0,0,0
14900,Sutter,2020-12-20,0,0,0
14901,Mendocino,2020-12-20,10,0,10
14902,San Luis Obispo,2020-12-20,39,0,39
14903,Del Norte,2020-12-20,2,0,2
14904,Siskiyou,2020-12-20,8,0,8
14905,Tuolumne,2020-12-20,11,0,11
14906,Mariposa,2020-12-20,0,0,0
14907,Colusa,2020-12-20,6,0,6
14908,Marin,2020-12-20,26,4,30
14909,Amador,2020-12-20,8,1,9
14910,Los Angeles,2020-12-20,5866,358,6224
14911,Trinity,2020-12-20,0,0,0
14912,Contra Costa,2020-12-20,236,14,250
14913,El Dorado,2020-12-20,21,1,22
14914,Nevada,2020-12-20,21,2,23
14915,Madera,2020-12-20,34,4,38
14916,Lake,2020-12-20,8,0,8
14917,Shasta,2020-12-20,60,0,60
14918,Inyo,2020-12-20,10,0,10
14919,San Diego,2020-12-20,1248,46,1294
14920,Riverside,2020-12-20,1239,94,1333
14921,Sacramento,2020-12-20,493,262,755
14922,Yolo,2020-12-20,26,1,27
14923,Humboldt,2020-12-20,7,3,10
14924,Sonoma,2020-12-20,66,3,69
14925,Yuba,2020-12-20,58,0,58
14926,Kern,2020-12-20,326,3,329
14927,Napa,2020-12-20,18,0,18
14928,Santa Clara,2020-12-20,599,24,623
14929,Tulare,2020-12-20,196,8,204
14930,Lassen,2020-12-20,5,0,5
14931,Santa Cruz,2020-12-20,60,0,60
14932,Glenn,2020-12-20,5,0,5
14933,Plumas,2020-12-20,4,0,4
14934,San Francisco,2020-12-20,170,5,175
14935,Orange,2020-12-20,1709,72,1781
14936,Alameda,2020-12-20,373,41,414
14937,Ventura,2020-12-20,262,16,278
14938,Calaveras,2020-12-20,6,0,6
14939,Monterey,2020-12-20,166,2,168
14940,Stanislaus,2020-12-20,346,9,355
14941,Modoc,2020-12-20,0,0,0
14942,Placer,2020-12-20,181,9,190
14943,Santa Barbara,2020-12-20,103,6,109
14944,Solano,2020-12-20,110,12,122
14945,San Bernardino,2020-12-20,1545,125,1670
14946,San Mateo,2020-12-20,133,8,141
14947,Merced,2020-12-20,67,0,67
14948,Kings,2020-12-20,90,0,90
14949,San Bernardino,2020-12-21,1618,101,1719
14950,San Mateo,2020-12-21,130,7,137
14951,Stanislaus,2020-12-21,365,8,373
14952,Santa Barbara,2020-12-21,113,5,118
14953,San Diego,2020-12-21,1314,61,1375
14954,Ventura,2020-12-21,273,8,281
14955,Alameda,2020-12-21,373,38,411
14956,Colusa,2020-12-21,12,0,12
14957,Sonoma,2020-12-21,62,3,65
14958,Sacramento,2020-12-21,500,262,762
14959,Inyo,2020-12-21,10,0,10
14960,Lassen,2020-12-21,5,0,5
14961,Santa Clara,2020-12-21,599,25,624
14962,El Dorado,2020-12-21,23,0,23
14963,Modoc,2020-12-21,0,0,0
14964,Napa,2020-12-21,20,0,20
14965,San Luis Obispo,2020-12-21,44,1,45
14966,Fresno,2020-12-21,587,28,615
14967,Imperial,2020-12-21,194,1,195
14968,Los Angeles,2020-12-21,6155,305,6460
14969,Calaveras,2020-12-21,6,0,6
14970,Humboldt,2020-12-21,6,3,9
14971,Mono,2020-12-21,0,0,0
14972,Yolo,2020-12-21,24,0,24
14973,Amador,2020-12-21,8,0,8
14974,Placer,2020-12-21,175,12,187
14975,Contra Costa,2020-12-21,238,17,255
14976,Yuba,2020-12-21,62,0,62
14977,Plumas,2020-12-21,5,0,5
14978,Tulare,2020-12-21,198,8,206
14979,Solano,2020-12-21,118,16,134
14980,Shasta,2020-12-21,57,0,57
14981,Lake,2020-12-21,7,0,7
14982,Del Norte,2020-12-21,2,0,2
14983,Mendocino,2020-12-21,14,0,14
14984,Glenn,2020-12-21,5,0,5
14985,Nevada,2020-12-21,17,0,17
14986,Santa Cruz,2020-12-21,60,0,60
14987,Sutter,2020-12-21,0,0,0
14988,Madera,2020-12-21,37,6,43
14989,Trinity,2020-12-21,0,0,0
14990,Kern,2020-12-21,348,7,355
14991,Tehama,2020-12-21,10,0,10
14992,Riverside,2020-12-21,1278,102,1380
14993,San Joaquin,2020-12-21,328,7,335
14994,San Francisco,2020-12-21,162,9,171
14995,San Benito,2020-12-21,15,0,15
14996,Butte,2020-12-21,95,0,95
14997,Orange,2020-12-21,1806,72,1878
14998,Kings,2020-12-21,87,0,87
14999,Siskiyou,2020-12-21,9,0,9
15000,Tuolumne,2020-12-21,10,0,10
15001,Marin,2020-12-21,28,4,32
15002,Monterey,2020-12-21,165,2,167
15003,Mariposa,2020-12-21,0,0,0
15004,Merced,2020-12-21,66,0,66
15005,Calaveras,2020-12-22,8,0,8
15006,Lake,2020-12-22,6,0,6
15007,Riverside,2020-12-22,1322,69,1391
15008,El Dorado,2020-12-22,26,0,26
15009,Fresno,2020-12-22,560,30,590
15010,Contra Costa,2020-12-22,237,16,253
15011,Orange,2020-12-22,1854,61,1915
15012,Madera,2020-12-22,43,4,47
15013,Mendocino,2020-12-22,16,0,16
15014,Ventura,2020-12-22,312,7,319
15015,Sutter,2020-12-22,0,0,0
15016,Modoc,2020-12-22,0,0,0
15017,Stanislaus,2020-12-22,349,11,360
15018,Los Angeles,2020-12-22,6499,321,6820
15019,Plumas,2020-12-22,6,0,6
15020,Del Norte,2020-12-22,2,0,2
15021,Colusa,2020-12-22,12,0,12
15022,Alameda,2020-12-22,388,40,428
15023,San Francisco,2020-12-22,157,9,166
15024,San Benito,2020-12-22,14,0,14
15025,Mono,2020-12-22,0,0,0
15026,Siskiyou,2020-12-22,6,0,6
15027,Lassen,2020-12-22,6,0,6
15028,Tulare,2020-12-22,202,10,212
15029,Shasta,2020-12-22,59,0,59
15030,Merced,2020-12-22,67,0,67
15031,Trinity,2020-12-22,0,0,0
15032,Monterey,2020-12-22,165,1,166
15033,Napa,2020-12-22,21,0,21
15034,San Mateo,2020-12-22,145,11,156
15035,San Diego,2020-12-22,1340,70,1410
15036,Santa Barbara,2020-12-22,123,3,126
15037,Marin,2020-12-22,25,2,27
15038,Santa Cruz,2020-12-22,65,0,65
15039,Sonoma,2020-12-22,77,1,78
15040,Yuba,2020-12-22,63,0,63
15041,Imperial,2020-12-22,205,0,205
15042,Placer,2020-12-22,185,18,203
15043,Santa Clara,2020-12-22,618,28,646
15044,San Joaquin,2020-12-22,323,15,338
15045,Butte,2020-12-22,88,0,88
15046,Sacramento,2020-12-22,518,21,539
15047,Mariposa,2020-12-22,0,0,0
15048,Solano,2020-12-22,137,16,153
15049,San Bernardino,2020-12-22,1635,119,1754
15050,San Luis Obispo,2020-12-22,49,1,50
15051,Glenn,2020-12-22,5,0,5
15052,Tehama,2020-12-22,13,0,13
15053,Kings,2020-12-22,83,0,83
15054,Inyo,2020-12-22,10,0,10
15055,Nevada,2020-12-22,15,0,15
15056,Kern,2020-12-22,342,3,345
15057,Yolo,2020-12-22,25,18,43
15058,Tuolumne,2020-12-22,7,0,7
15059,Amador,2020-12-22,9,0,9
15060,Humboldt,2020-12-22,6,8,14
15061,Santa Barbara,2020-12-23,124,5,129
15062,Kings,2020-12-23,83,0,83
15063,Tuolumne,2020-12-23,10,0,10
15064,Marin,2020-12-23,25,2,27
15065,Trinity,2020-12-23,0,0,0
15066,Kern,2020-12-23,328,10,338
15067,San Mateo,2020-12-23,157,8,165
15068,San Diego,2020-12-23,1404,62,1466
15069,Humboldt,2020-12-23,5,5,10
15070,El Dorado,2020-12-23,27,1,28
15071,Siskiyou,2020-12-23,4,0,4
15072,Nevada,2020-12-23,20,0,20
15073,San Benito,2020-12-23,15,0,15
15074,Mono,2020-12-23,0,0,0
15075,Del Norte,2020-12-23,2,0,2
15076,Inyo,2020-12-23,8,0,8
15077,Shasta,2020-12-23,52,0,52
15078,Santa Cruz,2020-12-23,63,0,63
15079,Sutter,2020-12-23,0,0,0
15080,Amador,2020-12-23,9,0,9
15081,San Joaquin,2020-12-23,333,13,346
15082,Plumas,2020-12-23,6,0,6
15083,Mendocino,2020-12-23,14,0,14
15084,Santa Clara,2020-12-23,635,22,657
15085,Solano,2020-12-23,137,15,152
15086,Los Angeles,2020-12-23,6708,292,7000
15087,Alameda,2020-12-23,403,46,449
15088,Modoc,2020-12-23,0,0,0
15089,Placer,2020-12-23,193,17,210
15090,Stanislaus,2020-12-23,342,12,354
15091,Merced,2020-12-23,60,0,60
15092,San Bernardino,2020-12-23,1642,107,1749
15093,Orange,2020-12-23,1893,73,1966
15094,San Luis Obispo,2020-12-23,48,2,50
15095,Colusa,2020-12-23,17,0,17
15096,Calaveras,2020-12-23,8,0,8
15097,Monterey,2020-12-23,155,3,158
15098,Yuba,2020-12-23,58,0,58
15099,Fresno,2020-12-23,629,37,666
15100,Madera,2020-12-23,45,9,54
15101,Mariposa,2020-12-23,1,0,1
15102,Napa,2020-12-23,20,0,20
15103,Lake,2020-12-23,6,0,6
15104,Sacramento,2020-12-23,512,22,534
15105,Contra Costa,2020-12-23,243,14,257
15106,Imperial,2020-12-23,197,0,197
15107,Sonoma,2020-12-23,74,3,77
15108,Yolo,2020-12-23,27,1,28
15109,Lassen,2020-12-23,5,0,5
15110,Butte,2020-12-23,81,0,81
15111,Glenn,2020-12-23,14,0,14
15112,Riverside,2020-12-23,1327,86,1413
15113,Ventura,2020-12-23,319,14,333
15114,Tehama,2020-12-23,15,0,15
15115,San Francisco,2020-12-23,164,11,175
15116,Tulare,2020-12-23,208,4,212
15117,Los Angeles,2020-12-24,6770,286,7056
15118,Modoc,2020-12-24,1,0,1
15119,Solano,2020-12-24,129,12,141
15120,Santa Barbara,2020-12-24,120,23,143
15121,Mendocino,2020-12-24,13,2,15
15122,Madera,2020-12-24,45,4,49
15123,San Diego,2020-12-24,1405,64,1469
15124,Sacramento,2020-12-24,475,19,494
15125,San Luis Obispo,2020-12-24,47,1,48
15126,Butte,2020-12-24,84,0,84
15127,Contra Costa,2020-12-24,242,16,258
15128,San Bernardino,2020-12-24,1641,90,1731
15129,Mariposa,2020-12-24,1,0,1
15130,Fresno,2020-12-24,621,29,650
15131,Kings,2020-12-24,83,0,83
15132,San Benito,2020-12-24,16,0,16
15133,Monterey,2020-12-24,176,3,179
15134,Amador,2020-12-24,10,0,10
15135,San Francisco,2020-12-24,171,11,182
15136,San Joaquin,2020-12-24,323,5,328
15137,Placer,2020-12-24,192,19,211
15138,Glenn,2020-12-24,14,0,14
15139,Nevada,2020-12-24,21,0,21
15140,Trinity,2020-12-24,0,0,0
15141,Siskiyou,2020-12-24,5,0,5
15142,Napa,2020-12-24,21,0,21
15143,Stanislaus,2020-12-24,342,7,349
15144,Plumas,2020-12-24,4,0,4
15145,Orange,2020-12-24,1955,51,2006
15146,Colusa,2020-12-24,17,0,17
15147,San Mateo,2020-12-24,149,8,157
15148,Sonoma,2020-12-24,78,3,81
15149,Marin,2020-12-24,30,6,36
15150,El Dorado,2020-12-24,25,0,25
15151,Tuolumne,2020-12-24,6,0,6
15152,Inyo,2020-12-24,9,0,9
15153,Shasta,2020-12-24,45,3,48
15154,Mono,2020-12-24,0,0,0
15155,Santa Clara,2020-12-24,629,21,650
15156,Santa Cruz,2020-12-24,67,2,69
15157,Humboldt,2020-12-24,6,4,10
15158,Yuba,2020-12-24,57,0,57
15159,Lassen,2020-12-24,6,0,6
15160,Yolo,2020-12-24,29,0,29
15161,Lake,2020-12-24,6,0,6
15162,Calaveras,2020-12-24,6,0,6
15163,Del Norte,2020-12-24,2,0,2
15164,Kern,2020-12-24,326,3,329
15165,Tehama,2020-12-24,14,0,14
15166,Sutter,2020-12-24,0,0,0
15167,Merced,2020-12-24,54,0,54
15168,Tulare,2020-12-24,198,7,205
15169,Alameda,2020-12-24,385,37,422
15170,Riverside,2020-12-24,1336,85,1421
15171,Ventura,2020-12-24,333,13,346
15172,Imperial,2020-12-24,197,0,197
15173,Humboldt,2020-12-25,6,4,10
15174,Santa Clara,2020-12-25,633,19,652
15175,Siskiyou,2020-12-25,8,0,8
15176,Mendocino,2020-12-25,12,0,12
15177,Stanislaus,2020-12-25,349,11,360
15178,Kings,2020-12-25,82,0,82
15179,Riverside,2020-12-25,1335,85,1420
15180,San Mateo,2020-12-25,142,6,148
15181,Nevada,2020-12-25,22,0,22
15182,El Dorado,2020-12-25,26,0,26
15183,Ventura,2020-12-25,325,13,338
15184,Alameda,2020-12-25,389,38,427
15185,Los Angeles,2020-12-25,6815,309,7124
15186,Monterey,2020-12-25,168,2,170
15187,Santa Cruz,2020-12-25,68,2,70
15188,Kern,2020-12-25,333,5,338
15189,Mono,2020-12-25,0,0,0
15190,Contra Costa,2020-12-25,249,16,265
15191,Placer,2020-12-25,192,8,200
15192,Tulare,2020-12-25,199,3,202
15193,San Bernardino,2020-12-25,1625,95,1720
15194,Sutter,2020-12-25,0,0,0
15195,Inyo,2020-12-25,7,0,7
15196,Merced,2020-12-25,49,0,49
15197,San Luis Obispo,2020-12-25,46,3,49
15198,Shasta,2020-12-25,43,4,47
15199,Modoc,2020-12-25,1,0,1
15200,Yuba,2020-12-25,60,2,62
15201,Trinity,2020-12-25,0,0,0
15202,Plumas,2020-12-25,3,0,3
15203,Del Norte,2020-12-25,3,0,3
15204,Imperial,2020-12-25,185,0,185
15205,San Diego,2020-12-25,1416,41,1457
15206,Amador,2020-12-25,7,1,8
15207,Yolo,2020-12-25,25,47,72
15208,Mariposa,2020-12-25,1,0,1
15209,Tuolumne,2020-12-25,6,0,6
15210,San Benito,2020-12-25,16,0,16
15211,Tehama,2020-12-25,16,0,16
15212,Glenn,2020-12-25,16,1,17
15213,Solano,2020-12-25,133,11,144
15214,Calaveras,2020-12-25,5,0,5
15215,Orange,2020-12-25,1957,54,2011
15216,Sonoma,2020-12-25,68,1,69
15217,Napa,2020-12-25,22,0,22
15218,Lassen,2020-12-25,6,0,6
15219,Madera,2020-12-25,47,5,52
15220,Butte,2020-12-25,91,0,91
15221,Fresno,2020-12-25,617,23,640
15222,Marin,2020-12-25,30,6,36
15223,Sacramento,2020-12-25,473,20,493
15224,Colusa,2020-12-25,14,0,14
15225,San Joaquin,2020-12-25,316,11,327
15226,Lake,2020-12-25,5,0,5
15227,San Francisco,2020-12-25,164,5,169
15228,Santa Barbara,2020-12-25,117,3,120
15229,Santa Barbara,2020-12-26,121,4,125
15230,El Dorado,2020-12-26,25,0,25
15231,Shasta,2020-12-26,47,1,48
15232,Yuba,2020-12-26,65,2,67
15233,Tulare,2020-12-26,200,5,205
15234,Sonoma,2020-12-26,70,0,70
15235,Mariposa,2020-12-26,1,0,1
15236,Tehama,2020-12-26,19,0,19
15237,San Benito,2020-12-26,16,0,16
15238,Stanislaus,2020-12-26,348,17,365
15239,Los Angeles,2020-12-26,6914,303,7217
15240,Siskiyou,2020-12-26,6,0,6
15241,Ventura,2020-12-26,336,20,356
15242,Kings,2020-12-26,88,0,88
15243,San Diego,2020-12-26,1440,41,1481
15244,Imperial,2020-12-26,174,2,176
15245,Plumas,2020-12-26,3,0,3
15246,Madera,2020-12-26,44,1,45
15247,Yolo,2020-12-26,29,0,29
15248,Placer,2020-12-26,192,11,203
15249,Mono,2020-12-26,1,0,1
15250,Butte,2020-12-26,100,0,100
15251,Inyo,2020-12-26,9,0,9
15252,Modoc,2020-12-26,1,0,1
15253,Santa Cruz,2020-12-26,64,0,64
15254,San Joaquin,2020-12-26,320,12,332
15255,Fresno,2020-12-26,620,32,652
15256,Humboldt,2020-12-26,5,2,7
15257,Lake,2020-12-26,8,1,9
15258,Contra Costa,2020-12-26,242,24,266
15259,Orange,2020-12-26,1990,56,2046
15260,Calaveras,2020-12-26,4,0,4
15261,Trinity,2020-12-26,0,0,0
15262,Merced,2020-12-26,51,0,51
15263,Sacramento,2020-12-26,452,27,479
15264,Lassen,2020-12-26,7,0,7
15265,Solano,2020-12-26,141,9,150
15266,San Bernardino,2020-12-26,1617,82,1699
15267,Nevada,2020-12-26,21,1,22
15268,San Mateo,2020-12-26,146,2,148
15269,Colusa,2020-12-26,14,0,14
15270,Napa,2020-12-26,23,3,26
15271,Tuolumne,2020-12-26,6,0,6
15272,Sutter,2020-12-26,0,0,0
15273,Kern,2020-12-26,357,9,366
15274,San Luis Obispo,2020-12-26,49,2,51
15275,Alameda,2020-12-26,412,37,449
15276,Mendocino,2020-12-26,14,0,14
15277,Marin,2020-12-26,26,3,29
15278,San Francisco,2020-12-26,172,3,175
15279,Del Norte,2020-12-26,3,0,3
15280,Monterey,2020-12-26,180,2,182
15281,Riverside,2020-12-26,1382,89,1471
15282,Amador,2020-12-26,9,0,9
15283,Santa Clara,2020-12-26,637,18,655
15284,Glenn,2020-12-26,16,1,17
15285,Sutter,2020-12-27,0,0,0
15286,Santa Cruz,2020-12-27,70,0,70
15287,Trinity,2020-12-27,0,0,0
15288,San Luis Obispo,2020-12-27,56,1,57
15289,Amador,2020-12-27,9,0,9
15290,Sacramento,2020-12-27,463,27,490
15291,San Diego,2020-12-27,1481,45,1526
15292,Inyo,2020-12-27,11,0,11
15293,Marin,2020-12-27,24,4,28
15294,Merced,2020-12-27,54,0,54
15295,Placer,2020-12-27,201,14,215
15296,Calaveras,2020-12-27,3,0,3
15297,Kern,2020-12-27,375,9,384
15298,Humboldt,2020-12-27,6,3,9
15299,Butte,2020-12-27,84,0,84
15300,San Joaquin,2020-12-27,327,11,338
15301,Del Norte,2020-12-27,3,0,3
15302,Glenn,2020-12-27,16,1,17
15303,Yuba,2020-12-27,68,1,69
15304,Orange,2020-12-27,2031,52,2083
15305,Napa,2020-12-27,24,1,25
15306,Tuolumne,2020-12-27,7,1,8
15307,Modoc,2020-12-27,1,0,1
15308,Kings,2020-12-27,90,0,90
15309,San Mateo,2020-12-27,152,8,160
15310,Mono,2020-12-27,1,0,1
15311,Fresno,2020-12-27,625,41,666
15312,Ventura,2020-12-27,341,17,358
15313,Solano,2020-12-27,136,9,145
15314,Colusa,2020-12-27,14,0,14
15315,Tehama,2020-12-27,22,0,22
15316,Nevada,2020-12-27,19,0,19
15317,Plumas,2020-12-27,2,0,2
15318,Santa Clara,2020-12-27,661,23,684
15319,Los Angeles,2020-12-27,7181,332,7513
15320,San Benito,2020-12-27,16,0,16
15321,Stanislaus,2020-12-27,352,11,363
15322,Lake,2020-12-27,8,0,8
15323,Alameda,2020-12-27,418,35,453
15324,Madera,2020-12-27,45,5,50
15325,San Francisco,2020-12-27,179,5,184
15326,Yolo,2020-12-27,29,0,29
15327,Riverside,2020-12-27,1367,106,1473
15328,Mendocino,2020-12-27,12,1,13
15329,Santa Barbara,2020-12-27,127,7,134
15330,Monterey,2020-12-27,179,0,179
15331,Shasta,2020-12-27,46,1,47
15332,Siskiyou,2020-12-27,5,0,5
15333,Imperial,2020-12-27,190,2,192
15334,El Dorado,2020-12-27,28,0,28
15335,San Bernardino,2020-12-27,1655,72,1727
15336,Contra Costa,2020-12-27,257,23,280
15337,Lassen,2020-12-27,5,0,5
15338,Tulare,2020-12-27,215,5,220
15339,Mariposa,2020-12-27,1,0,1
15340,Sonoma,2020-12-27,74,3,77
15341,Placer,2020-12-28,206,20,226
15342,San Francisco,2020-12-28,186,6,192
15343,Los Angeles,2020-12-28,7415,297,7712
15344,Modoc,2020-12-28,1,0,1
15345,Tulare,2020-12-28,218,12,230
15346,San Bernardino,2020-12-28,1738,83,1821
15347,San Mateo,2020-12-28,157,8,165
15348,Calaveras,2020-12-28,1,0,1
15349,San Luis Obispo,2020-12-28,65,2,67
15350,Siskiyou,2020-12-28,5,0,5
15351,Riverside,2020-12-28,1448,93,1541
15352,Mono,2020-12-28,0,0,0
15353,San Benito,2020-12-28,15,0,15
15354,Santa Cruz,2020-12-28,71,0,71
15355,Contra Costa,2020-12-28,249,11,260
15356,Nevada,2020-12-28,18,0,18
15357,Humboldt,2020-12-28,7,5,12
15358,Yuba,2020-12-28,67,0,67
15359,Madera,2020-12-28,47,5,52
15360,Mendocino,2020-12-28,10,0,10
15361,Glenn,2020-12-28,16,1,17
15362,Marin,2020-12-28,28,4,32
15363,Monterey,2020-12-28,191,0,191
15364,Napa,2020-12-28,23,2,25
15365,Butte,2020-12-28,77,0,77
15366,Fresno,2020-12-28,637,40,677
15367,Mariposa,2020-12-28,1,0,1
15368,Lassen,2020-12-28,5,0,5
15369,Colusa,2020-12-28,14,0,14
15370,Sutter,2020-12-28,0,0,0
15371,Shasta,2020-12-28,42,0,42
15372,Imperial,2020-12-28,182,3,185
15373,Solano,2020-12-28,137,9,146
15374,Santa Clara,2020-12-28,690,24,714
15375,Lake,2020-12-28,8,0,8
15376,Sacramento,2020-12-28,484,23,507
15377,Sonoma,2020-12-28,76,2,78
15378,Inyo,2020-12-28,11,0,11
15379,Stanislaus,2020-12-28,352,15,367
15380,Santa Barbara,2020-12-28,129,7,136
15381,El Dorado,2020-12-28,26,0,26
15382,Alameda,2020-12-28,441,32,473
15383,Orange,2020-12-28,2106,56,2162
15384,Merced,2020-12-28,55,0,55
15385,Ventura,2020-12-28,354,11,365
15386,Trinity,2020-12-28,0,0,0
15387,Amador,2020-12-28,9,0,9
15388,Del Norte,2020-12-28,2,0,2
15389,San Joaquin,2020-12-28,331,10,341
15390,Tuolumne,2020-12-28,8,1,9
15391,Plumas,2020-12-28,2,0,2
15392,Kings,2020-12-28,90,1,91
15393,Tehama,2020-12-28,23,0,23
15394,Kern,2020-12-28,388,11,399
15395,San Diego,2020-12-28,1504,56,1560
15396,Yolo,2020-12-28,24,0,24
15397,Lassen,2020-12-29,5,0,5
15398,San Joaquin,2020-12-29,329,12,341
15399,Amador,2020-12-29,10,0,10
15400,Shasta,2020-12-29,45,0,45
15401,Butte,2020-12-29,73,0,73
15402,San Francisco,2020-12-29,206,6,212
15403,Mendocino,2020-12-29,11,0,11
15404,Sonoma,2020-12-29,81,3,84
15405,Kings,2020-12-29,94,0,94
15406,El Dorado,2020-12-29,29,0,29
15407,Stanislaus,2020-12-29,329,16,345
15408,Santa Clara,2020-12-29,701,19,720
15409,Orange,2020-12-29,2145,44,2189
15410,Los Angeles,2020-12-29,7546,279,7825
15411,Glenn,2020-12-29,15,0,15
15412,Alameda,2020-12-29,449,32,481
15413,Santa Barbara,2020-12-29,135,6,141
15414,Yuba,2020-12-29,72,0,72
15415,Sutter,2020-12-29,0,0,0
15416,Placer,2020-12-29,216,15,231
15417,Ventura,2020-12-29,357,14,371
15418,Santa Cruz,2020-12-29,74,0,74
15419,Calaveras,2020-12-29,3,0,3
15420,Inyo,2020-12-29,10,0,10
15421,Tulare,2020-12-29,223,7,230
15422,Trinity,2020-12-29,0,0,0
15423,Yolo,2020-12-29,22,0,22
15424,Siskiyou,2020-12-29,2,0,2
15425,Solano,2020-12-29,142,13,155
15426,San Mateo,2020-12-29,168,5,173
15427,Monterey,2020-12-29,202,2,204
15428,Madera,2020-12-29,48,8,56
15429,Plumas,2020-12-29,2,0,2
15430,Kern,2020-12-29,383,7,390
15431,Fresno,2020-12-29,629,23,652
15432,Tuolumne,2020-12-29,10,1,11
15433,Lake,2020-12-29,7,0,7
15434,Merced,2020-12-29,56,0,56
15435,Humboldt,2020-12-29,7,3,10
15436,Contra Costa,2020-12-29,247,15,262
15437,San Bernardino,2020-12-29,1770,88,1858
15438,Imperial,2020-12-29,176,2,178
15439,San Benito,2020-12-29,13,0,13
15440,Napa,2020-12-29,26,1,27
15441,Mariposa,2020-12-29,1,0,1
15442,Tehama,2020-12-29,22,0,22
15443,San Luis Obispo,2020-12-29,61,0,61
15444,Colusa,2020-12-29,6,1,7
15445,Nevada,2020-12-29,15,0,15
15446,Riverside,2020-12-29,1484,84,1568
15447,Modoc,2020-12-29,1,0,1
15448,Marin,2020-12-29,30,4,34
15449,Del Norte,2020-12-29,3,0,3
15450,Mono,2020-12-29,0,0,0
15451,San Diego,2020-12-29,1470,62,1532
15452,Sacramento,2020-12-29,451,49,500
15453,Santa Cruz,2020-12-30,76,0,76
15454,Yuba,2020-12-30,73,25,98
15455,Santa Barbara,2020-12-30,141,6,147
15456,Kings,2020-12-30,90,1,91
15457,Siskiyou,2020-12-30,4,0,4
15458,Sonoma,2020-12-30,88,2,90
15459,Butte,2020-12-30,83,0,83
15460,San Luis Obispo,2020-12-30,58,1,59
15461,Plumas,2020-12-30,2,0,2
15462,Monterey,2020-12-30,198,1,199
15463,Stanislaus,2020-12-30,328,15,343
15464,Calaveras,2020-12-30,4,0,4
15465,Madera,2020-12-30,51,12,63
15466,Sutter,2020-12-30,0,0,0
15467,Del Norte,2020-12-30,4,0,4
15468,San Francisco,2020-12-30,212,3,215
15469,Fresno,2020-12-30,602,19,621
15470,Humboldt,2020-12-30,5,2,7
15471,Contra Costa,2020-12-30,255,16,271
15472,Glenn,2020-12-30,14,0,14
15473,Marin,2020-12-30,31,4,35
15474,Placer,2020-12-30,200,15,215
15475,Amador,2020-12-30,9,1,10
15476,El Dorado,2020-12-30,29,0,29
15477,San Mateo,2020-12-30,172,6,178
15478,Riverside,2020-12-30,1464,82,1546
15479,Mono,2020-12-30,0,0,0
15480,Los Angeles,2020-12-30,7628,300,7928
15481,Nevada,2020-12-30,13,0,13
15482,San Bernardino,2020-12-30,1707,78,1785
15483,Merced,2020-12-30,56,0,56
15484,Kern,2020-12-30,376,8,384
15485,Alameda,2020-12-30,454,42,496
15486,San Diego,2020-12-30,1499,50,1549
15487,Colusa,2020-12-30,6,0,6
15488,Imperial,2020-12-30,176,2,178
15489,Solano,2020-12-30,138,12,150
15490,Mariposa,2020-12-30,1,0,1
15491,Tehama,2020-12-30,22,0,22
15492,Sacramento,2020-12-30,491,20,511
15493,Napa,2020-12-30,30,1,31
15494,Tuolumne,2020-12-30,10,0,10
15495,Yolo,2020-12-30,25,0,25
15496,Santa Clara,2020-12-30,695,20,715
15497,Inyo,2020-12-30,9,0,9
15498,San Joaquin,2020-12-30,323,10,333
15499,Tulare,2020-12-30,218,9,227
15500,Lake,2020-12-30,8,0,8
15501,Modoc,2020-12-30,1,0,1
15502,Lassen,2020-12-30,5,0,5
15503,Trinity,2020-12-30,0,0,0
15504,San Benito,2020-12-30,14,0,14
15505,Mendocino,2020-12-30,11,0,11
15506,Orange,2020-12-30,2128,41,2169
15507,Shasta,2020-12-30,39,0,39
15508,Ventura,2020-12-30,364,20,384
15509,Merced,2020-12-31,57,1,58
15510,San Diego,2020-12-31,1487,56,1543
15511,San Benito,2020-12-31,14,0,14
15512,Siskiyou,2020-12-31,5,0,5
15513,Nevada,2020-12-31,10,0,10
15514,Humboldt,2020-12-31,4,3,7
15515,Alameda,2020-12-31,454,43,497
15516,Tulare,2020-12-31,225,13,238
15517,Santa Clara,2020-12-31,687,26,713
15518,Sonoma,2020-12-31,90,2,92
15519,Santa Cruz,2020-12-31,78,0,78
15520,Trinity,2020-12-31,0,0,0
15521,Napa,2020-12-31,28,0,28
15522,Calaveras,2020-12-31,3,0,3
15523,Colusa,2020-12-31,5,0,5
15524,Madera,2020-12-31,50,15,65
15525,Santa Barbara,2020-12-31,137,11,148
15526,Tehama,2020-12-31,21,0,21
15527,Monterey,2020-12-31,189,1,190
15528,Butte,2020-12-31,74,1,75
15529,Lassen,2020-12-31,6,0,6
15530,San Joaquin,2020-12-31,309,14,323
15531,Los Angeles,2020-12-31,7627,270,7897
15532,Placer,2020-12-31,188,13,201
15533,Solano,2020-12-31,149,11,160
15534,Inyo,2020-12-31,7,0,7
15535,Mariposa,2020-12-31,0,0,0
15536,Tuolumne,2020-12-31,9,0,9
15537,Modoc,2020-12-31,1,0,1
15538,Yolo,2020-12-31,25,0,25
15539,El Dorado,2020-12-31,33,0,33
15540,Riverside,2020-12-31,1516,123,1639
15541,Plumas,2020-12-31,2,0,2
15542,Contra Costa,2020-12-31,254,15,269
15543,Ventura,2020-12-31,359,15,374
15544,Shasta,2020-12-31,35,0,35
15545,San Luis Obispo,2020-12-31,62,1,63
15546,Sacramento,2020-12-31,467,27,494
15547,Mono,2020-12-31,0,0,0
15548,Amador,2020-12-31,10,0,10
15549,Glenn,2020-12-31,11,0,11
15550,Yuba,2020-12-31,69,23,92
15551,Kings,2020-12-31,79,1,80
15552,Fresno,2020-12-31,606,22,628
15553,San Bernardino,2020-12-31,1705,97,1802
15554,Del Norte,2020-12-31,4,0,4
15555,San Francisco,2020-12-31,207,8,215
15556,Orange,2020-12-31,2097,50,2147
15557,Sutter,2020-12-31,0,0,0
15558,Mendocino,2020-12-31,13,0,13
15559,Imperial,2020-12-31,167,1,168
15560,Kern,2020-12-31,379,8,387
15561,Marin,2020-12-31,38,4,42
15562,San Mateo,2020-12-31,162,5,167
15563,Lake,2020-12-31,11,0,11
15564,Stanislaus,2020-12-31,315,13,328
15565,Marin,2021-01-01,37,3,40
15566,Kings,2021-01-01,81,0,81
15567,Sonoma,2021-01-01,94,4,98
15568,Calaveras,2021-01-01,2,0,2
15569,El Dorado,2021-01-01,33,0,33
15570,Butte,2021-01-01,81,2,83
15571,Ventura,2021-01-01,359,16,375
15572,Colusa,2021-01-01,5,0,5
15573,Yuba,2021-01-01,69,17,86
15574,Santa Cruz,2021-01-01,77,0,77
15575,Placer,2021-01-01,193,13,206
15576,Yolo,2021-01-01,24,0,24
15577,San Diego,2021-01-01,1497,63,1560
15578,Stanislaus,2021-01-01,325,9,334
15579,Santa Clara,2021-01-01,682,21,703
15580,Tuolumne,2021-01-01,14,0,14
15581,Tehama,2021-01-01,22,0,22
15582,Inyo,2021-01-01,6,1,7
15583,Del Norte,2021-01-01,3,0,3
15584,Monterey,2021-01-01,194,0,194
15585,Madera,2021-01-01,49,3,52
15586,San Benito,2021-01-01,16,0,16
15587,Mariposa,2021-01-01,0,0,0
15588,Humboldt,2021-01-01,5,2,7
15589,Mendocino,2021-01-01,12,0,12
15590,Trinity,2021-01-01,0,0,0
15591,Mono,2021-01-01,0,0,0
15592,San Joaquin,2021-01-01,300,13,313
15593,Kern,2021-01-01,364,10,374
15594,Fresno,2021-01-01,597,20,617
15595,Nevada,2021-01-01,10,4,14
15596,Los Angeles,2021-01-01,7544,280,7824
15597,Alameda,2021-01-01,430,38,468
15598,Sacramento,2021-01-01,469,29,498
15599,Imperial,2021-01-01,176,0,176
15600,Santa Barbara,2021-01-01,136,7,143
15601,Merced,2021-01-01,53,0,53
15602,Napa,2021-01-01,30,0,30
15603,Amador,2021-01-01,10,0,10
15604,Contra Costa,2021-01-01,251,12,263
15605,San Bernardino,2021-01-01,1676,86,1762
15606,Modoc,2021-01-01,2,0,2
15607,Sutter,2021-01-01,0,0,0
15608,Orange,2021-01-01,2057,55,2112
15609,San Francisco,2021-01-01,209,5,214
15610,Siskiyou,2021-01-01,5,0,5
15611,Lassen,2021-01-01,5,0,5
15612,Lake,2021-01-01,9,0,9
15613,San Mateo,2021-01-01,171,6,177
15614,Plumas,2021-01-01,2,0,2
15615,Shasta,2021-01-01,40,1,41
15616,San Luis Obispo,2021-01-01,50,2,52
15617,Glenn,2021-01-01,11,0,11
15618,Riverside,2021-01-01,1486,117,1603
15619,Solano,2021-01-01,146,13,159
15620,Tulare,2021-01-01,225,7,232
15621,Monterey,2021-01-02,195,0,195
15622,El Dorado,2021-01-02,35,2,37
15623,Colusa,2021-01-02,5,0,5
15624,Los Angeles,2021-01-02,7697,274,7971
15625,San Francisco,2021-01-02,214,5,219
15626,Butte,2021-01-02,87,1,88
15627,Stanislaus,2021-01-02,331,8,339
15628,Mono,2021-01-02,0,0,0
15629,Merced,2021-01-02,54,0,54
15630,Contra Costa,2021-01-02,251,15,266
15631,Marin,2021-01-02,36,3,39
15632,Santa Cruz,2021-01-02,76,0,76
15633,Fresno,2021-01-02,601,27,628
15634,Santa Clara,2021-01-02,689,20,709
15635,Inyo,2021-01-02,6,1,7
15636,Plumas,2021-01-02,1,0,1
15637,Orange,2021-01-02,2136,36,2172
15638,Riverside,2021-01-02,1523,107,1630
15639,Humboldt,2021-01-02,6,3,9
15640,Kings,2021-01-02,85,0,85
15641,Tuolumne,2021-01-02,11,0,11
15642,Yuba,2021-01-02,69,12,81
15643,San Mateo,2021-01-02,170,12,182
15644,Del Norte,2021-01-02,4,0,4
15645,Nevada,2021-01-02,8,3,11
15646,Siskiyou,2021-01-02,5,0,5
15647,Trinity,2021-01-02,0,0,0
15648,San Bernardino,2021-01-02,1715,65,1780
15649,Tehama,2021-01-02,26,0,26
15650,Sutter,2021-01-02,0,0,0
15651,Santa Barbara,2021-01-02,143,9,152
15652,Alameda,2021-01-02,428,48,476
15653,Shasta,2021-01-02,39,2,41
15654,Sacramento,2021-01-02,451,29,480
15655,Amador,2021-01-02,11,0,11
15656,Modoc,2021-01-02,2,0,2
15657,Ventura,2021-01-02,366,18,384
15658,San Joaquin,2021-01-02,307,5,312
15659,San Diego,2021-01-02,1486,57,1543
15660,Madera,2021-01-02,50,9,59
15661,San Benito,2021-01-02,16,0,16
15662,Mariposa,2021-01-02,0,0,0
15663,Glenn,2021-01-02,11,0,11
15664,Kern,2021-01-02,375,8,383
15665,Calaveras,2021-01-02,3,0,3
15666,Sonoma,2021-01-02,93,1,94
15667,Tulare,2021-01-02,223,4,227
15668,Solano,2021-01-02,157,15,172
15669,Lake,2021-01-02,9,0,9
15670,Placer,2021-01-02,182,18,200
15671,Lassen,2021-01-02,5,0,5
15672,Napa,2021-01-02,29,1,30
15673,Yolo,2021-01-02,24,0,24
15674,Imperial,2021-01-02,182,0,182
15675,Mendocino,2021-01-02,13,0,13
15676,San Luis Obispo,2021-01-02,49,2,51
15677,Yolo,2021-01-03,29,0,29
15678,Merced,2021-01-03,57,0,57
15679,Modoc,2021-01-03,2,0,2
15680,San Benito,2021-01-03,11,0,11
15681,San Joaquin,2021-01-03,298,5,303
15682,Alameda,2021-01-03,425,41,466
15683,Stanislaus,2021-01-03,344,11,355
15684,Del Norte,2021-01-03,4,0,4
15685,San Mateo,2021-01-03,179,9,188
15686,Santa Barbara,2021-01-03,157,7,164
15687,Siskiyou,2021-01-03,5,0,5
15688,Placer,2021-01-03,176,16,192
15689,Yuba,2021-01-03,71,7,78
15690,Nevada,2021-01-03,8,3,11
15691,Lassen,2021-01-03,5,0,5
15692,Colusa,2021-01-03,3,1,4
15693,Plumas,2021-01-03,1,0,1
15694,Mono,2021-01-03,0,0,0
15695,San Bernardino,2021-01-03,1733,76,1809
15696,Mariposa,2021-01-03,1,0,1
15697,Butte,2021-01-03,86,1,87
15698,Mendocino,2021-01-03,12,0,12
15699,El Dorado,2021-01-03,35,0,35
15700,San Francisco,2021-01-03,206,5,211
15701,Sutter,2021-01-03,0,0,0
15702,Santa Cruz,2021-01-03,82,0,82
15703,Fresno,2021-01-03,620,43,663
15704,Shasta,2021-01-03,42,0,42
15705,Santa Clara,2021-01-03,704,20,724
15706,Kern,2021-01-03,384,11,395
15707,Trinity,2021-01-03,0,0,0
15708,Contra Costa,2021-01-03,259,13,272
15709,Marin,2021-01-03,39,2,41
15710,Orange,2021-01-03,2178,40,2218
15711,Riverside,2021-01-03,1543,117,1660
15712,Napa,2021-01-03,30,0,30
15713,San Diego,2021-01-03,1507,52,1559
15714,Ventura,2021-01-03,377,23,400
15715,Amador,2021-01-03,11,0,11
15716,Tehama,2021-01-03,22,0,22
15717,Kings,2021-01-03,84,0,84
15718,San Luis Obispo,2021-01-03,52,1,53
15719,Sonoma,2021-01-03,98,0,98
15720,Imperial,2021-01-03,170,0,170
15721,Madera,2021-01-03,53,7,60
15722,Humboldt,2021-01-03,7,3,10
15723,Inyo,2021-01-03,7,0,7
15724,Solano,2021-01-03,166,13,179
15725,Sacramento,2021-01-03,488,36,524
15726,Los Angeles,2021-01-03,7898,305,8203
15727,Glenn,2021-01-03,10,0,10
15728,Tulare,2021-01-03,224,7,231
15729,Calaveras,2021-01-03,3,0,3
15730,Tuolumne,2021-01-03,11,0,11
15731,Lake,2021-01-03,8,0,8
15732,Monterey,2021-01-03,203,0,203
15733,Sacramento,2021-01-04,465,33,498
15734,San Francisco,2021-01-04,211,5,216
15735,Glenn,2021-01-04,10,0,10
15736,Kings,2021-01-04,96,0,96
15737,Trinity,2021-01-04,0,0,0
15738,Orange,2021-01-04,2236,42,2278
15739,Modoc,2021-01-04,2,0,2
15740,San Joaquin,2021-01-04,324,9,333
15741,San Benito,2021-01-04,11,0,11
15742,San Mateo,2021-01-04,178,8,186
15743,Mono,2021-01-04,0,0,0
15744,Tuolumne,2021-01-04,12,0,12
15745,Inyo,2021-01-04,8,0,8
15746,Mariposa,2021-01-04,1,0,1
15747,Lassen,2021-01-04,6,0,6
15748,Siskiyou,2021-01-04,4,0,4
15749,San Bernardino,2021-01-04,1763,93,1856
15750,Madera,2021-01-04,53,9,62
15751,Plumas,2021-01-04,1,0,1
15752,Solano,2021-01-04,170,16,186
15753,Nevada,2021-01-04,9,1,10
15754,Monterey,2021-01-04,198,1,199
15755,Amador,2021-01-04,12,0,12
15756,Tulare,2021-01-04,231,5,236
15757,Tehama,2021-01-04,18,0,18
15758,Placer,2021-01-04,178,15,193
15759,Yolo,2021-01-04,28,0,28
15760,Humboldt,2021-01-04,7,3,10
15761,Santa Cruz,2021-01-04,86,0,86
15762,Santa Barbara,2021-01-04,172,8,180
15763,San Luis Obispo,2021-01-04,58,0,58
15764,Imperial,2021-01-04,181,0,181
15765,Marin,2021-01-04,34,4,38
15766,Colusa,2021-01-04,4,0,4
15767,Mendocino,2021-01-04,13,0,13
15768,Merced,2021-01-04,60,0,60
15769,Sutter,2021-01-04,0,0,0
15770,Del Norte,2021-01-04,4,0,4
15771,Calaveras,2021-01-04,3,0,3
15772,El Dorado,2021-01-04,38,0,38
15773,Riverside,2021-01-04,1615,122,1737
15774,Alameda,2021-01-04,424,57,481
15775,Kern,2021-01-04,401,5,406
15776,Santa Clara,2021-01-04,719,19,738
15777,Butte,2021-01-04,84,1,85
15778,San Diego,2021-01-04,1537,48,1585
15779,Sonoma,2021-01-04,102,0,102
15780,Lake,2021-01-04,9,0,9
15781,Shasta,2021-01-04,45,0,45
15782,Yuba,2021-01-04,68,2,70
15783,Contra Costa,2021-01-04,269,19,288
15784,Los Angeles,2021-01-04,8023,295,8318
15785,Fresno,2021-01-04,640,46,686
15786,Napa,2021-01-04,27,0,27
15787,Stanislaus,2021-01-04,355,7,362
15788,Ventura,2021-01-04,394,15,409
15789,Los Angeles,2021-01-05,8098,324,8422
15790,Shasta,2021-01-05,51,0,51
15791,Marin,2021-01-05,36,4,40
15792,Mariposa,2021-01-05,1,0,1
15793,Butte,2021-01-05,96,0,96
15794,San Benito,2021-01-05,13,0,13
15795,Tuolumne,2021-01-05,11,0,11
15796,Siskiyou,2021-01-05,5,0,5
15797,Nevada,2021-01-05,12,0,12
15798,Santa Barbara,2021-01-05,167,6,173
15799,Merced,2021-01-05,58,0,58
15800,Madera,2021-01-05,55,5,60
15801,Glenn,2021-01-05,6,0,6
15802,Orange,2021-01-05,2250,42,2292
15803,San Diego,2021-01-05,1585,61,1646
15804,San Mateo,2021-01-05,188,8,196
15805,Sonoma,2021-01-05,101,1,102
15806,Solano,2021-01-05,168,14,182
15807,Kings,2021-01-05,91,0,91
15808,Contra Costa,2021-01-05,271,13,284
15809,Sutter,2021-01-05,0,0,0
15810,Mono,2021-01-05,2,0,2
15811,Plumas,2021-01-05,0,0,0
15812,Tehama,2021-01-05,17,0,17
15813,Mendocino,2021-01-05,13,0,13
15814,Kern,2021-01-05,416,6,422
15815,Humboldt,2021-01-05,6,2,8
15816,Monterey,2021-01-05,190,4,194
15817,Placer,2021-01-05,180,22,202
15818,Stanislaus,2021-01-05,361,8,369
15819,Amador,2021-01-05,9,1,10
15820,Colusa,2021-01-05,5,0,5
15821,Del Norte,2021-01-05,3,0,3
15822,San Francisco,2021-01-05,221,8,229
15823,Lassen,2021-01-05,5,0,5
15824,Sacramento,2021-01-05,509,33,542
15825,Santa Clara,2021-01-05,726,15,741
15826,Fresno,2021-01-05,659,36,695
15827,Yuba,2021-01-05,71,5,76
15828,Riverside,2021-01-05,1611,120,1731
15829,Imperial,2021-01-05,172,1,173
15830,El Dorado,2021-01-05,40,0,40
15831,Trinity,2021-01-05,0,0,0
15832,Calaveras,2021-01-05,5,0,5
15833,Modoc,2021-01-05,2,0,2
15834,Napa,2021-01-05,25,0,25
15835,San Bernardino,2021-01-05,1785,77,1862
15836,San Joaquin,2021-01-05,340,8,348
15837,San Luis Obispo,2021-01-05,64,2,66
15838,Santa Cruz,2021-01-05,84,0,84
15839,Alameda,2021-01-05,442,51,493
15840,Yolo,2021-01-05,30,2,32
15841,Lake,2021-01-05,12,0,12
15842,Ventura,2021-01-05,419,13,432
15843,Tulare,2021-01-05,228,6,234
15844,Inyo,2021-01-05,8,0,8
15845,Nevada,2021-01-06,13,0,13
15846,San Benito,2021-01-06,14,0,14
15847,Tulare,2021-01-06,219,3,222
15848,Trinity,2021-01-06,0,0,0
15849,Santa Barbara,2021-01-06,178,4,182
15850,Mendocino,2021-01-06,12,0,12
15851,Mariposa,2021-01-06,1,0,1
15852,Humboldt,2021-01-06,8,3,11
15853,Butte,2021-01-06,86,0,86
15854,Plumas,2021-01-06,0,0,0
15855,Santa Cruz,2021-01-06,76,0,76
15856,San Mateo,2021-01-06,180,7,187
15857,Kern,2021-01-06,433,13,446
15858,Del Norte,2021-01-06,2,0,2
15859,San Francisco,2021-01-06,233,10,243
15860,Modoc,2021-01-06,1,0,1
15861,Napa,2021-01-06,26,1,27
15862,San Joaquin,2021-01-06,334,9,343
15863,El Dorado,2021-01-06,39,0,39
15864,Mono,2021-01-06,1,0,1
15865,Placer,2021-01-06,181,19,200
15866,Alameda,2021-01-06,431,50,481
15867,Calaveras,2021-01-06,6,0,6
15868,Inyo,2021-01-06,8,0,8
15869,Los Angeles,2021-01-06,8074,311,8385
15870,Monterey,2021-01-06,207,5,212
15871,Tehama,2021-01-06,17,0,17
15872,Riverside,2021-01-06,1634,119,1753
15873,Solano,2021-01-06,170,14,184
15874,Fresno,2021-01-06,626,29,655
15875,Santa Clara,2021-01-06,723,28,751
15876,Orange,2021-01-06,2253,53,2306
15877,Sacramento,2021-01-06,499,32,531
15878,San Luis Obispo,2021-01-06,70,1,71
15879,Imperial,2021-01-06,174,2,176
15880,Tuolumne,2021-01-06,10,0,10
15881,Sonoma,2021-01-06,105,3,108
15882,Marin,2021-01-06,38,3,41
15883,Kings,2021-01-06,93,1,94
15884,Ventura,2021-01-06,418,8,426
15885,Yuba,2021-01-06,65,5,70
15886,Lassen,2021-01-06,4,0,4
15887,Merced,2021-01-06,57,0,57
15888,Sutter,2021-01-06,0,0,0
15889,Madera,2021-01-06,57,4,61
15890,San Bernardino,2021-01-06,1762,81,1843
15891,Yolo,2021-01-06,30,0,30
15892,Glenn,2021-01-06,6,0,6
15893,Shasta,2021-01-06,49,0,49
15894,Stanislaus,2021-01-06,349,9,358
15895,San Diego,2021-01-06,1661,71,1732
15896,Amador,2021-01-06,9,0,9
15897,Colusa,2021-01-06,7,0,7
15898,Contra Costa,2021-01-06,273,17,290
15899,Siskiyou,2021-01-06,5,0,5
15900,Lake,2021-01-06,11,0,11
15901,El Dorado,2021-01-07,37,0,37
15902,Colusa,2021-01-07,7,0,7
15903,Del Norte,2021-01-07,2,0,2
15904,San Diego,2021-01-07,1685,71,1756
15905,Solano,2021-01-07,179,18,197
15906,Glenn,2021-01-07,6,0,6
15907,Marin,2021-01-07,38,3,41
15908,Santa Clara,2021-01-07,713,36,749
15909,San Bernardino,2021-01-07,1751,82,1833
15910,Merced,2021-01-07,58,0,58
15911,San Benito,2021-01-07,11,0,11
15912,Los Angeles,2021-01-07,7966,327,8293
15913,Contra Costa,2021-01-07,288,19,307
15914,Fresno,2021-01-07,640,22,662
15915,Imperial,2021-01-07,170,1,171
15916,Yuba,2021-01-07,69,3,72
15917,Modoc,2021-01-07,1,1,2
15918,Kern,2021-01-07,437,16,453
15919,Yolo,2021-01-07,31,0,31
15920,San Francisco,2021-01-07,244,6,250
15921,Monterey,2021-01-07,207,1,208
15922,Tuolumne,2021-01-07,11,0,11
15923,Orange,2021-01-07,2259,49,2308
15924,Butte,2021-01-07,84,0,84
15925,Mariposa,2021-01-07,1,0,1
15926,Stanislaus,2021-01-07,349,13,362
15927,San Luis Obispo,2021-01-07,61,3,64
15928,Humboldt,2021-01-07,8,2,10
15929,San Mateo,2021-01-07,174,14,188
15930,Sacramento,2021-01-07,497,40,537
15931,Siskiyou,2021-01-07,4,0,4
15932,Sutter,2021-01-07,0,0,0
15933,Mono,2021-01-07,0,0,0
15934,Mendocino,2021-01-07,12,0,12
15935,Nevada,2021-01-07,14,1,15
15936,Tehama,2021-01-07,15,0,15
15937,Shasta,2021-01-07,48,0,48
15938,Napa,2021-01-07,32,0,32
15939,Kings,2021-01-07,95,1,96
15940,Calaveras,2021-01-07,7,0,7
15941,Madera,2021-01-07,53,4,57
15942,Plumas,2021-01-07,0,0,0
15943,Riverside,2021-01-07,1648,128,1776
15944,Lake,2021-01-07,10,1,11
15945,Ventura,2021-01-07,408,8,416
15946,Inyo,2021-01-07,8,0,8
15947,Placer,2021-01-07,174,25,199
15948,Lassen,2021-01-07,4,0,4
15949,Alameda,2021-01-07,432,61,493
15950,Santa Barbara,2021-01-07,183,3,186
15951,San Joaquin,2021-01-07,319,12,331
15952,Santa Cruz,2021-01-07,77,0,77
15953,Trinity,2021-01-07,0,0,0
15954,Tulare,2021-01-07,210,5,215
15955,Amador,2021-01-07,8,1,9
15956,Sonoma,2021-01-07,110,4,114
15957,Stanislaus,2021-01-08,343,12,355
15958,Tuolumne,2021-01-08,11,0,11
15959,Fresno,2021-01-08,628,22,650
15960,Modoc,2021-01-08,1,0,1
15961,Solano,2021-01-08,179,9,188
15962,Santa Barbara,2021-01-08,180,6,186
15963,Glenn,2021-01-08,6,0,6
15964,Napa,2021-01-08,31,0,31
15965,Tehama,2021-01-08,14,0,14
15966,Tulare,2021-01-08,210,4,214
15967,Butte,2021-01-08,80,0,80
15968,San Luis Obispo,2021-01-08,56,0,56
15969,Placer,2021-01-08,176,17,193
15970,Lassen,2021-01-08,3,0,3
15971,Shasta,2021-01-08,52,0,52
15972,Nevada,2021-01-08,11,0,11
15973,Monterey,2021-01-08,204,3,207
15974,Del Norte,2021-01-08,2,0,2
15975,Mono,2021-01-08,2,0,2
15976,Ventura,2021-01-08,410,11,421
15977,Mendocino,2021-01-08,8,0,8
15978,San Benito,2021-01-08,15,0,15
15979,Inyo,2021-01-08,5,0,5
15980,Los Angeles,2021-01-08,7964,289,8253
15981,San Mateo,2021-01-08,180,10,190
15982,Santa Clara,2021-01-08,708,17,725
15983,Sonoma,2021-01-08,101,4,105
15984,Plumas,2021-01-08,0,0,0
15985,Trinity,2021-01-08,0,0,0
15986,Mariposa,2021-01-08,0,0,0
15987,Riverside,2021-01-08,1671,119,1790
15988,Alameda,2021-01-08,442,52,494
15989,Merced,2021-01-08,55,0,55
15990,Amador,2021-01-08,8,1,9
15991,Humboldt,2021-01-08,9,4,13
15992,Calaveras,2021-01-08,8,0,8
15993,Madera,2021-01-08,45,5,50
15994,Colusa,2021-01-08,6,0,6
15995,Yuba,2021-01-08,64,0,64
15996,Siskiyou,2021-01-08,6,0,6
15997,Contra Costa,2021-01-08,280,16,296
15998,Imperial,2021-01-08,156,0,156
15999,Santa Cruz,2021-01-08,78,0,78
16000,Lake,2021-01-08,12,0,12
16001,El Dorado,2021-01-08,36,0,36
16002,Sutter,2021-01-08,0,0,0
16003,San Joaquin,2021-01-08,314,7,321
16004,Yolo,2021-01-08,29,0,29
16005,San Diego,2021-01-08,1695,68,1763
16006,Orange,2021-01-08,2221,39,2260
16007,Kern,2021-01-08,422,14,436
16008,San Francisco,2021-01-08,249,5,254
16009,Kings,2021-01-08,94,0,94
16010,San Bernardino,2021-01-08,1758,79,1837
16011,Sacramento,2021-01-08,482,31,513
16012,Marin,2021-01-08,34,2,36
16013,Tehama,2021-01-09,13,0,13
16014,Mono,2021-01-09,2,0,2
16015,El Dorado,2021-01-09,42,0,42
16016,Lassen,2021-01-09,3,0,3
16017,Plumas,2021-01-09,0,0,0
16018,Kings,2021-01-09,92,0,92
16019,Yuba,2021-01-09,56,0,56
16020,Ventura,2021-01-09,421,12,433
16021,Los Angeles,2021-01-09,7910,280,8190
16022,Calaveras,2021-01-09,10,0,10
16023,Trinity,2021-01-09,0,0,0
16024,Glenn,2021-01-09,6,0,6
16025,Lake,2021-01-09,9,1,10
16026,Madera,2021-01-09,44,8,52
16027,Alameda,2021-01-09,428,43,471
16028,Del Norte,2021-01-09,2,0,2
16029,San Benito,2021-01-09,16,0,16
16030,Sonoma,2021-01-09,98,7,105
16031,Sacramento,2021-01-09,480,29,509
16032,Shasta,2021-01-09,50,1,51
16033,Riverside,2021-01-09,1650,146,1796
16034,Solano,2021-01-09,174,8,182
16035,San Luis Obispo,2021-01-09,50,0,50
16036,San Joaquin,2021-01-09,316,6,322
16037,Imperial,2021-01-09,165,0,165
16038,Tuolumne,2021-01-09,11,0,11
16039,Placer,2021-01-09,178,26,204
16040,Santa Clara,2021-01-09,694,17,711
16041,Santa Barbara,2021-01-09,174,3,177
16042,San Mateo,2021-01-09,185,12,197
16043,Contra Costa,2021-01-09,296,12,308
16044,Tulare,2021-01-09,211,3,214
16045,Mendocino,2021-01-09,15,0,15
16046,Sutter,2021-01-09,0,0,0
16047,Colusa,2021-01-09,5,0,5
16048,San Francisco,2021-01-09,245,7,252
16049,Orange,2021-01-09,2216,34,2250
16050,Nevada,2021-01-09,12,0,12
16051,Monterey,2021-01-09,208,4,212
16052,Humboldt,2021-01-09,11,0,11
16053,Yolo,2021-01-09,33,0,33
16054,Napa,2021-01-09,31,0,31
16055,Butte,2021-01-09,83,0,83
16056,Merced,2021-01-09,56,0,56
16057,Siskiyou,2021-01-09,4,0,4
16058,San Bernardino,2021-01-09,1716,75,1791
16059,San Diego,2021-01-09,1691,60,1751
16060,Marin,2021-01-09,29,2,31
16061,Inyo,2021-01-09,6,0,6
16062,Modoc,2021-01-09,1,0,1
16063,Fresno,2021-01-09,635,38,673
16064,Amador,2021-01-09,7,0,7
16065,Kern,2021-01-09,437,15,452
16066,Santa Cruz,2021-01-09,82,0,82
16067,Stanislaus,2021-01-09,338,17,355
16068,Mariposa,2021-01-09,0,0,0
16069,San Mateo,2021-01-10,189,12,201
16070,Humboldt,2021-01-10,12,0,12
16071,Colusa,2021-01-10,5,0,5
16072,Contra Costa,2021-01-10,261,13,274
16073,Tehama,2021-01-10,10,0,10
16074,Amador,2021-01-10,7,0,7
16075,Monterey,2021-01-10,207,14,221
16076,San Benito,2021-01-10,19,0,19
16077,Madera,2021-01-10,43,9,52
16078,Modoc,2021-01-10,1,0,1
16079,Lassen,2021-01-10,3,0,3
16080,Merced,2021-01-10,58,0,58
16081,Sonoma,2021-01-10,97,11,108
16082,El Dorado,2021-01-10,46,0,46
16083,Trinity,2021-01-10,0,0,0
16084,Glenn,2021-01-10,6,0,6
16085,Sacramento,2021-01-10,485,27,512
16086,Orange,2021-01-10,2221,56,2277
16087,San Diego,2021-01-10,1697,58,1755
16088,San Joaquin,2021-01-10,320,9,329
16089,Solano,2021-01-10,179,11,190
16090,Santa Cruz,2021-01-10,69,1,70
16091,Los Angeles,2021-01-10,7926,344,8270
16092,Mono,2021-01-10,1,0,1
16093,San Bernardino,2021-01-10,1720,75,1795
16094,Plumas,2021-01-10,0,0,0
16095,Del Norte,2021-01-10,2,0,2
16096,Butte,2021-01-10,73,1,74
16097,Yuba,2021-01-10,56,0,56
16098,Tuolumne,2021-01-10,10,0,10
16099,Siskiyou,2021-01-10,5,0,5
16100,Santa Barbara,2021-01-10,193,4,197
16101,San Francisco,2021-01-10,257,10,267
16102,Kern,2021-01-10,449,14,463
16103,Alameda,2021-01-10,424,37,461
16104,Ventura,2021-01-10,410,14,424
16105,Inyo,2021-01-10,5,0,5
16106,Yolo,2021-01-10,32,0,32
16107,Tulare,2021-01-10,215,5,220
16108,Imperial,2021-01-10,151,0,151
16109,Kings,2021-01-10,90,0,90
16110,Sutter,2021-01-10,0,0,0
16111,San Luis Obispo,2021-01-10,48,2,50
16112,Stanislaus,2021-01-10,340,13,353
16113,Mendocino,2021-01-10,12,0,12
16114,Calaveras,2021-01-10,12,0,12
16115,Shasta,2021-01-10,49,1,50
16116,Napa,2021-01-10,28,0,28
16117,Riverside,2021-01-10,1671,134,1805
16118,Fresno,2021-01-10,626,50,676
16119,Mariposa,2021-01-10,0,0,0
16120,Santa Clara,2021-01-10,688,16,704
16121,Marin,2021-01-10,30,4,34
16122,Placer,2021-01-10,183,20,203
16123,Lake,2021-01-10,10,0,10
16124,Nevada,2021-01-10,13,0,13
16125,Mariposa,2021-01-11,0,0,0
16126,Santa Cruz,2021-01-11,68,1,69
16127,Yuba,2021-01-11,54,0,54
16128,Madera,2021-01-11,45,2,47
16129,San Mateo,2021-01-11,195,10,205
16130,Riverside,2021-01-11,1660,131,1791
16131,Kern,2021-01-11,453,11,464
16132,Mendocino,2021-01-11,15,0,15
16133,Santa Clara,2021-01-11,687,15,702
16134,Mono,2021-01-11,1,0,1
16135,Yolo,2021-01-11,26,0,26
16136,Ventura,2021-01-11,437,11,448
16137,Trinity,2021-01-11,0,0,0
16138,Sonoma,2021-01-11,97,9,106
16139,Monterey,2021-01-11,202,2,204
16140,Lassen,2021-01-11,3,0,3
16141,San Benito,2021-01-11,18,0,18
16142,Tehama,2021-01-11,15,0,15
16143,Fresno,2021-01-11,647,37,684
16144,Glenn,2021-01-11,6,0,6
16145,Contra Costa,2021-01-11,266,13,279
16146,San Bernardino,2021-01-11,1692,87,1779
16147,Inyo,2021-01-11,4,0,4
16148,Los Angeles,2021-01-11,7949,330,8279
16149,Tulare,2021-01-11,215,6,221
16150,Marin,2021-01-11,32,3,35
16151,Modoc,2021-01-11,1,0,1
16152,Calaveras,2021-01-11,12,0,12
16153,Napa,2021-01-11,28,1,29
16154,Sacramento,2021-01-11,492,26,518
16155,Shasta,2021-01-11,52,2,54
16156,Placer,2021-01-11,184,14,198
16157,Del Norte,2021-01-11,1,0,1
16158,Plumas,2021-01-11,1,0,1
16159,Alameda,2021-01-11,428,50,478
16160,San Francisco,2021-01-11,252,4,256
16161,Solano,2021-01-11,180,16,196
16162,Colusa,2021-01-11,6,0,6
16163,El Dorado,2021-01-11,46,0,46
16164,Tuolumne,2021-01-11,8,0,8
16165,Kings,2021-01-11,88,1,89
16166,Humboldt,2021-01-11,13,1,14
16167,Butte,2021-01-11,72,1,73
16168,Santa Barbara,2021-01-11,211,7,218
16169,San Joaquin,2021-01-11,327,9,336
16170,Merced,2021-01-11,58,0,58
16171,Nevada,2021-01-11,12,1,13
16172,Stanislaus,2021-01-11,348,9,357
16173,Orange,2021-01-11,2200,47,2247
16174,San Diego,2021-01-11,1725,61,1786
16175,San Luis Obispo,2021-01-11,46,0,46
16176,Amador,2021-01-11,8,0,8
16177,Imperial,2021-01-11,148,0,148
16178,Siskiyou,2021-01-11,4,0,4
16179,Sutter,2021-01-11,0,0,0
16180,Lake,2021-01-11,9,0,9
16181,Kern,2021-01-12,441,10,451
16182,Los Angeles,2021-01-12,7906,295,8201
16183,Kings,2021-01-12,96,1,97
16184,Yuba,2021-01-12,55,0,55
16185,Del Norte,2021-01-12,1,0,1
16186,Santa Cruz,2021-01-12,72,0,72
16187,Santa Barbara,2021-01-12,199,10,209
16188,San Benito,2021-01-12,19,0,19
16189,Sonoma,2021-01-12,102,8,110
16190,Placer,2021-01-12,171,15,186
16191,Tulare,2021-01-12,206,9,215
16192,Shasta,2021-01-12,53,2,55
16193,Humboldt,2021-01-12,15,6,21
16194,Nevada,2021-01-12,12,0,12
16195,Trinity,2021-01-12,0,0,0
16196,Santa Clara,2021-01-12,687,16,703
16197,Mono,2021-01-12,0,0,0
16198,Ventura,2021-01-12,448,14,462
16199,Fresno,2021-01-12,645,30,675
16200,Inyo,2021-01-12,4,0,4
16201,Lassen,2021-01-12,3,0,3
16202,Lake,2021-01-12,7,1,8
16203,Calaveras,2021-01-12,12,0,12
16204,Butte,2021-01-12,67,1,68
16205,Modoc,2021-01-12,0,0,0
16206,Tehama,2021-01-12,12,0,12
16207,Alameda,2021-01-12,430,38,468
16208,Orange,2021-01-12,2180,42,2222
16209,San Joaquin,2021-01-12,321,14,335
16210,San Francisco,2021-01-12,259,14,273
16211,San Diego,2021-01-12,1721,69,1790
16212,Glenn,2021-01-12,6,0,6
16213,Amador,2021-01-12,8,0,8
16214,Imperial,2021-01-12,142,2,144
16215,Colusa,2021-01-12,8,0,8
16216,Stanislaus,2021-01-12,359,10,369
16217,Contra Costa,2021-01-12,263,7,270
16218,Mariposa,2021-01-12,0,0,0
16219,San Luis Obispo,2021-01-12,55,2,57
16220,Siskiyou,2021-01-12,5,2,7
16221,Monterey,2021-01-12,207,4,211
16222,Yolo,2021-01-12,30,0,30
16223,Napa,2021-01-12,30,1,31
16224,Tuolumne,2021-01-12,8,0,8
16225,Solano,2021-01-12,176,17,193
16226,Mendocino,2021-01-12,17,0,17
16227,Plumas,2021-01-12,1,0,1
16228,El Dorado,2021-01-12,42,0,42
16229,Sacramento,2021-01-12,492,23,515
16230,San Bernardino,2021-01-12,1703,91,1794
16231,Madera,2021-01-12,46,4,50
16232,Sutter,2021-01-12,0,0,0
16233,Merced,2021-01-12,51,0,51
16234,Riverside,2021-01-12,1636,125,1761
16235,Marin,2021-01-12,31,2,33
16236,San Mateo,2021-01-12,194,11,205
16237,Riverside,2021-01-13,1584,117,1701
16238,Los Angeles,2021-01-13,7715,371,8086
16239,Yolo,2021-01-13,30,0,30
16240,Ventura,2021-01-13,448,13,461
16241,Mariposa,2021-01-13,1,0,1
16242,Inyo,2021-01-13,5,0,5
16243,San Mateo,2021-01-13,193,9,202
16244,Butte,2021-01-13,66,0,66
16245,Merced,2021-01-13,46,0,46
16246,Santa Clara,2021-01-13,669,23,692
16247,Stanislaus,2021-01-13,345,8,353
16248,Siskiyou,2021-01-13,8,0,8
16249,Del Norte,2021-01-13,2,0,2
16250,Sacramento,2021-01-13,494,16,510
16251,Colusa,2021-01-13,7,0,7
16252,Lassen,2021-01-13,5,0,5
16253,Nevada,2021-01-13,14,0,14
16254,Kings,2021-01-13,95,1,96
16255,Monterey,2021-01-13,211,2,213
16256,San Luis Obispo,2021-01-13,57,2,59
16257,Lake,2021-01-13,8,1,9
16258,Marin,2021-01-13,31,2,33
16259,Kern,2021-01-13,436,10,446
16260,Calaveras,2021-01-13,9,0,9
16261,Alameda,2021-01-13,437,55,492
16262,Modoc,2021-01-13,0,0,0
16263,Santa Cruz,2021-01-13,79,0,79
16264,San Diego,2021-01-13,1719,56,1775
16265,San Joaquin,2021-01-13,309,12,321
16266,Fresno,2021-01-13,623,21,644
16267,Madera,2021-01-13,52,9,61
16268,Solano,2021-01-13,173,11,184
16269,Sutter,2021-01-13,0,0,0
16270,Contra Costa,2021-01-13,250,10,260
16271,Humboldt,2021-01-13,13,4,17
16272,Orange,2021-01-13,2169,55,2224
16273,Mono,2021-01-13,0,0,0
16274,Trinity,2021-01-13,0,0,0
16275,Shasta,2021-01-13,54,2,56
16276,Sonoma,2021-01-13,100,0,100
16277,El Dorado,2021-01-13,37,0,37
16278,Napa,2021-01-13,29,2,31
16279,Amador,2021-01-13,7,0,7
16280,Tehama,2021-01-13,13,0,13
16281,Glenn,2021-01-13,6,2,8
16282,Santa Barbara,2021-01-13,197,6,203
16283,Placer,2021-01-13,165,12,177
16284,San Bernardino,2021-01-13,1678,73,1751
16285,Tuolumne,2021-01-13,7,0,7
16286,Plumas,2021-01-13,1,0,1
16287,San Francisco,2021-01-13,257,9,266
16288,Tulare,2021-01-13,200,11,211
16289,San Benito,2021-01-13,19,0,19
16290,Yuba,2021-01-13,53,0,53
16291,Mendocino,2021-01-13,16,0,16
16292,Imperial,2021-01-13,140,3,143
16293,Colusa,2021-01-14,6,0,6
16294,Santa Barbara,2021-01-14,192,4,196
16295,Marin,2021-01-14,35,3,38
16296,Placer,2021-01-14,163,5,168
16297,Yolo,2021-01-14,30,0,30
16298,Napa,2021-01-14,26,2,28
16299,Siskiyou,2021-01-14,5,0,5
16300,Riverside,2021-01-14,1563,129,1692
16301,Ventura,2021-01-14,434,12,446
16302,Santa Clara,2021-01-14,647,21,668
16303,Butte,2021-01-14,70,0,70
16304,Monterey,2021-01-14,209,7,216
16305,El Dorado,2021-01-14,34,0,34
16306,San Bernardino,2021-01-14,1660,63,1723
16307,Imperial,2021-01-14,148,2,150
16308,Sutter,2021-01-14,0,0,0
16309,Calaveras,2021-01-14,11,0,11
16310,San Luis Obispo,2021-01-14,57,1,58
16311,Amador,2021-01-14,10,0,10
16312,Merced,2021-01-14,47,0,47
16313,Nevada,2021-01-14,14,0,14
16314,Modoc,2021-01-14,0,0,0
16315,Yuba,2021-01-14,58,0,58
16316,Tulare,2021-01-14,199,8,207
16317,Santa Cruz,2021-01-14,80,0,80
16318,Mariposa,2021-01-14,1,0,1
16319,Tuolumne,2021-01-14,5,0,5
16320,Fresno,2021-01-14,614,34,648
16321,Lassen,2021-01-14,4,0,4
16322,Shasta,2021-01-14,55,0,55
16323,Sacramento,2021-01-14,469,17,486
16324,Sonoma,2021-01-14,94,6,100
16325,Plumas,2021-01-14,2,0,2
16326,Kern,2021-01-14,435,10,445
16327,Glenn,2021-01-14,6,1,7
16328,San Joaquin,2021-01-14,315,8,323
16329,Mendocino,2021-01-14,16,0,16
16330,Alameda,2021-01-14,437,52,489
16331,Contra Costa,2021-01-14,257,19,276
16332,Kings,2021-01-14,89,1,90
16333,Del Norte,2021-01-14,2,0,2
16334,Inyo,2021-01-14,4,0,4
16335,Solano,2021-01-14,170,16,186
16336,San Mateo,2021-01-14,196,8,204
16337,San Diego,2021-01-14,1728,57,1785
16338,Trinity,2021-01-14,0,0,0
16339,Madera,2021-01-14,49,3,52
16340,Mono,2021-01-14,0,0,0
16341,Stanislaus,2021-01-14,355,5,360
16342,Lake,2021-01-14,12,0,12
16343,Humboldt,2021-01-14,11,1,12
16344,San Francisco,2021-01-14,244,9,253
16345,Tehama,2021-01-14,13,0,13
16346,Orange,2021-01-14,2102,54,2156
16347,Los Angeles,2021-01-14,7597,300,7897
16348,San Benito,2021-01-14,19,0,19
16349,El Dorado,2021-01-15,36,2,38
16350,Mendocino,2021-01-15,13,1,14
16351,Amador,2021-01-15,14,0,14
16352,Los Angeles,2021-01-15,7498,328,7826
16353,San Luis Obispo,2021-01-15,54,0,54
16354,Monterey,2021-01-15,217,2,219
16355,San Diego,2021-01-15,1720,65,1785
16356,Tulare,2021-01-15,203,9,212
16357,Fresno,2021-01-15,580,25,605
16358,Calaveras,2021-01-15,7,0,7
16359,Trinity,2021-01-15,0,0,0
16360,Lassen,2021-01-15,4,0,4
16361,Yuba,2021-01-15,53,1,54
16362,Riverside,2021-01-15,1567,121,1688
16363,San Bernardino,2021-01-15,1602,64,1666
16364,Marin,2021-01-15,36,2,38
16365,Shasta,2021-01-15,52,0,52
16366,Santa Barbara,2021-01-15,196,6,202
16367,Merced,2021-01-15,54,0,54
16368,Butte,2021-01-15,68,0,68
16369,Tehama,2021-01-15,14,0,14
16370,Mono,2021-01-15,0,0,0
16371,San Francisco,2021-01-15,240,4,244
16372,Nevada,2021-01-15,12,0,12
16373,Solano,2021-01-15,168,17,185
16374,Glenn,2021-01-15,7,1,8
16375,Sacramento,2021-01-15,461,12,473
16376,Sonoma,2021-01-15,101,3,104
16377,Humboldt,2021-01-15,10,1,11
16378,Kings,2021-01-15,88,2,90
16379,Orange,2021-01-15,2065,45,2110
16380,Placer,2021-01-15,159,11,170
16381,San Joaquin,2021-01-15,296,5,301
16382,Lake,2021-01-15,13,0,13
16383,Plumas,2021-01-15,2,0,2
16384,San Benito,2021-01-15,17,0,17
16385,Alameda,2021-01-15,422,48,470
16386,Contra Costa,2021-01-15,274,15,289
16387,Ventura,2021-01-15,440,11,451
16388,Siskiyou,2021-01-15,5,0,5
16389,Modoc,2021-01-15,0,0,0
16390,Napa,2021-01-15,22,0,22
16391,Santa Cruz,2021-01-15,81,0,81
16392,Yolo,2021-01-15,28,0,28
16393,Inyo,2021-01-15,2,0,2
16394,Santa Clara,2021-01-15,654,18,672
16395,Colusa,2021-01-15,15,0,15
16396,Imperial,2021-01-15,135,4,139
16397,Madera,2021-01-15,49,9,58
16398,Del Norte,2021-01-15,1,0,1
16399,Tuolumne,2021-01-15,6,0,6
16400,Stanislaus,2021-01-15,352,10,362
16401,Kern,2021-01-15,418,9,427
16402,San Mateo,2021-01-15,190,6,196
16403,Mariposa,2021-01-15,1,0,1
16404,Sutter,2021-01-15,0,0,0
16405,Marin,2021-01-16,29,1,30
16406,San Diego,2021-01-16,1696,65,1761
16407,Tulare,2021-01-16,204,8,212
16408,Yolo,2021-01-16,28,0,28
16409,Solano,2021-01-16,166,13,179
16410,Tehama,2021-01-16,15,0,15
16411,Mendocino,2021-01-16,15,1,16
16412,San Benito,2021-01-16,18,0,18
16413,Kern,2021-01-16,407,4,411
16414,Butte,2021-01-16,71,0,71
16415,San Joaquin,2021-01-16,296,20,316
16416,Inyo,2021-01-16,3,0,3
16417,Shasta,2021-01-16,58,0,58
16418,Placer,2021-01-16,154,7,161
16419,Riverside,2021-01-16,1560,107,1667
16420,Fresno,2021-01-16,576,24,600
16421,Imperial,2021-01-16,138,0,138
16422,Nevada,2021-01-16,10,0,10
16423,Lassen,2021-01-16,4,0,4
16424,Kings,2021-01-16,87,1,88
16425,Trinity,2021-01-16,0,0,0
16426,Santa Barbara,2021-01-16,195,7,202
16427,Merced,2021-01-16,64,0,64
16428,Madera,2021-01-16,47,8,55
16429,Contra Costa,2021-01-16,265,14,279
16430,Del Norte,2021-01-16,2,0,2
16431,Stanislaus,2021-01-16,331,8,339
16432,Calaveras,2021-01-16,6,0,6
16433,San Luis Obispo,2021-01-16,45,0,45
16434,Sutter,2021-01-16,0,0,0
16435,Alameda,2021-01-16,446,48,494
16436,Napa,2021-01-16,21,0,21
16437,Amador,2021-01-16,14,1,15
16438,San Francisco,2021-01-16,239,7,246
16439,Sonoma,2021-01-16,97,6,103
16440,San Bernardino,2021-01-16,1523,74,1597
16441,Los Angeles,2021-01-16,7328,296,7624
16442,Orange,2021-01-16,2026,52,2078
16443,San Mateo,2021-01-16,180,4,184
16444,Ventura,2021-01-16,434,5,439
16445,Siskiyou,2021-01-16,5,0,5
16446,El Dorado,2021-01-16,32,1,33
16447,Lake,2021-01-16,16,0,16
16448,Sacramento,2021-01-16,444,18,462
16449,Santa Clara,2021-01-16,635,17,652
16450,Modoc,2021-01-16,0,0,0
16451,Humboldt,2021-01-16,10,1,11
16452,Plumas,2021-01-16,2,0,2
16453,Mono,2021-01-16,0,0,0
16454,Monterey,2021-01-16,209,1,210
16455,Santa Cruz,2021-01-16,84,0,84
16456,Tuolumne,2021-01-16,9,0,9
16457,Colusa,2021-01-16,16,0,16
16458,Glenn,2021-01-16,7,1,8
16459,Mariposa,2021-01-16,2,0,2
16460,Yuba,2021-01-16,54,0,54
16461,Riverside,2021-01-17,1524,122,1646
16462,San Mateo,2021-01-17,186,4,190
16463,Santa Clara,2021-01-17,613,19,632
16464,Yuba,2021-01-17,55,0,55
16465,Placer,2021-01-17,152,13,165
16466,Inyo,2021-01-17,2,0,2
16467,Marin,2021-01-17,28,0,28
16468,Plumas,2021-01-17,1,0,1
16469,Napa,2021-01-17,27,0,27
16470,Tuolumne,2021-01-17,10,0,10
16471,Trinity,2021-01-17,0,0,0
16472,San Bernardino,2021-01-17,1511,51,1562
16473,San Benito,2021-01-17,18,0,18
16474,El Dorado,2021-01-17,33,0,33
16475,Del Norte,2021-01-17,1,0,1
16476,Sacramento,2021-01-17,441,19,460
16477,Santa Cruz,2021-01-17,83,1,84
16478,Mariposa,2021-01-17,2,0,2
16479,Butte,2021-01-17,64,0,64
16480,Sutter,2021-01-17,0,0,0
16481,Tehama,2021-01-17,14,0,14
16482,San Luis Obispo,2021-01-17,50,0,50
16483,Siskiyou,2021-01-17,2,0,2
16484,Santa Barbara,2021-01-17,208,13,221
16485,Orange,2021-01-17,1964,51,2015
16486,Merced,2021-01-17,65,0,65
16487,San Diego,2021-01-17,1664,69,1733
16488,Stanislaus,2021-01-17,331,10,341
16489,Kings,2021-01-17,92,1,93
16490,Lake,2021-01-17,16,0,16
16491,Mendocino,2021-01-17,13,0,13
16492,San Francisco,2021-01-17,242,5,247
16493,Contra Costa,2021-01-17,266,18,284
16494,Madera,2021-01-17,53,11,64
16495,Los Angeles,2021-01-17,7322,302,7624
16496,Ventura,2021-01-17,430,5,435
16497,Nevada,2021-01-17,10,1,11
16498,San Joaquin,2021-01-17,291,10,301
16499,Sonoma,2021-01-17,101,6,107
16500,Yolo,2021-01-17,28,0,28
16501,Glenn,2021-01-17,5,3,8
16502,Humboldt,2021-01-17,10,1,11
16503,Mono,2021-01-17,0,0,0
16504,Imperial,2021-01-17,131,0,131
16505,Calaveras,2021-01-17,6,0,6
16506,Shasta,2021-01-17,54,0,54
16507,Solano,2021-01-17,172,13,185
16508,Amador,2021-01-17,14,0,14
16509,Fresno,2021-01-17,562,23,585
16510,Tulare,2021-01-17,202,7,209
16511,Alameda,2021-01-17,458,44,502
16512,Monterey,2021-01-17,213,3,216
16513,Colusa,2021-01-17,14,0,14
16514,Lassen,2021-01-17,2,0,2
16515,Modoc,2021-01-17,0,0,0
16516,Kern,2021-01-17,416,5,421
16517,Tulare,2021-01-18,201,7,208
16518,Monterey,2021-01-18,201,4,205
16519,San Bernardino,2021-01-18,1487,40,1527
16520,Imperial,2021-01-18,134,0,134
16521,Napa,2021-01-18,27,0,27
16522,San Benito,2021-01-18,18,0,18
16523,San Diego,2021-01-18,1632,73,1705
16524,Mariposa,2021-01-18,2,0,2
16525,Fresno,2021-01-18,554,26,580
16526,Lassen,2021-01-18,4,0,4
16527,Siskiyou,2021-01-18,2,0,2
16528,Inyo,2021-01-18,2,1,3
16529,Lake,2021-01-18,16,0,16
16530,Glenn,2021-01-18,5,3,8
16531,Santa Clara,2021-01-18,611,18,629
16532,Merced,2021-01-18,62,0,62
16533,San Joaquin,2021-01-18,303,3,306
16534,Mono,2021-01-18,0,0,0
16535,Madera,2021-01-18,58,5,63
16536,Mendocino,2021-01-18,12,1,13
16537,Plumas,2021-01-18,1,0,1
16538,Sacramento,2021-01-18,452,20,472
16539,Calaveras,2021-01-18,6,0,6
16540,Alameda,2021-01-18,445,40,485
16541,Shasta,2021-01-18,53,0,53
16542,Del Norte,2021-01-18,1,0,1
16543,Santa Barbara,2021-01-18,205,9,214
16544,Colusa,2021-01-18,15,0,15
16545,San Luis Obispo,2021-01-18,56,0,56
16546,Humboldt,2021-01-18,12,3,15
16547,Placer,2021-01-18,148,18,166
16548,Amador,2021-01-18,14,0,14
16549,Kings,2021-01-18,94,1,95
16550,Yuba,2021-01-18,54,0,54
16551,Trinity,2021-01-18,0,0,0
16552,Tuolumne,2021-01-18,9,0,9
16553,Sutter,2021-01-18,0,0,0
16554,San Francisco,2021-01-18,241,2,243
16555,Yolo,2021-01-18,30,0,30
16556,Stanislaus,2021-01-18,336,13,349
16557,Santa Cruz,2021-01-18,78,1,79
16558,Kern,2021-01-18,418,7,425
16559,Contra Costa,2021-01-18,268,13,281
16560,Riverside,2021-01-18,1524,127,1651
16561,Nevada,2021-01-18,8,0,8
16562,Sonoma,2021-01-18,94,12,106
16563,San Mateo,2021-01-18,187,7,194
16564,Modoc,2021-01-18,0,0,0
16565,Marin,2021-01-18,29,1,30
16566,Solano,2021-01-18,165,9,174
16567,Orange,2021-01-18,2007,61,2068
16568,Los Angeles,2021-01-18,7253,347,7600
16569,Ventura,2021-01-18,426,7,433
16570,El Dorado,2021-01-18,25,0,25
16571,Butte,2021-01-18,63,1,64
16572,Tehama,2021-01-18,14,0,14
16573,Santa Clara,2021-01-19,604,16,620
16574,Stanislaus,2021-01-19,325,17,342
16575,Sonoma,2021-01-19,99,4,103
16576,El Dorado,2021-01-19,22,0,22
16577,Alameda,2021-01-19,443,47,490
16578,San Joaquin,2021-01-19,305,9,314
16579,Yolo,2021-01-19,30,0,30
16580,Calaveras,2021-01-19,4,0,4
16581,Santa Cruz,2021-01-19,70,1,71
16582,Siskiyou,2021-01-19,2,0,2
16583,Lassen,2021-01-19,5,0,5
16584,Amador,2021-01-19,12,0,12
16585,Glenn,2021-01-19,6,2,8
16586,Riverside,2021-01-19,1514,126,1640
16587,Nevada,2021-01-19,10,0,10
16588,Plumas,2021-01-19,1,0,1
16589,Tuolumne,2021-01-19,9,0,9
16590,Del Norte,2021-01-19,1,0,1
16591,Ventura,2021-01-19,420,14,434
16592,San Diego,2021-01-19,1658,62,1720
16593,Merced,2021-01-19,62,0,62
16594,Kern,2021-01-19,403,2,405
16595,Imperial,2021-01-19,122,0,122
16596,Humboldt,2021-01-19,11,3,14
16597,Butte,2021-01-19,61,0,61
16598,Solano,2021-01-19,158,10,168
16599,Santa Barbara,2021-01-19,206,9,215
16600,Lake,2021-01-19,17,0,17
16601,San Benito,2021-01-19,19,0,19
16602,San Francisco,2021-01-19,243,4,247
16603,Marin,2021-01-19,31,2,33
16604,Shasta,2021-01-19,52,0,52
16605,San Mateo,2021-01-19,192,6,198
16606,Colusa,2021-01-19,17,0,17
16607,San Luis Obispo,2021-01-19,61,0,61
16608,Mariposa,2021-01-19,1,0,1
16609,Napa,2021-01-19,28,0,28
16610,Tehama,2021-01-19,16,0,16
16611,Mendocino,2021-01-19,16,1,17
16612,Los Angeles,2021-01-19,7263,308,7571
16613,Madera,2021-01-19,57,7,64
16614,Sutter,2021-01-19,0,0,0
16615,Yuba,2021-01-19,50,0,50
16616,Tulare,2021-01-19,201,13,214
16617,Placer,2021-01-19,149,13,162
16618,Kings,2021-01-19,93,1,94
16619,Monterey,2021-01-19,183,5,188
16620,Fresno,2021-01-19,551,22,573
16621,Modoc,2021-01-19,0,2,2
16622,San Bernardino,2021-01-19,1477,51,1528
16623,Trinity,2021-01-19,0,0,0
16624,Inyo,2021-01-19,1,0,1
16625,Sacramento,2021-01-19,447,25,472
16626,Contra Costa,2021-01-19,276,10,286
16627,Orange,2021-01-19,1975,43,2018
16628,Mono,2021-01-19,0,0,0
16629,San Joaquin,2021-01-20,296,5,301
16630,Alameda,2021-01-20,416,41,457
16631,Imperial,2021-01-20,118,0,118
16632,Sacramento,2021-01-20,436,25,461
16633,Butte,2021-01-20,51,0,51
16634,San Diego,2021-01-20,1585,62,1647
16635,Colusa,2021-01-20,17,0,17
16636,Humboldt,2021-01-20,14,4,18
16637,Napa,2021-01-20,26,0,26
16638,Tehama,2021-01-20,17,0,17
16639,Modoc,2021-01-20,0,0,0
16640,Tuolumne,2021-01-20,9,0,9
16641,Lassen,2021-01-20,5,0,5
16642,San Bernardino,2021-01-20,1434,50,1484
16643,Monterey,2021-01-20,162,1,163
16644,Fresno,2021-01-20,560,29,589
16645,Mendocino,2021-01-20,14,1,15
16646,Stanislaus,2021-01-20,322,11,333
16647,Sonoma,2021-01-20,98,5,103
16648,Calaveras,2021-01-20,4,0,4
16649,San Mateo,2021-01-20,192,11,203
16650,Tulare,2021-01-20,186,11,197
16651,El Dorado,2021-01-20,22,1,23
16652,Kings,2021-01-20,87,0,87
16653,Santa Clara,2021-01-20,595,28,623
16654,Del Norte,2021-01-20,1,0,1
16655,Shasta,2021-01-20,50,0,50
16656,Nevada,2021-01-20,9,0,9
16657,Ventura,2021-01-20,434,12,446
16658,Santa Barbara,2021-01-20,204,8,212
16659,Solano,2021-01-20,161,9,170
16660,Siskiyou,2021-01-20,4,0,4
16661,Kern,2021-01-20,415,3,418
16662,Madera,2021-01-20,52,4,56
16663,Plumas,2021-01-20,0,0,0
16664,San Benito,2021-01-20,19,0,19
16665,Yuba,2021-01-20,44,0,44
16666,Lake,2021-01-20,17,0,17
16667,Yolo,2021-01-20,30,0,30
16668,Amador,2021-01-20,15,0,15
16669,Los Angeles,2021-01-20,7073,340,7413
16670,Sutter,2021-01-20,0,0,0
16671,Mariposa,2021-01-20,0,0,0
16672,Contra Costa,2021-01-20,288,11,299
16673,Trinity,2021-01-20,0,0,0
16674,Mono,2021-01-20,1,0,1
16675,Orange,2021-01-20,1935,45,1980
16676,Inyo,2021-01-20,1,0,1
16677,Santa Cruz,2021-01-20,69,3,72
16678,San Luis Obispo,2021-01-20,56,0,56
16679,Marin,2021-01-20,28,1,29
16680,San Francisco,2021-01-20,234,9,243
16681,Placer,2021-01-20,138,13,151
16682,Riverside,2021-01-20,1529,126,1655
16683,Glenn,2021-01-20,6,2,8
16684,Merced,2021-01-20,58,0,58
16685,Madera,2021-01-21,47,2,49
16686,Colusa,2021-01-21,15,0,15
16687,San Bernardino,2021-01-21,1395,62,1457
16688,Butte,2021-01-21,58,0,58
16689,Sacramento,2021-01-21,419,25,444
16690,Solano,2021-01-21,170,11,181
16691,Santa Barbara,2021-01-21,187,8,195
16692,Shasta,2021-01-21,46,0,46
16693,Tuolumne,2021-01-21,7,0,7
16694,Glenn,2021-01-21,4,2,6
16695,Siskiyou,2021-01-21,3,0,3
16696,El Dorado,2021-01-21,24,2,26
16697,Trinity,2021-01-21,0,0,0
16698,Monterey,2021-01-21,175,1,176
16699,Marin,2021-01-21,29,2,31
16700,Alameda,2021-01-21,409,42,451
16701,Fresno,2021-01-21,558,26,584
16702,Los Angeles,2021-01-21,6881,345,7226
16703,Calaveras,2021-01-21,5,0,5
16704,Mono,2021-01-21,1,0,1
16705,Imperial,2021-01-21,112,3,115
16706,Del Norte,2021-01-21,0,0,0
16707,Merced,2021-01-21,55,0,55
16708,Contra Costa,2021-01-21,267,13,280
16709,Modoc,2021-01-21,0,0,0
16710,Riverside,2021-01-21,1455,123,1578
16711,Napa,2021-01-21,26,1,27
16712,Humboldt,2021-01-21,13,4,17
16713,Yuba,2021-01-21,42,2,44
16714,Mariposa,2021-01-21,0,0,0
16715,Lassen,2021-01-21,5,0,5
16716,San Benito,2021-01-21,14,0,14
16717,Sutter,2021-01-21,0,0,0
16718,Santa Cruz,2021-01-21,68,0,68
16719,San Mateo,2021-01-21,175,7,182
16720,Ventura,2021-01-21,428,8,436
16721,Placer,2021-01-21,126,10,136
16722,Nevada,2021-01-21,8,0,8
16723,Tulare,2021-01-21,173,13,186
16724,San Joaquin,2021-01-21,289,11,300
16725,San Luis Obispo,2021-01-21,51,2,53
16726,Kings,2021-01-21,82,0,82
16727,Lake,2021-01-21,11,0,11
16728,Inyo,2021-01-21,2,0,2
16729,San Francisco,2021-01-21,218,5,223
16730,Yolo,2021-01-21,32,0,32
16731,Tehama,2021-01-21,15,0,15
16732,San Diego,2021-01-21,1536,69,1605
16733,Santa Clara,2021-01-21,591,20,611
16734,Orange,2021-01-21,1896,29,1925
16735,Sonoma,2021-01-21,95,5,100
16736,Amador,2021-01-21,12,0,12
16737,Mendocino,2021-01-21,16,1,17
16738,Kern,2021-01-21,412,3,415
16739,Stanislaus,2021-01-21,327,13,340
16740,Plumas,2021-01-21,0,0,0
16741,El Dorado,2021-01-22,24,0,24
16742,Yolo,2021-01-22,32,0,32
16743,Colusa,2021-01-22,18,0,18
16744,Mono,2021-01-22,0,0,0
16745,Napa,2021-01-22,23,0,23
16746,Contra Costa,2021-01-22,258,14,272
16747,Alameda,2021-01-22,406,38,444
16748,Tuolumne,2021-01-22,9,0,9
16749,Orange,2021-01-22,1818,31,1849
16750,Nevada,2021-01-22,10,0,10
16751,San Diego,2021-01-22,1501,63,1564
16752,Kern,2021-01-22,386,5,391
16753,Plumas,2021-01-22,0,0,0
16754,San Joaquin,2021-01-22,285,15,300
16755,Calaveras,2021-01-22,4,0,4
16756,Solano,2021-01-22,166,11,177
16757,San Benito,2021-01-22,14,0,14
16758,Amador,2021-01-22,12,0,12
16759,Marin,2021-01-22,32,4,36
16760,San Francisco,2021-01-22,200,14,214
16761,Fresno,2021-01-22,520,23,543
16762,Shasta,2021-01-22,42,0,42
16763,Mendocino,2021-01-22,16,2,18
16764,Mariposa,2021-01-22,0,0,0
16765,Sutter,2021-01-22,0,0,0
16766,Monterey,2021-01-22,184,0,184
16767,Del Norte,2021-01-22,0,0,0
16768,Tulare,2021-01-22,162,13,175
16769,Tehama,2021-01-22,18,0,18
16770,Los Angeles,2021-01-22,6697,317,7014
16771,San Bernardino,2021-01-22,1341,74,1415
16772,Glenn,2021-01-22,4,2,6
16773,Trinity,2021-01-22,0,0,0
16774,Merced,2021-01-22,45,0,45
16775,Santa Cruz,2021-01-22,67,2,69
16776,Lake,2021-01-22,9,0,9
16777,Siskiyou,2021-01-22,3,0,3
16778,Imperial,2021-01-22,104,1,105
16779,Kings,2021-01-22,84,0,84
16780,Sonoma,2021-01-22,100,5,105
16781,Sacramento,2021-01-22,401,21,422
16782,San Mateo,2021-01-22,165,7,172
16783,Butte,2021-01-22,50,0,50
16784,Riverside,2021-01-22,1422,117,1539
16785,San Luis Obispo,2021-01-22,48,1,49
16786,Humboldt,2021-01-22,16,7,23
16787,Santa Clara,2021-01-22,579,17,596
16788,Modoc,2021-01-22,0,0,0
16789,Yuba,2021-01-22,45,0,45
16790,Santa Barbara,2021-01-22,191,8,199
16791,Placer,2021-01-22,116,10,126
16792,Lassen,2021-01-22,5,0,5
16793,Stanislaus,2021-01-22,312,12,324
16794,Inyo,2021-01-22,3,0,3
16795,Madera,2021-01-22,54,5,59
16796,Ventura,2021-01-22,441,12,453
16797,San Mateo,2021-01-23,160,12,172
16798,Butte,2021-01-23,50,0,50
16799,Kern,2021-01-23,382,11,393
16800,Ventura,2021-01-23,419,12,431
16801,San Bernardino,2021-01-23,1277,61,1338
16802,Santa Cruz,2021-01-23,63,2,65
16803,Inyo,2021-01-23,8,0,8
16804,Glenn,2021-01-23,4,2,6
16805,Shasta,2021-01-23,47,0,47
16806,San Benito,2021-01-23,15,0,15
16807,Siskiyou,2021-01-23,3,0,3
16808,Yuba,2021-01-23,49,0,49
16809,San Luis Obispo,2021-01-23,43,1,44
16810,Santa Barbara,2021-01-23,185,5,190
16811,Santa Clara,2021-01-23,550,16,566
16812,Modoc,2021-01-23,0,0,0
16813,Los Angeles,2021-01-23,6486,307,6793
16814,Mendocino,2021-01-23,15,2,17
16815,Orange,2021-01-23,1732,47,1779
16816,Nevada,2021-01-23,1,0,1
16817,Fresno,2021-01-23,527,32,559
16818,San Francisco,2021-01-23,195,6,201
16819,Tehama,2021-01-23,15,0,15
16820,Napa,2021-01-23,19,0,19
16821,Riverside,2021-01-23,1342,106,1448
16822,Imperial,2021-01-23,100,1,101
16823,Placer,2021-01-23,118,11,129
16824,Mariposa,2021-01-23,0,0,0
16825,Del Norte,2021-01-23,0,0,0
16826,Contra Costa,2021-01-23,248,15,263
16827,San Diego,2021-01-23,1467,55,1522
16828,Amador,2021-01-23,11,0,11
16829,El Dorado,2021-01-23,20,0,20
16830,Colusa,2021-01-23,8,0,8
16831,Tuolumne,2021-01-23,12,0,12
16832,Sacramento,2021-01-23,374,21,395
16833,Stanislaus,2021-01-23,298,16,314
16834,Sutter,2021-01-23,0,0,0
16835,Solano,2021-01-23,166,8,174
16836,Calaveras,2021-01-23,3,0,3
16837,Alameda,2021-01-23,404,40,444
16838,Humboldt,2021-01-23,13,3,16
16839,Madera,2021-01-23,53,8,61
16840,Tulare,2021-01-23,157,9,166
16841,San Joaquin,2021-01-23,285,10,295
16842,Kings,2021-01-23,94,0,94
16843,Mono,2021-01-23,0,0,0
16844,Merced,2021-01-23,44,0,44
16845,Lake,2021-01-23,9,0,9
16846,Trinity,2021-01-23,0,0,0
16847,Lassen,2021-01-23,6,0,6
16848,Marin,2021-01-23,34,3,37
16849,Yolo,2021-01-23,33,0,33
16850,Plumas,2021-01-23,0,0,0
16851,Monterey,2021-01-23,170,0,170
16852,Sonoma,2021-01-23,96,6,102
16853,Trinity,2021-01-24,0,0,0
16854,Butte,2021-01-24,55,1,56
16855,Solano,2021-01-24,165,11,176
16856,San Mateo,2021-01-24,159,9,168
16857,Plumas,2021-01-24,0,0,0
16858,Napa,2021-01-24,21,0,21
16859,Amador,2021-01-24,10,0,10
16860,Yolo,2021-01-24,29,2,31
16861,Mono,2021-01-24,0,0,0
16862,Tuolumne,2021-01-24,13,0,13
16863,Marin,2021-01-24,28,2,30
16864,San Luis Obispo,2021-01-24,48,0,48
16865,Inyo,2021-01-24,6,0,6
16866,Mariposa,2021-01-24,0,0,0
16867,Contra Costa,2021-01-24,241,18,259
16868,Glenn,2021-01-24,2,2,4
16869,Humboldt,2021-01-24,15,3,18
16870,Tehama,2021-01-24,13,0,13
16871,El Dorado,2021-01-24,23,1,24
16872,Mendocino,2021-01-24,16,2,18
16873,Santa Cruz,2021-01-24,60,1,61
16874,Los Angeles,2021-01-24,6307,299,6606
16875,San Bernardino,2021-01-24,1274,69,1343
16876,Stanislaus,2021-01-24,291,11,302
16877,Nevada,2021-01-24,12,0,12
16878,Imperial,2021-01-24,93,1,94
16879,Calaveras,2021-01-24,4,0,4
16880,Sonoma,2021-01-24,92,2,94
16881,Santa Clara,2021-01-24,554,17,571
16882,Fresno,2021-01-24,536,39,575
16883,San Benito,2021-01-24,14,0,14
16884,Yuba,2021-01-24,53,0,53
16885,Sutter,2021-01-24,0,0,0
16886,Orange,2021-01-24,1703,45,1748
16887,Colusa,2021-01-24,8,0,8
16888,Lassen,2021-01-24,7,0,7
16889,Monterey,2021-01-24,161,0,161
16890,Sacramento,2021-01-24,377,24,401
16891,Kern,2021-01-24,367,12,379
16892,Santa Barbara,2021-01-24,112,84,196
16893,Shasta,2021-01-24,42,0,42
16894,Modoc,2021-01-24,0,0,0
16895,San Diego,2021-01-24,1440,51,1491
16896,Lake,2021-01-24,9,0,9
16897,Merced,2021-01-24,51,0,51
16898,San Joaquin,2021-01-24,288,12,300
16899,Madera,2021-01-24,54,5,59
16900,Riverside,2021-01-24,1304,108,1412
16901,San Francisco,2021-01-24,192,5,197
16902,Alameda,2021-01-24,406,39,445
16903,Siskiyou,2021-01-24,2,0,2
16904,Kings,2021-01-24,96,0,96
16905,Ventura,2021-01-24,417,19,436
16906,Placer,2021-01-24,114,14,128
16907,Tulare,2021-01-24,148,7,155
16908,Del Norte,2021-01-24,0,0,0
16909,San Francisco,2021-01-25,190,9,199
16910,San Luis Obispo,2021-01-25,46,1,47
16911,Placer,2021-01-25,109,14,123
16912,Inyo,2021-01-25,6,0,6
16913,Imperial,2021-01-25,82,2,84
16914,Lassen,2021-01-25,7,0,7
16915,Orange,2021-01-25,1677,37,1714
16916,Santa Cruz,2021-01-25,55,3,58
16917,Tulare,2021-01-25,151,10,161
16918,Marin,2021-01-25,29,1,30
16919,Madera,2021-01-25,56,8,64
16920,Ventura,2021-01-25,405,20,425
16921,Sonoma,2021-01-25,96,4,100
16922,Alameda,2021-01-25,396,40,436
16923,Sacramento,2021-01-25,371,21,392
16924,Nevada,2021-01-25,12,0,12
16925,Amador,2021-01-25,11,0,11
16926,Butte,2021-01-25,49,0,49
16927,Merced,2021-01-25,54,0,54
16928,Stanislaus,2021-01-25,302,14,316
16929,Humboldt,2021-01-25,12,2,14
16930,Santa Clara,2021-01-25,538,11,549
16931,San Mateo,2021-01-25,147,8,155
16932,Santa Barbara,2021-01-25,192,8,200
16933,Del Norte,2021-01-25,0,0,0
16934,Fresno,2021-01-25,553,16,569
16935,Riverside,2021-01-25,1265,124,1389
16936,San Diego,2021-01-25,1429,63,1492
16937,Siskiyou,2021-01-25,2,0,2
16938,Monterey,2021-01-25,158,0,158
16939,Mendocino,2021-01-25,16,2,18
16940,Solano,2021-01-25,159,12,171
16941,Tuolumne,2021-01-25,10,0,10
16942,Lake,2021-01-25,9,0,9
16943,Contra Costa,2021-01-25,224,17,241
16944,Colusa,2021-01-25,4,0,4
16945,Shasta,2021-01-25,43,0,43
16946,San Benito,2021-01-25,14,0,14
16947,Trinity,2021-01-25,0,0,0
16948,Yuba,2021-01-25,54,0,54
16949,Calaveras,2021-01-25,3,0,3
16950,Mariposa,2021-01-25,0,0,0
16951,El Dorado,2021-01-25,19,1,20
16952,Los Angeles,2021-01-25,6213,287,6500
16953,San Joaquin,2021-01-25,280,6,286
16954,Modoc,2021-01-25,0,0,0
16955,Sutter,2021-01-25,0,0,0
16956,Kings,2021-01-25,95,0,95
16957,Glenn,2021-01-25,1,2,3
16958,Yolo,2021-01-25,28,0,28
16959,Tehama,2021-01-25,14,0,14
16960,Plumas,2021-01-25,0,0,0
16961,San Bernardino,2021-01-25,1248,51,1299
16962,Mono,2021-01-25,0,0,0
16963,Napa,2021-01-25,24,0,24
16964,Kern,2021-01-25,378,9,387
16965,Glenn,2021-01-26,1,2,3
16966,Humboldt,2021-01-26,13,11,24
16967,Sutter,2021-01-26,0,0,0
16968,El Dorado,2021-01-26,21,1,22
16969,Butte,2021-01-26,51,1,52
16970,Santa Clara,2021-01-26,503,15,518
16971,Santa Barbara,2021-01-26,203,9,212
16972,Siskiyou,2021-01-26,2,0,2
16973,San Bernardino,2021-01-26,1209,52,1261
16974,San Francisco,2021-01-26,181,6,187
16975,Sacramento,2021-01-26,382,22,404
16976,Stanislaus,2021-01-26,293,10,303
16977,Mono,2021-01-26,0,0,0
16978,Del Norte,2021-01-26,0,0,0
16979,Amador,2021-01-26,11,0,11
16980,Monterey,2021-01-26,161,0,161
16981,Los Angeles,2021-01-26,6026,345,6371
16982,Ventura,2021-01-26,418,12,430
16983,Lassen,2021-01-26,6,0,6
16984,Kings,2021-01-26,89,1,90
16985,Napa,2021-01-26,21,0,21
16986,San Benito,2021-01-26,12,0,12
16987,Contra Costa,2021-01-26,222,14,236
16988,Madera,2021-01-26,58,9,67
16989,Plumas,2021-01-26,0,0,0
16990,Imperial,2021-01-26,77,5,82
16991,Sonoma,2021-01-26,97,1,98
16992,Yuba,2021-01-26,54,0,54
16993,Mariposa,2021-01-26,0,0,0
16994,Calaveras,2021-01-26,4,0,4
16995,Santa Cruz,2021-01-26,58,3,61
16996,Kern,2021-01-26,358,11,369
16997,Solano,2021-01-26,153,9,162
16998,Colusa,2021-01-26,4,0,4
16999,Trinity,2021-01-26,0,0,0
17000,Nevada,2021-01-26,12,0,12
17001,San Diego,2021-01-26,1410,62,1472
17002,Tehama,2021-01-26,10,0,10
17003,Modoc,2021-01-26,0,0,0
17004,Lake,2021-01-26,9,0,9
17005,Mendocino,2021-01-26,16,2,18
17006,Alameda,2021-01-26,382,36,418
17007,Yolo,2021-01-26,27,0,27
17008,Fresno,2021-01-26,543,29,572
17009,San Luis Obispo,2021-01-26,47,2,49
17010,Inyo,2021-01-26,7,0,7
17011,Tulare,2021-01-26,152,8,160
17012,San Mateo,2021-01-26,147,13,160
17013,Merced,2021-01-26,54,0,54
17014,Tuolumne,2021-01-26,8,0,8
17015,Orange,2021-01-26,1639,55,1694
17016,Riverside,2021-01-26,1238,99,1337
17017,Placer,2021-01-26,113,13,126
17018,Marin,2021-01-26,29,3,32
17019,San Joaquin,2021-01-26,269,10,279
17020,Shasta,2021-01-26,39,0,39
17021,Inyo,2021-01-27,6,0,6
17022,Napa,2021-01-27,20,1,21
17023,Plumas,2021-01-27,0,0,0
17024,Santa Barbara,2021-01-27,193,5,198
17025,Kern,2021-01-27,338,8,346
17026,San Joaquin,2021-01-27,255,16,271
17027,Solano,2021-01-27,147,14,161
17028,Imperial,2021-01-27,75,1,76
17029,Glenn,2021-01-27,3,2,5
17030,Tehama,2021-01-27,8,0,8
17031,Yolo,2021-01-27,22,0,22
17032,Santa Cruz,2021-01-27,51,1,52
17033,Stanislaus,2021-01-27,288,13,301
17034,Ventura,2021-01-27,411,8,419
17035,Siskiyou,2021-01-27,2,0,2
17036,Lassen,2021-01-27,3,0,3
17037,Mariposa,2021-01-27,0,0,0
17038,Modoc,2021-01-27,0,0,0
17039,Kings,2021-01-27,76,1,77
17040,Orange,2021-01-27,1592,32,1624
17041,El Dorado,2021-01-27,18,2,20
17042,San Mateo,2021-01-27,149,12,161
17043,Trinity,2021-01-27,0,0,0
17044,Monterey,2021-01-27,163,1,164
17045,Mono,2021-01-27,0,0,0
17046,Tulare,2021-01-27,153,4,157
17047,Sonoma,2021-01-27,94,6,100
17048,Nevada,2021-01-27,9,0,9
17049,Alameda,2021-01-27,359,41,400
17050,Tuolumne,2021-01-27,6,0,6
17051,San Bernardino,2021-01-27,1164,68,1232
17052,Riverside,2021-01-27,1191,122,1313
17053,San Diego,2021-01-27,1343,61,1404
17054,Yuba,2021-01-27,51,0,51
17055,Butte,2021-01-27,46,1,47
17056,Contra Costa,2021-01-27,197,11,208
17057,Colusa,2021-01-27,4,0,4
17058,Amador,2021-01-27,10,0,10
17059,Merced,2021-01-27,53,0,53
17060,Los Angeles,2021-01-27,5855,355,6210
17061,Santa Clara,2021-01-27,509,12,521
17062,Marin,2021-01-27,28,2,30
17063,San Benito,2021-01-27,11,0,11
17064,Placer,2021-01-27,105,15,120
17065,Lake,2021-01-27,9,1,10
17066,Calaveras,2021-01-27,4,0,4
17067,Sutter,2021-01-27,0,0,0
17068,Sacramento,2021-01-27,379,23,402
17069,San Luis Obispo,2021-01-27,46,0,46
17070,Mendocino,2021-01-27,15,2,17
17071,Humboldt,2021-01-27,12,11,23
17072,Fresno,2021-01-27,500,33,533
17073,Del Norte,2021-01-27,0,0,0
17074,Madera,2021-01-27,63,6,69
17075,Shasta,2021-01-27,37,0,37
17076,San Francisco,2021-01-27,178,1,179
17077,Plumas,2021-01-28,0,0,0
17078,Trinity,2021-01-28,0,0,0
17079,Merced,2021-01-28,52,0,52
17080,Santa Clara,2021-01-28,487,9,496
17081,Shasta,2021-01-28,32,0,32
17082,Orange,2021-01-28,1521,33,1554
17083,Santa Cruz,2021-01-28,39,1,40
17084,El Dorado,2021-01-28,15,3,18
17085,San Bernardino,2021-01-28,1128,51,1179
17086,Modoc,2021-01-28,0,0,0
17087,Los Angeles,2021-01-28,5669,372,6041
17088,Mono,2021-01-28,0,0,0
17089,Mariposa,2021-01-28,0,0,0
17090,Lake,2021-01-28,7,1,8
17091,Santa Barbara,2021-01-28,180,7,187
17092,Fresno,2021-01-28,472,28,500
17093,Tuolumne,2021-01-28,7,0,7
17094,Nevada,2021-01-28,13,0,13
17095,Lassen,2021-01-28,3,0,3
17096,Solano,2021-01-28,147,11,158
17097,Mendocino,2021-01-28,15,2,17
17098,Tehama,2021-01-28,11,0,11
17099,Napa,2021-01-28,21,0,21
17100,Imperial,2021-01-28,75,0,75
17101,Riverside,2021-01-28,1128,124,1252
17102,Sonoma,2021-01-28,89,6,95
17103,San Francisco,2021-01-28,176,2,178
17104,Butte,2021-01-28,41,1,42
17105,Alameda,2021-01-28,353,46,399
17106,Kern,2021-01-28,317,9,326
17107,San Mateo,2021-01-28,146,10,156
17108,Marin,2021-01-28,27,2,29
17109,Calaveras,2021-01-28,3,0,3
17110,San Diego,2021-01-28,1328,55,1383
17111,Colusa,2021-01-28,7,0,7
17112,Yolo,2021-01-28,19,0,19
17113,Ventura,2021-01-28,386,7,393
17114,Inyo,2021-01-28,4,0,4
17115,Kings,2021-01-28,81,0,81
17116,San Benito,2021-01-28,12,0,12
17117,San Joaquin,2021-01-28,253,16,269
17118,Siskiyou,2021-01-28,2,1,3
17119,Del Norte,2021-01-28,0,1,1
17120,Yuba,2021-01-28,49,0,49
17121,San Luis Obispo,2021-01-28,43,0,43
17122,Madera,2021-01-28,67,6,73
17123,Glenn,2021-01-28,3,2,5
17124,Monterey,2021-01-28,149,2,151
17125,Stanislaus,2021-01-28,281,10,291
17126,Sacramento,2021-01-28,365,16,381
17127,Placer,2021-01-28,115,17,132
17128,Sutter,2021-01-28,0,0,0
17129,Amador,2021-01-28,12,0,12
17130,Tulare,2021-01-28,153,7,160
17131,Contra Costa,2021-01-28,189,14,203
17132,Humboldt,2021-01-28,13,4,17
17133,Calaveras,2021-01-29,3,0,3
17134,Sonoma,2021-01-29,86,3,89
17135,Orange,2021-01-29,1442,36,1478
17136,Santa Barbara,2021-01-29,182,10,192
17137,Lake,2021-01-29,8,0,8
17138,Santa Clara,2021-01-29,487,8,495
17139,San Diego,2021-01-29,1317,58,1375
17140,Solano,2021-01-29,149,9,158
17141,El Dorado,2021-01-29,15,0,15
17142,Ventura,2021-01-29,376,14,390
17143,Amador,2021-01-29,12,2,14
17144,Trinity,2021-01-29,0,0,0
17145,San Joaquin,2021-01-29,223,12,235
17146,Tuolumne,2021-01-29,6,0,6
17147,Alameda,2021-01-29,347,39,386
17148,San Benito,2021-01-29,12,0,12
17149,Sacramento,2021-01-29,352,17,369
17150,Riverside,2021-01-29,1103,122,1225
17151,San Mateo,2021-01-29,136,12,148
17152,Kern,2021-01-29,298,10,308
17153,Modoc,2021-01-29,1,0,1
17154,Tulare,2021-01-29,154,5,159
17155,Siskiyou,2021-01-29,0,0,0
17156,Butte,2021-01-29,43,0,43
17157,Fresno,2021-01-29,475,27,502
17158,Del Norte,2021-01-29,0,1,1
17159,Yolo,2021-01-29,17,0,17
17160,Santa Cruz,2021-01-29,45,2,47
17161,Yuba,2021-01-29,42,0,42
17162,Lassen,2021-01-29,2,0,2
17163,Mariposa,2021-01-29,0,0,0
17164,San Luis Obispo,2021-01-29,46,2,48
17165,Plumas,2021-01-29,0,0,0
17166,Los Angeles,2021-01-29,5511,325,5836
17167,Stanislaus,2021-01-29,270,13,283
17168,Merced,2021-01-29,43,0,43
17169,Glenn,2021-01-29,3,2,5
17170,Sutter,2021-01-29,0,0,0
17171,Colusa,2021-01-29,9,0,9
17172,Mendocino,2021-01-29,13,1,14
17173,San Francisco,2021-01-29,190,6,196
17174,Monterey,2021-01-29,151,1,152
17175,Inyo,2021-01-29,4,0,4
17176,Madera,2021-01-29,59,9,68
17177,Marin,2021-01-29,27,3,30
17178,Tehama,2021-01-29,10,0,10
17179,Nevada,2021-01-29,13,0,13
17180,Placer,2021-01-29,118,17,135
17181,Napa,2021-01-29,18,0,18
17182,Humboldt,2021-01-29,8,3,11
17183,Kings,2021-01-29,75,0,75
17184,Imperial,2021-01-29,80,0,80
17185,Shasta,2021-01-29,28,0,28
17186,Mono,2021-01-29,0,0,0
17187,San Bernardino,2021-01-29,1100,41,1141
17188,Contra Costa,2021-01-29,187,18,205
17189,San Luis Obispo,2021-01-30,46,1,47
17190,San Joaquin,2021-01-30,207,18,225
17191,Sonoma,2021-01-30,85,6,91
17192,Yuba,2021-01-30,43,8,51
17193,Napa,2021-01-30,18,0,18
17194,Madera,2021-01-30,51,6,57
17195,Butte,2021-01-30,43,0,43
17196,Orange,2021-01-30,1412,38,1450
17197,Imperial,2021-01-30,76,2,78
17198,Modoc,2021-01-30,1,0,1
17199,Alameda,2021-01-30,330,38,368
17200,Los Angeles,2021-01-30,5398,320,5718
17201,Colusa,2021-01-30,5,0,5
17202,Amador,2021-01-30,9,0,9
17203,El Dorado,2021-01-30,17,1,18
17204,Yolo,2021-01-30,16,0,16
17205,Monterey,2021-01-30,142,2,144
17206,Humboldt,2021-01-30,8,7,15
17207,Inyo,2021-01-30,3,0,3
17208,Solano,2021-01-30,134,9,143
17209,Calaveras,2021-01-30,1,0,1
17210,Plumas,2021-01-30,0,0,0
17211,Fresno,2021-01-30,460,34,494
17212,Kern,2021-01-30,298,8,306
17213,Riverside,2021-01-30,1028,109,1137
17214,San Diego,2021-01-30,1310,42,1352
17215,Lake,2021-01-30,7,0,7
17216,Merced,2021-01-30,41,0,41
17217,San Bernardino,2021-01-30,1060,52,1112
17218,Kings,2021-01-30,64,0,64
17219,Ventura,2021-01-30,362,14,376
17220,Stanislaus,2021-01-30,262,15,277
17221,Santa Clara,2021-01-30,475,7,482
17222,San Francisco,2021-01-30,177,4,181
17223,Tehama,2021-01-30,9,0,9
17224,San Benito,2021-01-30,12,0,12
17225,Mono,2021-01-30,0,0,0
17226,Mendocino,2021-01-30,12,1,13
17227,Shasta,2021-01-30,26,0,26
17228,San Mateo,2021-01-30,146,10,156
17229,Siskiyou,2021-01-30,0,0,0
17230,Santa Cruz,2021-01-30,40,2,42
17231,Santa Barbara,2021-01-30,179,7,186
17232,Del Norte,2021-01-30,0,0,0
17233,Tuolumne,2021-01-30,5,1,6
17234,Sacramento,2021-01-30,346,14,360
17235,Sutter,2021-01-30,0,0,0
17236,Placer,2021-01-30,121,16,137
17237,Lassen,2021-01-30,2,0,2
17238,Trinity,2021-01-30,0,0,0
17239,Mariposa,2021-01-30,0,0,0
17240,Contra Costa,2021-01-30,182,18,200
17241,Marin,2021-01-30,27,4,31
17242,Glenn,2021-01-30,3,2,5
17243,Tulare,2021-01-30,146,4,150
17244,Nevada,2021-01-30,11,0,11
17245,Placer,2021-01-31,107,11,118
17246,Mendocino,2021-01-31,10,1,11
17247,Stanislaus,2021-01-31,246,11,257
17248,Solano,2021-01-31,126,4,130
17249,Mariposa,2021-01-31,0,0,0
17250,Sonoma,2021-01-31,78,2,80
17251,Santa Clara,2021-01-31,454,12,466
17252,Colusa,2021-01-31,5,0,5
17253,Contra Costa,2021-01-31,172,16,188
17254,Fresno,2021-01-31,452,29,481
17255,San Joaquin,2021-01-31,212,15,227
17256,Butte,2021-01-31,43,0,43
17257,Madera,2021-01-31,51,10,61
17258,Imperial,2021-01-31,72,0,72
17259,Riverside,2021-01-31,979,129,1108
17260,San Francisco,2021-01-31,170,4,174
17261,Monterey,2021-01-31,128,1,129
17262,Sutter,2021-01-31,0,0,0
17263,Del Norte,2021-01-31,0,0,0
17264,Merced,2021-01-31,39,0,39
17265,Nevada,2021-01-31,1,11,12
17266,San Benito,2021-01-31,10,0,10
17267,Kings,2021-01-31,84,0,84
17268,Orange,2021-01-31,1362,30,1392
17269,Lassen,2021-01-31,4,0,4
17270,Marin,2021-01-31,29,3,32
17271,Yuba,2021-01-31,43,7,50
17272,Trinity,2021-01-31,0,0,0
17273,Lake,2021-01-31,7,0,7
17274,Ventura,2021-01-31,351,16,367
17275,Kern,2021-01-31,293,6,299
17276,Los Angeles,2021-01-31,5259,300,5559
17277,Tehama,2021-01-31,11,0,11
17278,San Bernardino,2021-01-31,1036,39,1075
17279,Calaveras,2021-01-31,2,0,2
17280,Santa Cruz,2021-01-31,42,2,44
17281,Inyo,2021-01-31,4,0,4
17282,Alameda,2021-01-31,318,31,349
17283,Napa,2021-01-31,15,0,15
17284,Tuolumne,2021-01-31,9,0,9
17285,Shasta,2021-01-31,25,0,25
17286,Mono,2021-01-31,0,0,0
17287,Glenn,2021-01-31,3,2,5
17288,Humboldt,2021-01-31,10,2,12
17289,Santa Barbara,2021-01-31,170,8,178
17290,Amador,2021-01-31,8,0,8
17291,Plumas,2021-01-31,0,0,0
17292,El Dorado,2021-01-31,12,0,12
17293,Modoc,2021-01-31,1,0,1
17294,San Luis Obispo,2021-01-31,45,2,47
17295,Tulare,2021-01-31,149,5,154
17296,Yolo,2021-01-31,12,0,12
17297,Siskiyou,2021-01-31,0,0,0
17298,Sacramento,2021-01-31,339,14,353
17299,San Mateo,2021-01-31,139,5,144
17300,San Diego,2021-01-31,1306,41,1347
17301,Mariposa,2021-02-01,0,0,0
17302,San Joaquin,2021-02-01,222,15,237
17303,Napa,2021-02-01,16,0,16
17304,Madera,2021-02-01,44,2,46
17305,Santa Barbara,2021-02-01,161,8,169
17306,Amador,2021-02-01,8,0,8
17307,Mendocino,2021-02-01,9,1,10
17308,Sutter,2021-02-01,0,0,0
17309,Yolo,2021-02-01,14,0,14
17310,San Bernardino,2021-02-01,1017,46,1063
17311,Marin,2021-02-01,28,4,32
17312,Sacramento,2021-02-01,325,19,344
17313,Trinity,2021-02-01,0,0,0
17314,Kings,2021-02-01,90,2,92
17315,Humboldt,2021-02-01,7,3,10
17316,Sonoma,2021-02-01,81,3,84
17317,Kern,2021-02-01,287,5,292
17318,San Francisco,2021-02-01,174,1,175
17319,Glenn,2021-02-01,0,0,0
17320,Siskiyou,2021-02-01,3,0,3
17321,Plumas,2021-02-01,0,0,0
17322,Modoc,2021-02-01,1,0,1
17323,Shasta,2021-02-01,21,0,21
17324,Nevada,2021-02-01,10,0,10
17325,Tulare,2021-02-01,142,7,149
17326,El Dorado,2021-02-01,11,0,11
17327,Lake,2021-02-01,5,0,5
17328,Inyo,2021-02-01,3,0,3
17329,Alameda,2021-02-01,314,39,353
17330,Lassen,2021-02-01,5,0,5
17331,Imperial,2021-02-01,73,0,73
17332,Tehama,2021-02-01,10,0,10
17333,Merced,2021-02-01,38,0,38
17334,Santa Clara,2021-02-01,466,12,478
17335,San Diego,2021-02-01,1258,76,1334
17336,Fresno,2021-02-01,480,28,508
17337,Santa Cruz,2021-02-01,41,1,42
17338,Riverside,2021-02-01,954,131,1085
17339,Mono,2021-02-01,0,0,0
17340,Monterey,2021-02-01,122,3,125
17341,Tuolumne,2021-02-01,8,1,9
17342,Orange,2021-02-01,1330,22,1352
17343,San Benito,2021-02-01,9,0,9
17344,Solano,2021-02-01,139,7,146
17345,Colusa,2021-02-01,4,0,4
17346,San Luis Obispo,2021-02-01,47,1,48
17347,Butte,2021-02-01,37,0,37
17348,Los Angeles,2021-02-01,5165,278,5443
17349,Calaveras,2021-02-01,2,0,2
17350,Ventura,2021-02-01,330,10,340
17351,San Mateo,2021-02-01,132,3,135
17352,Placer,2021-02-01,102,14,116
17353,Contra Costa,2021-02-01,181,18,199
17354,Del Norte,2021-02-01,0,0,0
17355,Stanislaus,2021-02-01,256,12,268
17356,Yuba,2021-02-01,39,6,45
17357,Solano,2021-02-02,128,10,138
17358,Riverside,2021-02-02,920,127,1047
17359,Tulare,2021-02-02,135,7,142
17360,Del Norte,2021-02-02,0,0,0
17361,Santa Barbara,2021-02-02,167,7,174
17362,Mendocino,2021-02-02,9,1,10
17363,Imperial,2021-02-02,66,0,66
17364,Colusa,2021-02-02,4,0,4
17365,Tuolumne,2021-02-02,3,0,3
17366,Sutter,2021-02-02,0,0,0
17367,Humboldt,2021-02-02,11,3,14
17368,Shasta,2021-02-02,18,0,18
17369,Alameda,2021-02-02,316,35,351
17370,San Luis Obispo,2021-02-02,38,0,38
17371,Contra Costa,2021-02-02,181,21,202
17372,Santa Clara,2021-02-02,436,12,448
17373,Nevada,2021-02-02,10,1,11
17374,Sacramento,2021-02-02,305,14,319
17375,San Benito,2021-02-02,9,0,9
17376,San Mateo,2021-02-02,132,7,139
17377,Stanislaus,2021-02-02,256,21,277
17378,San Diego,2021-02-02,1233,51,1284
17379,San Bernardino,2021-02-02,969,43,1012
17380,Santa Cruz,2021-02-02,40,0,40
17381,Modoc,2021-02-02,1,0,1
17382,Orange,2021-02-02,1298,33,1331
17383,Napa,2021-02-02,16,0,16
17384,Fresno,2021-02-02,448,39,487
17385,Siskiyou,2021-02-02,3,0,3
17386,Kern,2021-02-02,273,8,281
17387,Marin,2021-02-02,25,3,28
17388,Inyo,2021-02-02,3,0,3
17389,San Francisco,2021-02-02,176,7,183
17390,Mariposa,2021-02-02,0,0,0
17391,Amador,2021-02-02,8,0,8
17392,San Joaquin,2021-02-02,217,9,226
17393,Madera,2021-02-02,39,4,43
17394,Placer,2021-02-02,108,14,122
17395,Mono,2021-02-02,0,0,0
17396,Yuba,2021-02-02,45,4,49
17397,Merced,2021-02-02,36,0,36
17398,Yolo,2021-02-02,12,0,12
17399,Calaveras,2021-02-02,2,0,2
17400,Tehama,2021-02-02,10,0,10
17401,Kings,2021-02-02,85,0,85
17402,Ventura,2021-02-02,333,9,342
17403,Glenn,2021-02-02,0,0,0
17404,Butte,2021-02-02,34,0,34
17405,Los Angeles,2021-02-02,4990,314,5304
17406,Monterey,2021-02-02,118,2,120
17407,Sonoma,2021-02-02,81,6,87
17408,Lassen,2021-02-02,5,0,5
17409,Lake,2021-02-02,4,0,4
17410,Plumas,2021-02-02,0,0,0
17411,Trinity,2021-02-02,0,0,0
17412,El Dorado,2021-02-02,10,0,10
17413,Sutter,2021-02-03,0,0,0
17414,Tuolumne,2021-02-03,5,0,5
17415,Santa Cruz,2021-02-03,42,1,43
17416,San Joaquin,2021-02-03,209,6,215
17417,Solano,2021-02-03,128,7,135
17418,San Bernardino,2021-02-03,945,49,994
17419,San Diego,2021-02-03,1202,52,1254
17420,Colusa,2021-02-03,4,0,4
17421,Shasta,2021-02-03,19,0,19
17422,Yuba,2021-02-03,48,3,51
17423,Tehama,2021-02-03,11,0,11
17424,Fresno,2021-02-03,435,33,468
17425,Inyo,2021-02-03,5,0,5
17426,Mendocino,2021-02-03,5,1,6
17427,San Benito,2021-02-03,12,0,12
17428,Contra Costa,2021-02-03,165,15,180
17429,Imperial,2021-02-03,61,1,62
17430,Santa Clara,2021-02-03,418,9,427
17431,Humboldt,2021-02-03,11,3,14
17432,Placer,2021-02-03,108,19,127
17433,Orange,2021-02-03,1238,41,1279
17434,Sonoma,2021-02-03,72,9,81
17435,Siskiyou,2021-02-03,3,0,3
17436,Monterey,2021-02-03,118,2,120
17437,San Luis Obispo,2021-02-03,42,1,43
17438,Lake,2021-02-03,3,0,3
17439,Napa,2021-02-03,17,0,17
17440,Mariposa,2021-02-03,0,0,0
17441,Nevada,2021-02-03,10,1,11
17442,Yolo,2021-02-03,12,0,12
17443,Glenn,2021-02-03,0,0,0
17444,San Mateo,2021-02-03,125,6,131
17445,Riverside,2021-02-03,864,127,991
17446,Los Angeles,2021-02-03,4796,346,5142
17447,San Francisco,2021-02-03,166,9,175
17448,Mono,2021-02-03,0,0,0
17449,Trinity,2021-02-03,0,0,0
17450,Kings,2021-02-03,76,1,77
17451,Alameda,2021-02-03,301,39,340
17452,Kern,2021-02-03,260,10,270
17453,Santa Barbara,2021-02-03,164,4,168
17454,Tulare,2021-02-03,137,13,150
17455,Modoc,2021-02-03,2,0,2
17456,Ventura,2021-02-03,340,8,348
17457,Butte,2021-02-03,32,0,32
17458,Amador,2021-02-03,7,0,7
17459,Marin,2021-02-03,23,2,25
17460,El Dorado,2021-02-03,9,0,9
17461,Lassen,2021-02-03,2,0,2
17462,Plumas,2021-02-03,0,0,0
17463,Stanislaus,2021-02-03,250,22,272
17464,Del Norte,2021-02-03,0,0,0
17465,Calaveras,2021-02-03,3,0,3
17466,Madera,2021-02-03,32,7,39
17467,Merced,2021-02-03,38,0,38
17468,Sacramento,2021-02-03,302,14,316
17469,Stanislaus,2021-02-04,245,21,266
17470,San Mateo,2021-02-04,119,5,124
17471,Fresno,2021-02-04,419,24,443
17472,Ventura,2021-02-04,319,9,328
17473,Placer,2021-02-04,114,15,129
17474,Inyo,2021-02-04,4,0,4
17475,Mariposa,2021-02-04,0,0,0
17476,Imperial,2021-02-04,55,1,56
17477,Merced,2021-02-04,40,0,40
17478,Modoc,2021-02-04,2,0,2
17479,San Luis Obispo,2021-02-04,43,0,43
17480,Santa Cruz,2021-02-04,45,0,45
17481,Shasta,2021-02-04,21,0,21
17482,Santa Clara,2021-02-04,381,14,395
17483,Los Angeles,2021-02-04,4607,319,4926
17484,Tulare,2021-02-04,139,8,147
17485,Mono,2021-02-04,0,0,0
17486,Glenn,2021-02-04,0,0,0
17487,Marin,2021-02-04,25,4,29
17488,Yolo,2021-02-04,13,0,13
17489,Riverside,2021-02-04,847,117,964
17490,Alameda,2021-02-04,302,42,344
17491,Calaveras,2021-02-04,4,0,4
17492,Humboldt,2021-02-04,14,2,16
17493,San Joaquin,2021-02-04,196,8,204
17494,San Bernardino,2021-02-04,906,50,956
17495,Contra Costa,2021-02-04,174,20,194
17496,Santa Barbara,2021-02-04,161,6,167
17497,San Benito,2021-02-04,12,0,12
17498,El Dorado,2021-02-04,8,0,8
17499,Lake,2021-02-04,2,0,2
17500,Madera,2021-02-04,34,5,39
17501,Kings,2021-02-04,72,1,73
17502,Monterey,2021-02-04,114,0,114
17503,Butte,2021-02-04,32,0,32
17504,San Francisco,2021-02-04,171,5,176
17505,Tuolumne,2021-02-04,7,1,8
17506,Nevada,2021-02-04,14,2,16
17507,Sacramento,2021-02-04,292,18,310
17508,Orange,2021-02-04,1233,36,1269
17509,Amador,2021-02-04,6,1,7
17510,Sutter,2021-02-04,0,0,0
17511,Solano,2021-02-04,118,11,129
17512,Napa,2021-02-04,14,0,14
17513,Kern,2021-02-04,259,5,264
17514,Trinity,2021-02-04,0,0,0
17515,Yuba,2021-02-04,43,3,46
17516,Siskiyou,2021-02-04,2,0,2
17517,Sonoma,2021-02-04,69,8,77
17518,San Diego,2021-02-04,1142,47,1189
17519,Mendocino,2021-02-04,8,1,9
17520,Colusa,2021-02-04,5,0,5
17521,Lassen,2021-02-04,2,0,2
17522,Plumas,2021-02-04,0,0,0
17523,Del Norte,2021-02-04,0,0,0
17524,Tehama,2021-02-04,9,0,9
17525,San Joaquin,2021-02-05,172,6,178
17526,Tehama,2021-02-05,11,0,11
17527,Merced,2021-02-05,38,0,38
17528,Sutter,2021-02-05,0,0,0
17529,Stanislaus,2021-02-05,229,24,253
17530,Sonoma,2021-02-05,62,2,64
17531,Calaveras,2021-02-05,5,0,5
17532,Nevada,2021-02-05,11,4,15
17533,Orange,2021-02-05,1164,29,1193
17534,San Mateo,2021-02-05,115,9,124
17535,Plumas,2021-02-05,0,0,0
17536,Santa Barbara,2021-02-05,154,6,160
17537,Kern,2021-02-05,256,2,258
17538,Napa,2021-02-05,14,0,14
17539,Lake,2021-02-05,2,0,2
17540,Yuba,2021-02-05,43,3,46
17541,Madera,2021-02-05,39,8,47
17542,Fresno,2021-02-05,405,29,434
17543,Inyo,2021-02-05,6,0,6
17544,Mariposa,2021-02-05,0,0,0
17545,Marin,2021-02-05,23,2,25
17546,San Bernardino,2021-02-05,905,45,950
17547,Modoc,2021-02-05,2,0,2
17548,Lassen,2021-02-05,2,0,2
17549,Alameda,2021-02-05,294,34,328
17550,Glenn,2021-02-05,0,0,0
17551,Amador,2021-02-05,7,1,8
17552,Colusa,2021-02-05,4,0,4
17553,Monterey,2021-02-05,109,1,110
17554,San Francisco,2021-02-05,172,4,176
17555,Contra Costa,2021-02-05,166,21,187
17556,Sacramento,2021-02-05,260,17,277
17557,El Dorado,2021-02-05,6,0,6
17558,Imperial,2021-02-05,49,0,49
17559,Butte,2021-02-05,31,0,31
17560,Humboldt,2021-02-05,15,1,16
17561,San Luis Obispo,2021-02-05,36,1,37
17562,Riverside,2021-02-05,821,109,930
17563,Del Norte,2021-02-05,0,0,0
17564,San Diego,2021-02-05,1100,38,1138
17565,Siskiyou,2021-02-05,2,0,2
17566,Santa Cruz,2021-02-05,48,1,49
17567,Shasta,2021-02-05,20,0,20
17568,Mendocino,2021-02-05,8,0,8
17569,Solano,2021-02-05,110,9,119
17570,Tulare,2021-02-05,134,9,143
17571,San Benito,2021-02-05,12,0,12
17572,Los Angeles,2021-02-05,4421,338,4759
17573,Ventura,2021-02-05,305,11,316
17574,Placer,2021-02-05,109,10,119
17575,Kings,2021-02-05,67,0,67
17576,Yolo,2021-02-05,12,0,12
17577,Mono,2021-02-05,0,0,0
17578,Tuolumne,2021-02-05,9,1,10
17579,Santa Clara,2021-02-05,360,17,377
17580,Trinity,2021-02-05,0,0,0
17581,San Diego,2021-02-06,1074,43,1117
17582,Modoc,2021-02-06,1,0,1
17583,San Bernardino,2021-02-06,828,46,874
17584,Mariposa,2021-02-06,0,0,0
17585,Marin,2021-02-06,23,1,24
17586,Contra Costa,2021-02-06,154,17,171
17587,Tuolumne,2021-02-06,7,1,8
17588,Monterey,2021-02-06,105,0,105
17589,San Mateo,2021-02-06,107,7,114
17590,Orange,2021-02-06,1093,35,1128
17591,Tulare,2021-02-06,126,6,132
17592,Napa,2021-02-06,12,0,12
17593,Mono,2021-02-06,0,0,0
17594,Amador,2021-02-06,6,1,7
17595,Kings,2021-02-06,69,2,71
17596,Trinity,2021-02-06,0,0,0
17597,Sutter,2021-02-06,0,0,0
17598,Shasta,2021-02-06,22,0,22
17599,Los Angeles,2021-02-06,4186,306,4492
17600,San Benito,2021-02-06,10,0,10
17601,Humboldt,2021-02-06,15,2,17
17602,Sacramento,2021-02-06,245,16,261
17603,Merced,2021-02-06,44,0,44
17604,Placer,2021-02-06,94,14,108
17605,Butte,2021-02-06,25,0,25
17606,Yolo,2021-02-06,12,0,12
17607,Santa Barbara,2021-02-06,132,5,137
17608,Calaveras,2021-02-06,4,0,4
17609,Ventura,2021-02-06,298,9,307
17610,Siskiyou,2021-02-06,1,0,1
17611,Tehama,2021-02-06,12,0,12
17612,Madera,2021-02-06,39,8,47
17613,Solano,2021-02-06,98,12,110
17614,Alameda,2021-02-06,282,37,319
17615,Yuba,2021-02-06,42,1,43
17616,Santa Clara,2021-02-06,341,24,365
17617,Glenn,2021-02-06,0,0,0
17618,Inyo,2021-02-06,5,0,5
17619,Del Norte,2021-02-06,0,1,1
17620,San Joaquin,2021-02-06,175,7,182
17621,Plumas,2021-02-06,0,0,0
17622,Fresno,2021-02-06,378,25,403
17623,Kern,2021-02-06,244,3,247
17624,Santa Cruz,2021-02-06,46,2,48
17625,Imperial,2021-02-06,43,0,43
17626,Lake,2021-02-06,2,0,2
17627,San Luis Obispo,2021-02-06,32,0,32
17628,San Francisco,2021-02-06,159,5,164
17629,Mendocino,2021-02-06,6,0,6
17630,Colusa,2021-02-06,7,0,7
17631,Sonoma,2021-02-06,69,1,70
17632,Stanislaus,2021-02-06,218,31,249
17633,Lassen,2021-02-06,3,0,3
17634,El Dorado,2021-02-06,6,0,6
17635,Nevada,2021-02-06,9,2,11
17636,Riverside,2021-02-06,786,111,897
17637,Fresno,2021-02-07,366,25,391
17638,San Luis Obispo,2021-02-07,33,1,34
17639,Contra Costa,2021-02-07,137,18,155
17640,San Diego,2021-02-07,1042,37,1079
17641,Kings,2021-02-07,67,1,68
17642,Colusa,2021-02-07,7,0,7
17643,Inyo,2021-02-07,5,0,5
17644,Santa Cruz,2021-02-07,41,1,42
17645,Plumas,2021-02-07,0,0,0
17646,Amador,2021-02-07,5,0,5
17647,Napa,2021-02-07,12,0,12
17648,Tehama,2021-02-07,11,0,11
17649,Trinity,2021-02-07,0,0,0
17650,San Joaquin,2021-02-07,171,8,179
17651,Kern,2021-02-07,270,2,272
17652,Riverside,2021-02-07,768,103,871
17653,Tulare,2021-02-07,124,11,135
17654,Mendocino,2021-02-07,8,0,8
17655,Solano,2021-02-07,92,8,100
17656,Marin,2021-02-07,20,3,23
17657,San Bernardino,2021-02-07,822,48,870
17658,Alameda,2021-02-07,279,32,311
17659,Madera,2021-02-07,42,7,49
17660,El Dorado,2021-02-07,6,0,6
17661,Imperial,2021-02-07,38,2,40
17662,Ventura,2021-02-07,282,12,294
17663,Lake,2021-02-07,2,0,2
17664,Mariposa,2021-02-07,1,0,1
17665,Lassen,2021-02-07,3,0,3
17666,Butte,2021-02-07,24,0,24
17667,Sonoma,2021-02-07,67,2,69
17668,Santa Barbara,2021-02-07,141,6,147
17669,Modoc,2021-02-07,1,0,1
17670,Yolo,2021-02-07,10,0,10
17671,Sacramento,2021-02-07,237,15,252
17672,Calaveras,2021-02-07,4,0,4
17673,Monterey,2021-02-07,106,1,107
17674,Sutter,2021-02-07,0,0,0
17675,Placer,2021-02-07,84,17,101
17676,Santa Clara,2021-02-07,327,18,345
17677,Nevada,2021-02-07,9,2,11
17678,San Mateo,2021-02-07,101,9,110
17679,Los Angeles,2021-02-07,4079,255,4334
17680,San Benito,2021-02-07,11,0,11
17681,Orange,2021-02-07,1046,24,1070
17682,Yuba,2021-02-07,38,2,40
17683,Mono,2021-02-07,0,0,0
17684,Siskiyou,2021-02-07,2,0,2
17685,Stanislaus,2021-02-07,210,22,232
17686,San Francisco,2021-02-07,151,3,154
17687,Glenn,2021-02-07,0,0,0
17688,Del Norte,2021-02-07,0,1,1
17689,Tuolumne,2021-02-07,7,0,7
17690,Merced,2021-02-07,40,0,40
17691,Shasta,2021-02-07,22,0,22
17692,Humboldt,2021-02-07,14,4,18
17693,Napa,2021-02-08,13,0,13
17694,Imperial,2021-02-08,38,0,38
17695,Placer,2021-02-08,86,11,97
17696,San Francisco,2021-02-08,147,2,149
17697,San Diego,2021-02-08,992,47,1039
17698,Kern,2021-02-08,257,3,260
17699,El Dorado,2021-02-08,8,0,8
17700,Tehama,2021-02-08,11,0,11
17701,Yuba,2021-02-08,36,2,38
17702,Mono,2021-02-08,0,0,0
17703,Shasta,2021-02-08,22,0,22
17704,Plumas,2021-02-08,0,0,0
17705,Butte,2021-02-08,23,0,23
17706,Alameda,2021-02-08,273,28,301
17707,Los Angeles,2021-02-08,3973,267,4240
17708,Sonoma,2021-02-08,60,2,62
17709,Humboldt,2021-02-08,12,6,18
17710,Contra Costa,2021-02-08,131,18,149
17711,Colusa,2021-02-08,7,0,7
17712,San Bernardino,2021-02-08,802,67,869
17713,Glenn,2021-02-08,0,0,0
17714,Siskiyou,2021-02-08,5,0,5
17715,Madera,2021-02-08,41,6,47
17716,Marin,2021-02-08,18,3,21
17717,San Luis Obispo,2021-02-08,31,2,33
17718,Inyo,2021-02-08,4,0,4
17719,Del Norte,2021-02-08,1,0,1
17720,Riverside,2021-02-08,755,98,853
17721,Tuolumne,2021-02-08,10,0,10
17722,Amador,2021-02-08,4,0,4
17723,Solano,2021-02-08,99,8,107
17724,Kings,2021-02-08,72,0,72
17725,Orange,2021-02-08,1058,34,1092
17726,Modoc,2021-02-08,1,0,1
17727,Stanislaus,2021-02-08,221,14,235
17728,Mendocino,2021-02-08,12,0,12
17729,Trinity,2021-02-08,0,0,0
17730,Lake,2021-02-08,3,0,3
17731,Mariposa,2021-02-08,1,0,1
17732,San Mateo,2021-02-08,96,13,109
17733,San Joaquin,2021-02-08,165,5,170
17734,Sutter,2021-02-08,0,0,0
17735,Lassen,2021-02-08,3,0,3
17736,San Benito,2021-02-08,11,0,11
17737,Santa Barbara,2021-02-08,149,3,152
17738,Fresno,2021-02-08,361,17,378
17739,Yolo,2021-02-08,9,0,9
17740,Calaveras,2021-02-08,4,0,4
17741,Merced,2021-02-08,40,0,40
17742,Tulare,2021-02-08,128,11,139
17743,Nevada,2021-02-08,9,2,11
17744,Santa Cruz,2021-02-08,40,0,40
17745,Ventura,2021-02-08,280,12,292
17746,Santa Clara,2021-02-08,339,13,352
17747,Sacramento,2021-02-08,239,12,251
17748,Monterey,2021-02-08,98,0,98
17749,San Diego,2021-02-09,951,50,1001
17750,Merced,2021-02-09,39,0,39
17751,San Mateo,2021-02-09,101,17,118
17752,Contra Costa,2021-02-09,124,17,141
17753,Los Angeles,2021-02-09,3772,312,4084
17754,Colusa,2021-02-09,3,0,3
17755,Lassen,2021-02-09,3,0,3
17756,Marin,2021-02-09,18,3,21
17757,Del Norte,2021-02-09,1,0,1
17758,Santa Cruz,2021-02-09,38,1,39
17759,Nevada,2021-02-09,8,0,8
17760,Placer,2021-02-09,82,9,91
17761,Plumas,2021-02-09,1,0,1
17762,San Bernardino,2021-02-09,738,57,795
17763,Humboldt,2021-02-09,15,2,17
17764,Glenn,2021-02-09,0,0,0
17765,Santa Barbara,2021-02-09,145,4,149
17766,San Francisco,2021-02-09,147,2,149
17767,Sacramento,2021-02-09,250,16,266
17768,Siskiyou,2021-02-09,4,0,4
17769,Imperial,2021-02-09,36,1,37
17770,Riverside,2021-02-09,726,75,801
17771,Lake,2021-02-09,5,0,5
17772,Trinity,2021-02-09,0,0,0
17773,Solano,2021-02-09,98,8,106
17774,Sonoma,2021-02-09,65,2,67
17775,San Luis Obispo,2021-02-09,34,2,36
17776,San Benito,2021-02-09,12,0,12
17777,Butte,2021-02-09,22,0,22
17778,Fresno,2021-02-09,353,16,369
17779,El Dorado,2021-02-09,4,0,4
17780,Modoc,2021-02-09,1,0,1
17781,Orange,2021-02-09,1009,32,1041
17782,Shasta,2021-02-09,20,0,20
17783,Kings,2021-02-09,63,0,63
17784,Madera,2021-02-09,45,10,55
17785,Tulare,2021-02-09,121,8,129
17786,Santa Clara,2021-02-09,342,17,359
17787,Calaveras,2021-02-09,5,0,5
17788,Tuolumne,2021-02-09,8,0,8
17789,Kern,2021-02-09,268,6,274
17790,Mono,2021-02-09,0,0,0
17791,Mendocino,2021-02-09,11,0,11
17792,Ventura,2021-02-09,274,17,291
17793,Monterey,2021-02-09,98,0,98
17794,Tehama,2021-02-09,12,0,12
17795,Mariposa,2021-02-09,1,0,1
17796,Amador,2021-02-09,6,0,6
17797,Yolo,2021-02-09,11,0,11
17798,Stanislaus,2021-02-09,210,13,223
17799,Alameda,2021-02-09,260,40,300
17800,Napa,2021-02-09,12,0,12
17801,Inyo,2021-02-09,3,0,3
17802,San Joaquin,2021-02-09,160,8,168
17803,Sutter,2021-02-09,0,0,0
17804,Yuba,2021-02-09,36,0,36
17805,Butte,2021-02-10,18,0,18
17806,Trinity,2021-02-10,0,0,0
17807,San Joaquin,2021-02-10,153,12,165
17808,Humboldt,2021-02-10,14,3,17
17809,Glenn,2021-02-10,0,0,0
17810,Tehama,2021-02-10,13,0,13
17811,Sutter,2021-02-10,0,0,0
17812,Calaveras,2021-02-10,5,0,5
17813,Alameda,2021-02-10,242,41,283
17814,Placer,2021-02-10,79,5,84
17815,San Francisco,2021-02-10,132,2,134
17816,Napa,2021-02-10,12,0,12
17817,San Mateo,2021-02-10,97,13,110
17818,San Luis Obispo,2021-02-10,34,1,35
17819,Del Norte,2021-02-10,1,0,1
17820,Mendocino,2021-02-10,13,0,13
17821,San Bernardino,2021-02-10,706,61,767
17822,San Diego,2021-02-10,916,41,957
17823,Kern,2021-02-10,266,7,273
17824,Yolo,2021-02-10,11,0,11
17825,Mono,2021-02-10,1,0,1
17826,Contra Costa,2021-02-10,124,14,138
17827,Merced,2021-02-10,38,0,38
17828,Los Angeles,2021-02-10,3614,256,3870
17829,Shasta,2021-02-10,20,0,20
17830,Colusa,2021-02-10,3,0,3
17831,Imperial,2021-02-10,33,4,37
17832,Inyo,2021-02-10,2,0,2
17833,Yuba,2021-02-10,34,0,34
17834,Siskiyou,2021-02-10,4,0,4
17835,Madera,2021-02-10,44,7,51
17836,Marin,2021-02-10,20,3,23
17837,Santa Barbara,2021-02-10,154,8,162
17838,Riverside,2021-02-10,687,71,758
17839,Plumas,2021-02-10,1,0,1
17840,Modoc,2021-02-10,1,0,1
17841,Amador,2021-02-10,5,0,5
17842,Lassen,2021-02-10,1,0,1
17843,Fresno,2021-02-10,344,13,357
17844,Lake,2021-02-10,7,0,7
17845,El Dorado,2021-02-10,4,0,4
17846,Tuolumne,2021-02-10,6,0,6
17847,Tulare,2021-02-10,117,7,124
17848,Mariposa,2021-02-10,1,0,1
17849,Stanislaus,2021-02-10,203,14,217
17850,Sacramento,2021-02-10,245,18,263
17851,San Benito,2021-02-10,12,0,12
17852,Orange,2021-02-10,965,35,1000
17853,Santa Clara,2021-02-10,319,11,330
17854,Solano,2021-02-10,96,11,107
17855,Monterey,2021-02-10,99,1,100
17856,Kings,2021-02-10,60,0,60
17857,Sonoma,2021-02-10,53,3,56
17858,Santa Cruz,2021-02-10,38,0,38
17859,Ventura,2021-02-10,273,18,291
17860,Nevada,2021-02-10,8,0,8
17861,Marin,2021-02-11,19,4,23
17862,Tulare,2021-02-11,110,13,123
17863,Sacramento,2021-02-11,237,18,255
17864,Tehama,2021-02-11,9,0,9
17865,Lassen,2021-02-11,1,0,1
17866,Del Norte,2021-02-11,1,0,1
17867,Los Angeles,2021-02-11,3415,223,3638
17868,Alameda,2021-02-11,230,40,270
17869,Nevada,2021-02-11,8,0,8
17870,Orange,2021-02-11,908,22,930
17871,Sonoma,2021-02-11,48,2,50
17872,Glenn,2021-02-11,0,0,0
17873,Yolo,2021-02-11,13,0,13
17874,Siskiyou,2021-02-11,4,0,4
17875,Mono,2021-02-11,2,0,2
17876,Modoc,2021-02-11,1,0,1
17877,Fresno,2021-02-11,325,21,346
17878,San Francisco,2021-02-11,122,2,124
17879,Imperial,2021-02-11,32,3,35
17880,Lake,2021-02-11,7,0,7
17881,Colusa,2021-02-11,4,0,4
17882,Tuolumne,2021-02-11,6,0,6
17883,Plumas,2021-02-11,1,0,1
17884,Stanislaus,2021-02-11,197,11,208
17885,Contra Costa,2021-02-11,114,15,129
17886,Humboldt,2021-02-11,11,3,14
17887,Sutter,2021-02-11,0,0,0
17888,Ventura,2021-02-11,262,10,272
17889,San Joaquin,2021-02-11,170,4,174
17890,San Mateo,2021-02-11,93,14,107
17891,San Diego,2021-02-11,857,37,894
17892,San Bernardino,2021-02-11,674,43,717
17893,Madera,2021-02-11,42,7,49
17894,Merced,2021-02-11,37,0,37
17895,San Benito,2021-02-11,15,0,15
17896,Butte,2021-02-11,25,0,25
17897,Trinity,2021-02-11,0,0,0
17898,Santa Clara,2021-02-11,328,23,351
17899,Napa,2021-02-11,12,0,12
17900,Santa Barbara,2021-02-11,139,11,150
17901,Riverside,2021-02-11,660,64,724
17902,El Dorado,2021-02-11,2,0,2
17903,Monterey,2021-02-11,99,0,99
17904,Yuba,2021-02-11,32,0,32
17905,Solano,2021-02-11,96,15,111
17906,Kings,2021-02-11,65,0,65
17907,San Luis Obispo,2021-02-11,30,0,30
17908,Calaveras,2021-02-11,4,0,4
17909,Amador,2021-02-11,3,1,4
17910,Shasta,2021-02-11,17,0,17
17911,Mariposa,2021-02-11,0,0,0
17912,Placer,2021-02-11,76,8,84
17913,Mendocino,2021-02-11,13,0,13
17914,Kern,2021-02-11,255,8,263
17915,Inyo,2021-02-11,2,0,2
17916,Santa Cruz,2021-02-11,39,0,39
17917,Lassen,2021-02-12,1,0,1
17918,Santa Barbara,2021-02-12,129,5,134
17919,Mono,2021-02-12,2,0,2
17920,San Bernardino,2021-02-12,626,43,669
17921,Colusa,2021-02-12,5,0,5
17922,San Mateo,2021-02-12,88,11,99
17923,Sonoma,2021-02-12,50,1,51
17924,Trinity,2021-02-12,0,0,0
17925,San Diego,2021-02-12,850,40,890
17926,Ventura,2021-02-12,242,9,251
17927,Butte,2021-02-12,18,0,18
17928,Madera,2021-02-12,41,4,45
17929,Mariposa,2021-02-12,0,0,0
17930,Nevada,2021-02-12,9,0,9
17931,Tuolumne,2021-02-12,4,0,4
17932,Modoc,2021-02-12,1,0,1
17933,Santa Clara,2021-02-12,314,20,334
17934,Monterey,2021-02-12,92,0,92
17935,Napa,2021-02-12,11,0,11
17936,San Benito,2021-02-12,16,0,16
17937,Plumas,2021-02-12,1,0,1
17938,Merced,2021-02-12,37,0,37
17939,Humboldt,2021-02-12,11,3,14
17940,Orange,2021-02-12,839,30,869
17941,Del Norte,2021-02-12,2,0,2
17942,Santa Cruz,2021-02-12,30,0,30
17943,Shasta,2021-02-12,17,0,17
17944,Solano,2021-02-12,93,13,106
17945,Kings,2021-02-12,64,1,65
17946,Siskiyou,2021-02-12,2,0,2
17947,Glenn,2021-02-12,0,0,0
17948,Amador,2021-02-12,4,0,4
17949,Kern,2021-02-12,240,3,243
17950,Yolo,2021-02-12,12,0,12
17951,Yuba,2021-02-12,32,2,34
17952,Sacramento,2021-02-12,222,19,241
17953,Imperial,2021-02-12,32,1,33
17954,Sutter,2021-02-12,0,0,0
17955,Riverside,2021-02-12,626,58,684
17956,Fresno,2021-02-12,319,30,349
17957,Contra Costa,2021-02-12,99,12,111
17958,Stanislaus,2021-02-12,196,14,210
17959,Marin,2021-02-12,20,3,23
17960,Mendocino,2021-02-12,8,0,8
17961,El Dorado,2021-02-12,4,0,4
17962,San Luis Obispo,2021-02-12,28,0,28
17963,San Joaquin,2021-02-12,158,8,166
17964,Tulare,2021-02-12,109,7,116
17965,Los Angeles,2021-02-12,3270,196,3466
17966,Alameda,2021-02-12,219,39,258
17967,Calaveras,2021-02-12,4,0,4
17968,San Francisco,2021-02-12,118,2,120
17969,Tehama,2021-02-12,9,0,9
17970,Lake,2021-02-12,6,0,6
17971,Placer,2021-02-12,81,9,90
17972,Inyo,2021-02-12,3,1,4
17973,Glenn,2021-02-13,0,0,0
17974,Los Angeles,2021-02-13,3092,201,3293
17975,San Francisco,2021-02-13,124,5,129
17976,Tuolumne,2021-02-13,3,0,3
17977,Stanislaus,2021-02-13,185,16,201
17978,San Benito,2021-02-13,15,0,15
17979,Calaveras,2021-02-13,4,0,4
17980,Santa Cruz,2021-02-13,28,1,29
17981,San Joaquin,2021-02-13,168,11,179
17982,Monterey,2021-02-13,83,0,83
17983,Kern,2021-02-13,229,3,232
17984,Del Norte,2021-02-13,2,0,2
17985,Placer,2021-02-13,77,15,92
17986,Riverside,2021-02-13,586,65,651
17987,San Mateo,2021-02-13,86,12,98
17988,Sacramento,2021-02-13,227,18,245
17989,Nevada,2021-02-13,7,0,7
17990,Tehama,2021-02-13,6,0,6
17991,El Dorado,2021-02-13,4,0,4
17992,Sutter,2021-02-13,0,0,0
17993,Lake,2021-02-13,7,0,7
17994,Colusa,2021-02-13,5,0,5
17995,Siskiyou,2021-02-13,2,0,2
17996,Butte,2021-02-13,15,0,15
17997,San Luis Obispo,2021-02-13,28,2,30
17998,Inyo,2021-02-13,2,1,3
17999,Shasta,2021-02-13,16,0,16
18000,Yolo,2021-02-13,11,0,11
18001,Sonoma,2021-02-13,47,1,48
18002,Contra Costa,2021-02-13,97,18,115
18003,Mono,2021-02-13,1,0,1
18004,Fresno,2021-02-13,317,24,341
18005,Mariposa,2021-02-13,0,0,0
18006,Humboldt,2021-02-13,12,7,19
18007,San Diego,2021-02-13,824,38,862
18008,Orange,2021-02-13,790,26,816
18009,San Bernardino,2021-02-13,572,69,641
18010,Santa Clara,2021-02-13,302,20,322
18011,Madera,2021-02-13,41,6,47
18012,Trinity,2021-02-13,0,0,0
18013,Mendocino,2021-02-13,12,0,12
18014,Plumas,2021-02-13,1,0,1
18015,Santa Barbara,2021-02-13,122,7,129
18016,Napa,2021-02-13,12,1,13
18017,Alameda,2021-02-13,213,38,251
18018,Solano,2021-02-13,91,11,102
18019,Tulare,2021-02-13,104,6,110
18020,Marin,2021-02-13,18,5,23
18021,Lassen,2021-02-13,2,0,2
18022,Imperial,2021-02-13,31,2,33
18023,Merced,2021-02-13,40,0,40
18024,Ventura,2021-02-13,232,11,243
18025,Yuba,2021-02-13,35,0,35
18026,Modoc,2021-02-13,2,0,2
18027,Amador,2021-02-13,5,0,5
18028,Kings,2021-02-13,61,0,61
18029,Inyo,2021-02-14,0,0,0
18030,Los Angeles,2021-02-14,2964,200,3164
18031,San Francisco,2021-02-14,118,3,121
18032,Riverside,2021-02-14,576,56,632
18033,Placer,2021-02-14,78,10,88
18034,Santa Cruz,2021-02-14,30,0,30
18035,Plumas,2021-02-14,2,0,2
18036,Del Norte,2021-02-14,2,0,2
18037,Calaveras,2021-02-14,2,0,2
18038,Mariposa,2021-02-14,0,0,0
18039,Imperial,2021-02-14,29,1,30
18040,Solano,2021-02-14,92,14,106
18041,Humboldt,2021-02-14,13,2,15
18042,San Diego,2021-02-14,806,36,842
18043,Stanislaus,2021-02-14,178,17,195
18044,Kern,2021-02-14,221,7,228
18045,Orange,2021-02-14,777,32,809
18046,Mono,2021-02-14,1,0,1
18047,El Dorado,2021-02-14,6,0,6
18048,Merced,2021-02-14,33,0,33
18049,Mendocino,2021-02-14,13,0,13
18050,Lassen,2021-02-14,2,0,2
18051,Modoc,2021-02-14,2,0,2
18052,San Mateo,2021-02-14,81,10,91
18053,Shasta,2021-02-14,16,0,16
18054,Colusa,2021-02-14,5,0,5
18055,Monterey,2021-02-14,79,0,79
18056,Santa Clara,2021-02-14,293,24,317
18057,Santa Barbara,2021-02-14,119,4,123
18058,Sutter,2021-02-14,0,0,0
18059,Tulare,2021-02-14,97,5,102
18060,Alameda,2021-02-14,201,49,250
18061,San Benito,2021-02-14,13,0,13
18062,Amador,2021-02-14,7,0,7
18063,Tuolumne,2021-02-14,4,0,4
18064,Fresno,2021-02-14,308,16,324
18065,Marin,2021-02-14,17,3,20
18066,Nevada,2021-02-14,6,0,6
18067,Glenn,2021-02-14,0,0,0
18068,Madera,2021-02-14,42,7,49
18069,Kings,2021-02-14,60,0,60
18070,Contra Costa,2021-02-14,99,17,116
18071,San Joaquin,2021-02-14,159,11,170
18072,Butte,2021-02-14,14,2,16
18073,Lake,2021-02-14,4,0,4
18074,San Bernardino,2021-02-14,576,42,618
18075,Yolo,2021-02-14,10,0,10
18076,Yuba,2021-02-14,30,0,30
18077,Trinity,2021-02-14,0,0,0
18078,San Luis Obispo,2021-02-14,30,0,30
18079,Napa,2021-02-14,11,0,11
18080,Siskiyou,2021-02-14,3,0,3
18081,Sonoma,2021-02-14,48,1,49
18082,Sacramento,2021-02-14,223,25,248
18083,Tehama,2021-02-14,6,0,6
18084,Ventura,2021-02-14,221,12,233
18085,Stanislaus,2021-02-15,177,11,188
18086,Santa Clara,2021-02-15,271,41,312
18087,Santa Barbara,2021-02-15,106,3,109
18088,San Benito,2021-02-15,10,0,10
18089,San Joaquin,2021-02-15,146,8,154
18090,San Mateo,2021-02-15,80,7,87
18091,Lake,2021-02-15,3,0,3
18092,Sonoma,2021-02-15,50,1,51
18093,Modoc,2021-02-15,2,0,2
18094,Mariposa,2021-02-15,0,0,0
18095,Plumas,2021-02-15,2,0,2
18096,Orange,2021-02-15,748,21,769
18097,Solano,2021-02-15,85,13,98
18098,Butte,2021-02-15,11,2,13
18099,Sacramento,2021-02-15,227,27,254
18100,Mendocino,2021-02-15,11,0,11
18101,Tuolumne,2021-02-15,2,0,2
18102,Santa Cruz,2021-02-15,28,0,28
18103,Kern,2021-02-15,228,9,237
18104,Alameda,2021-02-15,207,38,245
18105,Calaveras,2021-02-15,1,0,1
18106,Humboldt,2021-02-15,15,4,19
18107,Yolo,2021-02-15,10,0,10
18108,Madera,2021-02-15,46,9,55
18109,Contra Costa,2021-02-15,104,28,132
18110,Los Angeles,2021-02-15,2855,189,3044
18111,San Francisco,2021-02-15,114,5,119
18112,Amador,2021-02-15,7,0,7
18113,Nevada,2021-02-15,4,0,4
18114,Fresno,2021-02-15,309,19,328
18115,Inyo,2021-02-15,0,0,0
18116,Napa,2021-02-15,9,0,9
18117,Glenn,2021-02-15,0,0,0
18118,Kings,2021-02-15,60,0,60
18119,Placer,2021-02-15,77,17,94
18120,Marin,2021-02-15,17,4,21
18121,Del Norte,2021-02-15,2,0,2
18122,Lassen,2021-02-15,1,0,1
18123,Riverside,2021-02-15,567,51,618
18124,San Luis Obispo,2021-02-15,27,0,27
18125,Tehama,2021-02-15,3,0,3
18126,Mono,2021-02-15,1,0,1
18127,Siskiyou,2021-02-15,3,0,3
18128,Shasta,2021-02-15,14,0,14
18129,Trinity,2021-02-15,0,0,0
18130,Imperial,2021-02-15,28,1,29
18131,Monterey,2021-02-15,72,0,72
18132,El Dorado,2021-02-15,3,0,3
18133,Merced,2021-02-15,34,0,34
18134,Tulare,2021-02-15,95,7,102
18135,Sutter,2021-02-15,0,0,0
18136,Colusa,2021-02-15,5,0,5
18137,Ventura,2021-02-15,216,10,226
18138,Yuba,2021-02-15,29,0,29
18139,San Diego,2021-02-15,782,37,819
18140,San Bernardino,2021-02-15,575,54,629
18141,Marin,2021-02-16,14,3,17
18142,Nevada,2021-02-16,5,0,5
18143,Butte,2021-02-16,12,1,13
18144,Modoc,2021-02-16,2,1,3
18145,Contra Costa,2021-02-16,98,25,123
18146,Kern,2021-02-16,226,9,235
18147,Riverside,2021-02-16,553,60,613
18148,Santa Cruz,2021-02-16,23,1,24
18149,Napa,2021-02-16,5,0,5
18150,Tulare,2021-02-16,95,9,104
18151,Colusa,2021-02-16,3,0,3
18152,San Bernardino,2021-02-16,557,55,612
18153,Mono,2021-02-16,1,0,1
18154,Yolo,2021-02-16,11,0,11
18155,Mendocino,2021-02-16,11,0,11
18156,Kings,2021-02-16,56,0,56
18157,Sacramento,2021-02-16,212,17,229
18158,Glenn,2021-02-16,0,0,0
18159,San Francisco,2021-02-16,118,7,125
18160,Ventura,2021-02-16,202,9,211
18161,Placer,2021-02-16,67,12,79
18162,Humboldt,2021-02-16,13,5,18
18163,Lake,2021-02-16,1,0,1
18164,Merced,2021-02-16,33,0,33
18165,Amador,2021-02-16,7,0,7
18166,Los Angeles,2021-02-16,2757,223,2980
18167,Sonoma,2021-02-16,45,1,46
18168,Shasta,2021-02-16,12,0,12
18169,Imperial,2021-02-16,27,1,28
18170,Madera,2021-02-16,39,4,43
18171,San Mateo,2021-02-16,82,7,89
18172,El Dorado,2021-02-16,5,0,5
18173,Calaveras,2021-02-16,1,0,1
18174,Fresno,2021-02-16,303,21,324
18175,Alameda,2021-02-16,200,37,237
18176,Orange,2021-02-16,719,24,743
18177,Sutter,2021-02-16,0,0,0
18178,Inyo,2021-02-16,0,0,0
18179,San Joaquin,2021-02-16,144,14,158
18180,Stanislaus,2021-02-16,172,12,184
18181,San Diego,2021-02-16,782,39,821
18182,Solano,2021-02-16,82,13,95
18183,San Benito,2021-02-16,10,0,10
18184,Siskiyou,2021-02-16,1,0,1
18185,Plumas,2021-02-16,1,0,1
18186,Mariposa,2021-02-16,0,0,0
18187,Santa Barbara,2021-02-16,104,3,107
18188,Del Norte,2021-02-16,2,0,2
18189,San Luis Obispo,2021-02-16,28,0,28
18190,Yuba,2021-02-16,29,0,29
18191,Santa Clara,2021-02-16,267,27,294
18192,Trinity,2021-02-16,0,0,0
18193,Tuolumne,2021-02-16,2,0,2
18194,Tehama,2021-02-16,4,0,4
18195,Lassen,2021-02-16,0,0,0
18196,Monterey,2021-02-16,72,0,72
18197,San Benito,2021-02-17,10,0,10
18198,Solano,2021-02-17,85,12,97
18199,Sutter,2021-02-17,0,0,0
18200,Colusa,2021-02-17,3,0,3
18201,Santa Cruz,2021-02-17,23,1,24
18202,Shasta,2021-02-17,12,0,12
18203,Monterey,2021-02-17,65,0,65
18204,Modoc,2021-02-17,2,0,2
18205,Plumas,2021-02-17,1,0,1
18206,Trinity,2021-02-17,0,0,0
18207,Siskiyou,2021-02-17,1,0,1
18208,Marin,2021-02-17,15,3,18
18209,Amador,2021-02-17,6,0,6
18210,Mono,2021-02-17,1,0,1
18211,San Bernardino,2021-02-17,556,44,600
18212,Madera,2021-02-17,41,9,50
18213,Humboldt,2021-02-17,12,3,15
18214,Contra Costa,2021-02-17,98,20,118
18215,Riverside,2021-02-17,535,68,603
18216,Orange,2021-02-17,663,26,689
18217,Tuolumne,2021-02-17,3,0,3
18218,Tulare,2021-02-17,96,10,106
18219,Mariposa,2021-02-17,0,0,0
18220,Calaveras,2021-02-17,1,0,1
18221,San Diego,2021-02-17,746,55,801
18222,Tehama,2021-02-17,4,0,4
18223,Lake,2021-02-17,2,0,2
18224,Stanislaus,2021-02-17,173,15,188
18225,Los Angeles,2021-02-17,2640,230,2870
18226,Sacramento,2021-02-17,204,21,225
18227,Sonoma,2021-02-17,43,0,43
18228,Placer,2021-02-17,63,13,76
18229,San Mateo,2021-02-17,85,9,94
18230,Nevada,2021-02-17,4,0,4
18231,San Francisco,2021-02-17,108,10,118
18232,Napa,2021-02-17,3,0,3
18233,Mendocino,2021-02-17,11,0,11
18234,Butte,2021-02-17,16,0,16
18235,Yolo,2021-02-17,11,0,11
18236,Ventura,2021-02-17,195,8,203
18237,Kern,2021-02-17,219,14,233
18238,Del Norte,2021-02-17,1,0,1
18239,Inyo,2021-02-17,1,0,1
18240,Kings,2021-02-17,49,0,49
18241,San Joaquin,2021-02-17,134,9,143
18242,El Dorado,2021-02-17,5,1,6
18243,Alameda,2021-02-17,194,33,227
18244,Yuba,2021-02-17,29,1,30
18245,Santa Barbara,2021-02-17,95,6,101
18246,Fresno,2021-02-17,295,16,311
18247,Merced,2021-02-17,32,0,32
18248,Santa Clara,2021-02-17,261,20,281
18249,San Luis Obispo,2021-02-17,24,3,27
18250,Imperial,2021-02-17,28,2,30
18251,Glenn,2021-02-17,0,0,0
18252,Lassen,2021-02-17,0,0,0
18253,Madera,2021-02-18,40,12,52
18254,Del Norte,2021-02-18,1,2,3
18255,San Benito,2021-02-18,9,0,9
18256,Sacramento,2021-02-18,201,17,218
18257,Mendocino,2021-02-18,9,0,9
18258,Plumas,2021-02-18,1,0,1
18259,Santa Barbara,2021-02-18,97,9,106
18260,Kern,2021-02-18,185,9,194
18261,San Francisco,2021-02-18,93,7,100
18262,Fresno,2021-02-18,289,18,307
18263,Riverside,2021-02-18,513,63,576
18264,Stanislaus,2021-02-18,173,19,192
18265,Orange,2021-02-18,636,25,661
18266,Amador,2021-02-18,5,1,6
18267,San Luis Obispo,2021-02-18,21,2,23
18268,Santa Clara,2021-02-18,255,19,274
18269,Lassen,2021-02-18,0,0,0
18270,Mono,2021-02-18,0,0,0
18271,Solano,2021-02-18,86,12,98
18272,Shasta,2021-02-18,12,0,12
18273,San Bernardino,2021-02-18,505,34,539
18274,Los Angeles,2021-02-18,2498,247,2745
18275,San Diego,2021-02-18,717,41,758
18276,San Joaquin,2021-02-18,129,16,145
18277,Contra Costa,2021-02-18,96,11,107
18278,Nevada,2021-02-18,6,0,6
18279,Tuolumne,2021-02-18,0,0,0
18280,Lake,2021-02-18,2,0,2
18281,Siskiyou,2021-02-18,1,0,1
18282,Merced,2021-02-18,33,0,33
18283,Modoc,2021-02-18,2,0,2
18284,Humboldt,2021-02-18,10,2,12
18285,Santa Cruz,2021-02-18,23,2,25
18286,Placer,2021-02-18,59,15,74
18287,Sonoma,2021-02-18,38,1,39
18288,Kings,2021-02-18,42,0,42
18289,Butte,2021-02-18,12,0,12
18290,Mariposa,2021-02-18,0,0,0
18291,Inyo,2021-02-18,2,0,2
18292,Yuba,2021-02-18,26,0,26
18293,San Mateo,2021-02-18,82,6,88
18294,Tulare,2021-02-18,93,6,99
18295,Calaveras,2021-02-18,2,0,2
18296,Imperial,2021-02-18,29,1,30
18297,Trinity,2021-02-18,0,0,0
18298,El Dorado,2021-02-18,6,0,6
18299,Colusa,2021-02-18,2,0,2
18300,Glenn,2021-02-18,0,0,0
18301,Ventura,2021-02-18,188,9,197
18302,Alameda,2021-02-18,183,29,212
18303,Monterey,2021-02-18,67,0,67
18304,Marin,2021-02-18,18,4,22
18305,Sutter,2021-02-18,0,0,0
18306,Napa,2021-02-18,2,3,5
18307,Yolo,2021-02-18,10,0,10
18308,Tehama,2021-02-18,5,0,5
18309,Tulare,2021-02-19,83,4,87
18310,Napa,2021-02-19,5,1,6
18311,Siskiyou,2021-02-19,1,0,1
18312,Shasta,2021-02-19,14,0,14
18313,Imperial,2021-02-19,27,1,28
18314,Los Angeles,2021-02-19,2369,228,2597
18315,Mariposa,2021-02-19,0,0,0
18316,Kings,2021-02-19,46,0,46
18317,San Diego,2021-02-19,670,35,705
18318,Lassen,2021-02-19,1,0,1
18319,Humboldt,2021-02-19,11,2,13
18320,Trinity,2021-02-19,0,0,0
18321,Inyo,2021-02-19,2,0,2
18322,Merced,2021-02-19,32,0,32
18323,Santa Barbara,2021-02-19,84,5,89
18324,Colusa,2021-02-19,6,0,6
18325,Solano,2021-02-19,84,10,94
18326,Contra Costa,2021-02-19,84,13,97
18327,Yuba,2021-02-19,26,0,26
18328,Kern,2021-02-19,182,5,187
18329,Sutter,2021-02-19,0,0,0
18330,Orange,2021-02-19,591,31,622
18331,Del Norte,2021-02-19,1,4,5
18332,Yolo,2021-02-19,11,0,11
18333,Riverside,2021-02-19,493,40,533
18334,Butte,2021-02-19,12,0,12
18335,Santa Cruz,2021-02-19,25,2,27
18336,San Francisco,2021-02-19,99,5,104
18337,Modoc,2021-02-19,0,0,0
18338,San Bernardino,2021-02-19,469,38,507
18339,Glenn,2021-02-19,0,0,0
18340,San Mateo,2021-02-19,80,5,85
18341,Tuolumne,2021-02-19,1,0,1
18342,Nevada,2021-02-19,3,0,3
18343,El Dorado,2021-02-19,7,0,7
18344,San Joaquin,2021-02-19,127,24,151
18345,Fresno,2021-02-19,265,27,292
18346,Madera,2021-02-19,39,6,45
18347,Sonoma,2021-02-19,41,1,42
18348,San Benito,2021-02-19,8,0,8
18349,Mono,2021-02-19,0,0,0
18350,San Luis Obispo,2021-02-19,19,2,21
18351,Alameda,2021-02-19,190,29,219
18352,Amador,2021-02-19,7,1,8
18353,Tehama,2021-02-19,7,0,7
18354,Santa Clara,2021-02-19,243,17,260
18355,Sacramento,2021-02-19,186,19,205
18356,Ventura,2021-02-19,178,6,184
18357,Plumas,2021-02-19,1,0,1
18358,Monterey,2021-02-19,72,1,73
18359,Lake,2021-02-19,1,0,1
18360,Stanislaus,2021-02-19,162,16,178
18361,Marin,2021-02-19,16,3,19
18362,Mendocino,2021-02-19,8,0,8
18363,Placer,2021-02-19,57,18,75
18364,Calaveras,2021-02-19,2,0,2
18365,Napa,2021-02-20,7,0,7
18366,Inyo,2021-02-20,0,0,0
18367,Lake,2021-02-20,1,0,1
18368,Sacramento,2021-02-20,177,13,190
18369,Mendocino,2021-02-20,6,1,7
18370,Tuolumne,2021-02-20,2,0,2
18371,Marin,2021-02-20,14,4,18
18372,Trinity,2021-02-20,0,0,0
18373,Plumas,2021-02-20,0,0,0
18374,Santa Clara,2021-02-20,228,15,243
18375,Stanislaus,2021-02-20,155,15,170
18376,Riverside,2021-02-20,455,56,511
18377,Mono,2021-02-20,0,0,0
18378,San Bernardino,2021-02-20,433,37,470
18379,Lassen,2021-02-20,1,0,1
18380,Nevada,2021-02-20,2,0,2
18381,Santa Barbara,2021-02-20,83,2,85
18382,Los Angeles,2021-02-20,2213,212,2425
18383,Calaveras,2021-02-20,2,0,2
18384,Ventura,2021-02-20,171,11,182
18385,Alameda,2021-02-20,176,26,202
18386,Imperial,2021-02-20,28,1,29
18387,Yuba,2021-02-20,21,1,22
18388,Siskiyou,2021-02-20,1,0,1
18389,Placer,2021-02-20,64,17,81
18390,San Joaquin,2021-02-20,126,25,151
18391,Mariposa,2021-02-20,0,0,0
18392,Sonoma,2021-02-20,38,1,39
18393,Contra Costa,2021-02-20,78,10,88
18394,Orange,2021-02-20,577,32,609
18395,San Benito,2021-02-20,9,0,9
18396,Santa Cruz,2021-02-20,25,2,27
18397,Tehama,2021-02-20,3,0,3
18398,Kern,2021-02-20,167,7,174
18399,Merced,2021-02-20,32,1,33
18400,Solano,2021-02-20,70,12,82
18401,Monterey,2021-02-20,59,0,59
18402,San Francisco,2021-02-20,89,5,94
18403,Modoc,2021-02-20,0,0,0
18404,Amador,2021-02-20,6,2,8
18405,Humboldt,2021-02-20,10,4,14
18406,Glenn,2021-02-20,0,0,0
18407,Kings,2021-02-20,45,0,45
18408,Tulare,2021-02-20,75,8,83
18409,Del Norte,2021-02-20,2,4,6
18410,Madera,2021-02-20,35,8,43
18411,El Dorado,2021-02-20,6,0,6
18412,San Mateo,2021-02-20,64,6,70
18413,Butte,2021-02-20,11,0,11
18414,Colusa,2021-02-20,7,0,7
18415,Shasta,2021-02-20,18,0,18
18416,San Luis Obispo,2021-02-20,22,3,25
18417,Fresno,2021-02-20,244,32,276
18418,Sutter,2021-02-20,0,0,0
18419,Yolo,2021-02-20,10,0,10
18420,San Diego,2021-02-20,636,36,672
18421,Tulare,2021-02-21,79,6,85
18422,Sonoma,2021-02-21,37,1,38
18423,San Bernardino,2021-02-21,437,56,493
18424,San Joaquin,2021-02-21,125,23,148
18425,Tehama,2021-02-21,2,0,2
18426,Del Norte,2021-02-21,2,4,6
18427,San Benito,2021-02-21,7,0,7
18428,Ventura,2021-02-21,189,4,193
18429,Lassen,2021-02-21,0,0,0
18430,Orange,2021-02-21,556,33,589
18431,Calaveras,2021-02-21,1,0,1
18432,Butte,2021-02-21,13,0,13
18433,Imperial,2021-02-21,27,1,28
18434,Los Angeles,2021-02-21,2146,191,2337
18435,Modoc,2021-02-21,0,0,0
18436,Madera,2021-02-21,33,7,40
18437,Nevada,2021-02-21,2,1,3
18438,Yolo,2021-02-21,9,0,9
18439,Santa Cruz,2021-02-21,22,2,24
18440,San Francisco,2021-02-21,93,5,98
18441,Alameda,2021-02-21,174,26,200
18442,Santa Clara,2021-02-21,221,21,242
18443,Sacramento,2021-02-21,185,25,210
18444,Shasta,2021-02-21,19,0,19
18445,Kern,2021-02-21,167,7,174
18446,El Dorado,2021-02-21,10,0,10
18447,Tuolumne,2021-02-21,2,0,2
18448,Fresno,2021-02-21,231,13,244
18449,Stanislaus,2021-02-21,143,14,157
18450,Marin,2021-02-21,15,5,20
18451,San Luis Obispo,2021-02-21,19,1,20
18452,Riverside,2021-02-21,441,51,492
18453,Merced,2021-02-21,32,1,33
18454,Mono,2021-02-21,0,0,0
18455,Napa,2021-02-21,7,0,7
18456,Kings,2021-02-21,41,0,41
18457,Solano,2021-02-21,63,16,79
18458,Mariposa,2021-02-21,0,0,0
18459,Siskiyou,2021-02-21,1,0,1
18460,Plumas,2021-02-21,0,0,0
18461,San Mateo,2021-02-21,66,8,74
18462,Santa Barbara,2021-02-21,82,2,84
18463,Glenn,2021-02-21,0,0,0
18464,Amador,2021-02-21,6,2,8
18465,Trinity,2021-02-21,0,0,0
18466,Sutter,2021-02-21,0,0,0
18467,Colusa,2021-02-21,8,0,8
18468,Monterey,2021-02-21,46,1,47
18469,San Diego,2021-02-21,622,36,658
18470,Inyo,2021-02-21,1,0,1
18471,Mendocino,2021-02-21,5,1,6
18472,Humboldt,2021-02-21,9,7,16
18473,Lake,2021-02-21,1,0,1
18474,Placer,2021-02-21,64,16,80
18475,Yuba,2021-02-21,24,0,24
18476,Contra Costa,2021-02-21,84,9,93
18477,San Diego,2021-02-22,601,31,632
18478,Santa Clara,2021-02-22,226,26,252
18479,Tulare,2021-02-22,75,7,82
18480,Yuba,2021-02-22,22,0,22
18481,Lake,2021-02-22,4,0,4
18482,Modoc,2021-02-22,0,0,0
18483,Ventura,2021-02-22,167,6,173
18484,San Mateo,2021-02-22,65,8,73
18485,Sonoma,2021-02-22,39,2,41
18486,Mono,2021-02-22,0,0,0
18487,Siskiyou,2021-02-22,2,0,2
18488,Merced,2021-02-22,32,1,33
18489,San Joaquin,2021-02-22,122,6,128
18490,Inyo,2021-02-22,1,0,1
18491,Trinity,2021-02-22,0,0,0
18492,Tehama,2021-02-22,1,0,1
18493,Orange,2021-02-22,539,28,567
18494,Monterey,2021-02-22,40,1,41
18495,Stanislaus,2021-02-22,138,15,153
18496,San Benito,2021-02-22,7,0,7
18497,San Francisco,2021-02-22,96,5,101
18498,Kings,2021-02-22,40,0,40
18499,Imperial,2021-02-22,29,0,29
18500,Kern,2021-02-22,170,9,179
18501,Contra Costa,2021-02-22,81,10,91
18502,San Bernardino,2021-02-22,414,44,458
18503,Fresno,2021-02-22,239,19,258
18504,Santa Cruz,2021-02-22,18,3,21
18505,Colusa,2021-02-22,8,0,8
18506,Plumas,2021-02-22,0,0,0
18507,Sacramento,2021-02-22,180,21,201
18508,Alameda,2021-02-22,180,23,203
18509,Mendocino,2021-02-22,4,0,4
18510,Mariposa,2021-02-22,0,0,0
18511,Glenn,2021-02-22,0,0,0
18512,Humboldt,2021-02-22,9,5,14
18513,Solano,2021-02-22,56,16,72
18514,Los Angeles,2021-02-22,2064,200,2264
18515,Shasta,2021-02-22,15,1,16
18516,Placer,2021-02-22,64,6,70
18517,Calaveras,2021-02-22,0,0,0
18518,San Luis Obispo,2021-02-22,18,0,18
18519,Napa,2021-02-22,9,2,11
18520,Butte,2021-02-22,13,0,13
18521,Marin,2021-02-22,13,5,18
18522,Yolo,2021-02-22,10,0,10
18523,Riverside,2021-02-22,407,49,456
18524,Amador,2021-02-22,5,1,6
18525,Nevada,2021-02-22,5,0,5
18526,El Dorado,2021-02-22,9,0,9
18527,Madera,2021-02-22,30,6,36
18528,Del Norte,2021-02-22,2,1,3
18529,Santa Barbara,2021-02-22,76,6,82
18530,Sutter,2021-02-22,0,0,0
18531,Lassen,2021-02-22,0,0,0
18532,Tuolumne,2021-02-22,0,0,0
18533,San Francisco,2021-02-23,95,6,101
18534,Santa Barbara,2021-02-23,85,3,88
18535,Del Norte,2021-02-23,1,0,1
18536,Merced,2021-02-23,33,1,34
18537,Tehama,2021-02-23,1,0,1
18538,San Benito,2021-02-23,4,0,4
18539,Marin,2021-02-23,12,6,18
18540,Santa Cruz,2021-02-23,22,2,24
18541,Madera,2021-02-23,35,3,38
18542,Trinity,2021-02-23,0,0,0
18543,Contra Costa,2021-02-23,89,17,106
18544,San Diego,2021-02-23,597,34,631
18545,Plumas,2021-02-23,0,0,0
18546,Mendocino,2021-02-23,3,1,4
18547,Fresno,2021-02-23,241,14,255
18548,Amador,2021-02-23,4,0,4
18549,Yolo,2021-02-23,11,0,11
18550,Tuolumne,2021-02-23,1,0,1
18551,Calaveras,2021-02-23,1,0,1
18552,Yuba,2021-02-23,20,0,20
18553,Imperial,2021-02-23,27,0,27
18554,Colusa,2021-02-23,3,0,3
18555,Shasta,2021-02-23,13,1,14
18556,Butte,2021-02-23,16,0,16
18557,Modoc,2021-02-23,0,0,0
18558,Mariposa,2021-02-23,0,0,0
18559,Siskiyou,2021-02-23,2,0,2
18560,El Dorado,2021-02-23,6,0,6
18561,San Joaquin,2021-02-23,118,15,133
18562,Lake,2021-02-23,4,0,4
18563,Nevada,2021-02-23,2,1,3
18564,Mono,2021-02-23,0,0,0
18565,Inyo,2021-02-23,1,0,1
18566,Glenn,2021-02-23,0,0,0
18567,Riverside,2021-02-23,406,49,455
18568,Sonoma,2021-02-23,37,1,38
18569,Solano,2021-02-23,52,13,65
18570,Stanislaus,2021-02-23,141,14,155
18571,Kern,2021-02-23,165,7,172
18572,Tulare,2021-02-23,78,9,87
18573,Humboldt,2021-02-23,9,2,11
18574,Orange,2021-02-23,515,26,541
18575,Monterey,2021-02-23,41,0,41
18576,San Luis Obispo,2021-02-23,17,1,18
18577,Ventura,2021-02-23,157,8,165
18578,San Mateo,2021-02-23,61,5,66
18579,San Bernardino,2021-02-23,396,36,432
18580,Los Angeles,2021-02-23,1988,226,2214
18581,Santa Clara,2021-02-23,215,24,239
18582,Placer,2021-02-23,54,11,65
18583,Lassen,2021-02-23,0,0,0
18584,Sacramento,2021-02-23,183,18,201
18585,Sutter,2021-02-23,0,0,0
18586,Kings,2021-02-23,39,0,39
18587,Alameda,2021-02-23,175,25,200
18588,Napa,2021-02-23,9,0,9
18589,Ventura,2021-02-24,151,9,160
18590,Lassen,2021-02-24,1,0,1
18591,Marin,2021-02-24,14,3,17
18592,Tuolumne,2021-02-24,2,0,2
18593,Alameda,2021-02-24,172,22,194
18594,Yuba,2021-02-24,22,0,22
18595,Madera,2021-02-24,29,5,34
18596,Fresno,2021-02-24,227,15,242
18597,San Francisco,2021-02-24,91,7,98
18598,Shasta,2021-02-24,14,1,15
18599,Del Norte,2021-02-24,1,0,1
18600,Mariposa,2021-02-24,0,0,0
18601,San Luis Obispo,2021-02-24,19,2,21
18602,Merced,2021-02-24,35,1,36
18603,Plumas,2021-02-24,0,0,0
18604,San Bernardino,2021-02-24,371,37,408
18605,Sacramento,2021-02-24,182,11,193
18606,Kings,2021-02-24,43,0,43
18607,Santa Barbara,2021-02-24,83,4,87
18608,San Joaquin,2021-02-24,117,13,130
18609,Placer,2021-02-24,53,13,66
18610,Nevada,2021-02-24,1,2,3
18611,Colusa,2021-02-24,3,0,3
18612,Sutter,2021-02-24,0,0,0
18613,Amador,2021-02-24,3,0,3
18614,San Diego,2021-02-24,560,35,595
18615,Tulare,2021-02-24,74,6,80
18616,Calaveras,2021-02-24,1,0,1
18617,Mono,2021-02-24,0,0,0
18618,Tehama,2021-02-24,2,0,2
18619,El Dorado,2021-02-24,4,1,5
18620,Trinity,2021-02-24,0,0,0
18621,Monterey,2021-02-24,39,0,39
18622,Santa Clara,2021-02-24,203,31,234
18623,Modoc,2021-02-24,0,0,0
18624,Mendocino,2021-02-24,2,0,2
18625,Orange,2021-02-24,515,27,542
18626,Sonoma,2021-02-24,39,0,39
18627,Santa Cruz,2021-02-24,19,2,21
18628,Kern,2021-02-24,161,7,168
18629,Solano,2021-02-24,52,14,66
18630,Imperial,2021-02-24,26,0,26
18631,Butte,2021-02-24,16,0,16
18632,Inyo,2021-02-24,1,0,1
18633,San Mateo,2021-02-24,53,5,58
18634,Los Angeles,2021-02-24,1886,215,2101
18635,Napa,2021-02-24,10,0,10
18636,Glenn,2021-02-24,0,0,0
18637,Contra Costa,2021-02-24,90,18,108
18638,Riverside,2021-02-24,381,57,438
18639,San Benito,2021-02-24,4,0,4
18640,Siskiyou,2021-02-24,2,0,2
18641,Stanislaus,2021-02-24,137,21,158
18642,Yolo,2021-02-24,12,0,12
18643,Lake,2021-02-24,3,0,3
18644,Humboldt,2021-02-24,8,2,10
18645,Mariposa,2021-02-25,0,0,0
18646,El Dorado,2021-02-25,5,0,5
18647,Ventura,2021-02-25,144,8,152
18648,Orange,2021-02-25,453,22,475
18649,Marin,2021-02-25,13,2,15
18650,Sacramento,2021-02-25,177,16,193
18651,Madera,2021-02-25,33,5,38
18652,Trinity,2021-02-25,0,0,0
18653,Santa Clara,2021-02-25,192,27,219
18654,Mono,2021-02-25,0,0,0
18655,Merced,2021-02-25,35,0,35
18656,Fresno,2021-02-25,218,17,235
18657,Sutter,2021-02-25,0,0,0
18658,Tuolumne,2021-02-25,2,1,3
18659,San Diego,2021-02-25,535,26,561
18660,Yolo,2021-02-25,10,0,10
18661,Colusa,2021-02-25,1,0,1
18662,Plumas,2021-02-25,0,0,0
18663,Stanislaus,2021-02-25,139,14,153
18664,Humboldt,2021-02-25,8,2,10
18665,San Benito,2021-02-25,6,0,6
18666,Shasta,2021-02-25,18,1,19
18667,Kings,2021-02-25,39,0,39
18668,Inyo,2021-02-25,0,0,0
18669,Yuba,2021-02-25,21,0,21
18670,Contra Costa,2021-02-25,74,14,88
18671,Placer,2021-02-25,56,17,73
18672,Tulare,2021-02-25,72,6,78
18673,Solano,2021-02-25,46,16,62
18674,Sonoma,2021-02-25,35,0,35
18675,Santa Barbara,2021-02-25,76,5,81
18676,Alameda,2021-02-25,168,19,187
18677,Imperial,2021-02-25,25,0,25
18678,Monterey,2021-02-25,38,1,39
18679,Los Angeles,2021-02-25,1733,229,1962
18680,Siskiyou,2021-02-25,2,0,2
18681,San Mateo,2021-02-25,54,2,56
18682,Kern,2021-02-25,162,1,163
18683,Lake,2021-02-25,4,1,5
18684,Del Norte,2021-02-25,1,0,1
18685,Mendocino,2021-02-25,5,0,5
18686,Lassen,2021-02-25,1,0,1
18687,Amador,2021-02-25,3,1,4
18688,Glenn,2021-02-25,0,0,0
18689,Santa Cruz,2021-02-25,17,1,18
18690,Calaveras,2021-02-25,1,0,1
18691,San Francisco,2021-02-25,94,1,95
18692,San Bernardino,2021-02-25,352,26,378
18693,Modoc,2021-02-25,0,0,0
18694,San Joaquin,2021-02-25,117,14,131
18695,Napa,2021-02-25,8,1,9
18696,Butte,2021-02-25,13,0,13
18697,Riverside,2021-02-25,361,63,424
18698,San Luis Obispo,2021-02-25,18,1,19
18699,Tehama,2021-02-25,3,0,3
18700,Nevada,2021-02-25,2,2,4
18701,Solano,2021-02-26,45,12,57
18702,Napa,2021-02-26,7,3,10
18703,Los Angeles,2021-02-26,1661,194,1855
18704,Santa Barbara,2021-02-26,74,6,80
18705,Placer,2021-02-26,52,10,62
18706,Santa Clara,2021-02-26,194,25,219
18707,Yuba,2021-02-26,18,0,18
18708,Sutter,2021-02-26,0,0,0
18709,Del Norte,2021-02-26,1,0,1
18710,Yolo,2021-02-26,11,0,11
18711,Madera,2021-02-26,29,7,36
18712,Monterey,2021-02-26,40,1,41
18713,El Dorado,2021-02-26,6,0,6
18714,Modoc,2021-02-26,0,0,0
18715,Shasta,2021-02-26,18,1,19
18716,San Francisco,2021-02-26,83,5,88
18717,Merced,2021-02-26,33,0,33
18718,Tehama,2021-02-26,3,0,3
18719,Sonoma,2021-02-26,35,1,36
18720,San Luis Obispo,2021-02-26,18,1,19
18721,Fresno,2021-02-26,207,20,227
18722,Riverside,2021-02-26,338,57,395
18723,Humboldt,2021-02-26,6,2,8
18724,Kings,2021-02-26,34,0,34
18725,Nevada,2021-02-26,2,2,4
18726,Plumas,2021-02-26,0,0,0
18727,Colusa,2021-02-26,0,0,0
18728,Stanislaus,2021-02-26,128,14,142
18729,Alameda,2021-02-26,157,24,181
18730,San Benito,2021-02-26,6,0,6
18731,San Diego,2021-02-26,523,39,562
18732,San Joaquin,2021-02-26,109,7,116
18733,Mariposa,2021-02-26,0,0,0
18734,Tuolumne,2021-02-26,2,0,2
18735,Marin,2021-02-26,15,2,17
18736,Lake,2021-02-26,3,0,3
18737,Contra Costa,2021-02-26,72,11,83
18738,Trinity,2021-02-26,0,0,0
18739,San Bernardino,2021-02-26,327,23,350
18740,Calaveras,2021-02-26,1,0,1
18741,Lassen,2021-02-26,1,0,1
18742,Mendocino,2021-02-26,5,0,5
18743,Amador,2021-02-26,3,0,3
18744,Santa Cruz,2021-02-26,16,2,18
18745,Butte,2021-02-26,15,0,15
18746,Kern,2021-02-26,158,4,162
18747,San Mateo,2021-02-26,54,3,57
18748,Mono,2021-02-26,1,0,1
18749,Orange,2021-02-26,444,15,459
18750,Ventura,2021-02-26,144,9,153
18751,Tulare,2021-02-26,69,8,77
18752,Sacramento,2021-02-26,177,17,194
18753,Inyo,2021-02-26,2,0,2
18754,Glenn,2021-02-26,0,0,0
18755,Imperial,2021-02-26,22,0,22
18756,Siskiyou,2021-02-26,3,0,3
18757,San Joaquin,2021-02-27,105,9,114
18758,Tuolumne,2021-02-27,0,0,0
18759,Humboldt,2021-02-27,6,3,9
18760,Mendocino,2021-02-27,6,0,6
18761,Riverside,2021-02-27,328,50,378
18762,San Francisco,2021-02-27,78,8,86
18763,San Benito,2021-02-27,4,0,4
18764,San Mateo,2021-02-27,56,3,59
18765,Sutter,2021-02-27,0,0,0
18766,Fresno,2021-02-27,201,22,223
18767,Del Norte,2021-02-27,1,0,1
18768,Tulare,2021-02-27,62,3,65
18769,Glenn,2021-02-27,0,0,0
18770,Monterey,2021-02-27,38,3,41
18771,Alameda,2021-02-27,163,26,189
18772,Placer,2021-02-27,61,9,70
18773,Los Angeles,2021-02-27,1578,183,1761
18774,Yolo,2021-02-27,11,0,11
18775,Merced,2021-02-27,33,0,33
18776,Trinity,2021-02-27,0,0,0
18777,Santa Clara,2021-02-27,187,33,220
18778,Tehama,2021-02-27,3,0,3
18779,Mariposa,2021-02-27,0,0,0
18780,San Diego,2021-02-27,485,34,519
18781,Mono,2021-02-27,1,0,1
18782,Stanislaus,2021-02-27,120,15,135
18783,Contra Costa,2021-02-27,78,16,94
18784,Napa,2021-02-27,8,0,8
18785,Colusa,2021-02-27,0,0,0
18786,Kings,2021-02-27,37,0,37
18787,Ventura,2021-02-27,141,5,146
18788,San Luis Obispo,2021-02-27,16,1,17
18789,Amador,2021-02-27,3,0,3
18790,Butte,2021-02-27,23,0,23
18791,Nevada,2021-02-27,2,2,4
18792,Marin,2021-02-27,13,3,16
18793,Kern,2021-02-27,159,3,162
18794,Santa Barbara,2021-02-27,70,6,76
18795,Lassen,2021-02-27,0,0,0
18796,Inyo,2021-02-27,1,0,1
18797,Modoc,2021-02-27,0,0,0
18798,Sacramento,2021-02-27,165,22,187
18799,El Dorado,2021-02-27,4,1,5
18800,Plumas,2021-02-27,0,0,0
18801,Sonoma,2021-02-27,30,1,31
18802,Siskiyou,2021-02-27,3,0,3
18803,San Bernardino,2021-02-27,299,23,322
18804,Yuba,2021-02-27,22,0,22
18805,Shasta,2021-02-27,18,1,19
18806,Madera,2021-02-27,26,7,33
18807,Imperial,2021-02-27,21,2,23
18808,Santa Cruz,2021-02-27,15,1,16
18809,Orange,2021-02-27,421,22,443
18810,Calaveras,2021-02-27,1,0,1
18811,Solano,2021-02-27,39,14,53
18812,Lake,2021-02-27,1,0,1
18813,Contra Costa,2021-02-28,73,17,90
18814,Yuba,2021-02-28,18,1,19
18815,San Bernardino,2021-02-28,285,23,308
18816,Alameda,2021-02-28,152,26,178
18817,San Joaquin,2021-02-28,94,11,105
18818,Colusa,2021-02-28,0,0,0
18819,Lake,2021-02-28,1,0,1
18820,Yolo,2021-02-28,16,0,16
18821,Placer,2021-02-28,61,11,72
18822,Sacramento,2021-02-28,157,22,179
18823,Imperial,2021-02-28,22,0,22
18824,Sonoma,2021-02-28,29,1,30
18825,Santa Barbara,2021-02-28,59,5,64
18826,Napa,2021-02-28,5,0,5
18827,Del Norte,2021-02-28,2,0,2
18828,Tehama,2021-02-28,3,0,3
18829,Butte,2021-02-28,24,0,24
18830,Plumas,2021-02-28,0,0,0
18831,Kern,2021-02-28,148,6,154
18832,Trinity,2021-02-28,0,0,0
18833,El Dorado,2021-02-28,4,0,4
18834,Modoc,2021-02-28,0,0,0
18835,Glenn,2021-02-28,0,0,0
18836,Amador,2021-02-28,3,0,3
18837,Mariposa,2021-02-28,0,0,0
18838,Siskiyou,2021-02-28,2,0,2
18839,Inyo,2021-02-28,0,0,0
18840,Mono,2021-02-28,0,0,0
18841,Humboldt,2021-02-28,7,3,10
18842,Shasta,2021-02-28,16,0,16
18843,Merced,2021-02-28,31,0,31
18844,Orange,2021-02-28,419,26,445
18845,Mendocino,2021-02-28,4,0,4
18846,Santa Cruz,2021-02-28,15,1,16
18847,Madera,2021-02-28,20,8,28
18848,Los Angeles,2021-02-28,1502,157,1659
18849,San Diego,2021-02-28,484,20,504
18850,San Luis Obispo,2021-02-28,17,1,18
18851,Nevada,2021-02-28,0,1,1
18852,Stanislaus,2021-02-28,111,15,126
18853,San Francisco,2021-02-28,79,6,85
18854,Riverside,2021-02-28,307,57,364
18855,Kings,2021-02-28,33,0,33
18856,Ventura,2021-02-28,116,4,120
18857,Sutter,2021-02-28,0,0,0
18858,Calaveras,2021-02-28,0,0,0
18859,Monterey,2021-02-28,38,1,39
18860,Fresno,2021-02-28,191,14,205
18861,Lassen,2021-02-28,0,0,0
18862,San Benito,2021-02-28,3,0,3
18863,San Mateo,2021-02-28,54,3,57
18864,Tuolumne,2021-02-28,0,0,0
18865,Tulare,2021-02-28,62,8,70
18866,Solano,2021-02-28,42,14,56
18867,Marin,2021-02-28,14,3,17
18868,Santa Clara,2021-02-28,189,32,221
18869,Riverside,2021-03-01,301,45,346
18870,Kings,2021-03-01,34,1,35
18871,San Francisco,2021-03-01,74,3,77
18872,San Bernardino,2021-03-01,280,29,309
18873,San Luis Obispo,2021-03-01,12,2,14
18874,Humboldt,2021-03-01,3,5,8
18875,Glenn,2021-03-01,0,0,0
18876,Santa Cruz,2021-03-01,13,1,14
18877,Del Norte,2021-03-01,2,0,2
18878,Mendocino,2021-03-01,5,0,5
18879,Santa Clara,2021-03-01,182,23,205
18880,Napa,2021-03-01,5,0,5
18881,Madera,2021-03-01,21,9,30
18882,Amador,2021-03-01,2,0,2
18883,Marin,2021-03-01,14,5,19
18884,Solano,2021-03-01,44,8,52
18885,Monterey,2021-03-01,40,1,41
18886,Siskiyou,2021-03-01,3,0,3
18887,Butte,2021-03-01,22,1,23
18888,Nevada,2021-03-01,4,0,4
18889,Sonoma,2021-03-01,30,2,32
18890,Modoc,2021-03-01,0,0,0
18891,El Dorado,2021-03-01,3,0,3
18892,Inyo,2021-03-01,1,0,1
18893,Trinity,2021-03-01,0,0,0
18894,Mariposa,2021-03-01,0,0,0
18895,Fresno,2021-03-01,181,17,198
18896,San Benito,2021-03-01,2,0,2
18897,Shasta,2021-03-01,16,0,16
18898,Lake,2021-03-01,0,0,0
18899,Calaveras,2021-03-01,0,0,0
18900,Tulare,2021-03-01,62,9,71
18901,Ventura,2021-03-01,102,7,109
18902,Yuba,2021-03-01,19,0,19
18903,Plumas,2021-03-01,0,0,0
18904,Alameda,2021-03-01,136,24,160
18905,Colusa,2021-03-01,1,0,1
18906,Tehama,2021-03-01,2,0,2
18907,Tuolumne,2021-03-01,0,0,0
18908,Imperial,2021-03-01,23,0,23
18909,Los Angeles,2021-03-01,1476,155,1631
18910,Orange,2021-03-01,425,21,446
18911,San Diego,2021-03-01,479,35,514
18912,Contra Costa,2021-03-01,75,19,94
18913,Mono,2021-03-01,0,0,0
18914,San Mateo,2021-03-01,53,3,56
18915,Lassen,2021-03-01,0,0,0
18916,Placer,2021-03-01,55,8,63
18917,San Joaquin,2021-03-01,98,9,107
18918,Santa Barbara,2021-03-01,61,6,67
18919,Yolo,2021-03-01,14,1,15
18920,Sacramento,2021-03-01,150,18,168
18921,Sutter,2021-03-01,0,0,0
18922,Kern,2021-03-01,143,8,151
18923,Merced,2021-03-01,33,0,33
18924,Stanislaus,2021-03-01,111,15,126
18925,Butte,2021-03-02,21,0,21
18926,Madera,2021-03-02,14,3,17
18927,Ventura,2021-03-02,101,14,115
18928,Fresno,2021-03-02,180,28,208
18929,San Benito,2021-03-02,2,0,2
18930,Tulare,2021-03-02,62,12,74
18931,Trinity,2021-03-02,0,0,0
18932,San Joaquin,2021-03-02,97,7,104
18933,Tuolumne,2021-03-02,0,0,0
18934,San Diego,2021-03-02,443,29,472
18935,San Luis Obispo,2021-03-02,11,3,14
18936,Santa Clara,2021-03-02,170,20,190
18937,Lake,2021-03-02,0,0,0
18938,Placer,2021-03-02,46,10,56
18939,Stanislaus,2021-03-02,112,18,130
18940,Amador,2021-03-02,2,0,2
18941,Modoc,2021-03-02,0,0,0
18942,Sacramento,2021-03-02,154,16,170
18943,Santa Cruz,2021-03-02,12,0,12
18944,Yolo,2021-03-02,11,0,11
18945,Contra Costa,2021-03-02,69,22,91
18946,Plumas,2021-03-02,0,0,0
18947,El Dorado,2021-03-02,3,0,3
18948,Mono,2021-03-02,0,0,0
18949,Glenn,2021-03-02,0,0,0
18950,Marin,2021-03-02,13,4,17
18951,Santa Barbara,2021-03-02,57,2,59
18952,Shasta,2021-03-02,17,0,17
18953,San Bernardino,2021-03-02,267,17,284
18954,Sutter,2021-03-02,0,0,0
18955,San Mateo,2021-03-02,49,5,54
18956,Siskiyou,2021-03-02,3,0,3
18957,Monterey,2021-03-02,38,1,39
18958,Solano,2021-03-02,45,8,53
18959,San Francisco,2021-03-02,76,2,78
18960,Humboldt,2021-03-02,1,5,6
18961,Mariposa,2021-03-02,0,0,0
18962,Kings,2021-03-02,34,1,35
18963,Inyo,2021-03-02,2,0,2
18964,Colusa,2021-03-02,1,2,3
18965,Kern,2021-03-02,127,14,141
18966,Riverside,2021-03-02,303,44,347
18967,Nevada,2021-03-02,4,1,5
18968,Alameda,2021-03-02,140,25,165
18969,Napa,2021-03-02,4,0,4
18970,Merced,2021-03-02,29,0,29
18971,Orange,2021-03-02,403,25,428
18972,Sonoma,2021-03-02,22,2,24
18973,Lassen,2021-03-02,0,0,0
18974,Del Norte,2021-03-02,1,0,1
18975,Tehama,2021-03-02,3,0,3
18976,Yuba,2021-03-02,21,0,21
18977,Calaveras,2021-03-02,0,0,0
18978,Los Angeles,2021-03-02,1401,173,1574
18979,Imperial,2021-03-02,22,0,22
18980,Mendocino,2021-03-02,4,0,4
18981,Sutter,2021-03-03,0,0,0
18982,Madera,2021-03-03,13,6,19
18983,San Francisco,2021-03-03,65,9,74
18984,Lassen,2021-03-03,0,0,0
18985,Alameda,2021-03-03,145,29,174
18986,Nevada,2021-03-03,3,1,4
18987,Tuolumne,2021-03-03,1,0,1
18988,Tehama,2021-03-03,3,0,3
18989,Humboldt,2021-03-03,1,2,3
18990,Siskiyou,2021-03-03,3,0,3
18991,Merced,2021-03-03,22,0,22
18992,San Benito,2021-03-03,2,0,2
18993,Kings,2021-03-03,35,1,36
18994,Marin,2021-03-03,16,3,19
18995,Del Norte,2021-03-03,1,0,1
18996,San Diego,2021-03-03,429,24,453
18997,Ventura,2021-03-03,102,4,106
18998,Riverside,2021-03-03,303,43,346
18999,Butte,2021-03-03,21,0,21
19000,Mendocino,2021-03-03,2,0,2
19001,El Dorado,2021-03-03,4,0,4
19002,Monterey,2021-03-03,40,1,41
19003,Amador,2021-03-03,2,0,2
19004,Shasta,2021-03-03,15,0,15
19005,Mariposa,2021-03-03,0,0,0
19006,Inyo,2021-03-03,2,0,2
19007,San Luis Obispo,2021-03-03,12,1,13
19008,Sonoma,2021-03-03,18,5,23
19009,Yolo,2021-03-03,7,0,7
19010,Modoc,2021-03-03,0,0,0
19011,Trinity,2021-03-03,0,0,0
19012,Solano,2021-03-03,44,8,52
19013,Yuba,2021-03-03,22,0,22
19014,Fresno,2021-03-03,174,24,198
19015,Lake,2021-03-03,0,0,0
19016,Kern,2021-03-03,127,9,136
19017,Napa,2021-03-03,4,0,4
19018,Tulare,2021-03-03,54,10,64
19019,Santa Clara,2021-03-03,176,28,204
19020,Calaveras,2021-03-03,0,0,0
19021,Sacramento,2021-03-03,152,9,161
19022,Glenn,2021-03-03,0,0,0
19023,Contra Costa,2021-03-03,64,24,88
19024,Santa Barbara,2021-03-03,52,1,53
19025,San Mateo,2021-03-03,50,6,56
19026,Mono,2021-03-03,0,0,0
19027,Placer,2021-03-03,50,4,54
19028,Orange,2021-03-03,379,26,405
19029,Imperial,2021-03-03,20,0,20
19030,Stanislaus,2021-03-03,114,13,127
19031,Los Angeles,2021-03-03,1341,182,1523
19032,San Joaquin,2021-03-03,93,11,104
19033,Colusa,2021-03-03,1,2,3
19034,Plumas,2021-03-03,0,0,0
19035,Santa Cruz,2021-03-03,11,1,12
19036,San Bernardino,2021-03-03,254,31,285
19037,Orange,2021-03-04,339,24,363
19038,Nevada,2021-03-04,5,0,5
19039,San Francisco,2021-03-04,53,12,65
19040,Santa Cruz,2021-03-04,11,1,12
19041,Shasta,2021-03-04,11,0,11
19042,Stanislaus,2021-03-04,121,10,131
19043,Lassen,2021-03-04,0,0,0
19044,Kings,2021-03-04,34,0,34
19045,Riverside,2021-03-04,279,43,322
19046,Alameda,2021-03-04,140,27,167
19047,Amador,2021-03-04,2,0,2
19048,Marin,2021-03-04,15,4,19
19049,San Mateo,2021-03-04,46,5,51
19050,Sutter,2021-03-04,0,0,0
19051,Yolo,2021-03-04,6,0,6
19052,Plumas,2021-03-04,0,0,0
19053,San Bernardino,2021-03-04,210,30,240
19054,Monterey,2021-03-04,39,1,40
19055,Lake,2021-03-04,0,0,0
19056,San Joaquin,2021-03-04,89,16,105
19057,Trinity,2021-03-04,0,0,0
19058,Mono,2021-03-04,0,0,0
19059,El Dorado,2021-03-04,4,0,4
19060,Merced,2021-03-04,20,0,20
19061,Los Angeles,2021-03-04,1264,191,1455
19062,Sonoma,2021-03-04,19,0,19
19063,Tulare,2021-03-04,54,9,63
19064,Mendocino,2021-03-04,2,0,2
19065,Tuolumne,2021-03-04,1,0,1
19066,Siskiyou,2021-03-04,3,0,3
19067,San Diego,2021-03-04,401,23,424
19068,Del Norte,2021-03-04,1,0,1
19069,Fresno,2021-03-04,156,23,179
19070,Imperial,2021-03-04,21,1,22
19071,Butte,2021-03-04,23,0,23
19072,Mariposa,2021-03-04,0,0,0
19073,Sacramento,2021-03-04,143,19,162
19074,Placer,2021-03-04,51,9,60
19075,Kern,2021-03-04,127,8,135
19076,Contra Costa,2021-03-04,67,26,93
19077,Humboldt,2021-03-04,1,4,5
19078,San Benito,2021-03-04,2,0,2
19079,Madera,2021-03-04,9,3,12
19080,Glenn,2021-03-04,0,0,0
19081,Yuba,2021-03-04,21,0,21
19082,Inyo,2021-03-04,2,0,2
19083,San Luis Obispo,2021-03-04,12,2,14
19084,Santa Clara,2021-03-04,171,23,194
19085,Colusa,2021-03-04,1,3,4
19086,Napa,2021-03-04,5,1,6
19087,Calaveras,2021-03-04,0,0,0
19088,Modoc,2021-03-04,0,0,0
19089,Tehama,2021-03-04,3,0,3
19090,Santa Barbara,2021-03-04,53,3,56
19091,Ventura,2021-03-04,103,8,111
19092,Solano,2021-03-04,39,6,45
19093,Lassen,2021-03-05,0,0,0
19094,Tuolumne,2021-03-05,0,0,0
19095,Tehama,2021-03-05,3,0,3
19096,San Mateo,2021-03-05,44,8,52
19097,Contra Costa,2021-03-05,60,22,82
19098,Napa,2021-03-05,7,0,7
19099,Yuba,2021-03-05,19,0,19
19100,Del Norte,2021-03-05,1,0,1
19101,Plumas,2021-03-05,0,0,0
19102,El Dorado,2021-03-05,3,0,3
19103,Santa Barbara,2021-03-05,50,1,51
19104,Riverside,2021-03-05,263,47,310
19105,Placer,2021-03-05,45,7,52
19106,Sacramento,2021-03-05,144,16,160
19107,Ventura,2021-03-05,110,6,116
19108,Kings,2021-03-05,35,0,35
19109,Calaveras,2021-03-05,0,0,0
19110,Madera,2021-03-05,7,6,13
19111,Inyo,2021-03-05,2,0,2
19112,Tulare,2021-03-05,51,9,60
19113,Humboldt,2021-03-05,2,5,7
19114,Santa Cruz,2021-03-05,8,1,9
19115,Modoc,2021-03-05,0,0,0
19116,Mendocino,2021-03-05,2,0,2
19117,Yolo,2021-03-05,7,0,7
19118,San Francisco,2021-03-05,55,12,67
19119,San Joaquin,2021-03-05,89,6,95
19120,Orange,2021-03-05,321,15,336
19121,San Bernardino,2021-03-05,248,38,286
19122,Santa Clara,2021-03-05,166,33,199
19123,Amador,2021-03-05,2,0,2
19124,Trinity,2021-03-05,0,0,0
19125,Shasta,2021-03-05,12,0,12
19126,Mono,2021-03-05,0,0,0
19127,Lake,2021-03-05,0,0,0
19128,Siskiyou,2021-03-05,2,0,2
19129,Nevada,2021-03-05,5,0,5
19130,Solano,2021-03-05,36,8,44
19131,Alameda,2021-03-05,131,28,159
19132,Butte,2021-03-05,19,0,19
19133,Monterey,2021-03-05,39,1,40
19134,Kern,2021-03-05,126,10,136
19135,Los Angeles,2021-03-05,1176,164,1340
19136,Colusa,2021-03-05,1,3,4
19137,Sutter,2021-03-05,0,0,0
19138,San Luis Obispo,2021-03-05,13,1,14
19139,San Benito,2021-03-05,1,0,1
19140,Stanislaus,2021-03-05,115,11,126
19141,Mariposa,2021-03-05,0,0,0
19142,Marin,2021-03-05,17,4,21
19143,Glenn,2021-03-05,0,0,0
19144,Merced,2021-03-05,16,0,16
19145,Fresno,2021-03-05,150,24,174
19146,Imperial,2021-03-05,22,0,22
19147,Sonoma,2021-03-05,20,0,20
19148,San Diego,2021-03-05,359,23,382
19149,Modoc,2021-03-06,0,0,0
19150,San Benito,2021-03-06,1,0,1
19151,Marin,2021-03-06,17,4,21
19152,San Bernardino,2021-03-06,242,20,262
19153,Butte,2021-03-06,18,1,19
19154,Fresno,2021-03-06,142,29,171
19155,Inyo,2021-03-06,2,0,2
19156,Sonoma,2021-03-06,19,0,19
19157,Yuba,2021-03-06,18,0,18
19158,San Francisco,2021-03-06,51,5,56
19159,Lassen,2021-03-06,0,0,0
19160,Placer,2021-03-06,42,9,51
19161,Nevada,2021-03-06,2,0,2
19162,Plumas,2021-03-06,0,0,0
19163,Tuolumne,2021-03-06,0,0,0
19164,San Joaquin,2021-03-06,86,5,91
19165,San Diego,2021-03-06,357,27,384
19166,Stanislaus,2021-03-06,105,13,118
19167,Sacramento,2021-03-06,130,19,149
19168,Del Norte,2021-03-06,1,0,1
19169,Mendocino,2021-03-06,1,0,1
19170,Solano,2021-03-06,34,5,39
19171,Shasta,2021-03-06,13,0,13
19172,Santa Clara,2021-03-06,159,23,182
19173,Siskiyou,2021-03-06,2,0,2
19174,Monterey,2021-03-06,35,0,35
19175,Lake,2021-03-06,0,0,0
19176,Colusa,2021-03-06,1,2,3
19177,Yolo,2021-03-06,7,0,7
19178,Humboldt,2021-03-06,2,6,8
19179,Madera,2021-03-06,9,11,20
19180,Riverside,2021-03-06,257,54,311
19181,Ventura,2021-03-06,106,11,117
19182,Tehama,2021-03-06,3,0,3
19183,Sutter,2021-03-06,0,0,0
19184,Merced,2021-03-06,14,0,14
19185,El Dorado,2021-03-06,2,0,2
19186,Amador,2021-03-06,2,0,2
19187,Los Angeles,2021-03-06,1132,156,1288
19188,Contra Costa,2021-03-06,61,13,74
19189,Glenn,2021-03-06,0,0,0
19190,Calaveras,2021-03-06,1,0,1
19191,Kern,2021-03-06,113,8,121
19192,Santa Cruz,2021-03-06,10,0,10
19193,Tulare,2021-03-06,47,9,56
19194,Trinity,2021-03-06,0,0,0
19195,Napa,2021-03-06,6,1,7
19196,Santa Barbara,2021-03-06,48,2,50
19197,Kings,2021-03-06,33,0,33
19198,San Luis Obispo,2021-03-06,11,0,11
19199,Orange,2021-03-06,296,15,311
19200,Alameda,2021-03-06,116,29,145
19201,San Mateo,2021-03-06,40,2,42
19202,Mariposa,2021-03-06,0,0,0
19203,Imperial,2021-03-06,18,0,18
19204,Mono,2021-03-06,0,0,0
19205,Sutter,2021-03-07,0,0,0
19206,Sonoma,2021-03-07,20,1,21
19207,Riverside,2021-03-07,251,63,314
19208,San Mateo,2021-03-07,39,2,41
19209,Kern,2021-03-07,112,6,118
19210,Solano,2021-03-07,35,4,39
19211,San Francisco,2021-03-07,47,9,56
19212,San Diego,2021-03-07,345,21,366
19213,Santa Barbara,2021-03-07,51,3,54
19214,Santa Clara,2021-03-07,154,21,175
19215,Ventura,2021-03-07,99,8,107
19216,San Benito,2021-03-07,1,0,1
19217,Kings,2021-03-07,28,0,28
19218,Madera,2021-03-07,8,6,14
19219,Amador,2021-03-07,2,0,2
19220,Sacramento,2021-03-07,118,27,145
19221,Contra Costa,2021-03-07,65,10,75
19222,Merced,2021-03-07,16,0,16
19223,Mendocino,2021-03-07,2,0,2
19224,Shasta,2021-03-07,11,0,11
19225,Trinity,2021-03-07,0,0,0
19226,Orange,2021-03-07,288,19,307
19227,Nevada,2021-03-07,3,0,3
19228,Del Norte,2021-03-07,1,0,1
19229,San Bernardino,2021-03-07,249,35,284
19230,San Joaquin,2021-03-07,90,5,95
19231,Stanislaus,2021-03-07,116,14,130
19232,El Dorado,2021-03-07,3,0,3
19233,Yolo,2021-03-07,6,0,6
19234,Santa Cruz,2021-03-07,10,0,10
19235,Plumas,2021-03-07,0,0,0
19236,Mariposa,2021-03-07,0,0,0
19237,Glenn,2021-03-07,0,0,0
19238,Mono,2021-03-07,0,0,0
19239,Siskiyou,2021-03-07,1,2,3
19240,Alameda,2021-03-07,114,27,141
19241,Lake,2021-03-07,0,0,0
19242,Inyo,2021-03-07,2,0,2
19243,Calaveras,2021-03-07,1,0,1
19244,Tehama,2021-03-07,3,0,3
19245,Tuolumne,2021-03-07,1,0,1
19246,Tulare,2021-03-07,46,8,54
19247,Napa,2021-03-07,5,0,5
19248,Humboldt,2021-03-07,4,4,8
19249,Butte,2021-03-07,18,1,19
19250,Imperial,2021-03-07,15,0,15
19251,Monterey,2021-03-07,38,0,38
19252,Marin,2021-03-07,17,3,20
19253,Yuba,2021-03-07,16,0,16
19254,Placer,2021-03-07,44,8,52
19255,Los Angeles,2021-03-07,1119,128,1247
19256,Fresno,2021-03-07,136,26,162
19257,San Luis Obispo,2021-03-07,15,1,16
19258,Lassen,2021-03-07,0,0,0
19259,Colusa,2021-03-07,1,0,1
19260,Modoc,2021-03-07,0,0,0
19261,Lake,2021-03-08,1,0,1
19262,Merced,2021-03-08,17,0,17
19263,Tehama,2021-03-08,4,0,4
19264,Sutter,2021-03-08,0,0,0
19265,Madera,2021-03-08,7,6,13
19266,Trinity,2021-03-08,0,0,0
19267,Stanislaus,2021-03-08,121,16,137
19268,Shasta,2021-03-08,9,0,9
19269,Plumas,2021-03-08,0,0,0
19270,Imperial,2021-03-08,13,0,13
19271,Inyo,2021-03-08,2,0,2
19272,Yuba,2021-03-08,18,0,18
19273,Kings,2021-03-08,30,1,31
19274,Humboldt,2021-03-08,4,5,9
19275,Solano,2021-03-08,33,4,37
19276,San Bernardino,2021-03-08,253,38,291
19277,El Dorado,2021-03-08,3,0,3
19278,Butte,2021-03-08,20,0,20
19279,Santa Cruz,2021-03-08,9,0,9
19280,Mariposa,2021-03-08,0,0,0
19281,San Mateo,2021-03-08,40,4,44
19282,Modoc,2021-03-08,0,0,0
19283,Los Angeles,2021-03-08,1079,139,1218
19284,San Luis Obispo,2021-03-08,16,1,17
19285,Monterey,2021-03-08,38,0,38
19286,San Diego,2021-03-08,341,23,364
19287,Santa Clara,2021-03-08,151,23,174
19288,Nevada,2021-03-08,4,0,4
19289,Ventura,2021-03-08,89,9,98
19290,Alameda,2021-03-08,118,22,140
19291,Orange,2021-03-08,283,19,302
19292,San Francisco,2021-03-08,49,8,57
19293,Tulare,2021-03-08,42,13,55
19294,Yolo,2021-03-08,7,1,8
19295,Contra Costa,2021-03-08,68,13,81
19296,San Joaquin,2021-03-08,91,4,95
19297,Napa,2021-03-08,5,0,5
19298,Tuolumne,2021-03-08,2,0,2
19299,San Benito,2021-03-08,0,0,0
19300,Santa Barbara,2021-03-08,47,3,50
19301,Colusa,2021-03-08,1,3,4
19302,Marin,2021-03-08,17,5,22
19303,Riverside,2021-03-08,264,50,314
19304,Kern,2021-03-08,115,5,120
19305,Sonoma,2021-03-08,19,3,22
19306,Placer,2021-03-08,46,8,54
19307,Calaveras,2021-03-08,1,0,1
19308,Mono,2021-03-08,0,0,0
19309,Amador,2021-03-08,2,0,2
19310,Fresno,2021-03-08,142,17,159
19311,Lassen,2021-03-08,0,0,0
19312,Mendocino,2021-03-08,2,0,2
19313,Glenn,2021-03-08,0,0,0
19314,Del Norte,2021-03-08,1,0,1
19315,Siskiyou,2021-03-08,4,0,4
19316,Sacramento,2021-03-08,116,18,134
19317,Orange,2021-03-09,277,31,308
19318,Tehama,2021-03-09,3,0,3
19319,El Dorado,2021-03-09,2,0,2
19320,Sacramento,2021-03-09,117,17,134
19321,San Mateo,2021-03-09,36,7,43
19322,San Benito,2021-03-09,2,0,2
19323,Sutter,2021-03-09,0,0,0
19324,San Joaquin,2021-03-09,91,9,100
19325,Yuba,2021-03-09,13,0,13
19326,Alameda,2021-03-09,110,18,128
19327,Imperial,2021-03-09,14,1,15
19328,Placer,2021-03-09,39,6,45
19329,Ventura,2021-03-09,90,17,107
19330,San Luis Obispo,2021-03-09,14,0,14
19331,San Francisco,2021-03-09,46,14,60
19332,Sonoma,2021-03-09,19,0,19
19333,Butte,2021-03-09,21,0,21
19334,Inyo,2021-03-09,2,0,2
19335,Colusa,2021-03-09,0,3,3
19336,Calaveras,2021-03-09,1,0,1
19337,Modoc,2021-03-09,0,0,0
19338,San Bernardino,2021-03-09,237,29,266
19339,Yolo,2021-03-09,6,0,6
19340,Shasta,2021-03-09,8,0,8
19341,Trinity,2021-03-09,0,0,0
19342,Del Norte,2021-03-09,1,0,1
19343,Kings,2021-03-09,29,0,29
19344,Mariposa,2021-03-09,0,0,0
19345,San Diego,2021-03-09,334,31,365
19346,Mono,2021-03-09,0,0,0
19347,Mendocino,2021-03-09,1,0,1
19348,Riverside,2021-03-09,254,35,289
19349,Merced,2021-03-09,22,0,22
19350,Lassen,2021-03-09,0,0,0
19351,Fresno,2021-03-09,142,29,171
19352,Napa,2021-03-09,5,0,5
19353,Kern,2021-03-09,104,8,112
19354,Santa Clara,2021-03-09,136,27,163
19355,Los Angeles,2021-03-09,1056,151,1207
19356,Contra Costa,2021-03-09,62,16,78
19357,Marin,2021-03-09,18,2,20
19358,Madera,2021-03-09,6,3,9
19359,Santa Cruz,2021-03-09,9,1,10
19360,Siskiyou,2021-03-09,3,0,3
19361,Plumas,2021-03-09,0,0,0
19362,Glenn,2021-03-09,0,0,0
19363,Stanislaus,2021-03-09,123,19,142
19364,Humboldt,2021-03-09,4,3,7
19365,Tulare,2021-03-09,43,11,54
19366,Lake,2021-03-09,0,0,0
19367,Santa Barbara,2021-03-09,46,2,48
19368,Solano,2021-03-09,29,4,33
19369,Amador,2021-03-09,2,0,2
19370,Monterey,2021-03-09,41,0,41
19371,Tuolumne,2021-03-09,1,0,1
19372,Nevada,2021-03-09,6,0,6
19373,Ventura,2021-03-10,87,12,99
19374,Marin,2021-03-10,14,2,16
19375,San Joaquin,2021-03-10,85,10,95
19376,Glenn,2021-03-10,0,0,0
19377,Plumas,2021-03-10,0,0,0
19378,Solano,2021-03-10,26,8,34
19379,Yolo,2021-03-10,5,0,5
19380,Merced,2021-03-10,21,0,21
19381,Colusa,2021-03-10,0,3,3
19382,Humboldt,2021-03-10,3,5,8
19383,El Dorado,2021-03-10,2,1,3
19384,Mono,2021-03-10,0,0,0
19385,Stanislaus,2021-03-10,126,15,141
19386,Nevada,2021-03-10,6,0,6
19387,Santa Cruz,2021-03-10,6,1,7
19388,Orange,2021-03-10,252,24,276
19389,Napa,2021-03-10,3,0,3
19390,Santa Barbara,2021-03-10,48,1,49
19391,Placer,2021-03-10,32,8,40
19392,Modoc,2021-03-10,0,0,0
19393,Trinity,2021-03-10,0,0,0
19394,Calaveras,2021-03-10,0,0,0
19395,Yuba,2021-03-10,12,1,13
19396,Alameda,2021-03-10,111,18,129
19397,Shasta,2021-03-10,9,0,9
19398,San Diego,2021-03-10,319,30,349
19399,Mendocino,2021-03-10,1,0,1
19400,Del Norte,2021-03-10,1,0,1
19401,Siskiyou,2021-03-10,3,0,3
19402,Inyo,2021-03-10,3,0,3
19403,Contra Costa,2021-03-10,54,12,66
19404,Santa Clara,2021-03-10,143,26,169
19405,Amador,2021-03-10,2,0,2
19406,Lake,2021-03-10,2,0,2
19407,Kern,2021-03-10,98,10,108
19408,Tulare,2021-03-10,42,4,46
19409,Imperial,2021-03-10,12,0,12
19410,Monterey,2021-03-10,36,0,36
19411,Riverside,2021-03-10,234,30,264
19412,Sacramento,2021-03-10,122,23,145
19413,San Bernardino,2021-03-10,219,28,247
19414,Madera,2021-03-10,7,6,13
19415,Mariposa,2021-03-10,0,0,0
19416,Butte,2021-03-10,23,0,23
19417,San Mateo,2021-03-10,34,8,42
19418,San Luis Obispo,2021-03-10,11,0,11
19419,Kings,2021-03-10,24,0,24
19420,Sonoma,2021-03-10,20,0,20
19421,Los Angeles,2021-03-10,1015,163,1178
19422,Tuolumne,2021-03-10,1,0,1
19423,Lassen,2021-03-10,0,0,0
19424,Tehama,2021-03-10,5,0,5
19425,Sutter,2021-03-10,0,0,0
19426,San Benito,2021-03-10,2,0,2
19427,San Francisco,2021-03-10,44,9,53
19428,Fresno,2021-03-10,152,23,175
19429,Calaveras,2021-03-11,0,0,0
19430,Nevada,2021-03-11,6,0,6
19431,Yolo,2021-03-11,1,4,5
19432,San Joaquin,2021-03-11,75,8,83
19433,San Benito,2021-03-11,1,0,1
19434,Alameda,2021-03-11,107,30,137
19435,San Francisco,2021-03-11,41,10,51
19436,Lassen,2021-03-11,0,0,0
19437,Amador,2021-03-11,2,0,2
19438,Tehama,2021-03-11,6,0,6
19439,Stanislaus,2021-03-11,128,16,144
19440,Siskiyou,2021-03-11,3,0,3
19441,Monterey,2021-03-11,35,0,35
19442,Sutter,2021-03-11,0,0,0
19443,Solano,2021-03-11,21,7,28
19444,Del Norte,2021-03-11,0,0,0
19445,Madera,2021-03-11,8,10,18
19446,Imperial,2021-03-11,15,0,15
19447,Glenn,2021-03-11,0,0,0
19448,Napa,2021-03-11,5,0,5
19449,San Luis Obispo,2021-03-11,9,1,10
19450,El Dorado,2021-03-11,2,0,2
19451,Santa Barbara,2021-03-11,43,0,43
19452,Lake,2021-03-11,1,0,1
19453,Mendocino,2021-03-11,2,0,2
19454,Colusa,2021-03-11,1,1,2
19455,Merced,2021-03-11,23,0,23
19456,Los Angeles,2021-03-11,979,167,1146
19457,Butte,2021-03-11,21,0,21
19458,Inyo,2021-03-11,3,0,3
19459,Tuolumne,2021-03-11,2,0,2
19460,Fresno,2021-03-11,147,25,172
19461,Sacramento,2021-03-11,118,19,137
19462,Riverside,2021-03-11,217,25,242
19463,Sonoma,2021-03-11,21,1,22
19464,Mariposa,2021-03-11,0,0,0
19465,Modoc,2021-03-11,0,0,0
19466,Shasta,2021-03-11,9,0,9
19467,Contra Costa,2021-03-11,50,11,61
19468,Kings,2021-03-11,20,0,20
19469,San Bernardino,2021-03-11,217,34,251
19470,Plumas,2021-03-11,0,0,0
19471,Mono,2021-03-11,0,0,0
19472,Humboldt,2021-03-11,4,3,7
19473,Orange,2021-03-11,245,21,266
19474,Yuba,2021-03-11,12,0,12
19475,San Diego,2021-03-11,293,23,316
19476,Ventura,2021-03-11,88,6,94
19477,Tulare,2021-03-11,36,7,43
19478,San Mateo,2021-03-11,38,8,46
19479,Placer,2021-03-11,30,12,42
19480,Santa Cruz,2021-03-11,6,1,7
19481,Kern,2021-03-11,98,8,106
19482,Marin,2021-03-11,15,3,18
19483,Trinity,2021-03-11,0,0,0
19484,Santa Clara,2021-03-11,131,16,147
19485,Yolo,2021-03-12,4,0,4
19486,Modoc,2021-03-12,0,0,0
19487,Orange,2021-03-12,237,30,267
19488,Riverside,2021-03-12,204,23,227
19489,Glenn,2021-03-12,0,0,0
19490,San Francisco,2021-03-12,41,3,44
19491,Kings,2021-03-12,17,0,17
19492,Humboldt,2021-03-12,4,3,7
19493,Napa,2021-03-12,3,0,3
19494,Placer,2021-03-12,31,9,40
19495,Santa Clara,2021-03-12,132,17,149
19496,Tulare,2021-03-12,37,6,43
19497,Amador,2021-03-12,1,0,1
19498,Merced,2021-03-12,20,0,20
19499,Fresno,2021-03-12,143,20,163
19500,Alameda,2021-03-12,118,27,145
19501,Mariposa,2021-03-12,0,0,0
19502,Ventura,2021-03-12,85,4,89
19503,Tehama,2021-03-12,6,0,6
19504,Lake,2021-03-12,1,0,1
19505,San Luis Obispo,2021-03-12,9,2,11
19506,Sonoma,2021-03-12,22,0,22
19507,San Diego,2021-03-12,290,30,320
19508,Shasta,2021-03-12,9,0,9
19509,Plumas,2021-03-12,0,0,0
19510,Del Norte,2021-03-12,0,0,0
19511,Trinity,2021-03-12,0,0,0
19512,San Mateo,2021-03-12,35,6,41
19513,Solano,2021-03-12,25,9,34
19514,Los Angeles,2021-03-12,951,155,1106
19515,Contra Costa,2021-03-12,49,11,60
19516,Kern,2021-03-12,95,4,99
19517,Mendocino,2021-03-12,3,0,3
19518,Colusa,2021-03-12,1,2,3
19519,Yuba,2021-03-12,10,1,11
19520,San Bernardino,2021-03-12,200,21,221
19521,Nevada,2021-03-12,5,0,5
19522,Inyo,2021-03-12,2,0,2
19523,Santa Barbara,2021-03-12,39,0,39
19524,Sacramento,2021-03-12,116,17,133
19525,Monterey,2021-03-12,39,0,39
19526,Tuolumne,2021-03-12,2,0,2
19527,Marin,2021-03-12,17,3,20
19528,Stanislaus,2021-03-12,126,15,141
19529,Calaveras,2021-03-12,0,0,0
19530,Siskiyou,2021-03-12,2,0,2
19531,Madera,2021-03-12,6,6,12
19532,El Dorado,2021-03-12,3,1,4
19533,San Benito,2021-03-12,1,0,1
19534,Mono,2021-03-12,0,0,0
19535,Santa Cruz,2021-03-12,5,1,6
19536,Lassen,2021-03-12,0,0,0
19537,Imperial,2021-03-12,14,0,14
19538,San Joaquin,2021-03-12,73,13,86
19539,Sutter,2021-03-12,0,0,0
19540,Butte,2021-03-12,17,0,17
19541,Amador,2021-03-13,1,0,1
19542,San Luis Obispo,2021-03-13,9,2,11
19543,Napa,2021-03-13,5,0,5
19544,Stanislaus,2021-03-13,118,14,132
19545,Kings,2021-03-13,15,0,15
19546,Tehama,2021-03-13,5,0,5
19547,Kern,2021-03-13,92,5,97
19548,Lake,2021-03-13,2,0,2
19549,Yolo,2021-03-13,4,0,4
19550,Trinity,2021-03-13,0,0,0
19551,Siskiyou,2021-03-13,1,0,1
19552,Placer,2021-03-13,39,6,45
19553,San Bernardino,2021-03-13,194,20,214
19554,Modoc,2021-03-13,0,0,0
19555,Sonoma,2021-03-13,23,1,24
19556,Mendocino,2021-03-13,3,0,3
19557,Mono,2021-03-13,0,0,0
19558,Orange,2021-03-13,241,26,267
19559,San Diego,2021-03-13,279,24,303
19560,San Joaquin,2021-03-13,69,11,80
19561,Humboldt,2021-03-13,4,6,10
19562,Santa Cruz,2021-03-13,9,0,9
19563,Nevada,2021-03-13,6,0,6
19564,Colusa,2021-03-13,1,1,2
19565,Ventura,2021-03-13,77,6,83
19566,Glenn,2021-03-13,0,0,0
19567,El Dorado,2021-03-13,1,0,1
19568,Plumas,2021-03-13,0,0,0
19569,Calaveras,2021-03-13,1,0,1
19570,Madera,2021-03-13,9,14,23
19571,Lassen,2021-03-13,0,0,0
19572,Los Angeles,2021-03-13,893,156,1049
19573,Santa Clara,2021-03-13,131,12,143
19574,Butte,2021-03-13,13,1,14
19575,Monterey,2021-03-13,37,0,37
19576,Marin,2021-03-13,18,5,23
19577,Del Norte,2021-03-13,0,0,0
19578,Solano,2021-03-13,25,7,32
19579,San Benito,2021-03-13,1,0,1
19580,Shasta,2021-03-13,10,0,10
19581,San Mateo,2021-03-13,35,7,42
19582,Inyo,2021-03-13,3,0,3
19583,Imperial,2021-03-13,13,0,13
19584,Riverside,2021-03-13,182,23,205
19585,Tulare,2021-03-13,34,4,38
19586,Sacramento,2021-03-13,119,14,133
19587,Fresno,2021-03-13,128,20,148
19588,Mariposa,2021-03-13,0,0,0
19589,Santa Barbara,2021-03-13,37,1,38
19590,Merced,2021-03-13,20,0,20
19591,Alameda,2021-03-13,117,34,151
19592,Yuba,2021-03-13,9,1,10
19593,Tuolumne,2021-03-13,3,0,3
19594,Contra Costa,2021-03-13,48,16,64
19595,Sutter,2021-03-13,0,0,0
19596,San Francisco,2021-03-13,46,8,54
19597,Tuolumne,2021-03-14,1,0,1
19598,Siskiyou,2021-03-14,1,0,1
19599,Solano,2021-03-14,29,7,36
19600,Kings,2021-03-14,14,0,14
19601,Fresno,2021-03-14,131,22,153
19602,Placer,2021-03-14,37,6,43
19603,San Bernardino,2021-03-14,191,29,220
19604,Sonoma,2021-03-14,23,1,24
19605,San Francisco,2021-03-14,45,9,54
19606,Orange,2021-03-14,233,24,257
19607,Tulare,2021-03-14,35,3,38
19608,Yolo,2021-03-14,4,0,4
19609,El Dorado,2021-03-14,2,0,2
19610,Kern,2021-03-14,95,5,100
19611,Contra Costa,2021-03-14,51,15,66
19612,Lake,2021-03-14,2,0,2
19613,Merced,2021-03-14,21,0,21
19614,Napa,2021-03-14,3,0,3
19615,Monterey,2021-03-14,39,0,39
19616,Amador,2021-03-14,1,0,1
19617,Madera,2021-03-14,12,7,19
19618,Santa Barbara,2021-03-14,39,3,42
19619,Alameda,2021-03-14,114,32,146
19620,Los Angeles,2021-03-14,865,145,1010
19621,Colusa,2021-03-14,1,1,2
19622,Mariposa,2021-03-14,0,0,0
19623,Butte,2021-03-14,12,1,13
19624,Lassen,2021-03-14,0,0,0
19625,Tehama,2021-03-14,5,0,5
19626,Sutter,2021-03-14,0,0,0
19627,Del Norte,2021-03-14,0,0,0
19628,San Mateo,2021-03-14,34,8,42
19629,Humboldt,2021-03-14,4,6,10
19630,Shasta,2021-03-14,9,0,9
19631,Santa Clara,2021-03-14,138,16,154
19632,San Diego,2021-03-14,284,23,307
19633,Plumas,2021-03-14,0,0,0
19634,Marin,2021-03-14,16,5,21
19635,Yuba,2021-03-14,10,1,11
19636,Nevada,2021-03-14,5,0,5
19637,Riverside,2021-03-14,195,21,216
19638,Trinity,2021-03-14,0,0,0
19639,Stanislaus,2021-03-14,122,15,137
19640,Sacramento,2021-03-14,121,16,137
19641,Mono,2021-03-14,0,0,0
19642,Inyo,2021-03-14,3,0,3
19643,San Joaquin,2021-03-14,61,11,72
19644,Ventura,2021-03-14,76,6,82
19645,Imperial,2021-03-14,14,0,14
19646,Santa Cruz,2021-03-14,9,0,9
19647,San Luis Obispo,2021-03-14,8,0,8
19648,Mendocino,2021-03-14,2,0,2
19649,Glenn,2021-03-14,0,0,0
19650,Calaveras,2021-03-14,1,0,1
19651,San Benito,2021-03-14,1,0,1
19652,Modoc,2021-03-14,0,0,0
19653,Sutter,2021-03-15,0,0,0
19654,Nevada,2021-03-15,5,0,5
19655,Placer,2021-03-15,40,6,46
19656,Alameda,2021-03-15,108,27,135
19657,Mendocino,2021-03-15,2,0,2
19658,Fresno,2021-03-15,125,19,144
19659,San Benito,2021-03-15,0,0,0
19660,Shasta,2021-03-15,8,1,9
19661,Monterey,2021-03-15,36,0,36
19662,Mono,2021-03-15,0,0,0
19663,Tuolumne,2021-03-15,1,0,1
19664,Inyo,2021-03-15,2,0,2
19665,Trinity,2021-03-15,0,0,0
19666,Contra Costa,2021-03-15,44,17,61
19667,Sonoma,2021-03-15,26,1,27
19668,San Joaquin,2021-03-15,64,10,74
19669,Napa,2021-03-15,2,0,2
19670,Yuba,2021-03-15,9,0,9
19671,San Diego,2021-03-15,286,20,306
19672,Los Angeles,2021-03-15,857,137,994
19673,Kern,2021-03-15,98,10,108
19674,Colusa,2021-03-15,1,1,2
19675,Stanislaus,2021-03-15,125,13,138
19676,Yolo,2021-03-15,2,0,2
19677,Plumas,2021-03-15,0,0,0
19678,Solano,2021-03-15,29,7,36
19679,San Luis Obispo,2021-03-15,7,0,7
19680,Lassen,2021-03-15,0,0,0
19681,San Bernardino,2021-03-15,185,17,202
19682,El Dorado,2021-03-15,1,0,1
19683,Glenn,2021-03-15,0,0,0
19684,Tulare,2021-03-15,37,7,44
19685,Santa Cruz,2021-03-15,7,1,8
19686,San Mateo,2021-03-15,26,6,32
19687,Amador,2021-03-15,1,0,1
19688,Sacramento,2021-03-15,119,14,133
19689,Tehama,2021-03-15,5,0,5
19690,Del Norte,2021-03-15,0,0,0
19691,Kings,2021-03-15,15,0,15
19692,Merced,2021-03-15,19,0,19
19693,Calaveras,2021-03-15,1,0,1
19694,Santa Barbara,2021-03-15,40,1,41
19695,Modoc,2021-03-15,0,0,0
19696,Mariposa,2021-03-15,0,0,0
19697,Imperial,2021-03-15,14,0,14
19698,Lake,2021-03-15,2,0,2
19699,Ventura,2021-03-15,73,9,82
19700,Butte,2021-03-15,12,1,13
19701,Siskiyou,2021-03-15,2,0,2
19702,Madera,2021-03-15,9,4,13
19703,Humboldt,2021-03-15,5,2,7
19704,Marin,2021-03-15,15,3,18
19705,Orange,2021-03-15,216,24,240
19706,Santa Clara,2021-03-15,144,14,158
19707,Riverside,2021-03-15,188,23,211
19708,San Francisco,2021-03-15,45,3,48
