county,date,confirmed_patients,suspected_patients,all_hospital_beds,icu_covid_confirmed,icu_covid_suspected,icu_available_beds,total_covid_patients
Madera,2020-03-29,1,6,0,1,1,8,7
Calaveras,2020-03-29,0,0,0,0,0,0,0
Sonoma,2020-03-29,7,20,0,2,5,12,27
Tulare,2020-03-29,6,13,0,5,3,7,19
San Bernardino,2020-03-29,33,123,0,19,20,65,156
Yuba,2020-03-29,2,12,0,2,4,2,14
Tehama,2020-03-29,0,0,0,0,0,2,0
San Mateo,2020-03-29,46,27,0,16,10,28,73
Shasta,2020-03-29,0,0,0,0,0,0,0
Tuolumne,2020-03-29,1,5,0,0,0,0,6
El Dorado,2020-03-29,0,6,0,0,3,3,6
Sutter,2020-03-29,0,0,0,0,0,0,0
San Diego,2020-03-29,121,211,0,77,39,205,332
Los Angeles,2020-03-29,489,1132,0,191,182,345,1621
Modoc,2020-03-29,0,0,0,0,0,0,0
Santa Cruz,2020-03-29,0,0,0,0,0,0,0
Merced,2020-03-29,1,7,0,0,0,3,8
San Luis Obispo,2020-03-29,7,12,0,3,4,948,19
Lassen,2020-03-29,0,2,0,0,0,0,2
Stanislaus,2020-03-29,20,48,0,9,8,25,68
Riverside,2020-03-29,44,78,0,13,20,46,122
Santa Clara,2020-03-29,141,72,0,65,15,70,213
Mendocino,2020-03-29,1,11,0,0,0,1,12
Trinity,2020-03-29,0,0,0,0,0,0,0
Del Norte,2020-03-29,1,2,0,0,0,3,3
Placer,2020-03-29,18,14,0,4,1,10,32
Siskiyou,2020-03-29,0,0,0,0,0,2,0
Alameda,2020-03-29,36,91,0,20,16,119,127
Orange,2020-03-29,74,167,0,31,40,131,241
San Joaquin,2020-03-29,34,35,0,5,2,7,69
Kings,2020-03-29,2,5,0,1,0,2,7
Mono,2020-03-29,0,1,0,0,0,2,1
Amador,2020-03-29,1,0,0,0,0,2,1
Sacramento,2020-03-29,36,27,0,12,18,50,63
Humboldt,2020-03-29,1,10,0,0,0,18,11
Monterey,2020-03-29,2,16,0,1,2,10,18
Imperial,2020-03-29,5,100,0,1,2,2,105
Fresno,2020-03-29,8,116,0,3,14,22,124
Solano,2020-03-29,7,27,0,4,1,28,34
Butte,2020-03-29,0,0,0,0,0,0,0
Marin,2020-03-29,7,13,0,2,6,11,20
San Benito,2020-03-29,1,1,0,1,0,1,2
Santa Barbara,2020-03-29,15,21,0,9,3,47,36
Napa,2020-03-29,0,26,0,0,0,5,26
Kern,2020-03-29,16,57,0,8,8,39,73
Nevada,2020-03-29,23,0,0,1,0,3,0
Inyo,2020-03-29,0,0,0,0,0,0,0
Plumas,2020-03-29,0,1,0,0,1,0,1
Contra Costa,2020-03-29,23,62,0,8,15,62,85
Yolo,2020-03-29,2,3,0,1,1,0,5
Ventura,2020-03-29,24,85,0,5,19,14,109
Glenn,2020-03-29,0,0,0,0,0,0,0
San Francisco,2020-03-29,50,73,0,24,10,61,123
Colusa,2020-03-29,0,0,0,0,0,0,0
Lake,2020-03-29,0,1,0,0,1,2,1
Lassen,2020-03-30,0,4,0,0,0,0,4
Modoc,2020-03-30,0,31,0,0,0,0,31
San Diego,2020-03-30,146,446,0,72,23,228,592
Yolo,2020-03-30,2,2,0,1,2,0,4
San Bernardino,2020-03-30,67,179,0,27,33,66,246
Shasta,2020-03-30,1,4,0,0,0,13,5
Orange,2020-03-30,98,251,0,42,58,131,349
Butte,2020-03-30,4,12,0,2,1,5,16
San Luis Obispo,2020-03-30,5,11,0,3,4,957,16
Trinity,2020-03-30,0,0,0,0,0,0,0
Placer,2020-03-30,19,19,0,5,1,29,38
Imperial,2020-03-30,19,109,0,3,3,4,128
Marin,2020-03-30,10,9,0,4,2,16,19
Nevada,2020-03-30,26,17,0,2,5,3,43
Sutter,2020-03-30,0,0,0,0,0,0,0
Merced,2020-03-30,1,9,0,0,2,11,10
Siskiyou,2020-03-30,0,0,0,0,0,3,0
Mono,2020-03-30,0,1,0,0,0,2,1
Tulare,2020-03-30,5,21,0,4,6,7,26
Monterey,2020-03-30,11,16,0,4,0,17,27
Santa Clara,2020-03-30,153,93,0,74,23,103,246
Kern,2020-03-30,18,123,0,6,8,51,141
Colusa,2020-03-30,0,1,0,0,1,5,1
Santa Cruz,2020-03-30,0,2,0,0,0,4,2
Alameda,2020-03-30,59,89,0,27,18,146,148
Kings,2020-03-30,2,12,0,1,2,0,14
San Francisco,2020-03-30,58,92,0,18,7,90,150
Riverside,2020-03-30,60,133,0,22,33,77,193
Stanislaus,2020-03-30,17,51,0,9,5,29,68
Los Angeles,2020-03-30,601,1277,0,245,244,456,1878
Napa,2020-03-30,3,8,0,1,0,9,11
Lake,2020-03-30,0,1,0,0,1,3,1
Yuba,2020-03-30,3,17,0,2,4,10,20
Mendocino,2020-03-30,2,11,0,0,1,8,13
Ventura,2020-03-30,25,82,0,5,28,15,107
San Joaquin,2020-03-30,28,30,0,8,4,53,58
Santa Barbara,2020-03-30,19,25,0,11,7,48,44
Sonoma,2020-03-30,7,22,0,3,4,29,29
Plumas,2020-03-30,0,1,0,0,0,0,1
Calaveras,2020-03-30,0,3,0,0,1,5,3
Humboldt,2020-03-30,1,8,0,0,0,10,9
Amador,2020-03-30,0,1,0,0,0,4,1
Madera,2020-03-30,1,5,0,1,3,4,6
Tuolumne,2020-03-30,1,2,0,0,0,3,3
Solano,2020-03-30,15,16,0,6,0,47,31
El Dorado,2020-03-30,0,9,0,0,6,9,9
Fresno,2020-03-30,10,88,0,3,14,24,98
Contra Costa,2020-03-30,25,54,0,11,6,90,79
Del Norte,2020-03-30,0,2,0,0,0,5,2
Glenn,2020-03-30,0,0,0,0,0,0,0
San Benito,2020-03-30,1,1,0,1,0,1,2
Sacramento,2020-03-30,45,86,0,21,23,58,131
Inyo,2020-03-30,0,0,0,0,0,0,0
San Mateo,2020-03-30,56,40,0,18,11,47,96
Tehama,2020-03-30,0,2,0,0,0,2,2
Kings,2020-03-31,1,3,0,1,2,4,4
Solano,2020-03-31,15,15,0,6,5,42,30
Sacramento,2020-03-31,53,110,0,20,31,66,163
Sonoma,2020-03-31,8,18,0,3,3,21,26
Kern,2020-03-31,14,63,0,6,6,46,77
Santa Barbara,2020-03-31,19,29,0,14,7,48,48
San Diego,2020-03-31,158,408,0,75,39,208,566
Stanislaus,2020-03-31,20,31,0,9,1,34,51
Fresno,2020-03-31,30,274,0,4,19,23,304
Plumas,2020-03-31,0,0,0,0,0,0,0
Sutter,2020-03-31,0,0,0,0,0,0,0
Nevada,2020-03-31,36,40,0,2,1,6,76
Contra Costa,2020-03-31,27,54,0,11,10,68,81
Mendocino,2020-03-31,0,1,0,0,0,7,1
Placer,2020-03-31,18,27,0,6,0,28,45
El Dorado,2020-03-31,10,9,0,0,6,12,19
Siskiyou,2020-03-31,0,0,0,0,0,4,0
Calaveras,2020-03-31,0,1,0,0,0,4,1
Colusa,2020-03-31,0,1,0,0,1,5,1
Imperial,2020-03-31,12,100,0,3,4,4,112
San Joaquin,2020-03-31,44,54,0,14,5,28,98
Amador,2020-03-31,0,0,0,0,0,4,0
San Francisco,2020-03-31,67,69,0,30,14,77,136
Los Angeles,2020-03-31,713,1239,0,315,239,445,1952
San Mateo,2020-03-31,60,23,0,18,5,37,83
Tulare,2020-03-31,6,14,0,4,5,9,20
Merced,2020-03-31,3,11,0,0,2,10,14
Butte,2020-03-31,4,20,0,2,3,2,24
Marin,2020-03-31,9,14,0,4,2,15,23
Santa Clara,2020-03-31,155,98,0,73,17,92,253
Glenn,2020-03-31,0,0,0,0,0,0,0
San Luis Obispo,2020-03-31,7,15,0,3,6,955,22
Shasta,2020-03-31,1,5,0,1,0,4,6
Trinity,2020-03-31,0,0,0,0,0,0,0
Lassen,2020-03-31,0,7,0,0,0,0,7
Napa,2020-03-31,1,5,0,1,1,12,6
Alameda,2020-03-31,56,94,0,27,17,77,150
San Bernardino,2020-03-31,82,231,0,33,48,63,313
Tuolumne,2020-03-31,0,37,0,0,0,4,37
Ventura,2020-03-31,21,90,0,5,24,12,111
Riverside,2020-03-31,80,155,0,28,59,75,235
Del Norte,2020-03-31,0,4,0,0,0,3,4
San Benito,2020-03-31,1,0,0,1,0,1,1
Inyo,2020-03-31,0,83,0,0,0,6,0
Mono,2020-03-31,0,1,0,0,0,2,1
Santa Cruz,2020-03-31,1,10,0,1,2,7,11
Humboldt,2020-03-31,1,11,0,0,4,8,12
Yolo,2020-03-31,3,2,0,2,2,1,5
Orange,2020-03-31,105,233,0,45,44,131,338
Monterey,2020-03-31,11,15,0,4,2,17,26
Tehama,2020-03-31,0,2,0,0,0,4,2
Madera,2020-03-31,1,3,0,1,0,5,4
Modoc,2020-03-31,0,19,0,0,0,0,19
Yuba,2020-03-31,2,21,0,2,4,6,23
Lake,2020-03-31,0,4,0,0,2,3,4
Tehama,2020-04-01,0,1,0,0,1,4,1
Placer,2020-04-01,25,28,0,6,2,7,53
Imperial,2020-04-01,4,15,0,3,4,7,19
Madera,2020-04-01,1,3,0,1,0,4,4
Lassen,2020-04-01,0,7,0,0,0,0,7
Napa,2020-04-01,2,2,0,0,1,9,4
Siskiyou,2020-04-01,0,5,0,0,2,3,5
San Benito,2020-04-01,2,0,0,2,0,0,2
Colusa,2020-04-01,0,1,0,0,1,5,1
San Bernardino,2020-04-01,95,196,0,39,52,34,291
Stanislaus,2020-04-01,25,39,0,10,6,31,64
Amador,2020-04-01,0,3,0,0,0,2,3
Kings,2020-04-01,2,6,0,1,2,1,8
Inyo,2020-04-01,7,89,0,0,0,6,96
Glenn,2020-04-01,0,0,0,0,0,0,0
Calaveras,2020-04-01,0,1,0,0,0,5,1
Mariposa,2020-04-01,0,0,0,0,0,0,0
Lake,2020-04-01,0,2,0,0,0,2,2
Shasta,2020-04-01,1,4,0,0,1,13,5
Del Norte,2020-04-01,0,5,0,0,0,3,5
Humboldt,2020-04-01,1,9,0,0,3,7,10
Tulare,2020-04-01,4,12,0,3,4,9,16
Los Angeles,2020-04-01,739,1332,0,335,220,492,2071
Plumas,2020-04-01,0,0,0,0,0,0,0
San Diego,2020-04-01,168,340,0,71,32,215,508
Orange,2020-04-01,117,221,0,50,48,118,338
Contra Costa,2020-04-01,31,42,0,12,12,61,73
Modoc,2020-04-01,0,1,0,0,0,0,1
Riverside,2020-04-01,85,182,0,29,47,76,267
El Dorado,2020-04-01,14,8,0,1,3,9,22
San Mateo,2020-04-01,57,35,0,19,9,36,92
Kern,2020-04-01,15,45,0,7,9,32,60
San Francisco,2020-04-01,67,66,0,30,8,64,133
Mono,2020-04-01,0,0,0,0,0,2,0
Trinity,2020-04-01,0,0,0,0,0,0,0
Marin,2020-04-01,9,19,0,4,2,14,28
Merced,2020-04-01,3,15,0,0,3,9,18
Butte,2020-04-01,5,33,0,2,4,9,38
San Luis Obispo,2020-04-01,8,10,0,5,6,968,18
Yolo,2020-04-01,3,3,0,1,1,2,6
Santa Barbara,2020-04-01,23,23,0,15,6,51,46
Ventura,2020-04-01,22,96,0,5,23,27,118
Sonoma,2020-04-01,5,18,0,1,2,22,23
Sutter,2020-04-01,0,0,0,0,0,0,0
Alameda,2020-04-01,52,76,0,27,15,106,128
Santa Cruz,2020-04-01,2,12,0,2,2,3,14
Monterey,2020-04-01,13,16,0,4,4,15,29
Yuba,2020-04-01,2,24,0,2,4,6,26
Santa Clara,2020-04-01,160,85,0,77,15,91,245
Nevada,2020-04-01,36,54,0,0,4,3,90
Solano,2020-04-01,14,18,0,5,2,31,32
Sacramento,2020-04-01,53,138,0,20,33,74,191
Tuolumne,2020-04-01,0,0,0,0,0,2,0
San Joaquin,2020-04-01,25,35,0,16,11,21,60
Mendocino,2020-04-01,0,2,0,0,0,8,2
Fresno,2020-04-01,19,101,0,5,13,53,120
Placer,2020-04-02,32,15,0,9,0,11,47
Solano,2020-04-02,15,8,0,7,1,27,23
Fresno,2020-04-02,17,74,0,6,13,33,91
Marin,2020-04-02,7,16,0,3,1,16,23
Riverside,2020-04-02,136,181,0,45,49,104,317
Santa Barbara,2020-04-02,26,44,0,18,10,47,70
Mariposa,2020-04-02,0,1,0,0,0,0,1
Tehama,2020-04-02,0,1,0,0,1,4,1
Trinity,2020-04-02,0,0,0,0,0,0,0
Lassen,2020-04-02,0,7,0,0,0,0,7
Napa,2020-04-02,1,4,0,1,1,12,5
Los Angeles,2020-04-02,818,1270,0,346,193,488,2088
Humboldt,2020-04-02,1,8,0,0,2,8,9
Santa Clara,2020-04-02,163,101,0,69,19,95,264
San Mateo,2020-04-02,62,40,0,26,4,26,102
Siskiyou,2020-04-02,0,3,0,0,2,4,3
Glenn,2020-04-02,0,0,0,0,0,0,0
Sacramento,2020-04-02,71,92,0,24,19,80,163
Mono,2020-04-02,18,2,0,0,0,2,20
Del Norte,2020-04-02,0,3,0,0,0,2,3
Madera,2020-04-02,1,7,0,1,3,6,8
Tuolumne,2020-04-02,0,0,0,0,0,2,0
San Francisco,2020-04-02,75,60,0,32,11,58,135
El Dorado,2020-04-02,15,12,0,0,6,10,27
Calaveras,2020-04-02,0,1,0,0,0,5,1
Tulare,2020-04-02,4,26,0,4,5,3,30
Plumas,2020-04-02,0,0,0,0,0,0,0
Alameda,2020-04-02,57,76,0,29,17,112,133
San Luis Obispo,2020-04-02,5,5,0,4,4,966,10
Lake,2020-04-02,0,1,0,0,0,2,1
Contra Costa,2020-04-02,32,38,0,13,10,73,70
Modoc,2020-04-02,0,1,0,0,0,0,1
Yolo,2020-04-02,3,2,0,2,3,0,5
Monterey,2020-04-02,14,14,0,4,2,12,28
Ventura,2020-04-02,27,111,0,7,24,15,138
Butte,2020-04-02,4,26,0,2,2,12,30
Imperial,2020-04-02,4,16,0,3,5,6,20
Sonoma,2020-04-02,8,18,0,1,0,10,26
Santa Cruz,2020-04-02,4,4,0,3,0,7,8
Inyo,2020-04-02,8,102,0,0,1,3,110
Amador,2020-04-02,0,3,0,0,0,2,3
Yuba,2020-04-02,2,25,0,2,6,4,27
San Diego,2020-04-02,144,343,0,69,35,206,487
Orange,2020-04-02,129,225,0,67,47,96,354
San Benito,2020-04-02,2,0,0,2,0,0,2
Shasta,2020-04-02,2,4,0,1,0,10,6
San Bernardino,2020-04-02,126,185,0,50,45,37,311
Merced,2020-04-02,4,5,0,0,1,3,9
Kings,2020-04-02,2,6,0,1,1,7,8
Sutter,2020-04-02,0,0,0,0,0,0,0
Kern,2020-04-02,27,77,0,12,23,36,104
Stanislaus,2020-04-02,30,43,0,11,7,22,73
Colusa,2020-04-02,0,1,0,0,1,5,1
Nevada,2020-04-02,38,58,0,2,1,6,96
Mendocino,2020-04-02,0,1,0,0,0,8,1
San Joaquin,2020-04-02,42,42,0,20,7,17,84
Tulare,2020-04-03,6,15,0,5,2,3,21
Plumas,2020-04-03,0,0,0,0,0,0,0
Kings,2020-04-03,0,3,0,1,0,3,3
Tuolumne,2020-04-03,0,0,0,0,0,1,0
Mendocino,2020-04-03,0,5,0,0,1,6,5
Santa Clara,2020-04-03,164,83,0,71,17,97,247
Contra Costa,2020-04-03,31,39,0,15,10,75,70
Madera,2020-04-03,0,5,0,0,1,7,5
Humboldt,2020-04-03,1,7,0,0,0,10,8
San Mateo,2020-04-03,65,39,0,26,4,38,104
Stanislaus,2020-04-03,28,45,0,12,8,22,73
Orange,2020-04-03,131,182,0,66,36,151,313
Ventura,2020-04-03,22,116,0,6,28,56,138
Fresno,2020-04-03,15,81,0,7,16,35,96
Mariposa,2020-04-03,0,2,0,0,0,0,2
Napa,2020-04-03,1,9,0,0,1,9,10
San Bernardino,2020-04-03,118,204,0,44,53,57,322
Yuba,2020-04-03,2,12,0,2,2,5,14
Tehama,2020-04-03,0,0,0,0,0,8,0
Los Angeles,2020-04-03,962,1239,0,422,209,473,2201
Butte,2020-04-03,3,19,0,2,6,9,22
Inyo,2020-04-03,8,102,0,1,2,1,110
Kern,2020-04-03,35,73,0,12,16,47,108
Glenn,2020-04-03,0,0,0,0,0,0,0
Solano,2020-04-03,16,21,0,7,5,23,37
Sacramento,2020-04-03,77,76,0,28,17,76,153
Santa Cruz,2020-04-03,4,8,0,3,0,2,12
Alameda,2020-04-03,64,74,0,32,13,117,138
Placer,2020-04-03,21,23,0,10,1,7,44
Lassen,2020-04-03,0,3,0,0,0,0,3
Imperial,2020-04-03,9,7,0,7,0,5,16
Del Norte,2020-04-03,0,2,0,0,0,2,2
Merced,2020-04-03,4,5,0,1,1,4,9
Trinity,2020-04-03,0,0,0,0,0,0,0
Riverside,2020-04-03,105,182,0,44,59,127,287
Colusa,2020-04-03,1,0,0,1,0,5,1
San Joaquin,2020-04-03,41,38,0,18,8,22,79
San Francisco,2020-04-03,80,71,0,39,8,74,151
Sonoma,2020-04-03,6,24,0,2,3,15,30
El Dorado,2020-04-03,15,9,0,0,4,14,24
Monterey,2020-04-03,16,18,0,3,1,17,34
Modoc,2020-04-03,0,0,0,0,0,0,0
Amador,2020-04-03,0,0,0,0,0,1,0
Santa Barbara,2020-04-03,27,29,0,18,4,50,56
Shasta,2020-04-03,2,9,0,1,3,14,11
Calaveras,2020-04-03,0,1,0,0,0,5,1
San Luis Obispo,2020-04-03,4,5,0,3,2,967,9
Yolo,2020-04-03,2,7,0,3,6,4,9
Lake,2020-04-03,0,2,0,0,1,2,2
Sutter,2020-04-03,0,0,0,0,0,0,0
San Diego,2020-04-03,171,308,0,84,28,216,479
Siskiyou,2020-04-03,0,3,0,0,1,4,3
Nevada,2020-04-03,2,4,0,2,1,5,6
Mono,2020-04-03,18,2,0,0,0,2,20
Marin,2020-04-03,6,16,0,3,5,17,22
San Benito,2020-04-03,2,0,0,2,0,0,2
Mariposa,2020-04-04,0,2,0,0,0,0,2
San Luis Obispo,2020-04-04,4,6,0,3,3,954,10
Napa,2020-04-04,1,8,0,0,1,6,9
Yuba,2020-04-04,2,16,0,2,2,7,18
Yolo,2020-04-04,4,5,0,3,3,4,9
Tehama,2020-04-04,0,1,0,0,0,8,1
Riverside,2020-04-04,126,186,0,39,56,125,312
Madera,2020-04-04,0,4,0,0,0,8,4
Calaveras,2020-04-04,0,1,0,0,0,5,1
Sutter,2020-04-04,0,0,0,0,0,0,0
Alameda,2020-04-04,60,95,0,35,18,120,155
San Benito,2020-04-04,2,3,0,2,0,0,5
Nevada,2020-04-04,2,6,0,2,2,5,8
Siskiyou,2020-04-04,0,2,0,0,1,5,2
Monterey,2020-04-04,16,25,0,4,2,18,41
Santa Clara,2020-04-04,159,79,0,72,19,91,238
Marin,2020-04-04,5,16,0,3,5,12,21
Amador,2020-04-04,0,0,0,0,0,2,0
Contra Costa,2020-04-04,30,47,0,12,7,87,77
Ventura,2020-04-04,21,127,0,7,25,10,148
Sonoma,2020-04-04,7,16,0,2,6,15,23
Mono,2020-04-04,20,2,0,0,0,2,22
Solano,2020-04-04,16,19,0,7,2,23,35
Mendocino,2020-04-04,0,3,0,0,1,7,3
Tuolumne,2020-04-04,0,1,0,0,1,2,1
Modoc,2020-04-04,0,0,0,0,0,0,0
San Joaquin,2020-04-04,43,30,0,16,7,24,73
Santa Cruz,2020-04-04,4,6,0,3,0,7,10
Lassen,2020-04-04,0,0,0,0,0,0,0
Butte,2020-04-04,3,14,0,1,4,7,17
Del Norte,2020-04-04,0,2,0,0,0,1,2
Sacramento,2020-04-04,69,76,0,25,18,82,145
San Mateo,2020-04-04,66,19,0,25,6,40,85
Santa Barbara,2020-04-04,28,34,0,18,2,53,62
Plumas,2020-04-04,0,0,0,0,0,0,0
Kings,2020-04-04,1,9,0,1,0,0,10
Trinity,2020-04-04,0,0,0,0,0,0,0
Stanislaus,2020-04-04,30,45,0,12,9,26,75
Colusa,2020-04-04,1,0,0,1,0,5,1
Imperial,2020-04-04,9,10,0,5,2,5,19
Inyo,2020-04-04,8,106,0,1,1,2,114
Merced,2020-04-04,5,14,0,1,1,6,19
San Diego,2020-04-04,177,218,0,86,19,222,395
El Dorado,2020-04-04,15,9,0,0,3,12,24
Tulare,2020-04-04,8,20,0,5,1,6,28
San Bernardino,2020-04-04,138,254,0,51,66,67,392
Orange,2020-04-04,143,213,0,70,45,153,356
Glenn,2020-04-04,0,0,0,0,0,0,0
Lake,2020-04-04,0,4,0,0,1,4,4
Placer,2020-04-04,23,14,0,10,1,12,37
Humboldt,2020-04-04,1,4,0,0,0,7,5
Fresno,2020-04-04,14,93,0,7,20,36,107
Shasta,2020-04-04,2,10,0,4,0,13,12
Kern,2020-04-04,33,54,0,14,11,29,87
San Francisco,2020-04-04,80,65,0,37,7,79,145
Los Angeles,2020-04-04,1007,1190,0,449,181,537,2197
Mono,2020-04-05,20,2,0,0,0,2,22
Tuolumne,2020-04-05,0,0,0,0,0,4,0
Sonoma,2020-04-05,6,21,0,2,6,16,27
San Mateo,2020-04-05,69,15,0,24,6,36,84
Solano,2020-04-05,15,17,0,6,24,3,32
Lassen,2020-04-05,0,0,0,0,0,0,0
Tulare,2020-04-05,4,20,0,8,2,3,24
Mendocino,2020-04-05,0,3,0,0,2,4,3
Riverside,2020-04-05,129,207,0,47,60,130,336
Alameda,2020-04-05,72,87,0,39,13,113,159
San Francisco,2020-04-05,79,68,0,37,11,74,147
Calaveras,2020-04-05,0,0,0,0,0,6,0
Kings,2020-04-05,3,1,0,2,0,0,4
Mariposa,2020-04-05,0,2,0,0,0,0,2
Nevada,2020-04-05,2,4,0,2,1,3,6
San Luis Obispo,2020-04-05,2,11,0,2,9,28,13
Inyo,2020-04-05,9,106,0,1,0,3,115
Yolo,2020-04-05,3,6,0,3,3,4,9
San Diego,2020-04-05,179,220,0,89,31,247,399
Contra Costa,2020-04-05,29,35,0,15,10,74,64
Glenn,2020-04-05,0,0,0,0,0,0,0
Orange,2020-04-05,144,221,0,70,46,156,365
Los Angeles,2020-04-05,1094,1082,0,473,166,554,2176
Marin,2020-04-05,5,15,0,3,5,13,20
Madera,2020-04-05,0,1,0,0,0,8,1
Butte,2020-04-05,2,16,0,1,6,10,18
Santa Cruz,2020-04-05,5,12,0,4,4,10,17
El Dorado,2020-04-05,16,6,0,0,3,7,22
Sutter,2020-04-05,0,0,0,0,0,0,0
Napa,2020-04-05,1,8,0,0,1,11,9
Imperial,2020-04-05,9,9,0,8,1,3,18
Plumas,2020-04-05,0,0,0,0,0,0,0
Siskiyou,2020-04-05,0,2,0,0,2,3,2
Modoc,2020-04-05,0,0,0,0,0,0,0
Monterey,2020-04-05,16,15,0,4,0,23,31
Del Norte,2020-04-05,0,1,0,0,0,1,1
San Bernardino,2020-04-05,146,240,0,59,54,70,386
Fresno,2020-04-05,16,81,0,8,15,39,97
Shasta,2020-04-05,8,11,0,4,0,13,19
Trinity,2020-04-05,0,0,0,0,0,0,0
Merced,2020-04-05,15,10,0,1,3,8,25
Lake,2020-04-05,0,4,0,0,2,3,4
San Joaquin,2020-04-05,46,24,0,17,4,19,70
Stanislaus,2020-04-05,30,25,0,14,5,30,55
Placer,2020-04-05,23,13,0,10,1,10,36
Amador,2020-04-05,0,0,0,0,0,2,0
Ventura,2020-04-05,21,128,0,7,28,12,149
Kern,2020-04-05,23,27,0,12,4,40,50
Tehama,2020-04-05,0,1,0,0,0,5,1
Sacramento,2020-04-05,64,78,0,23,26,82,142
Santa Clara,2020-04-05,166,69,0,68,18,90,235
Humboldt,2020-04-05,2,3,0,0,0,8,5
San Benito,2020-04-05,3,0,0,2,0,0,3
Santa Barbara,2020-04-05,31,26,0,18,2,59,57
Colusa,2020-04-05,1,0,0,1,0,5,1
Yuba,2020-04-05,1,14,0,1,1,10,15
Inyo,2020-04-06,9,114,0,1,0,3,123
San Joaquin,2020-04-06,31,32,0,14,3,20,63
Alameda,2020-04-06,79,70,0,43,19,92,149
Yuba,2020-04-06,1,19,0,1,3,7,20
Yolo,2020-04-06,4,0,0,3,4,-3,4
Colusa,2020-04-06,0,0,0,0,0,6,0
Modoc,2020-04-06,0,0,0,0,0,0,0
San Mateo,2020-04-06,68,20,0,25,5,36,88
Fresno,2020-04-06,18,81,0,11,20,45,99
Plumas,2020-04-06,0,0,0,0,0,0,0
San Benito,2020-04-06,3,3,0,2,0,0,6
Santa Barbara,2020-04-06,34,26,0,19,5,54,60
Solano,2020-04-06,15,21,0,6,6,28,36
Riverside,2020-04-06,129,193,0,46,65,152,322
San Luis Obispo,2020-04-06,2,3,0,2,2,42,5
Tulare,2020-04-06,12,24,0,8,3,16,36
Del Norte,2020-04-06,0,3,0,0,0,0,3
Tuolumne,2020-04-06,0,0,0,0,0,0,0
Merced,2020-04-06,4,2,0,0,2,4,6
Stanislaus,2020-04-06,28,28,0,12,4,37,56
Los Angeles,2020-04-06,1166,1070,0,486,175,587,2236
Ventura,2020-04-06,22,106,0,9,20,32,128
Calaveras,2020-04-06,0,0,0,0,0,6,0
Kings,2020-04-06,3,3,0,2,0,3,6
Sutter,2020-04-06,0,0,0,0,0,0,0
Santa Cruz,2020-04-06,5,9,0,4,2,5,14
Shasta,2020-04-06,6,3,0,2,2,28,9
Sonoma,2020-04-06,6,18,0,2,4,20,24
Imperial,2020-04-06,9,14,0,7,2,3,23
Monterey,2020-04-06,16,15,0,5,1,18,31
Amador,2020-04-06,0,0,0,0,0,2,0
Lake,2020-04-06,0,8,0,0,2,1,8
Napa,2020-04-06,0,7,0,0,0,15,7
Sacramento,2020-04-06,77,78,0,26,19,75,155
Butte,2020-04-06,1,15,0,1,5,9,16
San Francisco,2020-04-06,80,71,0,34,9,71,151
Siskiyou,2020-04-06,0,0,0,0,0,5,0
Mendocino,2020-04-06,0,2,0,0,2,10,2
Lassen,2020-04-06,0,0,0,0,0,0,0
Mono,2020-04-06,20,2,0,0,0,2,22
Contra Costa,2020-04-06,30,28,0,15,11,78,58
San Bernardino,2020-04-06,148,185,0,60,43,102,333
Humboldt,2020-04-06,3,12,0,0,3,2,15
Santa Clara,2020-04-06,181,49,0,79,10,100,230
Placer,2020-04-06,20,12,0,10,1,24,32
Madera,2020-04-06,0,2,0,0,1,8,2
Trinity,2020-04-06,0,0,0,0,0,0,0
Tehama,2020-04-06,0,0,0,0,0,4,0
El Dorado,2020-04-06,16,1,0,0,0,10,17
Kern,2020-04-06,24,36,0,12,5,39,60
San Diego,2020-04-06,187,224,0,83,25,270,411
Mariposa,2020-04-06,0,3,0,0,0,0,3
Marin,2020-04-06,8,8,0,4,4,13,16
Glenn,2020-04-06,0,0,0,0,0,0,0
Orange,2020-04-06,145,171,0,73,33,134,316
Nevada,2020-04-06,1,5,0,1,2,4,6
San Luis Obispo,2020-04-07,2,5,0,2,4,30,7
Sacramento,2020-04-07,74,91,0,28,18,72,165
Santa Clara,2020-04-07,187,47,0,77,7,105,234
Mono,2020-04-07,20,2,0,0,0,2,22
Imperial,2020-04-07,9,14,0,7,2,3,23
Ventura,2020-04-07,22,68,0,9,20,31,90
Calaveras,2020-04-07,0,1,0,0,0,8,1
Madera,2020-04-07,0,3,0,0,1,7,3
Inyo,2020-04-07,9,121,0,1,0,3,130
Trinity,2020-04-07,0,0,0,0,0,0,0
Colusa,2020-04-07,0,0,0,0,0,6,0
Plumas,2020-04-07,0,1,0,0,0,0,1
Sutter,2020-04-07,0,0,0,0,0,0,0
Merced,2020-04-07,3,3,0,0,3,3,6
Napa,2020-04-07,0,5,0,0,3,7,5
Kern,2020-04-07,28,91,0,14,13,50,119
Tulare,2020-04-07,8,23,0,5,6,10,31
Riverside,2020-04-07,129,207,0,57,57,129,336
Glenn,2020-04-07,0,0,0,0,0,0,0
San Mateo,2020-04-07,63,13,0,26,2,35,76
Sonoma,2020-04-07,6,28,0,2,6,21,34
Marin,2020-04-07,6,5,0,4,4,12,11
Nevada,2020-04-07,1,4,0,1,2,3,5
Santa Barbara,2020-04-07,41,8,0,23,1,48,49
El Dorado,2020-04-07,16,2,0,0,3,10,18
San Diego,2020-04-07,203,124,0,87,29,189,327
Orange,2020-04-07,143,144,0,71,29,136,287
Mariposa,2020-04-07,0,3,0,0,0,0,3
Tuolumne,2020-04-07,0,0,0,0,0,0,0
Tehama,2020-04-07,0,1,0,0,0,2,1
Placer,2020-04-07,19,18,0,9,3,20,37
Alameda,2020-04-07,76,84,0,43,25,90,160
Shasta,2020-04-07,5,8,0,2,3,6,13
Monterey,2020-04-07,18,25,0,5,4,21,43
Lassen,2020-04-07,0,1,0,0,0,0,1
Mendocino,2020-04-07,0,2,0,0,0,9,2
Lake,2020-04-07,0,0,0,0,0,1,0
Fresno,2020-04-07,20,82,0,11,13,50,102
San Bernardino,2020-04-07,146,178,0,54,49,126,324
Del Norte,2020-04-07,0,3,0,0,1,2,3
Yolo,2020-04-07,2,3,0,2,1,4,5
San Benito,2020-04-07,3,3,0,2,0,0,6
Siskiyou,2020-04-07,0,1,0,0,1,5,1
Santa Cruz,2020-04-07,4,4,0,4,3,4,8
Butte,2020-04-07,1,14,0,1,5,6,15
Humboldt,2020-04-07,2,7,0,0,0,7,9
San Francisco,2020-04-07,88,116,0,36,9,57,204
Kings,2020-04-07,3,4,0,2,0,3,7
Contra Costa,2020-04-07,31,38,0,17,9,82,69
Modoc,2020-04-07,0,1,0,0,0,0,1
San Joaquin,2020-04-07,31,33,0,14,4,20,64
Solano,2020-04-07,14,24,0,7,6,31,38
Amador,2020-04-07,0,0,0,0,0,3,0
Los Angeles,2020-04-07,1251,1350,0,517,162,603,2601
Yuba,2020-04-07,2,25,0,1,5,6,27
Stanislaus,2020-04-07,28,40,0,13,9,32,68
San Benito,2020-04-08,2,0,0,1,0,1,2
San Diego,2020-04-08,225,103,0,92,24,183,328
Santa Cruz,2020-04-08,4,9,0,3,4,8,13
Calaveras,2020-04-08,0,2,0,0,0,8,2
Merced,2020-04-08,1,1,0,0,2,5,2
Los Angeles,2020-04-08,1331,1077,0,532,211,582,2408
Santa Clara,2020-04-08,156,34,0,70,6,104,190
Imperial,2020-04-08,16,7,0,8,3,3,23
Yolo,2020-04-08,2,7,0,1,2,6,9
Sutter,2020-04-08,0,0,0,0,0,0,0
Sonoma,2020-04-08,6,22,0,2,5,18,28
Marin,2020-04-08,5,3,0,4,2,17,8
San Joaquin,2020-04-08,32,19,0,11,8,18,51
Colusa,2020-04-08,0,0,0,0,0,6,0
Mariposa,2020-04-08,0,0,0,0,0,0,0
Sacramento,2020-04-08,76,81,0,28,12,73,157
Modoc,2020-04-08,0,0,0,0,0,0,0
Nevada,2020-04-08,2,7,0,2,2,6,9
Madera,2020-04-08,0,6,0,0,1,7,6
Monterey,2020-04-08,18,24,0,5,0,24,42
Stanislaus,2020-04-08,30,35,0,11,5,58,65
Contra Costa,2020-04-08,35,50,0,18,13,78,85
Tehama,2020-04-08,0,2,0,0,0,4,2
Santa Barbara,2020-04-08,42,18,0,19,1,51,60
San Mateo,2020-04-08,66,20,0,25,2,32,86
San Luis Obispo,2020-04-08,2,13,0,2,11,22,15
Tuolumne,2020-04-08,0,0,0,0,0,1,0
Kings,2020-04-08,2,8,0,1,1,1,10
Fresno,2020-04-08,22,63,0,10,8,64,85
Ventura,2020-04-08,18,73,0,9,14,31,91
Alameda,2020-04-08,84,69,0,45,18,111,153
Placer,2020-04-08,18,15,0,10,2,19,33
Shasta,2020-04-08,4,5,0,2,2,10,9
Inyo,2020-04-08,9,128,0,1,1,2,137
Trinity,2020-04-08,0,0,0,0,0,0,0
Yuba,2020-04-08,2,24,0,1,3,5,26
Amador,2020-04-08,0,0,0,0,0,1,0
Napa,2020-04-08,0,7,0,0,1,5,7
Orange,2020-04-08,153,181,0,49,34,201,334
Lassen,2020-04-08,0,1,0,0,0,0,1
San Bernardino,2020-04-08,132,301,0,51,53,144,433
Butte,2020-04-08,1,15,0,1,7,4,16
El Dorado,2020-04-08,16,3,0,0,1,10,19
Riverside,2020-04-08,149,145,0,56,41,154,294
Lake,2020-04-08,0,0,0,0,1,1,0
Humboldt,2020-04-08,2,3,0,0,0,6,5
Kern,2020-04-08,31,57,0,16,3,32,88
Mono,2020-04-08,19,8,0,0,0,2,27
Del Norte,2020-04-08,0,2,0,0,1,4,2
Plumas,2020-04-08,0,1,0,0,0,0,1
Mendocino,2020-04-08,0,0,0,0,0,7,0
Solano,2020-04-08,15,19,0,8,2,27,34
Tulare,2020-04-08,7,16,0,2,5,22,23
San Francisco,2020-04-08,90,116,0,36,17,55,206
Siskiyou,2020-04-08,0,3,0,0,1,5,3
Glenn,2020-04-08,0,0,0,0,0,0,0
Monterey,2020-04-09,17,26,0,5,0,22,43
Nevada,2020-04-09,2,4,0,2,1,4,6
Humboldt,2020-04-09,2,6,0,0,2,6,8
Solano,2020-04-09,14,9,0,8,0,33,23
Los Angeles,2020-04-09,1368,758,0,541,156,569,2126
Trinity,2020-04-09,0,0,0,0,0,0,0
Mariposa,2020-04-09,0,0,0,0,0,0,0
Colusa,2020-04-09,0,0,0,0,1,5,0
Kern,2020-04-09,27,35,0,16,9,25,62
Yolo,2020-04-09,2,4,0,1,2,11,6
Contra Costa,2020-04-09,37,64,0,18,12,73,101
Tuolumne,2020-04-09,0,0,0,0,0,5,0
Sonoma,2020-04-09,5,21,0,2,4,24,26
Sutter,2020-04-09,0,0,0,0,0,0,0
San Luis Obispo,2020-04-09,2,10,0,2,8,21,12
Napa,2020-04-09,0,7,0,0,0,10,7
Plumas,2020-04-09,0,1,0,0,0,0,1
Butte,2020-04-09,1,14,0,1,4,5,15
Mono,2020-04-09,18,15,0,0,0,2,33
Shasta,2020-04-09,5,7,0,2,1,5,12
Mendocino,2020-04-09,0,0,0,0,0,8,0
Fresno,2020-04-09,25,41,0,10,9,59,66
San Mateo,2020-04-09,58,14,0,18,2,39,72
Orange,2020-04-09,146,117,0,45,29,206,263
San Diego,2020-04-09,227,124,0,98,18,163,351
Santa Cruz,2020-04-09,4,14,0,2,5,7,18
Riverside,2020-04-09,201,159,0,59,34,133,360
San Joaquin,2020-04-09,29,18,0,12,7,16,47
Madera,2020-04-09,0,3,0,0,2,5,3
San Benito,2020-04-09,2,1,0,1,0,1,3
Modoc,2020-04-09,0,0,0,0,0,0,0
Glenn,2020-04-09,0,0,0,0,0,0,0
Stanislaus,2020-04-09,28,30,0,11,7,45,58
Imperial,2020-04-09,14,10,0,7,3,1,24
Merced,2020-04-09,1,7,0,0,2,5,8
Ventura,2020-04-09,18,69,0,8,13,29,87
Santa Clara,2020-04-09,158,65,0,70,17,87,223
San Bernardino,2020-04-09,136,269,0,56,41,143,405
Yuba,2020-04-09,3,18,0,2,4,6,21
Del Norte,2020-04-09,0,2,0,0,0,5,2
Marin,2020-04-09,5,7,0,2,1,21,12
Lake,2020-04-09,0,0,0,0,1,2,0
Tulare,2020-04-09,10,11,0,5,4,19,21
Kings,2020-04-09,6,6,0,3,0,2,12
Sacramento,2020-04-09,74,60,0,31,11,63,134
Lassen,2020-04-09,0,2,0,0,0,0,2
El Dorado,2020-04-09,17,3,0,0,1,10,20
Placer,2020-04-09,18,12,0,9,1,16,30
Amador,2020-04-09,0,0,0,0,0,3,0
Tehama,2020-04-09,0,1,0,0,1,5,1
Santa Barbara,2020-04-09,40,18,0,20,2,45,58
San Francisco,2020-04-09,88,64,0,33,13,45,152
Inyo,2020-04-09,9,135,0,1,0,3,144
Alameda,2020-04-09,80,76,0,44,18,107,156
Calaveras,2020-04-09,0,0,0,0,0,11,0
Siskiyou,2020-04-09,0,2,0,0,0,5,2
Solano,2020-04-10,18,9,0,9,3,31,27
Sutter,2020-04-10,0,0,0,0,0,0,0
Modoc,2020-04-10,0,0,0,0,0,0,0
Plumas,2020-04-10,0,0,0,0,0,0,0
Colusa,2020-04-10,0,0,0,0,0,6,0
Imperial,2020-04-10,14,12,0,8,3,1,26
San Joaquin,2020-04-10,26,17,0,14,5,20,43
Los Angeles,2020-04-10,1299,754,0,514,142,663,2053
Del Norte,2020-04-10,0,3,0,0,0,4,3
Sonoma,2020-04-10,4,18,0,1,6,32,22
San Luis Obispo,2020-04-10,2,3,0,2,3,24,5
Mendocino,2020-04-10,0,1,0,0,1,5,1
Lake,2020-04-10,0,1,0,0,0,2,1
Orange,2020-04-10,139,129,0,69,25,187,268
Humboldt,2020-04-10,2,10,0,0,3,0,12
Santa Cruz,2020-04-10,4,11,0,3,5,4,15
Santa Clara,2020-04-10,151,44,0,67,5,99,195
Yolo,2020-04-10,3,2,0,1,1,7,5
Fresno,2020-04-10,27,41,0,11,9,57,68
Contra Costa,2020-04-10,42,30,0,17,6,75,72
Monterey,2020-04-10,18,21,0,5,1,25,39
Trinity,2020-04-10,0,0,0,0,0,0,0
Calaveras,2020-04-10,0,0,0,0,0,11,0
El Dorado,2020-04-10,17,1,0,0,1,10,18
Marin,2020-04-10,6,26,0,1,1,17,32
Nevada,2020-04-10,3,3,0,2,1,6,6
San Mateo,2020-04-10,56,12,0,18,3,41,68
Kern,2020-04-10,33,38,0,15,5,45,71
Yuba,2020-04-10,2,8,0,1,0,7,10
Napa,2020-04-10,0,7,0,0,4,7,7
Tulare,2020-04-10,11,10,0,6,1,16,21
Alameda,2020-04-10,93,71,0,45,26,128,164
Mono,2020-04-10,0,3,0,0,0,2,3
Riverside,2020-04-10,206,141,0,57,34,140,347
Siskiyou,2020-04-10,0,0,0,0,0,4,0
Kings,2020-04-10,8,0,0,3,0,1,8
Tehama,2020-04-10,0,1,0,0,0,8,1
San Benito,2020-04-10,2,1,0,1,0,1,3
Inyo,2020-04-10,9,135,0,1,0,3,144
San Bernardino,2020-04-10,156,295,0,66,58,134,451
Ventura,2020-04-10,19,76,0,8,13,30,95
Merced,2020-04-10,0,2,0,0,1,4,2
Shasta,2020-04-10,5,7,0,2,1,12,12
Amador,2020-04-10,0,0,0,0,0,4,0
Tuolumne,2020-04-10,0,0,0,0,1,0,0
Lassen,2020-04-10,0,2,0,0,0,0,2
Butte,2020-04-10,1,15,0,1,5,5,16
Stanislaus,2020-04-10,27,17,0,11,3,44,44
Glenn,2020-04-10,0,0,0,0,0,0,0
Madera,2020-04-10,0,5,0,0,1,6,5
Placer,2020-04-10,16,11,0,9,3,9,27
San Francisco,2020-04-10,85,46,0,32,12,125,131
Mariposa,2020-04-10,0,0,0,0,0,0,0
Sacramento,2020-04-10,70,45,0,30,13,69,115
Santa Barbara,2020-04-10,42,13,0,19,1,43,55
San Diego,2020-04-10,230,124,0,96,14,153,354
Merced,2020-04-11,0,2,0,0,1,3,2
Mono,2020-04-11,0,3,0,0,0,2,3
Modoc,2020-04-11,0,0,0,0,0,0,0
Placer,2020-04-11,20,19,0,7,4,13,39
Tehama,2020-04-11,0,0,0,0,0,7,0
Mariposa,2020-04-11,0,0,0,0,0,0,0
Sonoma,2020-04-11,3,19,0,1,4,30,22
Siskiyou,2020-04-11,0,0,0,0,0,4,0
Amador,2020-04-11,0,0,0,0,0,4,0
Shasta,2020-04-11,5,3,0,2,0,12,8
Alameda,2020-04-11,87,91,0,46,19,121,178
San Bernardino,2020-04-11,153,213,0,57,42,117,366
Calaveras,2020-04-11,0,1,0,0,1,11,1
Plumas,2020-04-11,0,0,0,0,0,0,0
Sacramento,2020-04-11,67,46,0,29,10,80,113
Glenn,2020-04-11,0,0,0,0,0,0,0
Nevada,2020-04-11,3,3,0,2,1,5,6
Colusa,2020-04-11,0,0,0,0,0,6,0
Stanislaus,2020-04-11,23,19,0,8,4,44,42
Kings,2020-04-11,10,0,0,4,0,1,10
Tulare,2020-04-11,12,3,0,4,2,19,15
Santa Clara,2020-04-11,146,61,0,66,8,106,207
San Mateo,2020-04-11,54,15,0,18,2,42,69
Imperial,2020-04-11,14,11,0,7,3,1,25
Del Norte,2020-04-11,0,2,0,0,1,5,2
Yolo,2020-04-11,3,4,0,1,0,7,7
Trinity,2020-04-11,0,0,0,0,0,0,0
Butte,2020-04-11,2,4,0,1,1,5,6
Marin,2020-04-11,2,27,0,1,3,14,29
Napa,2020-04-11,0,0,0,0,0,5,0
Yuba,2020-04-11,2,2,0,2,0,9,4
Fresno,2020-04-11,28,63,0,11,8,52,91
San Benito,2020-04-11,2,2,0,0,0,2,4
Humboldt,2020-04-11,2,5,0,0,3,3,7
Solano,2020-04-11,13,16,0,9,4,32,29
Los Angeles,2020-04-11,1362,905,0,555,135,595,2267
Inyo,2020-04-11,10,140,0,1,0,3,150
San Luis Obispo,2020-04-11,2,10,0,2,5,23,12
Riverside,2020-04-11,232,127,0,57,26,149,359
Sutter,2020-04-11,0,0,0,0,0,0,0
Kern,2020-04-11,32,52,0,17,4,41,84
Madera,2020-04-11,0,5,0,0,2,5,5
Monterey,2020-04-11,18,17,0,5,2,24,35
Lassen,2020-04-11,0,4,0,0,0,0,4
Tuolumne,2020-04-11,0,2,0,0,0,3,2
Santa Barbara,2020-04-11,40,16,0,21,4,53,56
San Francisco,2020-04-11,82,51,0,28,13,132,133
San Diego,2020-04-11,239,118,0,98,23,140,357
Lake,2020-04-11,0,0,0,0,0,0,0
Mendocino,2020-04-11,0,1,0,0,1,9,1
San Joaquin,2020-04-11,23,14,0,14,5,28,37
El Dorado,2020-04-11,17,2,0,0,1,9,19
Orange,2020-04-11,144,109,0,44,20,219,253
Contra Costa,2020-04-11,39,38,0,15,15,75,77
Ventura,2020-04-11,22,58,0,9,11,33,80
Santa Cruz,2020-04-11,4,14,0,3,6,6,18
Orange,2020-04-12,138,108,0,63,33,190,246
Marin,2020-04-12,2,24,0,1,1,13,26
Riverside,2020-04-12,245,142,0,69,26,146,387
Sutter,2020-04-12,0,0,0,0,0,0,0
Tehama,2020-04-12,0,3,0,0,0,6,3
Butte,2020-04-12,2,0,0,2,0,15,2
Santa Cruz,2020-04-12,4,15,0,3,6,4,19
Sonoma,2020-04-12,3,11,0,1,3,25,14
Placer,2020-04-12,19,15,0,6,3,6,34
Yuba,2020-04-12,1,0,0,1,0,6,1
Del Norte,2020-04-12,0,2,0,0,0,6,2
Yolo,2020-04-12,4,4,0,2,0,3,8
Glenn,2020-04-12,0,0,0,0,0,0,0
Mariposa,2020-04-12,0,0,0,0,0,0,0
Napa,2020-04-12,0,0,0,0,0,6,0
Kings,2020-04-12,8,0,0,3,0,3,8
Lassen,2020-04-12,0,4,0,0,0,0,4
Siskiyou,2020-04-12,0,0,0,0,0,6,0
San Benito,2020-04-12,0,0,0,0,0,2,0
Inyo,2020-04-12,10,140,0,1,0,4,150
Colusa,2020-04-12,0,0,0,0,0,6,0
El Dorado,2020-04-12,19,1,0,0,0,11,20
Plumas,2020-04-12,0,0,0,0,0,0,0
Alameda,2020-04-12,91,101,0,42,21,52,192
Kern,2020-04-12,31,28,0,18,3,41,59
Madera,2020-04-12,0,5,0,0,0,5,5
San Diego,2020-04-12,244,108,0,99,19,170,352
Sacramento,2020-04-12,69,46,0,28,9,68,115
Fresno,2020-04-12,23,46,0,11,4,54,69
Mendocino,2020-04-12,0,0,0,0,0,6,0
San Joaquin,2020-04-12,25,21,0,10,6,23,46
Lake,2020-04-12,0,0,0,0,0,0,0
Nevada,2020-04-12,3,1,0,2,2,4,4
Tulare,2020-04-12,15,4,0,6,1,22,19
Merced,2020-04-12,0,3,0,0,2,2,3
Los Angeles,2020-04-12,1433,715,0,559,144,564,2148
Ventura,2020-04-12,21,65,0,8,8,36,86
Stanislaus,2020-04-12,19,19,0,8,3,7,38
San Bernardino,2020-04-12,157,172,0,63,36,108,329
Santa Clara,2020-04-12,145,51,0,66,8,102,196
San Francisco,2020-04-12,92,44,0,30,7,71,136
San Luis Obispo,2020-04-12,2,8,0,2,4,24,10
Shasta,2020-04-12,4,3,0,2,0,15,7
Santa Barbara,2020-04-12,42,7,0,21,1,53,49
Contra Costa,2020-04-12,46,32,0,16,3,64,78
Monterey,2020-04-12,19,13,0,4,4,26,32
San Mateo,2020-04-12,46,31,0,16,2,23,77
Tuolumne,2020-04-12,0,0,0,0,0,5,0
Amador,2020-04-12,0,0,0,0,0,3,0
Calaveras,2020-04-12,0,2,0,0,2,9,2
Humboldt,2020-04-12,2,4,0,0,2,3,6
Imperial,2020-04-12,18,13,0,8,1,2,31
Solano,2020-04-12,13,19,0,7,10,30,32
Trinity,2020-04-12,0,0,0,0,0,0,0
Modoc,2020-04-12,0,0,0,0,0,0,0
Mono,2020-04-12,0,3,0,0,0,2,3
Riverside,2020-04-13,247,122,0,66,30,132,369
San Diego,2020-04-13,243,107,0,101,24,171,350
Santa Clara,2020-04-13,151,66,0,65,11,87,217
Fresno,2020-04-13,22,57,0,12,8,60,79
Tehama,2020-04-13,0,0,0,0,0,6,0
El Dorado,2020-04-13,19,1,0,0,1,12,20
Sonoma,2020-04-13,3,14,0,1,3,31,17
Tulare,2020-04-13,14,3,0,6,0,18,17
Inyo,2020-04-13,10,150,0,1,2,3,160
Santa Barbara,2020-04-13,42,7,0,21,2,59,49
Calaveras,2020-04-13,0,1,0,0,1,10,1
Contra Costa,2020-04-13,44,44,0,16,5,69,88
Kings,2020-04-13,0,1,0,0,1,0,1
Monterey,2020-04-13,22,19,0,4,2,21,41
Kern,2020-04-13,39,32,0,18,1,49,71
Amador,2020-04-13,0,0,0,0,0,3,0
Alameda,2020-04-13,85,81,0,40,21,58,166
Placer,2020-04-13,18,9,0,5,3,10,27
Sacramento,2020-04-13,73,36,0,28,7,65,109
Lake,2020-04-13,0,2,0,0,1,3,2
Solano,2020-04-13,13,13,0,7,5,27,26
Orange,2020-04-13,149,81,0,54,17,205,230
San Luis Obispo,2020-04-13,2,5,0,2,2,20,7
Madera,2020-04-13,0,4,0,0,1,8,4
San Benito,2020-04-13,1,1,0,0,0,2,2
Tuolumne,2020-04-13,0,0,0,0,0,6,0
Los Angeles,2020-04-13,1501,793,0,570,150,632,2294
Modoc,2020-04-13,0,0,0,0,0,0,0
Ventura,2020-04-13,21,56,0,9,9,35,77
Lassen,2020-04-13,0,4,0,0,0,0,4
Siskiyou,2020-04-13,0,2,0,0,2,3,2
Humboldt,2020-04-13,2,8,0,0,1,10,10
San Francisco,2020-04-13,89,48,0,30,9,61,137
Mariposa,2020-04-13,0,3,0,0,0,0,3
Imperial,2020-04-13,19,8,0,7,1,6,27
San Mateo,2020-04-13,57,19,0,18,4,26,76
Butte,2020-04-13,1,8,0,1,7,3,9
Nevada,2020-04-13,2,2,0,2,2,5,4
Marin,2020-04-13,2,20,0,2,1,12,22
San Bernardino,2020-04-13,167,155,0,60,24,135,322
Yuba,2020-04-13,1,2,0,0,0,8,3
Glenn,2020-04-13,0,0,0,0,0,0,0
Mendocino,2020-04-13,7,1,0,3,0,6,8
Del Norte,2020-04-13,0,1,0,0,1,3,1
San Joaquin,2020-04-13,26,16,0,12,8,14,42
Sutter,2020-04-13,0,0,0,0,0,0,0
Colusa,2020-04-13,0,0,0,0,0,6,0
Yolo,2020-04-13,4,0,0,2,0,14,4
Shasta,2020-04-13,3,0,0,2,0,6,3
Napa,2020-04-13,0,1,0,0,0,9,1
Santa Cruz,2020-04-13,4,8,0,3,2,1,12
Merced,2020-04-13,0,4,0,0,1,5,4
Stanislaus,2020-04-13,21,22,0,9,5,45,43
Plumas,2020-04-13,0,1,0,0,0,0,1
Mono,2020-04-13,0,1,0,0,0,2,1
Trinity,2020-04-13,0,0,0,0,0,0,0
Sacramento,2020-04-14,70,46,0,24,8,59,116
Fresno,2020-04-14,24,45,0,12,8,42,69
Shasta,2020-04-14,1,4,0,1,2,9,5
Inyo,2020-04-14,10,156,0,0,1,5,166
Imperial,2020-04-14,19,14,0,6,3,3,33
Yuba,2020-04-14,1,1,0,0,1,7,2
Plumas,2020-04-14,0,1,0,0,0,0,1
Contra Costa,2020-04-14,37,51,0,15,9,61,88
Tuolumne,2020-04-14,0,0,0,0,0,1,0
Madera,2020-04-14,0,4,0,0,2,7,4
Lassen,2020-04-14,0,6,0,0,0,0,6
Yolo,2020-04-14,3,0,0,2,0,12,3
Santa Cruz,2020-04-14,4,4,0,3,0,3,8
Mariposa,2020-04-14,0,3,0,0,0,0,3
San Joaquin,2020-04-14,22,10,0,12,1,12,32
Siskiyou,2020-04-14,0,0,0,0,0,2,0
Marin,2020-04-14,2,23,0,2,3,9,25
Kern,2020-04-14,35,23,0,17,3,45,58
Glenn,2020-04-14,0,0,0,0,0,0,0
Nevada,2020-04-14,3,4,0,2,1,7,7
Santa Clara,2020-04-14,144,47,0,66,5,104,191
Amador,2020-04-14,0,0,0,0,0,4,0
Del Norte,2020-04-14,0,5,0,0,4,4,5
Calaveras,2020-04-14,0,1,0,0,0,12,1
San Luis Obispo,2020-04-14,3,15,0,2,6,18,18
Kings,2020-04-14,8,0,0,2,0,2,8
Sonoma,2020-04-14,3,9,0,1,3,23,12
Placer,2020-04-14,17,15,0,5,4,9,32
Sutter,2020-04-14,0,0,0,0,0,0,0
Ventura,2020-04-14,24,35,0,9,7,43,59
San Benito,2020-04-14,1,1,0,0,0,2,2
Mendocino,2020-04-14,0,0,0,0,0,6,0
San Bernardino,2020-04-14,166,149,0,59,43,117,315
Humboldt,2020-04-14,2,7,0,0,0,10,9
Merced,2020-04-14,0,4,0,0,2,4,4
Stanislaus,2020-04-14,18,25,0,9,7,50,43
Colusa,2020-04-14,0,0,0,0,0,6,0
Tulare,2020-04-14,15,5,0,6,0,18,20
Butte,2020-04-14,1,6,0,1,6,4,7
Mono,2020-04-14,0,1,0,0,0,2,1
San Mateo,2020-04-14,55,12,0,19,4,25,67
Lake,2020-04-14,0,3,0,0,0,3,3
Monterey,2020-04-14,18,13,0,3,0,25,31
Trinity,2020-04-14,0,0,0,0,0,0,0
Riverside,2020-04-14,235,117,0,64,36,141,352
Orange,2020-04-14,147,111,0,57,31,259,258
Los Angeles,2020-04-14,1587,613,0,588,115,614,2200
Santa Barbara,2020-04-14,42,8,0,19,1,64,50
Solano,2020-04-14,12,25,0,6,4,27,37
San Diego,2020-04-14,243,109,0,101,22,162,352
Alameda,2020-04-14,92,106,0,34,21,61,198
Napa,2020-04-14,0,0,0,0,0,8,0
El Dorado,2020-04-14,20,3,0,0,0,12,23
Modoc,2020-04-14,0,1,0,0,0,0,1
San Francisco,2020-04-14,87,53,0,28,5,69,140
Tehama,2020-04-14,0,0,0,0,0,4,0
Mendocino,2020-04-15,0,0,0,0,0,8,0
Los Angeles,2020-04-15,1624,632,0,600,139,566,2256
Kings,2020-04-15,8,0,0,2,0,3,8
San Diego,2020-04-15,236,112,0,98,23,148,348
San Mateo,2020-04-15,53,18,0,14,4,27,71
Tehama,2020-04-15,0,0,0,0,0,7,0
Contra Costa,2020-04-15,38,41,0,16,8,76,79
Mariposa,2020-04-15,0,4,0,0,0,0,4
Sutter,2020-04-15,0,0,0,0,0,0,0
San Joaquin,2020-04-15,21,21,0,10,3,27,42
Modoc,2020-04-15,0,0,0,0,0,0,0
San Bernardino,2020-04-15,149,109,0,65,39,61,258
Fresno,2020-04-15,25,33,0,12,2,44,58
Napa,2020-04-15,0,0,0,0,0,8,0
Riverside,2020-04-15,207,155,0,70,29,112,362
Marin,2020-04-15,4,10,0,2,4,11,14
Siskiyou,2020-04-15,2,0,0,0,2,3,2
Placer,2020-04-15,13,11,0,2,4,12,24
Solano,2020-04-15,9,14,0,6,4,30,23
Stanislaus,2020-04-15,19,17,0,7,4,33,36
El Dorado,2020-04-15,0,5,0,0,1,12,5
Shasta,2020-04-15,1,1,0,1,0,13,2
Calaveras,2020-04-15,0,0,0,0,0,10,0
Lake,2020-04-15,3,3,0,0,2,1,6
Humboldt,2020-04-15,2,5,0,0,0,11,7
Plumas,2020-04-15,0,0,0,0,0,0,0
Del Norte,2020-04-15,0,0,0,0,1,4,0
Glenn,2020-04-15,0,0,0,0,0,0,0
Sacramento,2020-04-15,66,60,0,20,14,55,126
Kern,2020-04-15,40,12,0,16,1,47,52
Santa Cruz,2020-04-15,4,2,0,3,2,5,6
Inyo,2020-04-15,15,163,0,0,0,6,178
San Francisco,2020-04-15,87,84,0,25,7,76,171
Monterey,2020-04-15,20,11,0,4,1,22,31
Alameda,2020-04-15,81,99,0,34,11,70,180
Sonoma,2020-04-15,3,13,0,1,7,25,16
Butte,2020-04-15,1,5,0,0,2,6,6
Mono,2020-04-15,0,0,0,0,0,2,0
San Luis Obispo,2020-04-15,2,6,0,2,4,28,8
Yuba,2020-04-15,0,2,0,0,2,8,2
San Benito,2020-04-15,1,0,0,0,0,4,1
Madera,2020-04-15,1,6,0,0,1,6,7
Lassen,2020-04-15,0,6,0,0,0,0,6
Imperial,2020-04-15,21,13,0,7,4,2,34
Colusa,2020-04-15,0,0,0,0,0,6,0
Ventura,2020-04-15,25,57,0,8,16,37,82
Tulare,2020-04-15,18,3,0,7,0,22,21
Santa Clara,2020-04-15,144,42,0,65,6,92,186
Trinity,2020-04-15,0,0,0,0,0,0,0
Nevada,2020-04-15,3,4,0,2,1,2,7
Merced,2020-04-15,0,0,0,0,0,5,0
Amador,2020-04-15,0,0,0,0,0,2,0
Yolo,2020-04-15,2,1,0,2,0,14,3
Tuolumne,2020-04-15,0,0,0,0,0,3,0
Orange,2020-04-15,156,103,0,73,27,235,259
Santa Barbara,2020-04-15,37,7,0,17,2,61,44
Sacramento,2020-04-16,64,54,0,25,13,43,118
Siskiyou,2020-04-16,0,2,0,0,1,4,2
Tehama,2020-04-16,0,1,0,0,0,5,1
San Mateo,2020-04-16,54,18,0,13,3,26,72
Monterey,2020-04-16,20,22,0,4,0,23,42
Santa Cruz,2020-04-16,4,3,0,3,1,7,7
Sonoma,2020-04-16,3,10,0,1,3,28,13
Del Norte,2020-04-16,0,3,0,0,0,2,3
Napa,2020-04-16,0,0,0,0,0,2,0
Tuolumne,2020-04-16,0,0,0,0,0,2,0
Humboldt,2020-04-16,1,5,0,4,2,-1,6
Nevada,2020-04-16,3,3,0,2,2,2,6
Imperial,2020-04-16,21,7,0,9,1,3,28
Lake,2020-04-16,1,0,0,0,0,1,1
Colusa,2020-04-16,0,1,0,0,1,5,1
Mariposa,2020-04-16,0,1,0,0,0,0,1
Solano,2020-04-16,9,15,0,6,4,28,24
Ventura,2020-04-16,24,52,0,7,10,38,76
Butte,2020-04-16,1,10,0,0,3,8,11
Glenn,2020-04-16,0,0,0,0,0,0,0
Santa Clara,2020-04-16,134,48,0,69,8,89,182
Marin,2020-04-16,5,7,0,2,1,15,12
Amador,2020-04-16,0,0,0,0,0,5,0
Mono,2020-04-16,0,0,0,0,0,2,0
Sutter,2020-04-16,0,0,0,0,0,0,0
Merced,2020-04-16,1,1,0,0,0,7,2
Mendocino,2020-04-16,0,0,0,0,0,8,0
Orange,2020-04-16,152,117,0,55,25,258,269
Shasta,2020-04-16,1,0,0,1,0,14,1
Riverside,2020-04-16,216,150,0,72,34,123,366
Inyo,2020-04-16,0,3,0,0,1,5,3
Tulare,2020-04-16,22,5,0,8,1,17,27
San Benito,2020-04-16,1,0,0,0,0,2,1
San Francisco,2020-04-16,84,35,0,31,9,64,119
Stanislaus,2020-04-16,18,19,0,6,3,25,37
Yuba,2020-04-16,0,2,0,0,2,6,2
Fresno,2020-04-16,33,33,0,12,4,48,66
Madera,2020-04-16,0,7,0,0,0,6,7
Placer,2020-04-16,12,18,0,1,1,15,30
Los Angeles,2020-04-16,1679,620,0,594,108,608,2299
Contra Costa,2020-04-16,37,59,0,14,13,61,96
Trinity,2020-04-16,0,0,0,0,0,0,0
Calaveras,2020-04-16,0,1,0,0,1,10,1
San Bernardino,2020-04-16,164,124,0,60,25,83,288
Lassen,2020-04-16,0,5,0,0,0,0,5
Plumas,2020-04-16,0,0,0,0,0,0,0
Kings,2020-04-16,8,0,0,2,0,5,8
San Luis Obispo,2020-04-16,3,11,0,3,0,32,14
Yolo,2020-04-16,2,1,0,1,0,15,3
Santa Barbara,2020-04-16,37,4,0,16,0,62,41
Kern,2020-04-16,41,19,0,17,0,57,60
Modoc,2020-04-16,0,2,0,0,0,0,2
Alameda,2020-04-16,73,82,0,31,9,66,155
El Dorado,2020-04-16,0,5,0,0,0,14,5
San Diego,2020-04-16,231,111,0,94,19,151,342
San Joaquin,2020-04-16,21,16,0,11,2,28,37
Marin,2020-04-17,4,2,0,2,0,15,6
San Bernardino,2020-04-17,165,123,0,62,29,82,288
Kings,2020-04-17,7,0,0,2,0,0,7
Butte,2020-04-17,1,9,0,0,6,7,10
Lassen,2020-04-17,0,5,0,0,0,0,5
Riverside,2020-04-17,215,144,0,69,23,119,359
Alameda,2020-04-17,85,91,0,35,18,55,176
Mariposa,2020-04-17,0,1,0,0,0,0,1
Sonoma,2020-04-17,2,6,0,1,3,33,8
Del Norte,2020-04-17,0,4,0,0,1,3,4
Stanislaus,2020-04-17,15,17,0,7,2,22,32
Kern,2020-04-17,36,16,0,18,1,59,52
Yolo,2020-04-17,4,0,0,1,0,14,4
Glenn,2020-04-17,0,0,0,0,0,0,0
Siskiyou,2020-04-17,0,3,0,0,0,4,3
Santa Clara,2020-04-17,140,60,0,71,11,86,200
Modoc,2020-04-17,0,1,0,0,0,0,1
Lake,2020-04-17,0,6,0,0,1,3,6
Sutter,2020-04-17,0,0,0,0,0,0,0
Mono,2020-04-17,0,0,0,0,0,2,0
Madera,2020-04-17,0,5,0,0,0,7,5
Sacramento,2020-04-17,63,46,0,24,18,38,109
Nevada,2020-04-17,2,4,0,1,3,0,6
San Diego,2020-04-17,232,111,0,92,21,157,343
Napa,2020-04-17,0,1,0,0,0,13,1
Humboldt,2020-04-17,0,4,0,2,1,1,4
Trinity,2020-04-17,0,0,0,0,0,0,0
San Benito,2020-04-17,1,0,0,0,0,2,1
Shasta,2020-04-17,1,0,0,1,0,13,1
Colusa,2020-04-17,0,1,0,0,1,5,1
Fresno,2020-04-17,31,29,0,12,2,52,60
Mendocino,2020-04-17,0,0,0,0,0,7,0
Inyo,2020-04-17,0,3,0,0,1,5,3
Imperial,2020-04-17,19,15,0,10,2,3,34
Santa Barbara,2020-04-17,36,6,0,16,0,63,42
San Luis Obispo,2020-04-17,3,11,0,3,2,32,14
San Francisco,2020-04-17,79,36,0,28,8,66,115
San Joaquin,2020-04-17,23,23,0,10,3,26,46
Los Angeles,2020-04-17,1720,634,0,594,105,593,2354
Monterey,2020-04-17,22,25,0,3,1,22,47
San Mateo,2020-04-17,51,16,0,16,1,22,67
Tehama,2020-04-17,0,0,0,0,0,5,0
Orange,2020-04-17,160,124,0,58,15,274,284
Amador,2020-04-17,0,0,0,0,0,3,0
Tuolumne,2020-04-17,0,0,0,0,0,2,0
Tulare,2020-04-17,23,5,0,7,1,6,28
Placer,2020-04-17,12,17,0,1,2,16,29
Santa Cruz,2020-04-17,2,3,0,1,2,6,5
Solano,2020-04-17,10,11,0,5,1,36,21
El Dorado,2020-04-17,0,6,0,0,1,12,6
Calaveras,2020-04-17,0,2,0,0,2,9,2
Contra Costa,2020-04-17,34,46,0,13,11,59,80
Merced,2020-04-17,0,4,0,0,2,3,4
Yuba,2020-04-17,0,5,0,0,4,4,5
Ventura,2020-04-17,23,33,0,8,11,37,56
Plumas,2020-04-17,0,1,0,0,0,0,1
Contra Costa,2020-04-18,35,44,0,13,8,79,79
Yuba,2020-04-18,0,3,0,0,2,5,3
Humboldt,2020-04-18,0,4,0,0,0,5,4
Solano,2020-04-18,9,11,0,6,1,34,20
Kings,2020-04-18,8,0,0,2,0,1,8
Tehama,2020-04-18,0,0,0,0,0,4,0
San Joaquin,2020-04-18,23,27,0,11,4,38,50
Marin,2020-04-18,3,1,0,1,0,13,4
Yolo,2020-04-18,4,0,0,1,0,14,4
Sutter,2020-04-18,0,0,0,0,0,0,0
Glenn,2020-04-18,0,0,0,0,0,0,0
Napa,2020-04-18,0,0,0,0,0,13,0
Tuolumne,2020-04-18,0,0,0,0,0,1,0
Placer,2020-04-18,11,17,0,1,2,6,28
Fresno,2020-04-18,32,35,0,13,2,51,67
Mono,2020-04-18,0,0,0,0,0,2,0
El Dorado,2020-04-18,0,8,0,0,2,11,8
Mariposa,2020-04-18,0,0,0,0,0,0,0
Madera,2020-04-18,0,7,0,0,0,7,7
Imperial,2020-04-18,21,12,0,9,4,2,33
Del Norte,2020-04-18,0,2,0,0,1,6,2
San Benito,2020-04-18,0,0,0,0,0,2,0
Ventura,2020-04-18,25,28,0,9,5,35,53
Riverside,2020-04-18,223,118,0,71,19,133,341
Trinity,2020-04-18,0,0,0,0,0,0,0
Inyo,2020-04-18,1,1,0,1,0,4,2
Kern,2020-04-18,33,14,0,18,2,56,47
Santa Barbara,2020-04-18,31,9,0,15,4,60,40
Colusa,2020-04-18,0,0,0,0,0,6,0
Modoc,2020-04-18,0,1,0,0,0,0,1
Siskiyou,2020-04-18,0,1,0,0,1,4,1
Shasta,2020-04-18,1,1,0,1,0,13,2
Orange,2020-04-18,157,120,0,64,23,263,277
Nevada,2020-04-18,4,5,0,1,4,4,9
Stanislaus,2020-04-18,14,23,0,5,1,31,37
Lassen,2020-04-18,0,1,0,0,0,0,1
Alameda,2020-04-18,82,73,0,36,16,62,155
Sonoma,2020-04-18,2,4,0,1,1,32,6
Calaveras,2020-04-18,0,0,0,0,0,11,0
Amador,2020-04-18,0,0,0,0,0,3,0
Merced,2020-04-18,0,3,0,0,0,4,3
Butte,2020-04-18,1,4,0,0,2,11,5
Lake,2020-04-18,0,0,0,0,0,6,0
Tulare,2020-04-18,27,0,0,9,0,11,27
Santa Cruz,2020-04-18,2,2,0,1,1,12,4
Plumas,2020-04-18,0,1,0,0,0,0,1
San Mateo,2020-04-18,49,12,0,16,0,37,61
San Bernardino,2020-04-18,161,108,0,61,22,107,269
San Luis Obispo,2020-04-18,3,12,0,3,2,23,15
Mendocino,2020-04-18,0,0,0,0,0,9,0
Santa Clara,2020-04-18,137,52,0,67,13,84,189
Los Angeles,2020-04-18,1709,578,0,586,110,579,2287
Monterey,2020-04-18,26,21,0,2,0,38,47
Sacramento,2020-04-18,65,46,0,22,17,58,111
San Diego,2020-04-18,223,97,0,90,18,164,320
San Francisco,2020-04-18,74,29,0,27,7,75,103
Plumas,2020-04-19,0,0,0,0,0,0,0
San Joaquin,2020-04-19,23,16,0,12,2,32,39
Napa,2020-04-19,0,3,0,0,0,14,3
Del Norte,2020-04-19,0,0,0,0,0,3,0
Trinity,2020-04-19,0,0,0,0,0,0,0
Mono,2020-04-19,0,0,0,0,0,2,0
Shasta,2020-04-19,1,0,0,1,0,11,1
Santa Barbara,2020-04-19,29,7,0,16,1,60,36
Santa Clara,2020-04-19,143,32,0,67,5,105,175
Contra Costa,2020-04-19,34,40,0,14,7,69,74
San Luis Obispo,2020-04-19,2,7,0,2,1,27,9
San Francisco,2020-04-19,73,34,0,27,10,76,107
Ventura,2020-04-19,26,26,0,9,4,33,52
San Mateo,2020-04-19,53,6,0,18,0,22,59
Solano,2020-04-19,11,10,0,6,3,40,21
El Dorado,2020-04-19,0,11,0,0,3,11,11
Madera,2020-04-19,0,7,0,0,0,7,7
Riverside,2020-04-19,236,113,0,76,22,145,349
Stanislaus,2020-04-19,13,16,0,5,3,41,29
Sonoma,2020-04-19,2,8,0,0,2,27,10
Los Angeles,2020-04-19,1739,549,0,595,115,577,2288
Glenn,2020-04-19,0,0,0,0,0,0,0
Humboldt,2020-04-19,0,3,0,0,0,7,3
Colusa,2020-04-19,1,0,0,0,0,6,1
Lassen,2020-04-19,0,1,0,0,0,0,1
San Diego,2020-04-19,226,94,0,92,26,154,320
Inyo,2020-04-19,1,0,0,1,0,5,1
Orange,2020-04-19,162,130,0,73,24,248,292
Fresno,2020-04-19,32,35,0,14,2,59,67
San Benito,2020-04-19,0,0,0,0,0,3,0
Yuba,2020-04-19,0,2,0,0,2,5,2
Sacramento,2020-04-19,65,39,0,22,11,59,104
Placer,2020-04-19,11,12,0,1,5,6,23
Monterey,2020-04-19,25,6,0,2,0,26,31
Modoc,2020-04-19,0,0,0,0,0,0,0
San Bernardino,2020-04-19,158,97,0,62,17,107,255
Marin,2020-04-19,3,7,0,1,3,10,10
Alameda,2020-04-19,84,63,0,37,5,61,147
Kings,2020-04-19,8,0,0,3,0,0,8
Nevada,2020-04-19,1,4,0,1,4,4,5
Tehama,2020-04-19,0,0,0,0,0,5,0
Siskiyou,2020-04-19,0,1,0,0,1,4,1
Calaveras,2020-04-19,0,0,0,0,0,11,0
Mendocino,2020-04-19,0,0,0,0,0,9,0
Mariposa,2020-04-19,0,0,0,0,0,0,0
Merced,2020-04-19,0,2,0,0,1,4,2
Tuolumne,2020-04-19,0,0,0,0,0,2,0
Lake,2020-04-19,0,2,0,0,0,5,2
Tulare,2020-04-19,27,0,0,9,0,13,27
Sutter,2020-04-19,0,0,0,0,0,0,0
Imperial,2020-04-19,25,8,0,11,2,1,33
Butte,2020-04-19,1,3,0,0,1,11,4
Yolo,2020-04-19,6,0,0,0,0,21,6
Amador,2020-04-19,0,0,0,0,0,2,0
Santa Cruz,2020-04-19,2,3,0,1,0,13,5
Kern,2020-04-19,34,20,0,18,2,49,54
Shasta,2020-04-20,1,0,0,1,0,16,1
Imperial,2020-04-20,25,9,0,11,2,1,34
Glenn,2020-04-20,0,0,0,0,0,0,0
Kern,2020-04-20,34,11,0,13,1,51,45
Monterey,2020-04-20,24,7,0,2,1,23,31
Marin,2020-04-20,6,4,0,2,1,11,10
Yuba,2020-04-20,0,1,0,0,1,7,1
Merced,2020-04-20,0,1,0,0,1,6,1
Humboldt,2020-04-20,0,6,0,0,0,4,6
Modoc,2020-04-20,0,0,0,0,0,0,0
Inyo,2020-04-20,1,0,0,1,0,4,1
Riverside,2020-04-20,240,145,0,72,29,133,385
Sacramento,2020-04-20,69,32,0,33,8,62,101
Lassen,2020-04-20,0,1,0,0,0,0,1
Solano,2020-04-20,10,11,0,6,3,36,21
Lake,2020-04-20,0,2,0,0,1,0,2
Alameda,2020-04-20,85,52,0,38,4,59,137
Nevada,2020-04-20,1,5,0,1,2,7,6
Sutter,2020-04-20,0,0,0,0,0,0,0
Yolo,2020-04-20,5,1,0,0,0,14,6
Madera,2020-04-20,0,6,0,0,0,7,6
Del Norte,2020-04-20,0,2,0,0,1,1,2
Tulare,2020-04-20,27,0,0,9,0,15,27
San Francisco,2020-04-20,79,27,0,27,7,73,106
Plumas,2020-04-20,0,0,0,0,0,0,0
Kings,2020-04-20,8,0,0,3,0,3,8
Siskiyou,2020-04-20,0,1,0,0,1,5,1
Santa Cruz,2020-04-20,3,1,0,1,0,11,4
San Bernardino,2020-04-20,152,200,0,60,28,150,352
Ventura,2020-04-20,29,18,0,8,2,27,47
Trinity,2020-04-20,0,0,0,0,0,0,0
Amador,2020-04-20,0,0,0,0,0,4,0
San Joaquin,2020-04-20,30,23,0,16,4,18,53
Calaveras,2020-04-20,0,1,0,0,0,11,1
San Diego,2020-04-20,238,76,0,95,13,149,314
Mendocino,2020-04-20,0,0,0,0,0,7,0
Contra Costa,2020-04-20,37,28,0,13,8,75,65
Butte,2020-04-20,1,2,0,0,1,9,3
San Mateo,2020-04-20,56,16,0,18,4,19,72
Santa Barbara,2020-04-20,30,9,0,20,2,61,39
Placer,2020-04-20,8,7,0,2,1,15,15
Orange,2020-04-20,172,102,0,73,21,184,274
Sonoma,2020-04-20,2,12,0,0,6,29,14
San Luis Obispo,2020-04-20,2,3,0,2,0,28,5
Fresno,2020-04-20,35,30,0,15,1,55,65
El Dorado,2020-04-20,0,4,0,0,0,13,4
Mariposa,2020-04-20,0,1,0,0,0,0,1
San Benito,2020-04-20,0,0,0,0,0,3,0
Napa,2020-04-20,1,2,0,1,0,8,3
Colusa,2020-04-20,1,0,0,0,0,5,1
Los Angeles,2020-04-20,1791,602,0,625,93,607,2393
Santa Clara,2020-04-20,149,42,0,68,8,115,191
Stanislaus,2020-04-20,13,18,0,5,6,34,31
Tuolumne,2020-04-20,0,0,0,0,0,2,0
Mono,2020-04-20,0,0,0,0,0,2,0
Tehama,2020-04-20,0,0,0,0,0,6,0
San Bernardino,2020-04-21,153,204,2714,51,36,142,357
Santa Cruz,2020-04-21,3,2,351,1,0,16,5
Kern,2020-04-21,31,12,1171,13,1,57,43
Del Norte,2020-04-21,0,1,0,0,0,3,1
Napa,2020-04-21,1,1,387,1,0,9,2
Sutter,2020-04-21,0,0,0,0,0,0,0
Merced,2020-04-21,0,3,0,0,2,4,3
Tulare,2020-04-21,27,0,276,9,0,15,27
San Francisco,2020-04-21,76,45,738,25,9,79,121
Glenn,2020-04-21,0,0,0,0,0,0,0
Placer,2020-04-21,4,18,0,2,2,11,22
Mono,2020-04-21,0,0,17,0,0,2,0
Ventura,2020-04-21,28,28,976,9,10,25,56
San Benito,2020-04-21,1,0,25,0,0,2,1
Amador,2020-04-21,0,0,0,0,0,2,0
Santa Barbara,2020-04-21,26,8,415,13,5,82,34
Yuba,2020-04-21,0,0,445,0,0,16,0
Shasta,2020-04-21,1,0,279,1,0,16,1
Madera,2020-04-21,0,5,0,0,0,15,5
Tuolumne,2020-04-21,0,0,90,0,0,3,0
Imperial,2020-04-21,23,12,161,12,0,1,35
Stanislaus,2020-04-21,11,20,1400,4,7,72,31
Modoc,2020-04-21,0,1,20,0,0,0,1
Nevada,2020-04-21,1,4,58,1,2,7,5
Tehama,2020-04-21,0,0,0,0,0,3,0
Sonoma,2020-04-21,2,17,575,0,6,28,19
Yolo,2020-04-21,5,2,0,1,0,15,7
Inyo,2020-04-21,1,0,50,1,0,3,1
Mariposa,2020-04-21,0,1,0,0,0,0,1
Colusa,2020-04-21,1,0,80,1,0,4,1
Santa Clara,2020-04-21,144,34,2582,70,16,120,178
Lassen,2020-04-21,0,1,0,0,0,0,1
Lake,2020-04-21,0,2,58,0,0,6,2
Humboldt,2020-04-21,0,5,308,0,0,6,5
El Dorado,2020-04-21,0,3,155,0,0,12,3
San Luis Obispo,2020-04-21,1,5,303,1,3,25,6
Orange,2020-04-21,179,129,4213,77,27,277,308
Fresno,2020-04-21,35,35,764,15,3,46,70
Contra Costa,2020-04-21,33,44,1037,13,11,71,77
Trinity,2020-04-21,0,0,54,0,0,0,0
Mendocino,2020-04-21,0,1,151,0,0,9,1
Calaveras,2020-04-21,0,0,50,0,0,12,0
Marin,2020-04-21,5,4,242,2,1,11,9
Siskiyou,2020-04-21,0,1,36,0,1,5,1
Alameda,2020-04-21,85,59,591,41,9,66,144
Plumas,2020-04-21,0,0,9,0,0,0,0
Solano,2020-04-21,6,17,204,2,0,38,23
San Joaquin,2020-04-21,27,24,544,16,5,30,51
San Diego,2020-04-21,221,84,3776,98,21,161,305
Los Angeles,2020-04-21,1854,617,13663,613,111,941,2471
Kings,2020-04-21,8,0,223,3,0,6,8
Riverside,2020-04-21,250,120,2726,81,32,112,370
Butte,2020-04-21,0,1,424,0,1,19,1
San Mateo,2020-04-21,53,14,395,19,2,33,67
Sacramento,2020-04-21,54,39,50,21,8,72,93
Monterey,2020-04-21,7,4,875,2,1,68,11
San Benito,2020-04-22,0,0,25,0,0,1,0
Trinity,2020-04-22,0,0,54,0,0,0,0
Mariposa,2020-04-22,0,0,30,0,0,0,0
Colusa,2020-04-22,1,0,80,1,0,4,1
Alameda,2020-04-22,84,61,1141,38,17,46,145
Glenn,2020-04-22,0,0,0,0,0,0,0
Kern,2020-04-22,32,25,1167,14,1,58,57
Imperial,2020-04-22,26,8,161,12,0,1,34
Solano,2020-04-22,10,18,204,2,2,32,28
Fresno,2020-04-22,36,43,748,14,4,52,79
Sutter,2020-04-22,0,0,0,0,0,0,0
San Luis Obispo,2020-04-22,1,7,303,1,3,25,8
Santa Clara,2020-04-22,137,39,2741,68,9,157,176
Kings,2020-04-22,9,0,192,3,0,3,9
Yuba,2020-04-22,0,0,445,0,0,13,0
Siskiyou,2020-04-22,0,1,65,0,1,4,1
Merced,2020-04-22,3,3,0,0,0,4,6
Nevada,2020-04-22,1,0,57,1,0,8,1
San Joaquin,2020-04-22,29,28,632,14,4,25,57
Lake,2020-04-22,0,3,58,0,1,4,3
Amador,2020-04-22,0,1,0,0,0,3,1
Butte,2020-04-22,0,0,424,0,1,17,0
Del Norte,2020-04-22,0,2,0,0,1,3,2
Tulare,2020-04-22,27,0,226,9,0,25,27
San Mateo,2020-04-22,50,17,395,15,2,32,67
Tehama,2020-04-22,0,0,0,0,0,4,0
Orange,2020-04-22,172,111,4786,73,21,293,283
Shasta,2020-04-22,1,0,279,1,0,14,1
Sonoma,2020-04-22,3,16,596,0,7,27,19
Modoc,2020-04-22,0,0,12,0,0,0,0
Mendocino,2020-04-22,0,0,151,0,0,7,0
El Dorado,2020-04-22,0,5,165,0,1,13,5
Mono,2020-04-22,0,0,17,0,0,2,0
Lassen,2020-04-22,0,1,25,0,0,0,1
Los Angeles,2020-04-22,1858,590,17405,602,125,1215,2448
San Bernardino,2020-04-22,149,201,3830,54,32,167,350
Sacramento,2020-04-22,47,23,50,18,5,79,70
Contra Costa,2020-04-22,32,52,1031,13,14,75,84
Stanislaus,2020-04-22,13,20,1421,5,6,58,33
Riverside,2020-04-22,229,127,3668,84,25,176,356
Marin,2020-04-22,5,10,242,2,5,12,15
Madera,2020-04-22,0,3,568,0,0,22,3
Napa,2020-04-22,1,2,387,1,0,11,3
Placer,2020-04-22,5,20,0,1,1,10,25
San Diego,2020-04-22,241,77,5467,104,21,365,318
Santa Barbara,2020-04-22,25,9,427,13,3,88,34
Yolo,2020-04-22,4,0,0,1,0,14,4
Humboldt,2020-04-22,0,8,310,0,1,8,8
Ventura,2020-04-22,27,30,1049,8,9,33,57
Tuolumne,2020-04-22,0,1,151,0,0,2,1
Monterey,2020-04-22,6,3,875,2,1,95,9
Plumas,2020-04-22,0,0,9,0,0,0,0
San Francisco,2020-04-22,75,17,738,28,3,74,92
Santa Cruz,2020-04-22,3,4,351,1,1,10,7
Inyo,2020-04-22,1,0,50,1,0,4,1
Calaveras,2020-04-22,0,0,50,0,0,12,0
Fresno,2020-04-23,39,39,748,16,4,52,78
Kings,2020-04-23,9,0,192,3,0,4,9
Amador,2020-04-23,0,1,0,0,0,2,1
Sacramento,2020-04-23,48,40,737,17,7,80,88
Siskiyou,2020-04-23,0,1,65,0,1,4,1
Mono,2020-04-23,0,0,17,0,0,2,0
San Mateo,2020-04-23,53,19,517,16,1,35,72
Shasta,2020-04-23,1,0,645,1,0,16,1
Del Norte,2020-04-23,0,6,0,0,3,3,6
Lassen,2020-04-23,0,0,25,0,0,0,0
Monterey,2020-04-23,6,6,875,4,1,122,12
San Benito,2020-04-23,0,0,25,0,0,1,0
Humboldt,2020-04-23,0,7,310,0,1,4,7
Nevada,2020-04-23,1,3,116,0,1,6,4
Tehama,2020-04-23,0,0,106,0,0,4,0
San Luis Obispo,2020-04-23,1,4,526,1,1,30,5
Colusa,2020-04-23,1,0,80,1,0,4,1
Lake,2020-04-23,0,1,58,0,0,4,1
Yuba,2020-04-23,0,2,445,0,2,9,2
Napa,2020-04-23,1,1,387,1,0,2,2
El Dorado,2020-04-23,0,8,173,0,1,15,8
Santa Barbara,2020-04-23,24,16,717,13,4,90,40
Madera,2020-04-23,0,3,568,0,1,16,3
Plumas,2020-04-23,0,0,9,0,0,0,0
San Diego,2020-04-23,253,65,5501,105,12,389,318
Kern,2020-04-23,30,11,1429,16,1,63,41
Marin,2020-04-23,3,14,242,2,4,12,17
Trinity,2020-04-23,0,0,54,0,0,0,0
Orange,2020-04-23,170,143,5251,75,25,293,313
Butte,2020-04-23,0,0,424,0,1,14,0
Mendocino,2020-04-23,0,1,151,0,1,7,1
Sonoma,2020-04-23,3,17,615,0,5,48,20
Contra Costa,2020-04-23,31,51,1031,13,13,81,82
Calaveras,2020-04-23,0,1,50,0,1,11,1
San Joaquin,2020-04-23,31,34,1047,15,6,25,65
Glenn,2020-04-23,0,0,0,0,0,0,0
Mariposa,2020-04-23,0,1,30,0,0,0,1
Santa Clara,2020-04-23,137,28,2741,67,5,137,165
Tulare,2020-04-23,30,1,882,11,0,16,31
Santa Cruz,2020-04-23,3,3,351,1,0,9,6
San Bernardino,2020-04-23,146,94,4516,54,19,175,240
Tuolumne,2020-04-23,0,0,151,0,0,2,0
Los Angeles,2020-04-23,1863,595,21107,600,118,1263,2458
Imperial,2020-04-23,23,4,240,9,0,1,27
Solano,2020-04-23,11,15,204,5,4,31,26
Merced,2020-04-23,0,2,206,0,0,7,2
Inyo,2020-04-23,1,0,50,1,0,5,1
Sutter,2020-04-23,0,0,0,0,0,0,0
San Francisco,2020-04-23,75,29,1173,31,6,70,104
Yolo,2020-04-23,4,0,130,1,0,14,4
Modoc,2020-04-23,0,0,12,0,0,0,0
Placer,2020-04-23,4,21,0,1,1,11,25
Riverside,2020-04-23,222,118,3526,83,24,232,340
Alameda,2020-04-23,81,90,1129,37,24,95,171
Stanislaus,2020-04-23,14,17,1421,6,2,62,31
Ventura,2020-04-23,25,24,1305,10,5,47,49
San Luis Obispo,2020-04-24,1,8,526,1,5,24,9
Humboldt,2020-04-24,1,4,307,0,1,8,5
Orange,2020-04-24,175,138,5374,68,24,391,313
Del Norte,2020-04-24,0,4,0,0,0,6,4
Yuba,2020-04-24,0,2,445,0,2,10,2
Kern,2020-04-24,30,17,1715,16,1,59,47
Santa Clara,2020-04-24,129,34,2741,60,5,134,163
San Mateo,2020-04-24,49,16,517,16,4,40,65
San Bernardino,2020-04-24,152,101,4516,57,16,250,253
Modoc,2020-04-24,0,0,12,0,0,0,0
Merced,2020-04-24,0,5,206,0,1,6,5
Tulare,2020-04-24,33,0,882,11,0,19,33
Placer,2020-04-24,4,18,0,0,2,43,22
Santa Cruz,2020-04-24,4,1,351,2,0,12,5
Alameda,2020-04-24,79,63,1127,39,10,110,142
Colusa,2020-04-24,1,0,80,1,0,5,1
Sutter,2020-04-24,0,0,0,0,0,0,0
Siskiyou,2020-04-24,0,0,65,0,0,5,0
Mendocino,2020-04-24,0,1,151,0,0,9,1
Los Angeles,2020-04-24,1860,546,20782,600,87,1378,2406
Stanislaus,2020-04-24,12,15,1421,6,2,58,27
Napa,2020-04-24,1,0,387,1,0,7,1
Trinity,2020-04-24,0,0,54,0,0,0,0
Riverside,2020-04-24,223,120,3524,82,26,222,343
Amador,2020-04-24,0,1,0,0,0,6,1
El Dorado,2020-04-24,0,7,173,0,3,12,7
Inyo,2020-04-24,1,3,89,1,0,5,4
San Benito,2020-04-24,0,0,25,0,0,2,0
Fresno,2020-04-24,41,37,748,19,1,47,78
Santa Barbara,2020-04-24,21,11,717,12,5,80,32
Yolo,2020-04-24,4,0,130,1,0,17,4
Monterey,2020-04-24,5,8,875,4,1,112,13
Plumas,2020-04-24,0,0,9,0,0,0,0
Glenn,2020-04-24,0,0,0,0,0,0,0
Nevada,2020-04-24,1,4,116,0,2,6,5
Kings,2020-04-24,9,0,192,2,0,4,9
Shasta,2020-04-24,1,0,645,1,0,16,1
Mono,2020-04-24,0,0,17,0,0,2,0
Imperial,2020-04-24,24,10,248,8,1,6,34
Lake,2020-04-24,0,1,58,0,1,4,1
Tuolumne,2020-04-24,0,0,151,0,0,4,0
Lassen,2020-04-24,0,0,25,0,0,0,0
Calaveras,2020-04-24,0,2,50,0,1,11,2
San Diego,2020-04-24,257,78,5606,107,13,408,335
Tehama,2020-04-24,0,1,106,0,1,4,1
Mariposa,2020-04-24,0,0,30,0,0,0,0
Sonoma,2020-04-24,3,20,616,0,3,45,23
Sacramento,2020-04-24,53,37,737,17,11,121,90
Contra Costa,2020-04-24,29,54,1031,12,11,87,83
San Joaquin,2020-04-24,29,20,1047,12,4,26,49
Butte,2020-04-24,0,4,424,0,3,18,4
Madera,2020-04-24,0,4,568,0,0,11,4
Solano,2020-04-24,10,16,204,4,3,32,26
San Francisco,2020-04-24,75,19,1173,30,5,108,94
Marin,2020-04-24,2,11,242,2,2,12,13
Ventura,2020-04-24,24,63,1283,6,3,40,87
Merced,2020-04-25,0,3,206,0,1,9,3
Placer,2020-04-25,4,30,340,0,3,106,34
Riverside,2020-04-25,218,138,3550,81,30,235,356
Shasta,2020-04-25,1,0,645,1,0,11,1
Mariposa,2020-04-25,0,0,30,0,0,0,0
Trinity,2020-04-25,0,0,54,0,0,0,0
Santa Clara,2020-04-25,125,47,3331,62,15,203,172
Siskiyou,2020-04-25,0,1,65,0,0,5,1
Glenn,2020-04-25,0,0,0,0,0,0,0
Tulare,2020-04-25,26,0,882,7,0,22,26
San Mateo,2020-04-25,47,27,790,15,11,43,74
Ventura,2020-04-25,27,71,1286,6,9,51,98
Kings,2020-04-25,6,0,199,2,0,5,6
Sonoma,2020-04-25,3,9,789,0,0,64,12
Santa Cruz,2020-04-25,4,4,354,2,3,4,8
Mendocino,2020-04-25,0,0,151,0,0,10,0
San Diego,2020-04-25,268,96,5561,110,19,395,364
El Dorado,2020-04-25,1,7,155,0,2,11,8
Madera,2020-04-25,0,2,568,0,1,20,2
San Luis Obispo,2020-04-25,1,4,526,1,1,28,5
Monterey,2020-04-25,5,9,875,3,0,111,14
Nevada,2020-04-25,1,3,110,0,2,2,4
Orange,2020-04-25,177,133,5370,74,21,394,310
Santa Barbara,2020-04-25,23,12,717,16,4,79,35
Sutter,2020-04-25,0,0,0,0,0,0,0
San Benito,2020-04-25,0,0,25,0,0,0,0
Marin,2020-04-25,2,13,358,2,3,16,15
Colusa,2020-04-25,1,1,80,1,1,4,2
Contra Costa,2020-04-25,25,53,1464,10,6,154,78
Mono,2020-04-25,0,0,17,0,0,2,0
Humboldt,2020-04-25,0,3,308,0,0,4,3
Kern,2020-04-25,29,18,1715,22,3,56,47
Solano,2020-04-25,10,16,592,3,4,61,26
Fresno,2020-04-25,41,45,2014,19,2,86,86
Napa,2020-04-25,1,1,387,1,1,1,2
Inyo,2020-04-25,0,3,89,0,0,6,3
Tehama,2020-04-25,0,1,106,0,1,4,1
Sacramento,2020-04-25,53,46,1261,20,14,184,99
Yolo,2020-04-25,5,0,130,1,0,18,5
Lassen,2020-04-25,0,0,25,0,0,0,0
Amador,2020-04-25,0,1,0,0,1,5,1
San Francisco,2020-04-25,73,18,1412,29,3,132,91
San Bernardino,2020-04-25,147,101,4496,53,14,277,248
Tuolumne,2020-04-25,0,0,151,0,0,4,0
Plumas,2020-04-25,0,0,9,0,0,0,0
Del Norte,2020-04-25,0,4,0,0,0,0,4
Alameda,2020-04-25,83,53,1748,39,6,197,136
Butte,2020-04-25,0,3,424,0,0,14,3
Calaveras,2020-04-25,0,1,50,0,0,11,1
San Joaquin,2020-04-25,27,20,1146,12,5,20,47
Stanislaus,2020-04-25,21,23,1573,5,1,90,44
Lake,2020-04-25,0,2,58,0,0,3,2
Yuba,2020-04-25,0,2,445,0,2,6,2
Imperial,2020-04-25,24,8,249,8,1,5,32
Modoc,2020-04-25,0,0,12,0,0,0,0
Los Angeles,2020-04-25,1845,572,20233,579,99,1359,2417
Orange,2020-04-26,180,109,5370,73,23,378,289
Amador,2020-04-26,0,0,0,0,0,6,0
Santa Barbara,2020-04-26,24,13,717,12,4,85,37
Yuba,2020-04-26,0,2,445,0,1,10,2
Lake,2020-04-26,0,1,58,0,0,5,1
Contra Costa,2020-04-26,27,42,1464,9,9,150,69
Sonoma,2020-04-26,1,9,789,0,1,63,10
Santa Cruz,2020-04-26,4,1,354,2,0,5,5
Mono,2020-04-26,0,0,17,0,0,2,0
Sutter,2020-04-26,0,0,0,0,0,0,0
Monterey,2020-04-26,5,5,875,3,2,113,10
San Francisco,2020-04-26,79,21,1412,31,3,126,100
Nevada,2020-04-26,1,2,110,0,2,5,3
Butte,2020-04-26,0,0,424,0,0,18,0
San Benito,2020-04-26,0,0,25,0,0,0,0
Lassen,2020-04-26,0,0,25,0,0,0,0
Fresno,2020-04-26,37,44,2014,18,9,79,81
San Mateo,2020-04-26,53,10,790,18,2,43,63
San Luis Obispo,2020-04-26,1,3,526,1,2,21,4
Merced,2020-04-26,0,4,206,0,2,6,4
Humboldt,2020-04-26,0,0,305,0,0,4,0
San Bernardino,2020-04-26,146,83,4496,50,20,201,229
Del Norte,2020-04-26,0,2,0,0,1,5,2
Modoc,2020-04-26,0,0,12,0,0,0,0
Yolo,2020-04-26,1,1,130,1,1,23,2
Shasta,2020-04-26,1,0,645,1,0,10,1
San Joaquin,2020-04-26,24,19,1146,9,4,23,43
Solano,2020-04-26,8,14,592,3,1,62,22
Siskiyou,2020-04-26,0,0,65,0,0,5,0
Glenn,2020-04-26,0,0,0,0,0,0,0
Kern,2020-04-26,29,15,1706,23,0,50,44
Stanislaus,2020-04-26,28,19,1571,7,4,97,47
Tulare,2020-04-26,26,0,882,8,0,21,26
Mendocino,2020-04-26,0,0,151,0,0,12,0
Alameda,2020-04-26,84,43,1748,42,5,191,127
Mariposa,2020-04-26,0,0,30,0,0,0,0
Sacramento,2020-04-26,48,40,1255,16,6,171,88
Marin,2020-04-26,3,7,358,2,3,19,10
Plumas,2020-04-26,0,0,9,0,0,0,0
San Diego,2020-04-26,273,90,5552,114,21,427,363
El Dorado,2020-04-26,1,8,155,0,3,7,9
Calaveras,2020-04-26,0,0,50,0,0,11,0
Los Angeles,2020-04-26,1887,575,20162,588,122,1262,2462
Colusa,2020-04-26,1,1,80,1,1,4,2
Placer,2020-04-26,4,21,340,1,5,101,25
Napa,2020-04-26,1,0,387,1,0,8,1
Inyo,2020-04-26,0,0,89,0,0,6,0
Madera,2020-04-26,0,1,568,0,0,20,1
Tehama,2020-04-26,0,0,106,0,0,3,0
Trinity,2020-04-26,0,0,54,0,0,0,0
Ventura,2020-04-26,27,73,1282,6,3,55,100
Tuolumne,2020-04-26,0,0,151,0,0,4,0
Kings,2020-04-26,9,0,199,2,0,6,9
Santa Clara,2020-04-26,118,64,3331,60,17,194,182
Imperial,2020-04-26,26,12,252,8,2,5,38
Riverside,2020-04-26,215,152,3625,75,35,230,367
Mono,2020-04-27,0,0,17,0,0,2,0
Kings,2020-04-27,9,2,199,2,0,5,11
Yuba,2020-04-27,0,3,445,0,3,13,3
Imperial,2020-04-27,27,7,247,11,1,4,34
San Joaquin,2020-04-27,24,23,1146,10,6,25,47
Lake,2020-04-27,0,1,58,0,1,5,1
Inyo,2020-04-27,0,0,50,0,0,6,0
Riverside,2020-04-27,220,118,3649,73,25,208,338
San Luis Obispo,2020-04-27,3,6,526,2,2,37,9
Calaveras,2020-04-27,0,1,50,0,0,12,1
San Diego,2020-04-27,277,59,5544,115,15,377,336
El Dorado,2020-04-27,1,7,155,0,2,7,8
Fresno,2020-04-27,39,52,2013,17,3,89,91
Solano,2020-04-27,8,16,592,4,3,60,24
San Mateo,2020-04-27,52,28,790,16,4,62,80
Glenn,2020-04-27,0,0,0,0,0,0,0
Nevada,2020-04-27,1,1,103,0,1,2,2
Lassen,2020-04-27,0,0,25,0,0,0,0
Modoc,2020-04-27,0,0,12,0,0,0,0
Stanislaus,2020-04-27,30,36,1573,8,8,90,66
Ventura,2020-04-27,28,75,1282,6,10,36,103
Napa,2020-04-27,1,0,387,1,0,8,1
Marin,2020-04-27,2,6,358,1,0,26,8
San Bernardino,2020-04-27,154,83,4556,49,18,183,237
Colusa,2020-04-27,1,1,80,1,1,4,2
Kern,2020-04-27,31,19,1702,23,2,53,50
Orange,2020-04-27,189,113,5370,76,23,370,302
Plumas,2020-04-27,0,0,9,0,0,0,0
Amador,2020-04-27,0,0,0,0,0,5,0
Santa Barbara,2020-04-27,26,13,717,12,3,82,39
Alameda,2020-04-27,81,47,1748,39,8,183,128
San Francisco,2020-04-27,82,19,1412,29,3,149,101
Del Norte,2020-04-27,0,5,0,0,2,5,5
Humboldt,2020-04-27,0,3,305,0,0,4,3
Mendocino,2020-04-27,0,1,151,0,1,7,1
Sonoma,2020-04-27,2,11,789,0,2,63,13
Santa Cruz,2020-04-27,2,1,354,1,0,3,3
Mariposa,2020-04-27,0,1,30,0,0,0,1
Santa Clara,2020-04-27,115,49,3331,56,10,206,164
Butte,2020-04-27,0,0,424,0,0,22,0
Sutter,2020-04-27,0,0,0,0,0,0,0
Madera,2020-04-27,0,0,568,0,0,10,0
Yolo,2020-04-27,0,1,130,0,0,15,1
San Benito,2020-04-27,0,0,25,0,0,0,0
Monterey,2020-04-27,4,2,875,2,1,120,6
Tehama,2020-04-27,0,0,106,0,0,3,0
Sacramento,2020-04-27,46,42,1238,16,13,164,88
Los Angeles,2020-04-27,1940,609,20205,592,117,1226,2549
Merced,2020-04-27,1,3,206,0,0,7,4
Contra Costa,2020-04-27,24,44,1485,10,11,158,68
Siskiyou,2020-04-27,0,1,65,0,1,3,1
Tulare,2020-04-27,29,0,898,7,0,27,29
Tuolumne,2020-04-27,0,1,151,0,1,2,1
Placer,2020-04-27,5,17,340,1,3,111,22
Trinity,2020-04-27,0,0,54,0,0,0,0
Shasta,2020-04-27,1,1,645,1,0,12,2
Fresno,2020-04-28,39,44,2007,14,7,87,83
Stanislaus,2020-04-28,31,30,1573,7,2,92,61
Sutter,2020-04-28,0,0,0,0,0,0,0
Humboldt,2020-04-28,0,6,305,0,1,5,6
Sonoma,2020-04-28,3,11,789,0,4,52,14
Lassen,2020-04-28,0,0,25,0,0,0,0
Solano,2020-04-28,12,16,592,5,0,61,28
Mariposa,2020-04-28,0,1,30,0,0,0,1
Siskiyou,2020-04-28,0,2,65,0,1,4,2
Placer,2020-04-28,5,21,340,1,2,103,26
Santa Clara,2020-04-28,116,34,3331,51,5,197,150
Trinity,2020-04-28,0,0,54,0,0,0,0
Tuolumne,2020-04-28,0,0,151,0,0,1,0
Santa Barbara,2020-04-28,27,16,717,12,4,81,43
Yolo,2020-04-28,0,0,130,0,1,10,0
Del Norte,2020-04-28,0,5,0,0,1,3,5
Marin,2020-04-28,1,7,358,1,1,19,8
Shasta,2020-04-28,2,1,645,2,0,6,3
Riverside,2020-04-28,215,112,3716,78,20,170,327
Imperial,2020-04-28,29,4,260,12,1,4,33
Santa Cruz,2020-04-28,2,0,354,1,0,15,2
San Joaquin,2020-04-28,24,16,1146,10,6,25,40
Ventura,2020-04-28,31,71,1295,11,11,26,102
San Benito,2020-04-28,0,0,25,0,0,2,0
Napa,2020-04-28,1,0,387,0,0,5,1
Orange,2020-04-28,203,84,5370,75,25,369,287
Mendocino,2020-04-28,0,0,151,0,0,8,0
San Bernardino,2020-04-28,156,123,4556,51,31,179,279
Colusa,2020-04-28,1,0,80,1,0,5,1
Alameda,2020-04-28,76,64,1748,37,13,148,140
Los Angeles,2020-04-28,1962,581,20337,597,130,1209,2543
Monterey,2020-04-28,2,7,875,2,2,116,9
Glenn,2020-04-28,0,0,0,0,0,0,0
San Francisco,2020-04-28,81,23,1412,27,9,132,104
Sacramento,2020-04-28,43,33,1256,16,9,129,76
Mono,2020-04-28,0,0,17,0,0,2,0
Tulare,2020-04-28,32,2,898,6,0,26,34
San Luis Obispo,2020-04-28,3,3,526,3,1,33,6
El Dorado,2020-04-28,1,7,159,0,2,8,8
Calaveras,2020-04-28,0,1,50,0,0,12,1
Nevada,2020-04-28,1,2,102,1,1,4,3
Contra Costa,2020-04-28,27,43,1485,11,12,137,70
Plumas,2020-04-28,0,0,9,0,0,0,0
Butte,2020-04-28,0,1,424,0,0,19,1
Lake,2020-04-28,0,2,58,0,1,3,2
San Diego,2020-04-28,276,105,5605,112,18,361,381
Yuba,2020-04-28,0,2,445,0,1,8,2
Tehama,2020-04-28,0,0,106,0,0,5,0
Madera,2020-04-28,0,1,568,0,0,19,1
Merced,2020-04-28,2,6,206,1,1,4,8
Kern,2020-04-28,32,13,1702,22,3,53,45
Amador,2020-04-28,0,0,0,0,0,4,0
Kings,2020-04-28,9,2,199,2,0,8,11
Inyo,2020-04-28,0,0,56,0,0,6,0
Modoc,2020-04-28,0,1,12,0,0,0,1
San Mateo,2020-04-28,50,13,790,17,0,49,63
San Benito,2020-04-29,0,0,25,0,0,1,0
Tehama,2020-04-29,0,0,106,0,0,5,0
Tulare,2020-04-29,30,0,920,5,0,30,30
Lassen,2020-04-29,0,0,25,0,0,0,0
Merced,2020-04-29,2,7,206,1,1,5,9
San Luis Obispo,2020-04-29,3,2,526,3,0,34,5
Del Norte,2020-04-29,0,3,0,0,1,2,3
San Bernardino,2020-04-29,156,124,4556,56,23,162,280
Solano,2020-04-29,10,18,592,5,5,56,28
El Dorado,2020-04-29,0,4,156,0,2,6,4
Madera,2020-04-29,0,1,568,0,0,22,1
Marin,2020-04-29,0,6,358,0,1,22,6
Humboldt,2020-04-29,1,5,305,0,3,7,6
Stanislaus,2020-04-29,35,26,1573,4,5,97,61
Sacramento,2020-04-29,42,36,1314,17,5,137,78
Trinity,2020-04-29,0,0,54,0,0,0,0
Inyo,2020-04-29,0,0,56,0,0,6,0
Kings,2020-04-29,9,2,199,2,0,8,11
Imperial,2020-04-29,29,5,258,13,0,4,34
Ventura,2020-04-29,31,26,1354,10,7,50,57
Mono,2020-04-29,0,0,17,0,0,1,0
Los Angeles,2020-04-29,1959,591,20960,602,97,1167,2550
Riverside,2020-04-29,212,124,3728,78,32,201,336
Orange,2020-04-29,211,91,5397,76,16,373,302
San Joaquin,2020-04-29,21,20,1146,9,7,30,41
Yolo,2020-04-29,0,0,130,0,1,10,0
Lake,2020-04-29,0,2,58,0,1,1,2
Modoc,2020-04-29,0,0,24,0,0,0,0
Santa Barbara,2020-04-29,28,14,717,12,2,85,42
Nevada,2020-04-29,1,2,102,1,1,4,3
Yuba,2020-04-29,0,0,445,0,0,10,0
Monterey,2020-04-29,4,3,875,3,0,106,7
Alameda,2020-04-29,76,63,1746,33,13,168,139
Mariposa,2020-04-29,0,1,30,0,0,0,1
Shasta,2020-04-29,2,0,645,2,0,5,2
Calaveras,2020-04-29,0,0,50,0,0,12,0
Tuolumne,2020-04-29,0,0,151,0,0,0,0
Sonoma,2020-04-29,5,14,789,2,2,51,19
Placer,2020-04-29,5,28,340,1,3,80,33
Amador,2020-04-29,0,0,0,0,0,4,0
Santa Clara,2020-04-29,110,34,3331,46,2,198,144
Fresno,2020-04-29,38,48,2007,16,8,91,86
Mendocino,2020-04-29,0,0,151,0,0,6,0
Plumas,2020-04-29,0,0,39,0,0,0,0
Sutter,2020-04-29,0,0,0,0,0,0,0
Glenn,2020-04-29,0,0,0,0,0,0,0
Contra Costa,2020-04-29,24,50,1485,9,14,131,74
Napa,2020-04-29,1,0,387,0,0,6,1
Santa Cruz,2020-04-29,2,0,354,1,0,8,2
San Francisco,2020-04-29,80,24,1862,26,6,107,104
San Diego,2020-04-29,282,73,5619,119,17,363,355
Kern,2020-04-29,36,13,1702,23,3,59,49
San Mateo,2020-04-29,51,19,790,16,1,52,70
Butte,2020-04-29,0,2,424,0,1,20,2
Siskiyou,2020-04-29,0,3,65,0,1,2,3
Colusa,2020-04-29,1,0,80,1,0,5,1
Monterey,2020-04-30,6,6,875,3,3,106,12
Plumas,2020-04-30,0,0,39,0,0,0,0
Contra Costa,2020-04-30,24,43,1485,9,6,141,67
Del Norte,2020-04-30,0,4,0,0,2,2,4
Lake,2020-04-30,0,2,58,0,0,2,2
Los Angeles,2020-04-30,1894,470,18236,591,93,1235,2364
Alameda,2020-04-30,74,52,1746,34,12,165,126
Napa,2020-04-30,1,0,387,0,0,7,1
Calaveras,2020-04-30,0,0,50,0,0,12,0
Yolo,2020-04-30,0,0,130,0,0,12,0
Tuolumne,2020-04-30,0,0,151,0,0,0,0
Lassen,2020-04-30,0,0,25,0,0,0,0
Glenn,2020-04-30,0,0,0,0,0,0,0
Shasta,2020-04-30,2,0,645,2,0,10,2
Yuba,2020-04-30,0,0,445,0,0,14,0
Nevada,2020-04-30,0,1,104,0,1,4,1
Imperial,2020-04-30,29,3,261,13,0,4,32
El Dorado,2020-04-30,0,6,156,0,1,10,6
Sutter,2020-04-30,0,0,0,0,0,0,0
Placer,2020-04-30,4,28,340,1,4,82,32
Amador,2020-04-30,0,0,0,0,0,4,0
Merced,2020-04-30,3,2,206,1,0,5,5
Siskiyou,2020-04-30,0,2,65,0,0,4,2
Colusa,2020-04-30,1,0,80,1,0,5,1
San Luis Obispo,2020-04-30,3,3,526,3,1,30,6
Modoc,2020-04-30,0,0,41,0,0,0,0
Butte,2020-04-30,0,0,424,0,0,20,0
San Francisco,2020-04-30,85,11,1887,32,1,100,96
Santa Clara,2020-04-30,104,37,3331,45,3,191,141
Humboldt,2020-04-30,0,7,305,0,2,8,7
Tulare,2020-04-30,28,2,920,5,2,29,30
Sonoma,2020-04-30,5,7,789,2,3,50,12
Santa Cruz,2020-04-30,3,0,354,2,0,16,3
Tehama,2020-04-30,0,0,106,0,0,4,0
San Joaquin,2020-04-30,17,24,1146,8,4,30,41
San Benito,2020-04-30,1,0,25,0,0,2,1
Stanislaus,2020-04-30,35,27,1573,3,5,100,62
Orange,2020-04-30,214,68,4725,74,13,457,282
San Bernardino,2020-04-30,158,100,3738,58,17,184,258
Inyo,2020-04-30,0,0,56,0,0,6,0
Mendocino,2020-04-30,0,0,151,0,0,5,0
Kings,2020-04-30,10,0,199,2,0,3,10
Sacramento,2020-04-30,37,35,1332,17,5,129,72
Fresno,2020-04-30,41,37,1997,15,4,83,78
Ventura,2020-04-30,33,18,1381,10,4,51,51
Riverside,2020-04-30,214,138,3310,85,30,184,352
Trinity,2020-04-30,0,0,54,0,0,0,0
Santa Barbara,2020-04-30,26,9,717,13,3,85,35
Madera,2020-04-30,0,3,568,0,0,21,3
Solano,2020-04-30,11,12,592,5,3,57,23
Mono,2020-04-30,0,0,17,0,0,1,0
Kern,2020-04-30,29,25,1385,20,0,49,54
Marin,2020-04-30,0,3,358,0,0,19,3
San Diego,2020-04-30,283,81,4933,122,19,357,364
Mariposa,2020-04-30,0,2,30,0,0,0,2
San Mateo,2020-04-30,53,10,790,16,1,48,63
Humboldt,2020-05-01,0,5,305,0,0,7,5
Los Angeles,2020-05-01,1884,511,18549,606,98,1185,2395
Sonoma,2020-05-01,4,15,789,1,4,52,19
Modoc,2020-05-01,0,0,41,0,0,0,0
Calaveras,2020-05-01,0,1,50,0,0,12,1
Yuba,2020-05-01,0,0,445,0,0,8,0
Tuolumne,2020-05-01,0,0,151,0,0,0,0
Lassen,2020-05-01,0,0,25,0,0,0,0
Stanislaus,2020-05-01,35,19,1573,2,3,86,54
Tehama,2020-05-01,0,0,106,0,0,3,0
Butte,2020-05-01,0,1,424,0,1,20,1
Trinity,2020-05-01,0,0,54,0,0,0,0
Contra Costa,2020-05-01,21,37,1485,8,7,143,58
Placer,2020-05-01,5,15,340,2,2,80,20
Shasta,2020-05-01,1,0,645,1,0,15,1
Colusa,2020-05-01,1,0,80,1,0,5,1
Imperial,2020-05-01,36,3,263,14,1,2,39
San Diego,2020-05-01,290,60,4932,123,11,365,350
Mendocino,2020-05-01,0,0,151,0,0,6,0
Mariposa,2020-05-01,0,2,30,0,0,0,2
San Benito,2020-05-01,1,0,25,0,0,1,1
Yolo,2020-05-01,0,0,130,0,0,14,0
Amador,2020-05-01,0,0,0,0,0,-2,0
Marin,2020-05-01,0,5,358,0,0,23,5
Alameda,2020-05-01,75,60,1746,32,13,165,135
Sacramento,2020-05-01,35,29,1347,14,4,122,64
Nevada,2020-05-01,0,1,105,0,1,6,1
Tulare,2020-05-01,28,2,920,5,2,23,30
Lake,2020-05-01,0,2,58,0,1,2,2
Del Norte,2020-05-01,0,0,0,0,0,3,0
Kern,2020-05-01,35,13,1717,19,0,47,48
Siskiyou,2020-05-01,0,2,65,0,0,4,2
Riverside,2020-05-01,210,152,3302,83,39,217,362
San Bernardino,2020-05-01,157,106,3738,55,15,138,263
Glenn,2020-05-01,0,0,0,0,0,0,0
San Luis Obispo,2020-05-01,3,4,526,1,2,21,7
Kings,2020-05-01,11,0,199,2,0,1,11
Plumas,2020-05-01,0,0,39,0,0,0,0
Merced,2020-05-01,4,1,206,1,0,3,5
Orange,2020-05-01,218,101,4725,62,23,374,319
Santa Cruz,2020-05-01,3,1,354,2,0,13,4
Santa Clara,2020-05-01,97,43,3331,38,6,197,140
San Mateo,2020-05-01,48,12,790,15,3,49,60
Napa,2020-05-01,0,2,387,0,0,6,2
Santa Barbara,2020-05-01,28,10,717,13,2,77,38
Ventura,2020-05-01,29,12,1375,10,4,51,41
Mono,2020-05-01,0,0,17,0,0,1,0
Madera,2020-05-01,0,0,568,0,0,19,0
Sutter,2020-05-01,0,0,0,0,0,0,0
Inyo,2020-05-01,0,0,56,0,0,4,0
Solano,2020-05-01,10,11,592,6,3,58,21
San Joaquin,2020-05-01,17,16,1146,9,5,21,33
Monterey,2020-05-01,7,1,875,3,1,105,8
San Francisco,2020-05-01,86,14,1887,32,0,101,100
Fresno,2020-05-01,44,28,2004,18,3,77,72
El Dorado,2020-05-01,0,2,156,0,1,11,2
San Francisco,2020-05-02,81,27,1915,29,7,101,108
Mendocino,2020-05-02,0,0,151,0,0,7,0
Santa Cruz,2020-05-02,3,0,354,1,0,11,3
El Dorado,2020-05-02,0,2,156,0,1,10,2
Kern,2020-05-02,36,7,1723,19,1,41,43
San Mateo,2020-05-02,48,13,790,16,1,51,61
Colusa,2020-05-02,1,0,80,1,0,5,1
Fresno,2020-05-02,45,36,2008,17,2,87,81
Napa,2020-05-02,0,1,387,0,0,3,1
Glenn,2020-05-02,0,0,0,0,0,0,0
Mono,2020-05-02,0,0,17,0,0,1,0
Solano,2020-05-02,14,15,592,7,6,54,29
Humboldt,2020-05-02,0,5,305,0,0,8,5
Placer,2020-05-02,5,23,340,2,4,82,28
Sacramento,2020-05-02,23,35,1299,16,10,119,58
San Diego,2020-05-02,289,68,5513,123,18,370,357
Shasta,2020-05-02,0,0,645,0,0,13,0
Amador,2020-05-02,0,0,0,0,0,3,0
Tulare,2020-05-02,28,2,920,5,2,24,30
Yuba,2020-05-02,0,0,445,0,0,12,0
Lassen,2020-05-02,0,0,25,0,0,0,0
Trinity,2020-05-02,0,0,54,0,0,0,0
Sonoma,2020-05-02,3,14,789,2,1,49,17
San Benito,2020-05-02,1,0,25,0,0,2,1
Monterey,2020-05-02,8,3,829,3,2,103,11
Siskiyou,2020-05-02,0,0,65,0,0,6,0
San Luis Obispo,2020-05-02,3,10,526,1,4,21,13
Modoc,2020-05-02,0,0,41,0,0,0,0
Alameda,2020-05-02,73,59,1746,31,7,163,132
Tuolumne,2020-05-02,0,0,151,0,0,2,0
Calaveras,2020-05-02,0,1,50,0,1,11,1
Merced,2020-05-02,4,4,206,2,0,3,8
Los Angeles,2020-05-02,1819,561,21176,599,105,1185,2380
Santa Barbara,2020-05-02,25,11,717,13,4,80,36
Mariposa,2020-05-02,0,0,30,0,0,0,0
Butte,2020-05-02,0,0,424,0,0,19,0
Ventura,2020-05-02,26,26,1416,10,7,55,52
Stanislaus,2020-05-02,36,30,1573,1,7,87,66
Marin,2020-05-02,0,11,358,0,0,24,11
San Bernardino,2020-05-02,144,116,4419,55,22,126,260
Riverside,2020-05-02,211,126,3829,78,31,197,337
Contra Costa,2020-05-02,20,45,1485,9,8,139,65
Plumas,2020-05-02,0,0,39,0,0,0,0
Inyo,2020-05-02,0,0,42,0,0,2,0
Del Norte,2020-05-02,0,0,0,0,0,4,0
Madera,2020-05-02,0,0,568,0,0,20,0
Sutter,2020-05-02,0,0,0,0,0,0,0
Yolo,2020-05-02,0,0,130,0,0,11,0
Orange,2020-05-02,215,107,5374,64,34,376,322
San Joaquin,2020-05-02,17,16,1146,9,6,22,33
Santa Clara,2020-05-02,95,36,3331,40,6,195,131
Imperial,2020-05-02,36,3,261,14,1,2,39
Nevada,2020-05-02,0,2,118,0,1,6,2
Kings,2020-05-02,9,1,199,2,0,3,10
Lake,2020-05-02,0,0,58,0,0,2,0
Tehama,2020-05-02,0,0,106,0,0,5,0
Napa,2020-05-03,0,0,387,0,0,4,0
Kings,2020-05-03,9,1,199,2,0,2,10
Alameda,2020-05-03,73,62,1746,33,15,164,135
Shasta,2020-05-03,0,0,645,0,0,12,0
Siskiyou,2020-05-03,0,0,65,0,0,6,0
Placer,2020-05-03,7,12,340,2,4,84,19
Merced,2020-05-03,6,3,206,4,0,3,9
San Bernardino,2020-05-03,154,100,4419,59,16,135,254
San Luis Obispo,2020-05-03,4,5,526,1,3,22,9
Santa Barbara,2020-05-03,28,6,717,14,1,88,34
Nevada,2020-05-03,0,1,118,0,0,8,1
Inyo,2020-05-03,0,1,42,0,0,2,1
Mono,2020-05-03,0,0,17,0,0,1,0
San Diego,2020-05-03,276,76,5545,125,20,369,352
Santa Cruz,2020-05-03,3,0,354,1,0,15,3
Marin,2020-05-03,0,6,358,0,0,24,6
Madera,2020-05-03,0,0,568,0,0,19,0
Tehama,2020-05-03,0,0,106,0,0,5,0
San Joaquin,2020-05-03,17,18,1146,9,6,22,35
Mariposa,2020-05-03,0,0,30,0,0,0,0
San Mateo,2020-05-03,47,14,790,16,2,50,61
Plumas,2020-05-03,0,2,29,0,0,0,2
Stanislaus,2020-05-03,33,15,1573,1,7,77,48
Trinity,2020-05-03,0,0,54,0,0,0,0
El Dorado,2020-05-03,0,2,154,0,1,10,2
Humboldt,2020-05-03,1,2,305,0,0,8,3
Sacramento,2020-05-03,26,31,1293,16,12,117,57
Mendocino,2020-05-03,0,0,151,0,0,7,0
Riverside,2020-05-03,217,132,3809,78,34,179,349
Orange,2020-05-03,218,90,5374,66,25,376,308
Contra Costa,2020-05-03,20,44,1485,8,7,147,64
Sonoma,2020-05-03,2,14,789,1,4,51,16
Santa Clara,2020-05-03,93,39,3331,40,7,199,132
Los Angeles,2020-05-03,1779,520,21621,599,95,1178,2299
Yuba,2020-05-03,0,1,445,0,1,7,1
Del Norte,2020-05-03,0,0,0,0,0,7,0
Fresno,2020-05-03,45,43,2008,18,4,86,88
Monterey,2020-05-03,7,1,829,3,1,92,8
San Francisco,2020-05-03,83,18,1915,30,4,107,101
Glenn,2020-05-03,0,0,0,0,0,0,0
Calaveras,2020-05-03,0,1,50,0,1,11,1
Kern,2020-05-03,30,12,1710,16,2,86,42
Imperial,2020-05-03,39,5,251,13,1,3,44
Lassen,2020-05-03,0,0,25,0,0,0,0
San Benito,2020-05-03,0,0,25,0,0,2,0
Butte,2020-05-03,0,2,424,0,0,22,2
Amador,2020-05-03,0,0,0,0,0,2,0
Ventura,2020-05-03,29,34,1386,8,8,58,63
Solano,2020-05-03,14,11,592,8,1,58,25
Colusa,2020-05-03,1,0,80,1,0,5,1
Lake,2020-05-03,0,3,58,0,1,2,3
Yolo,2020-05-03,0,0,130,1,1,9,0
Tuolumne,2020-05-03,0,0,151,0,0,2,0
Tulare,2020-05-03,23,5,920,6,1,26,28
Modoc,2020-05-03,0,0,41,0,0,0,0
Sutter,2020-05-03,0,0,0,0,0,0,0
San Bernardino,2020-05-04,156,103,4564,58,11,146,259
Yolo,2020-05-04,0,0,130,1,1,9,0
Colusa,2020-05-04,0,0,88,0,0,6,0
Mariposa,2020-05-04,0,0,30,0,0,0,0
Tehama,2020-05-04,0,0,106,0,0,6,0
Sonoma,2020-05-04,3,13,789,1,2,57,16
Calaveras,2020-05-04,0,1,50,0,0,11,1
Humboldt,2020-05-04,1,2,344,0,1,8,3
Napa,2020-05-04,0,0,387,0,1,5,0
Riverside,2020-05-04,216,107,3898,75,29,202,323
Shasta,2020-05-04,0,0,667,0,0,12,0
Kings,2020-05-04,9,1,199,2,0,4,10
Amador,2020-05-04,0,0,0,0,0,3,0
Madera,2020-05-04,1,0,568,0,0,22,1
Trinity,2020-05-04,0,0,54,0,0,0,0
Lassen,2020-05-04,0,0,25,0,0,0,0
Butte,2020-05-04,0,1,448,0,0,12,1
Marin,2020-05-04,1,7,350,0,3,21,8
San Francisco,2020-05-04,84,10,1887,26,0,118,94
Sutter,2020-05-04,0,0,0,0,0,0,0
Solano,2020-05-04,15,22,592,8,0,57,37
San Diego,2020-05-04,300,54,5588,124,11,373,354
Stanislaus,2020-05-04,34,11,995,2,3,90,45
Merced,2020-05-04,6,6,206,4,1,6,12
Ventura,2020-05-04,26,17,1383,9,5,55,43
San Mateo,2020-05-04,45,14,790,13,0,54,59
Plumas,2020-05-04,0,2,29,0,0,0,2
Imperial,2020-05-04,47,9,252,16,0,1,56
Lake,2020-05-04,0,4,58,0,0,4,4
Glenn,2020-05-04,0,0,0,0,0,0,0
San Luis Obispo,2020-05-04,3,8,526,2,2,24,11
Modoc,2020-05-04,0,0,41,0,0,0,0
Santa Clara,2020-05-04,90,33,3331,37,5,210,123
Tulare,2020-05-04,21,1,920,6,0,24,22
Monterey,2020-05-04,5,0,829,3,0,102,5
Yuba,2020-05-04,0,1,445,0,1,9,1
Sacramento,2020-05-04,27,23,1284,16,5,131,50
Inyo,2020-05-04,0,1,42,0,0,4,1
Placer,2020-05-04,11,6,340,1,0,88,17
Fresno,2020-05-04,47,39,2001,19,6,89,86
Los Angeles,2020-05-04,1828,543,22298,581,95,1166,2371
Santa Cruz,2020-05-04,3,0,354,0,0,15,3
Kern,2020-05-04,36,12,1728,21,2,74,48
Contra Costa,2020-05-04,19,32,1485,7,6,142,51
San Benito,2020-05-04,0,0,25,0,0,2,0
Del Norte,2020-05-04,0,0,0,0,0,5,0
Mono,2020-05-04,0,0,17,0,0,1,0
Alameda,2020-05-04,73,62,1769,31,15,163,135
Mendocino,2020-05-04,0,0,180,0,0,5,0
El Dorado,2020-05-04,0,3,185,0,0,9,3
Santa Barbara,2020-05-04,29,10,717,15,3,97,39
Nevada,2020-05-04,0,1,122,0,0,3,1
Siskiyou,2020-05-04,0,0,65,0,0,6,0
San Joaquin,2020-05-04,19,14,1287,8,6,23,33
Tuolumne,2020-05-04,0,0,151,0,0,1,0
Orange,2020-05-04,214,80,5607,71,17,349,294
Tuolumne,2020-05-05,0,0,151,0,0,1,0
Yolo,2020-05-05,0,0,186,0,0,12,0
Monterey,2020-05-05,4,1,829,3,0,107,5
Marin,2020-05-05,1,13,390,0,3,20,14
Tulare,2020-05-05,23,1,920,5,0,18,24
Lake,2020-05-05,0,2,110,0,1,-2,2
San Luis Obispo,2020-05-05,3,2,526,2,1,27,5
Napa,2020-05-05,0,2,387,0,2,4,2
Siskiyou,2020-05-05,0,0,65,0,0,6,0
Stanislaus,2020-05-05,29,11,1369,3,1,87,40
Riverside,2020-05-05,208,125,3898,84,30,185,333
Santa Clara,2020-05-05,79,34,3273,36,3,220,113
Madera,2020-05-05,0,0,568,0,0,19,0
Inyo,2020-05-05,0,0,42,0,0,4,0
Yuba,2020-05-05,0,1,445,0,1,10,1
Trinity,2020-05-05,0,0,54,0,0,0,0
Santa Barbara,2020-05-05,31,4,717,13,2,99,35
Solano,2020-05-05,13,16,707,5,1,50,29
Amador,2020-05-05,0,0,51,0,0,0,0
El Dorado,2020-05-05,0,4,185,0,0,9,4
Sacramento,2020-05-05,25,25,2323,13,6,119,50
Calaveras,2020-05-05,0,0,50,0,0,12,0
Plumas,2020-05-05,0,2,45,0,0,0,2
San Francisco,2020-05-05,79,24,2619,27,6,101,103
Mendocino,2020-05-05,0,0,158,0,0,5,0
San Joaquin,2020-05-05,18,29,1366,9,8,25,47
Butte,2020-05-05,0,0,448,0,0,14,0
Contra Costa,2020-05-05,21,48,1628,8,10,119,69
Lassen,2020-05-05,0,0,25,0,0,0,0
Tehama,2020-05-05,0,0,106,0,0,6,0
Modoc,2020-05-05,0,0,41,0,0,0,0
San Mateo,2020-05-05,44,14,1096,13,5,35,58
Placer,2020-05-05,11,13,753,2,0,80,24
Imperial,2020-05-05,57,1,255,16,0,1,58
Santa Cruz,2020-05-05,2,1,397,0,1,12,3
San Diego,2020-05-05,294,69,6128,122,11,345,363
Alameda,2020-05-05,76,71,2446,28,14,143,147
San Benito,2020-05-05,0,0,25,0,0,2,0
Humboldt,2020-05-05,0,13,344,0,2,10,13
Mariposa,2020-05-05,0,1,30,0,0,0,1
Del Norte,2020-05-05,0,0,51,0,0,5,0
Sutter,2020-05-05,0,0,14,0,0,0,0
Los Angeles,2020-05-05,1826,544,22079,571,110,1164,2370
Nevada,2020-05-05,0,0,129,0,0,3,0
Orange,2020-05-05,210,69,5585,70,15,372,279
Kern,2020-05-05,32,10,1737,20,0,80,42
Glenn,2020-05-05,0,0,0,0,0,0,0
Merced,2020-05-05,5,5,242,4,0,4,10
Shasta,2020-05-05,0,0,667,0,0,9,0
Fresno,2020-05-05,49,50,2049,17,10,88,99
Kings,2020-05-05,12,0,199,2,0,0,12
Sonoma,2020-05-05,3,13,871,0,3,60,16
Ventura,2020-05-05,24,24,1360,9,9,56,48
Colusa,2020-05-05,0,0,88,0,0,6,0
San Bernardino,2020-05-05,155,105,4564,58,20,139,260
Mono,2020-05-05,0,0,17,0,0,2,0
Yolo,2020-05-06,0,1,186,0,0,11,1
San Benito,2020-05-06,0,0,25,0,0,1,0
Shasta,2020-05-06,0,0,667,0,0,12,0
Monterey,2020-05-06,4,2,829,3,0,106,6
Siskiyou,2020-05-06,0,0,65,0,0,5,0
Napa,2020-05-06,1,1,387,1,0,6,2
San Luis Obispo,2020-05-06,2,2,526,2,2,31,4
Trinity,2020-05-06,0,0,54,0,0,0,0
Modoc,2020-05-06,0,0,41,0,0,0,0
San Diego,2020-05-06,308,71,6195,120,14,339,379
Tuolumne,2020-05-06,0,0,151,0,0,1,0
Amador,2020-05-06,0,0,51,0,0,1,0
Kern,2020-05-06,34,7,1747,18,0,80,41
Orange,2020-05-06,216,63,5585,71,14,372,279
El Dorado,2020-05-06,0,4,175,0,0,8,4
Santa Clara,2020-05-06,73,38,3275,36,4,210,111
Glenn,2020-05-06,0,0,0,0,0,0,0
San Mateo,2020-05-06,43,18,1096,12,2,52,61
San Francisco,2020-05-06,76,12,2619,26,4,113,88
Mendocino,2020-05-06,0,0,180,0,0,4,0
Madera,2020-05-06,0,0,568,0,0,15,0
Lake,2020-05-06,0,3,110,0,1,4,3
Lassen,2020-05-06,0,1,25,0,0,0,1
Tehama,2020-05-06,0,0,106,0,0,4,0
Sonoma,2020-05-06,4,13,871,1,2,56,17
Colusa,2020-05-06,0,0,88,0,0,6,0
Nevada,2020-05-06,0,0,126,0,1,2,0
Contra Costa,2020-05-06,16,51,1628,7,13,122,67
Plumas,2020-05-06,0,2,45,0,0,0,2
Placer,2020-05-06,9,21,753,3,3,84,30
San Bernardino,2020-05-06,167,69,4564,51,14,157,236
Butte,2020-05-06,0,0,448,0,0,17,0
Marin,2020-05-06,3,14,390,2,1,21,17
Yuba,2020-05-06,0,0,445,0,0,7,0
Sacramento,2020-05-06,27,40,2319,12,7,115,67
Imperial,2020-05-06,62,1,252,19,0,7,63
Mono,2020-05-06,1,0,17,0,0,2,1
Los Angeles,2020-05-06,1790,502,23573,558,99,1206,2292
Stanislaus,2020-05-06,27,11,1369,2,1,88,38
Calaveras,2020-05-06,0,0,50,0,0,12,0
Inyo,2020-05-06,0,0,42,0,0,4,0
Santa Barbara,2020-05-06,30,6,717,13,1,81,36
Merced,2020-05-06,6,3,242,4,2,4,9
Del Norte,2020-05-06,0,0,51,0,0,6,0
Sutter,2020-05-06,0,0,14,0,0,0,0
Solano,2020-05-06,12,18,707,6,2,61,30
Alameda,2020-05-06,78,58,2407,34,9,171,136
Kings,2020-05-06,13,0,199,2,0,2,13
Mariposa,2020-05-06,0,1,30,0,0,0,1
Ventura,2020-05-06,28,23,1352,11,8,45,51
Tulare,2020-05-06,25,3,920,5,0,18,28
San Joaquin,2020-05-06,17,29,1366,8,9,31,46
Santa Cruz,2020-05-06,2,1,397,0,1,7,3
Humboldt,2020-05-06,1,6,344,0,2,6,7
Riverside,2020-05-06,197,99,3938,81,28,183,296
Fresno,2020-05-06,47,47,2054,17,5,92,94
Sacramento,2020-05-07,19,32,2318,12,7,91,51
Tehama,2020-05-07,0,0,106,0,0,5,0
Marin,2020-05-07,3,10,390,2,0,14,13
Amador,2020-05-07,0,0,51,0,0,1,0
Tulare,2020-05-07,11,0,920,5,0,28,11
Del Norte,2020-05-07,0,1,51,0,0,1,1
Madera,2020-05-07,1,0,568,0,0,14,1
Mariposa,2020-05-07,0,1,30,0,0,0,1
San Luis Obispo,2020-05-07,2,4,526,2,1,26,6
Inyo,2020-05-07,0,0,42,0,0,4,0
Imperial,2020-05-07,58,1,334,18,1,7,59
El Dorado,2020-05-07,0,2,172,0,0,10,2
Trinity,2020-05-07,0,0,54,0,0,0,0
Los Angeles,2020-05-07,1771,552,23461,548,90,1220,2323
Colusa,2020-05-07,1,0,88,0,0,6,1
San Joaquin,2020-05-07,13,25,1366,6,6,31,38
Orange,2020-05-07,222,77,5585,78,16,351,299
Butte,2020-05-07,1,1,448,0,0,19,2
Santa Cruz,2020-05-07,3,1,397,0,0,9,4
Alameda,2020-05-07,75,61,2446,34,9,131,136
Napa,2020-05-07,1,1,387,1,0,3,2
Contra Costa,2020-05-07,20,45,1628,7,12,97,65
Placer,2020-05-07,8,23,753,2,3,38,31
Merced,2020-05-07,5,3,242,4,0,4,8
Glenn,2020-05-07,0,0,0,0,0,0,0
Ventura,2020-05-07,33,25,1353,13,7,56,58
Lake,2020-05-07,0,0,110,0,0,3,0
Yuba,2020-05-07,0,0,445,0,0,7,0
Mono,2020-05-07,0,0,17,0,0,2,0
San Francisco,2020-05-07,72,21,2619,30,1,78,93
Solano,2020-05-07,10,15,707,7,3,39,25
Stanislaus,2020-05-07,25,14,1369,1,4,75,39
Kern,2020-05-07,33,3,1734,19,1,79,36
San Diego,2020-05-07,312,75,6204,123,16,338,387
Fresno,2020-05-07,49,39,2051,15,3,92,88
Mendocino,2020-05-07,0,0,180,0,0,3,0
Santa Barbara,2020-05-07,27,12,717,11,3,82,39
Nevada,2020-05-07,0,0,112,0,0,4,0
Calaveras,2020-05-07,0,0,50,0,0,12,0
San Mateo,2020-05-07,37,14,1096,11,2,43,51
Tuolumne,2020-05-07,0,0,151,0,0,1,0
Monterey,2020-05-07,4,1,829,3,0,106,5
Riverside,2020-05-07,194,76,3902,79,20,177,270
San Benito,2020-05-07,0,0,25,0,0,0,0
San Bernardino,2020-05-07,153,73,4564,51,12,165,226
Humboldt,2020-05-07,1,5,352,0,0,6,6
Lassen,2020-05-07,0,0,25,0,0,0,0
Sutter,2020-05-07,0,0,14,0,0,0,0
Kings,2020-05-07,14,0,199,3,0,0,14
Yolo,2020-05-07,0,0,186,0,0,11,0
Modoc,2020-05-07,0,0,41,0,0,0,0
Siskiyou,2020-05-07,0,3,65,0,2,3,3
Shasta,2020-05-07,0,0,667,0,0,17,0
Santa Clara,2020-05-07,70,37,3275,32,3,180,107
Plumas,2020-05-07,0,0,45,0,0,0,0
Sonoma,2020-05-07,2,11,871,1,2,52,13
Marin,2020-05-08,3,4,390,2,0,11,7
Solano,2020-05-08,10,23,707,7,0,48,33
Alameda,2020-05-08,80,56,2446,38,8,126,136
Sacramento,2020-05-08,17,34,2332,11,5,82,51
San Mateo,2020-05-08,33,23,1096,11,3,43,56
San Joaquin,2020-05-08,15,32,1366,6,8,27,47
Shasta,2020-05-08,0,0,667,0,0,15,0
Riverside,2020-05-08,189,88,3902,77,27,158,277
Kings,2020-05-08,14,1,199,3,1,0,15
San Benito,2020-05-08,0,0,25,0,0,1,0
Inyo,2020-05-08,1,0,42,0,0,4,1
Madera,2020-05-08,1,0,530,0,0,26,1
San Francisco,2020-05-08,71,32,2619,28,7,92,103
Glenn,2020-05-08,0,0,0,0,0,0,0
Ventura,2020-05-08,33,21,1300,13,6,52,54
Santa Barbara,2020-05-08,32,4,717,11,2,86,36
Imperial,2020-05-08,66,4,342,19,0,9,70
Trinity,2020-05-08,0,0,54,0,0,0,0
Plumas,2020-05-08,0,0,45,0,0,0,0
Yuba,2020-05-08,0,0,445,0,0,6,0
Mono,2020-05-08,0,0,17,0,0,2,0
Contra Costa,2020-05-08,21,61,1628,7,14,99,82
San Diego,2020-05-08,334,73,6156,129,15,328,407
Santa Cruz,2020-05-08,4,0,397,0,0,14,4
Amador,2020-05-08,0,0,51,0,0,2,0
Tehama,2020-05-08,0,0,106,0,0,2,0
Kern,2020-05-08,32,7,1726,22,1,81,39
Napa,2020-05-08,1,0,387,1,0,2,1
Stanislaus,2020-05-08,21,15,1369,3,2,81,36
Los Angeles,2020-05-08,1766,510,23900,535,82,1181,2276
Mendocino,2020-05-08,0,0,180,0,0,4,0
El Dorado,2020-05-08,0,4,171,0,0,7,4
Mariposa,2020-05-08,0,1,30,0,0,0,1
San Luis Obispo,2020-05-08,1,3,526,1,2,21,4
Butte,2020-05-08,1,1,448,0,0,23,2
Tulare,2020-05-08,26,0,920,7,0,20,26
Modoc,2020-05-08,0,0,41,0,0,0,0
Siskiyou,2020-05-08,0,3,65,0,2,0,3
Sutter,2020-05-08,0,0,14,0,0,0,0
Lake,2020-05-08,0,1,110,0,0,2,1
Del Norte,2020-05-08,0,1,51,0,1,2,1
Calaveras,2020-05-08,0,0,50,0,0,11,0
Nevada,2020-05-08,0,0,120,0,0,7,0
Lassen,2020-05-08,0,1,25,0,0,0,1
Humboldt,2020-05-08,1,5,352,0,0,6,6
Monterey,2020-05-08,7,2,829,3,0,115,9
Tuolumne,2020-05-08,0,0,151,0,0,2,0
Yolo,2020-05-08,0,0,186,0,0,4,0
Merced,2020-05-08,7,1,242,5,0,2,8
Colusa,2020-05-08,1,1,88,0,1,5,2
San Bernardino,2020-05-08,142,78,4821,52,11,166,220
Sonoma,2020-05-08,2,15,871,1,4,51,17
Santa Clara,2020-05-08,69,26,3306,29,5,180,95
Fresno,2020-05-08,50,31,2049,15,4,89,81
Orange,2020-05-08,222,77,6836,77,22,338,299
Placer,2020-05-08,9,17,753,2,1,32,26
San Luis Obispo,2020-05-09,3,3,526,3,1,27,6
Calaveras,2020-05-09,0,2,50,0,1,9,2
Santa Cruz,2020-05-09,3,0,397,0,0,19,3
Imperial,2020-05-09,66,4,349,19,0,9,70
Stanislaus,2020-05-09,18,11,1369,3,3,82,29
Del Norte,2020-05-09,0,0,51,0,0,0,0
Marin,2020-05-09,4,9,390,2,2,6,13
Madera,2020-05-09,1,0,530,0,0,30,1
Riverside,2020-05-09,190,120,3874,73,30,159,310
Glenn,2020-05-09,0,0,0,0,0,0,0
San Mateo,2020-05-09,32,26,1096,12,4,40,58
Tuolumne,2020-05-09,0,0,151,0,0,3,0
Nevada,2020-05-09,0,0,108,0,0,4,0
Plumas,2020-05-09,0,1,45,0,0,0,1
El Dorado,2020-05-09,0,4,171,0,0,11,4
San Francisco,2020-05-09,68,29,2619,28,4,97,97
Mendocino,2020-05-09,0,0,180,0,0,4,0
Kern,2020-05-09,36,15,1728,25,2,78,51
Monterey,2020-05-09,9,1,829,3,0,113,10
San Benito,2020-05-09,0,0,25,0,0,3,0
Lassen,2020-05-09,0,1,25,0,0,0,1
Los Angeles,2020-05-09,1690,531,23877,493,82,1213,2221
Sutter,2020-05-09,0,0,14,0,0,0,0
Placer,2020-05-09,8,29,753,2,1,40,37
Alameda,2020-05-09,81,58,2446,40,11,122,139
Ventura,2020-05-09,33,24,1321,13,4,50,57
Yolo,2020-05-09,0,0,186,1,1,1,0
Yuba,2020-05-09,0,0,445,0,0,7,0
Humboldt,2020-05-09,1,5,352,0,0,6,6
Shasta,2020-05-09,0,0,667,0,0,17,0
Butte,2020-05-09,1,2,448,0,2,24,3
Solano,2020-05-09,11,24,707,7,2,46,35
Mariposa,2020-05-09,0,1,30,0,0,0,1
Santa Clara,2020-05-09,66,36,3306,28,5,183,102
Trinity,2020-05-09,0,0,54,0,0,0,0
Tulare,2020-05-09,28,2,920,9,0,27,30
Fresno,2020-05-09,55,43,2049,16,5,88,98
San Bernardino,2020-05-09,145,86,4821,55,13,171,231
Contra Costa,2020-05-09,20,48,1628,8,12,104,68
Colusa,2020-05-09,0,0,88,0,0,6,0
Inyo,2020-05-09,0,0,42,0,0,3,0
Siskiyou,2020-05-09,0,0,65,0,0,4,0
Sacramento,2020-05-09,18,35,2327,12,5,88,53
San Joaquin,2020-05-09,16,28,1366,4,7,24,44
Amador,2020-05-09,0,0,51,0,0,2,0
Santa Barbara,2020-05-09,28,4,717,11,1,80,32
Tehama,2020-05-09,0,0,106,0,0,2,0
Modoc,2020-05-09,0,0,41,0,0,0,0
Kings,2020-05-09,12,6,199,4,0,0,18
Sonoma,2020-05-09,3,12,871,2,3,50,15
Napa,2020-05-09,1,1,387,1,0,8,2
Merced,2020-05-09,5,6,242,4,2,2,11
San Diego,2020-05-09,338,58,6172,134,9,329,396
Mono,2020-05-09,0,0,17,0,0,2,0
Lake,2020-05-09,0,0,110,0,0,3,0
Orange,2020-05-09,228,72,6836,85,19,321,300
Glenn,2020-05-10,0,0,0,0,0,0,0
Yolo,2020-05-10,0,0,186,1,1,1,0
Los Angeles,2020-05-10,1731,539,23858,498,90,1253,2270
Humboldt,2020-05-10,2,4,352,0,0,3,6
Kings,2020-05-10,12,5,199,4,0,3,17
Mono,2020-05-10,0,0,17,0,0,2,0
Placer,2020-05-10,8,19,753,2,2,34,27
Lassen,2020-05-10,0,1,25,0,0,0,1
Colusa,2020-05-10,0,0,88,0,0,6,0
Imperial,2020-05-10,63,1,336,17,0,9,64
Mariposa,2020-05-10,0,0,30,0,0,0,0
Ventura,2020-05-10,28,24,1308,12,5,49,52
Calaveras,2020-05-10,0,0,50,0,0,9,0
Siskiyou,2020-05-10,0,0,65,0,0,4,0
San Diego,2020-05-10,334,56,6056,134,8,357,390
Napa,2020-05-10,2,0,387,2,0,3,2
Del Norte,2020-05-10,0,0,51,0,0,1,0
San Bernardino,2020-05-10,144,83,4821,53,12,188,227
Amador,2020-05-10,0,0,51,0,0,2,0
Mendocino,2020-05-10,0,0,180,0,0,4,0
Sacramento,2020-05-10,18,37,2310,11,7,105,55
Butte,2020-05-10,1,2,448,0,1,21,3
Modoc,2020-05-10,0,0,41,0,0,0,0
Marin,2020-05-10,4,13,390,2,3,11,17
Plumas,2020-05-10,0,1,45,0,0,0,1
El Dorado,2020-05-10,0,2,171,0,0,15,2
Santa Cruz,2020-05-10,3,0,397,0,0,16,3
Riverside,2020-05-10,199,117,3856,73,29,177,316
Lake,2020-05-10,0,1,110,0,0,0,1
San Francisco,2020-05-10,66,25,2619,25,9,102,91
Trinity,2020-05-10,0,0,54,0,0,0,0
Tulare,2020-05-10,27,2,920,8,0,26,29
Tuolumne,2020-05-10,0,0,151,0,0,2,0
Contra Costa,2020-05-10,18,43,1628,7,9,110,61
Tehama,2020-05-10,0,0,106,0,0,3,0
Stanislaus,2020-05-10,17,10,1369,1,3,80,27
Monterey,2020-05-10,9,0,829,3,0,108,9
Sutter,2020-05-10,0,0,14,0,0,0,0
Madera,2020-05-10,1,1,530,0,0,30,2
Solano,2020-05-10,14,22,707,8,1,48,36
Merced,2020-05-10,6,0,242,4,0,4,6
San Benito,2020-05-10,0,0,25,0,0,1,0
San Joaquin,2020-05-10,15,28,1366,2,8,19,43
Shasta,2020-05-10,0,0,667,1,0,8,0
Santa Clara,2020-05-10,66,45,3306,28,4,179,111
San Luis Obispo,2020-05-10,3,2,526,2,0,24,5
Nevada,2020-05-10,0,1,107,0,0,5,1
Yuba,2020-05-10,0,0,445,0,0,6,0
Santa Barbara,2020-05-10,26,4,717,11,1,81,30
Fresno,2020-05-10,53,45,2056,22,9,89,98
Orange,2020-05-10,230,78,6836,81,21,353,308
Inyo,2020-05-10,0,0,42,0,0,3,0
San Mateo,2020-05-10,29,23,1096,12,5,43,52
Sonoma,2020-05-10,5,7,871,2,2,50,12
Kern,2020-05-10,37,14,1728,27,2,96,51
Alameda,2020-05-10,77,46,2446,40,4,125,123
San Luis Obispo,2020-05-11,3,2,526,2,1,22,5
Stanislaus,2020-05-11,21,14,1374,2,6,74,35
Calaveras,2020-05-11,0,1,50,0,1,8,1
Monterey,2020-05-11,9,0,829,5,0,109,9
Kings,2020-05-11,13,4,199,4,0,4,17
Colusa,2020-05-11,0,0,88,0,0,6,0
Trinity,2020-05-11,0,0,54,0,0,0,0
Del Norte,2020-05-11,0,0,51,0,0,0,0
Amador,2020-05-11,0,0,51,0,0,2,0
Yuba,2020-05-11,0,1,445,0,1,9,1
Alameda,2020-05-11,78,53,2446,36,13,125,131
Tuolumne,2020-05-11,0,1,151,0,0,2,1
Marin,2020-05-11,3,12,390,0,2,12,15
Tulare,2020-05-11,35,0,920,10,0,20,35
Sutter,2020-05-11,0,0,14,0,0,0,0
El Dorado,2020-05-11,0,3,171,0,0,8,3
Santa Cruz,2020-05-11,1,0,397,0,0,16,1
Placer,2020-05-11,8,16,753,2,2,36,24
Mendocino,2020-05-11,0,0,180,0,0,5,0
Lake,2020-05-11,0,0,110,0,0,5,0
Orange,2020-05-11,232,88,6836,85,25,362,320
Contra Costa,2020-05-11,16,38,1628,8,10,105,54
Tehama,2020-05-11,0,0,106,0,0,6,0
Napa,2020-05-11,1,0,387,1,0,13,1
Nevada,2020-05-11,0,1,114,0,1,7,1
Inyo,2020-05-11,1,0,42,0,0,3,1
Mariposa,2020-05-11,0,0,30,0,0,0,0
San Benito,2020-05-11,1,0,25,0,0,2,1
Sonoma,2020-05-11,5,9,871,2,4,50,14
Los Angeles,2020-05-11,1763,547,23866,498,86,1242,2310
Butte,2020-05-11,2,1,448,0,0,25,3
Solano,2020-05-11,13,15,707,10,2,45,28
Siskiyou,2020-05-11,0,0,65,0,0,5,0
Modoc,2020-05-11,0,0,41,0,0,0,0
Humboldt,2020-05-11,2,6,352,0,0,5,8
Kern,2020-05-11,39,4,1724,27,1,77,43
Lassen,2020-05-11,0,1,25,0,0,0,1
Santa Barbara,2020-05-11,22,10,717,9,3,89,32
San Francisco,2020-05-11,63,28,2619,23,11,107,91
San Bernardino,2020-05-11,152,66,4821,53,12,178,218
San Joaquin,2020-05-11,15,15,1366,2,5,34,30
Glenn,2020-05-11,0,0,0,0,0,0,0
San Diego,2020-05-11,339,61,6089,131,13,374,400
Fresno,2020-05-11,56,37,2057,19,11,87,93
Sacramento,2020-05-11,16,35,2335,9,5,93,51
Mono,2020-05-11,0,0,17,0,0,2,0
San Mateo,2020-05-11,31,18,1096,11,6,43,49
Yolo,2020-05-11,0,0,186,0,0,4,0
Santa Clara,2020-05-11,59,41,3306,27,7,193,100
Plumas,2020-05-11,0,1,45,0,0,0,1
Ventura,2020-05-11,31,23,1301,12,7,48,54
Riverside,2020-05-11,186,104,3935,69,34,184,290
Shasta,2020-05-11,0,0,667,0,0,9,0
Merced,2020-05-11,7,2,242,4,2,7,9
Imperial,2020-05-11,60,2,323,17,0,10,62
Madera,2020-05-11,1,0,528,0,0,27,1
Yolo,2020-05-12,0,0,186,0,0,5,0
Mendocino,2020-05-12,0,0,180,0,0,4,0
Tulare,2020-05-12,34,0,920,11,0,17,34
San Diego,2020-05-12,334,51,6136,132,10,357,385
Riverside,2020-05-12,206,100,3924,67,29,172,306
Tuolumne,2020-05-12,0,0,151,0,0,3,0
Placer,2020-05-12,9,18,753,3,2,32,27
Sutter,2020-05-12,0,0,14,0,0,0,0
San Luis Obispo,2020-05-12,4,4,526,2,1,28,8
Inyo,2020-05-12,0,0,42,0,0,4,0
Mariposa,2020-05-12,0,1,30,0,0,0,1
Orange,2020-05-12,263,85,6836,88,14,358,348
San Bernardino,2020-05-12,148,49,4821,48,10,180,197
Yuba,2020-05-12,0,1,445,0,1,11,1
Shasta,2020-05-12,0,0,667,0,0,9,0
Napa,2020-05-12,1,0,387,1,0,6,1
Kern,2020-05-12,38,14,1729,28,1,72,52
Madera,2020-05-12,0,0,528,0,0,31,0
Humboldt,2020-05-12,3,5,352,0,0,6,8
Calaveras,2020-05-12,0,0,50,0,0,8,0
San Benito,2020-05-12,1,0,25,0,0,2,1
Merced,2020-05-12,6,5,242,4,1,5,11
Amador,2020-05-12,0,0,51,0,0,1,0
Lassen,2020-05-12,0,0,25,0,0,0,0
Ventura,2020-05-12,26,25,1319,13,9,42,51
El Dorado,2020-05-12,0,2,199,0,0,10,2
Los Angeles,2020-05-12,1742,506,23941,499,84,1267,2248
Plumas,2020-05-12,0,0,45,0,0,0,0
Trinity,2020-05-12,0,0,54,0,0,0,0
Santa Cruz,2020-05-12,1,0,397,0,0,11,1
San Mateo,2020-05-12,30,33,1096,14,6,35,63
Modoc,2020-05-12,0,0,41,0,0,0,0
San Joaquin,2020-05-12,14,20,1366,1,7,26,34
Tehama,2020-05-12,0,0,106,0,0,6,0
Nevada,2020-05-12,0,0,111,0,1,5,0
Butte,2020-05-12,2,3,448,0,1,25,5
Contra Costa,2020-05-12,17,49,1628,7,12,121,66
Mono,2020-05-12,0,0,17,0,0,2,0
Monterey,2020-05-12,6,1,829,5,0,106,7
Imperial,2020-05-12,60,3,330,18,1,8,63
Santa Barbara,2020-05-12,24,5,717,9,2,83,29
Solano,2020-05-12,15,14,707,9,6,48,29
Lake,2020-05-12,0,1,110,0,1,1,1
Alameda,2020-05-12,79,51,2446,34,12,116,130
Kings,2020-05-12,16,4,199,4,0,0,20
Siskiyou,2020-05-12,0,0,65,0,1,3,0
San Francisco,2020-05-12,63,27,2619,23,4,100,90
Marin,2020-05-12,3,18,390,0,1,13,21
Stanislaus,2020-05-12,19,15,1369,1,2,81,34
Fresno,2020-05-12,62,48,2061,19,4,84,110
Sacramento,2020-05-12,14,34,2373,7,6,94,48
Del Norte,2020-05-12,0,0,51,0,0,1,0
Colusa,2020-05-12,0,1,88,0,1,5,1
Sonoma,2020-05-12,6,22,871,4,4,49,28
Glenn,2020-05-12,0,0,0,0,0,0,0
Santa Clara,2020-05-12,55,29,3306,24,5,180,84
Los Angeles,2020-05-13,1733,618,23951,504,83,1253,2351
Del Norte,2020-05-13,0,0,51,0,0,3,0
Tuolumne,2020-05-13,0,0,151,0,0,5,0
Alameda,2020-05-13,81,59,2446,37,12,117,140
Contra Costa,2020-05-13,20,40,1628,8,7,108,60
Placer,2020-05-13,3,27,753,0,4,37,30
San Francisco,2020-05-13,57,32,2619,24,7,108,89
Sacramento,2020-05-13,15,35,2371,5,4,105,50
Napa,2020-05-13,1,0,487,0,0,10,1
Yolo,2020-05-13,0,1,186,0,1,6,1
Stanislaus,2020-05-13,20,11,1369,2,1,79,31
Humboldt,2020-05-13,4,4,352,1,1,5,8
Solano,2020-05-13,16,18,707,8,3,41,34
Santa Clara,2020-05-13,58,33,3306,22,5,194,91
Monterey,2020-05-13,7,2,829,5,0,106,9
Amador,2020-05-13,0,0,51,0,0,1,0
Lake,2020-05-13,0,0,110,0,1,2,0
Yuba,2020-05-13,0,0,445,0,0,12,0
San Luis Obispo,2020-05-13,3,7,526,2,1,24,10
Sutter,2020-05-13,0,0,14,0,0,0,0
Fresno,2020-05-13,69,60,2051,18,5,78,129
Merced,2020-05-13,8,3,242,4,0,10,11
Kings,2020-05-13,16,4,199,4,0,0,20
Nevada,2020-05-13,0,0,112,0,1,7,0
Tulare,2020-05-13,40,0,920,10,0,22,40
Trinity,2020-05-13,0,0,54,0,0,0,0
Imperial,2020-05-13,61,4,317,19,0,8,65
El Dorado,2020-05-13,0,2,199,0,0,11,2
Calaveras,2020-05-13,0,0,50,0,0,11,0
San Benito,2020-05-13,1,0,25,1,0,1,1
Glenn,2020-05-13,0,0,0,0,0,0,0
San Joaquin,2020-05-13,11,16,1366,1,4,32,27
Marin,2020-05-13,3,16,390,0,1,16,19
Plumas,2020-05-13,0,0,45,0,0,0,0
Santa Cruz,2020-05-13,1,0,397,0,0,15,1
Modoc,2020-05-13,0,0,41,0,0,0,0
San Diego,2020-05-13,329,51,6144,136,10,346,380
Mendocino,2020-05-13,0,0,180,0,0,2,0
Lassen,2020-05-13,0,0,25,0,0,0,0
Siskiyou,2020-05-13,0,1,65,0,0,5,1
Butte,2020-05-13,2,3,448,0,2,19,5
San Mateo,2020-05-13,34,35,1096,17,2,38,69
Sonoma,2020-05-13,5,20,871,3,1,53,25
Riverside,2020-05-13,188,77,4002,66,22,180,265
Shasta,2020-05-13,0,0,667,0,0,5,0
Orange,2020-05-13,257,85,7007,105,22,393,342
Mariposa,2020-05-13,0,1,30,0,0,0,1
Madera,2020-05-13,0,0,528,0,0,26,0
Tehama,2020-05-13,0,0,106,0,0,5,0
Inyo,2020-05-13,0,0,42,0,0,4,0
Mono,2020-05-13,0,0,17,0,0,2,0
Santa Barbara,2020-05-13,26,3,717,9,2,67,29
Ventura,2020-05-13,25,29,1312,13,10,37,54
Kern,2020-05-13,34,6,1718,26,2,73,40
San Bernardino,2020-05-13,133,90,4821,49,10,153,223
Colusa,2020-05-13,0,1,88,0,1,5,1
Orange,2020-05-14,259,68,7007,102,14,385,327
Sonoma,2020-05-14,5,23,871,3,3,51,28
Riverside,2020-05-14,184,91,4015,68,26,180,275
Mono,2020-05-14,0,0,17,0,0,2,0
Los Angeles,2020-05-14,1648,559,23919,480,101,1230,2207
San Diego,2020-05-14,329,70,6151,140,15,354,399
Madera,2020-05-14,0,0,528,0,0,29,0
Amador,2020-05-14,0,0,51,0,0,0,0
San Mateo,2020-05-14,32,12,1096,12,0,45,44
Plumas,2020-05-14,0,0,45,0,0,0,0
San Bernardino,2020-05-14,132,97,4821,47,15,182,229
Butte,2020-05-14,2,1,448,0,0,19,3
Shasta,2020-05-14,0,0,667,0,0,8,0
Modoc,2020-05-14,0,0,41,0,0,0,0
Santa Cruz,2020-05-14,1,0,397,0,0,13,1
Trinity,2020-05-14,0,0,54,0,0,0,0
Ventura,2020-05-14,28,30,1340,16,11,48,58
Fresno,2020-05-14,64,52,2134,17,6,82,116
San Francisco,2020-05-14,56,38,2619,20,10,111,94
Mendocino,2020-05-14,0,0,180,0,0,3,0
San Luis Obispo,2020-05-14,2,3,526,1,0,21,5
Stanislaus,2020-05-14,19,19,1369,2,1,85,38
Marin,2020-05-14,3,9,390,0,2,12,12
Sacramento,2020-05-14,12,40,2393,5,11,91,52
Colusa,2020-05-14,0,0,88,0,0,6,0
Tulare,2020-05-14,37,0,920,10,0,21,37
Sutter,2020-05-14,0,0,14,0,0,0,0
Nevada,2020-05-14,0,0,110,0,1,7,0
Lassen,2020-05-14,0,0,25,0,0,0,0
Tuolumne,2020-05-14,0,0,151,0,0,5,0
Santa Clara,2020-05-14,51,40,3306,21,4,172,91
Mariposa,2020-05-14,0,1,30,0,0,0,1
Kern,2020-05-14,39,5,1721,23,0,58,44
Monterey,2020-05-14,6,1,829,5,0,104,7
Merced,2020-05-14,8,1,242,5,0,5,9
Humboldt,2020-05-14,5,7,352,1,1,3,12
Calaveras,2020-05-14,0,0,50,0,0,10,0
Solano,2020-05-14,15,25,707,8,2,47,40
Del Norte,2020-05-14,0,0,51,0,0,5,0
Lake,2020-05-14,0,0,110,0,0,2,0
Glenn,2020-05-14,0,0,0,0,0,0,0
Alameda,2020-05-14,82,56,2446,37,13,118,138
Placer,2020-05-14,2,21,753,0,3,29,23
Inyo,2020-05-14,0,0,42,0,0,4,0
Napa,2020-05-14,1,0,487,0,0,10,1
Santa Barbara,2020-05-14,26,4,717,10,2,64,30
Imperial,2020-05-14,62,9,327,20,0,6,71
San Benito,2020-05-14,1,0,25,1,0,1,1
Tehama,2020-05-14,0,1,106,0,0,5,1
El Dorado,2020-05-14,0,3,199,0,0,11,3
Kings,2020-05-14,16,2,199,4,0,2,18
San Joaquin,2020-05-14,10,26,1366,1,12,27,36
Contra Costa,2020-05-14,20,47,1628,8,4,121,67
Siskiyou,2020-05-14,0,1,65,0,0,4,1
Yuba,2020-05-14,0,0,445,0,0,10,0
Yolo,2020-05-14,0,0,186,0,0,3,0
Sonoma,2020-05-15,5,34,871,3,1,51,39
Butte,2020-05-15,2,2,448,1,0,14,4
Mono,2020-05-15,0,0,17,0,0,2,0
Calaveras,2020-05-15,0,1,50,0,1,10,1
Tuolumne,2020-05-15,0,0,151,0,0,3,0
Lassen,2020-05-15,0,0,25,0,0,0,0
Riverside,2020-05-15,184,72,4015,71,21,182,256
Sutter,2020-05-15,0,0,14,0,0,0,0
Los Angeles,2020-05-15,1648,553,23901,481,90,1229,2201
San Luis Obispo,2020-05-15,1,4,526,1,2,22,5
Santa Clara,2020-05-15,48,27,3318,23,2,164,75
Monterey,2020-05-15,6,1,829,5,0,109,7
San Benito,2020-05-15,1,0,25,1,0,1,1
Tulare,2020-05-15,38,1,920,9,0,15,39
Placer,2020-05-15,3,26,753,0,5,32,29
Contra Costa,2020-05-15,19,37,1628,9,7,114,56
Lake,2020-05-15,0,0,110,0,0,2,0
Merced,2020-05-15,6,2,242,4,0,7,8
San Francisco,2020-05-15,56,33,2619,19,4,85,89
Glenn,2020-05-15,0,0,0,0,0,0,0
Napa,2020-05-15,1,0,387,1,0,6,1
Modoc,2020-05-15,0,0,41,0,0,0,0
Alameda,2020-05-15,76,72,2446,38,19,117,148
Solano,2020-05-15,14,26,707,8,1,50,40
Kings,2020-05-15,20,2,199,3,0,4,22
Yuba,2020-05-15,0,0,445,0,0,12,0
Tehama,2020-05-15,0,1,106,0,1,4,1
Stanislaus,2020-05-15,19,19,1369,3,2,80,38
Marin,2020-05-15,2,8,390,0,1,11,10
Kern,2020-05-15,40,12,1721,18,0,82,52
Del Norte,2020-05-15,0,0,51,0,0,2,0
San Diego,2020-05-15,326,66,6126,139,12,332,392
Shasta,2020-05-15,0,0,667,0,0,7,0
Colusa,2020-05-15,0,0,88,0,0,6,0
San Bernardino,2020-05-15,125,69,4821,51,14,168,194
Inyo,2020-05-15,0,0,42,0,0,4,0
Plumas,2020-05-15,0,0,45,0,0,0,0
Humboldt,2020-05-15,3,6,352,1,0,6,9
Orange,2020-05-15,250,60,7007,110,14,339,310
El Dorado,2020-05-15,0,0,199,0,0,10,0
Fresno,2020-05-15,59,32,2128,16,2,81,91
Nevada,2020-05-15,0,0,119,0,1,7,0
Trinity,2020-05-15,0,0,54,0,0,0,0
Amador,2020-05-15,0,0,51,0,0,0,0
Madera,2020-05-15,1,0,528,0,0,29,1
San Joaquin,2020-05-15,11,34,1366,3,13,28,45
Yolo,2020-05-15,0,0,186,0,0,3,0
Ventura,2020-05-15,27,20,1340,14,5,54,47
Siskiyou,2020-05-15,0,0,65,0,0,5,0
San Mateo,2020-05-15,30,24,1096,10,6,40,54
Santa Cruz,2020-05-15,1,0,397,0,0,13,1
Sacramento,2020-05-15,11,44,2410,5,8,100,55
Imperial,2020-05-15,67,4,262,20,0,0,71
Santa Barbara,2020-05-15,26,6,717,12,2,64,32
Mariposa,2020-05-15,0,0,30,0,0,0,0
Mendocino,2020-05-15,0,0,180,0,0,4,0
Solano,2020-05-16,14,26,707,9,1,46,40
Plumas,2020-05-16,0,0,45,0,0,0,0
Stanislaus,2020-05-16,19,20,1369,1,2,82,39
Butte,2020-05-16,2,1,448,1,0,20,3
Placer,2020-05-16,3,25,753,0,7,38,28
Kern,2020-05-16,36,15,1713,18,1,77,51
Tehama,2020-05-16,0,0,106,0,0,4,0
Alameda,2020-05-16,81,64,2446,40,10,114,145
Marin,2020-05-16,1,10,390,0,0,15,11
El Dorado,2020-05-16,1,3,199,1,0,8,4
Riverside,2020-05-16,183,83,3957,68,17,194,266
Yuba,2020-05-16,0,0,445,0,0,11,0
Kings,2020-05-16,20,2,199,2,1,2,22
Lake,2020-05-16,0,0,110,0,0,2,0
Mendocino,2020-05-16,0,0,180,0,0,5,0
Los Angeles,2020-05-16,1570,516,23918,483,80,1207,2086
Ventura,2020-05-16,27,23,1333,13,8,47,50
Monterey,2020-05-16,8,1,811,4,0,104,9
Santa Clara,2020-05-16,51,39,3318,22,6,177,90
San Joaquin,2020-05-16,11,19,1366,2,10,21,30
Sacramento,2020-05-16,12,34,2370,5,7,100,46
Siskiyou,2020-05-16,0,1,65,0,1,3,1
Santa Barbara,2020-05-16,27,7,717,12,3,63,34
Inyo,2020-05-16,0,0,42,0,0,4,0
San Mateo,2020-05-16,31,23,1096,9,5,43,54
San Luis Obispo,2020-05-16,1,5,526,1,1,25,6
Lassen,2020-05-16,0,0,25,0,0,0,0
Amador,2020-05-16,0,0,51,0,0,2,0
San Benito,2020-05-16,1,0,25,1,0,2,1
Mariposa,2020-05-16,0,0,30,0,0,0,0
Tuolumne,2020-05-16,0,0,151,0,0,6,0
Imperial,2020-05-16,60,1,260,18,0,8,61
Colusa,2020-05-16,0,0,88,0,0,6,0
Humboldt,2020-05-16,3,4,352,1,0,5,7
Modoc,2020-05-16,0,0,41,0,0,0,0
Napa,2020-05-16,1,3,387,1,0,6,4
Santa Cruz,2020-05-16,1,0,397,0,0,15,1
Tulare,2020-05-16,40,1,920,10,0,14,41
Nevada,2020-05-16,0,0,113,0,2,7,0
Merced,2020-05-16,6,1,242,5,0,4,7
Madera,2020-05-16,0,0,528,0,0,28,0
Yolo,2020-05-16,0,1,186,0,0,2,1
San Diego,2020-05-16,319,51,6144,138,15,326,370
Calaveras,2020-05-16,0,0,50,0,0,10,0
Del Norte,2020-05-16,0,0,51,0,0,2,0
Orange,2020-05-16,251,74,7007,103,18,345,325
Glenn,2020-05-16,0,0,0,0,0,0,0
Mono,2020-05-16,0,0,17,0,0,2,0
Contra Costa,2020-05-16,16,34,1628,9,8,105,50
Shasta,2020-05-16,0,0,667,0,0,7,0
Fresno,2020-05-16,58,39,2139,16,4,85,97
San Bernardino,2020-05-16,122,79,4821,54,13,145,201
San Francisco,2020-05-16,44,30,2619,20,4,106,74
Trinity,2020-05-16,0,0,54,0,0,0,0
Sutter,2020-05-16,0,0,14,0,0,0,0
Sonoma,2020-05-16,5,31,871,2,0,54,36
Siskiyou,2020-05-17,0,1,65,0,1,3,1
San Benito,2020-05-17,1,0,25,1,0,1,1
Merced,2020-05-17,6,3,242,5,0,4,9
Trinity,2020-05-17,0,0,54,0,0,0,0
Stanislaus,2020-05-17,20,21,1369,1,2,85,41
Tuolumne,2020-05-17,0,0,151,0,0,3,0
Tehama,2020-05-17,0,0,106,0,0,3,0
Mono,2020-05-17,0,0,17,0,0,2,0
Tulare,2020-05-17,40,1,881,10,0,14,41
Ventura,2020-05-17,31,13,1314,11,2,45,44
Colusa,2020-05-17,0,0,88,0,0,6,0
San Francisco,2020-05-17,40,31,2619,18,5,101,71
Imperial,2020-05-17,68,3,268,18,0,5,71
Calaveras,2020-05-17,0,0,50,0,0,11,0
Mariposa,2020-05-17,0,1,30,0,0,0,1
Lake,2020-05-17,0,0,110,0,0,1,0
Alameda,2020-05-17,74,72,2446,38,15,125,146
Orange,2020-05-17,267,88,7007,117,18,341,355
Yolo,2020-05-17,0,0,186,1,1,1,0
Yuba,2020-05-17,1,0,445,0,0,10,1
Santa Clara,2020-05-17,44,38,3318,19,6,192,82
Kings,2020-05-17,21,4,199,4,1,5,25
Plumas,2020-05-17,0,0,45,0,0,0,0
Santa Cruz,2020-05-17,1,0,397,0,0,15,1
Glenn,2020-05-17,0,0,0,0,0,0,0
Inyo,2020-05-17,0,0,42,0,0,4,0
Solano,2020-05-17,17,30,707,9,1,46,47
Madera,2020-05-17,0,0,528,0,0,53,0
Lassen,2020-05-17,0,0,25,0,0,0,0
Placer,2020-05-17,2,25,753,0,7,38,27
San Luis Obispo,2020-05-17,1,4,526,1,1,21,5
Contra Costa,2020-05-17,16,39,1628,9,9,110,55
Del Norte,2020-05-17,0,0,51,0,0,3,0
Fresno,2020-05-17,60,46,2133,18,10,94,106
Napa,2020-05-17,1,2,387,1,0,6,3
Sonoma,2020-05-17,5,26,871,3,0,55,31
Santa Barbara,2020-05-17,25,6,717,12,4,62,31
Monterey,2020-05-17,8,2,811,4,0,102,10
Sutter,2020-05-17,0,0,14,0,0,0,0
Sacramento,2020-05-17,15,41,2350,6,8,107,56
San Diego,2020-05-17,321,59,6131,140,10,364,380
Los Angeles,2020-05-17,1549,558,23854,478,97,1233,2107
Humboldt,2020-05-17,4,1,352,1,0,6,5
Kern,2020-05-17,36,12,1743,17,1,71,48
Marin,2020-05-17,1,11,390,0,0,15,12
San Mateo,2020-05-17,32,23,1096,9,6,40,55
Mendocino,2020-05-17,1,0,180,1,0,4,1
Shasta,2020-05-17,0,0,667,1,0,6,0
San Bernardino,2020-05-17,129,81,4821,52,15,184,210
Amador,2020-05-17,0,0,51,0,0,1,0
El Dorado,2020-05-17,1,3,199,1,1,11,4
Nevada,2020-05-17,0,0,117,0,1,7,0
San Joaquin,2020-05-17,10,18,1366,1,9,21,28
Modoc,2020-05-17,1,0,41,0,0,0,1
Butte,2020-05-17,2,0,448,1,0,22,2
Riverside,2020-05-17,186,91,3945,68,18,187,277
Marin,2020-05-18,4,8,390,0,3,17,12
Monterey,2020-05-18,8,1,811,4,0,106,9
Calaveras,2020-05-18,0,0,50,0,0,11,0
Sacramento,2020-05-18,13,58,2367,4,14,113,71
Glenn,2020-05-18,0,0,0,0,0,0,0
Humboldt,2020-05-18,4,1,352,1,0,3,5
Mono,2020-05-18,0,0,17,0,0,2,0
Lake,2020-05-18,0,2,110,0,0,3,2
Napa,2020-05-18,1,0,387,1,1,10,1
San Joaquin,2020-05-18,9,23,1366,1,8,31,32
Sutter,2020-05-18,0,0,14,0,0,0,0
San Mateo,2020-05-18,41,19,1096,10,5,41,60
San Benito,2020-05-18,1,0,25,1,0,1,1
Imperial,2020-05-18,73,1,187,17,0,11,74
El Dorado,2020-05-18,1,3,199,1,1,13,4
Stanislaus,2020-05-18,18,20,1369,1,1,77,38
Kern,2020-05-18,36,12,1704,18,0,72,48
Santa Cruz,2020-05-18,2,0,397,0,0,15,2
Modoc,2020-05-18,0,1,41,0,0,0,1
Solano,2020-05-18,16,27,707,9,2,42,43
Amador,2020-05-18,0,1,51,0,1,4,1
San Luis Obispo,2020-05-18,1,2,526,1,1,22,3
Ventura,2020-05-18,33,16,1307,15,3,39,49
Inyo,2020-05-18,0,0,42,0,0,4,0
Contra Costa,2020-05-18,19,51,1628,9,10,122,70
Lassen,2020-05-18,0,1,25,0,0,0,1
Santa Barbara,2020-05-18,25,2,717,11,3,70,27
San Bernardino,2020-05-18,140,81,4821,52,14,197,221
Riverside,2020-05-18,195,86,3994,68,18,210,281
Plumas,2020-05-18,0,0,45,0,0,0,0
Colusa,2020-05-18,0,1,88,0,1,5,1
Tulare,2020-05-18,35,1,920,9,1,29,36
San Francisco,2020-05-18,46,33,2619,22,9,115,79
Alameda,2020-05-18,87,51,2968,42,10,120,138
Sonoma,2020-05-18,3,20,871,2,2,53,23
Fresno,2020-05-18,61,44,2135,15,4,99,105
Tuolumne,2020-05-18,0,0,151,0,0,1,0
Nevada,2020-05-18,0,0,107,0,0,8,0
Del Norte,2020-05-18,0,0,51,0,0,2,0
Tehama,2020-05-18,0,1,106,0,0,3,1
Orange,2020-05-18,263,78,7007,111,12,387,341
Trinity,2020-05-18,0,0,54,0,0,0,0
Kings,2020-05-18,21,4,199,5,1,2,25
San Diego,2020-05-18,329,49,6040,139,10,341,378
Los Angeles,2020-05-18,1531,520,23910,483,87,1221,2051
Santa Clara,2020-05-18,46,33,3318,17,5,201,79
Mendocino,2020-05-18,1,0,180,1,0,4,1
Merced,2020-05-18,6,0,242,5,0,7,6
Yuba,2020-05-18,1,0,445,0,0,13,1
Siskiyou,2020-05-18,0,0,65,0,0,4,0
Mariposa,2020-05-18,0,2,30,0,0,0,2
Shasta,2020-05-18,0,0,667,0,0,5,0
Butte,2020-05-18,2,1,448,1,0,22,3
Placer,2020-05-18,1,34,753,0,4,40,35
Yolo,2020-05-18,0,0,186,0,0,3,0
Madera,2020-05-18,0,2,528,0,0,4,2
Solano,2020-05-19,18,29,707,9,3,42,47
Humboldt,2020-05-19,4,3,352,1,0,6,7
Colusa,2020-05-19,0,1,88,0,1,5,1
San Francisco,2020-05-19,48,26,2619,18,2,114,74
Tulare,2020-05-19,37,5,920,9,2,22,42
Kern,2020-05-19,42,11,1735,20,1,72,53
Ventura,2020-05-19,33,27,1336,12,7,41,60
San Joaquin,2020-05-19,7,26,1366,2,10,27,33
Shasta,2020-05-19,0,0,667,0,0,4,0
Riverside,2020-05-19,189,103,3999,69,31,191,292
Sonoma,2020-05-19,4,24,871,2,2,54,28
Lake,2020-05-19,0,1,110,0,1,1,1
El Dorado,2020-05-19,0,2,199,0,2,10,2
Calaveras,2020-05-19,0,0,50,0,0,11,0
Imperial,2020-05-19,74,4,200,19,0,10,78
Mariposa,2020-05-19,0,3,30,0,0,0,3
Mono,2020-05-19,0,0,17,0,0,2,0
Yuba,2020-05-19,1,0,445,0,0,10,1
Los Angeles,2020-05-19,1517,619,23675,466,94,1216,2136
Orange,2020-05-19,269,97,7007,116,19,352,366
Marin,2020-05-19,4,20,390,0,2,14,24
Madera,2020-05-19,0,1,528,0,0,23,1
Fresno,2020-05-19,64,43,2138,17,7,88,107
Contra Costa,2020-05-19,14,74,1628,9,8,117,88
Santa Cruz,2020-05-19,1,0,397,0,0,13,1
Trinity,2020-05-19,0,0,54,0,0,0,0
Tuolumne,2020-05-19,0,0,151,0,0,1,0
Lassen,2020-05-19,0,1,25,0,0,0,1
Siskiyou,2020-05-19,0,0,65,0,0,3,0
Placer,2020-05-19,3,45,753,0,6,38,48
Tehama,2020-05-19,0,0,106,0,0,6,0
Stanislaus,2020-05-19,17,31,1369,3,2,87,48
Napa,2020-05-19,1,0,387,1,1,14,1
Mendocino,2020-05-19,1,0,180,1,0,6,1
Nevada,2020-05-19,0,0,113,0,0,9,0
San Bernardino,2020-05-19,134,76,4821,55,20,206,210
Alameda,2020-05-19,83,108,2968,40,16,122,191
San Mateo,2020-05-19,41,30,1096,10,5,26,71
Plumas,2020-05-19,0,0,45,0,0,0,0
Amador,2020-05-19,0,0,51,0,0,3,0
Santa Barbara,2020-05-19,23,5,717,11,2,61,28
Del Norte,2020-05-19,0,0,51,0,0,1,0
San Benito,2020-05-19,1,0,25,1,0,1,1
San Diego,2020-05-19,319,68,6142,142,13,311,387
Merced,2020-05-19,7,1,242,4,0,2,8
Inyo,2020-05-19,0,0,42,0,0,4,0
Sutter,2020-05-19,0,0,14,0,0,0,0
Monterey,2020-05-19,11,0,811,4,0,102,11
Kings,2020-05-19,23,1,199,5,1,0,24
Santa Clara,2020-05-19,43,57,3318,16,6,195,100
Yolo,2020-05-19,0,0,186,0,0,4,0
Butte,2020-05-19,1,0,448,1,0,23,1
Sacramento,2020-05-19,11,90,2392,4,12,115,101
San Luis Obispo,2020-05-19,2,1,526,1,1,20,3
Glenn,2020-05-19,0,0,0,0,0,0,0
Modoc,2020-05-19,0,1,41,0,0,0,1
Santa Clara,2020-05-20,40,56,3318,16,5,170,96
Solano,2020-05-20,18,37,707,9,2,44,55
San Benito,2020-05-20,1,0,25,1,0,0,1
Merced,2020-05-20,8,1,242,4,0,1,9
San Francisco,2020-05-20,47,32,2619,20,7,113,79
Fresno,2020-05-20,56,41,2140,14,4,97,97
Mariposa,2020-05-20,0,2,30,0,0,0,2
Stanislaus,2020-05-20,18,30,1369,3,5,80,48
Yolo,2020-05-20,0,0,186,0,0,7,0
Alameda,2020-05-20,81,134,2968,39,24,112,215
Plumas,2020-05-20,0,0,45,0,0,0,0
Tehama,2020-05-20,0,0,106,0,0,7,0
Tuolumne,2020-05-20,0,0,151,0,0,4,0
Kings,2020-05-20,22,4,199,5,0,5,26
Siskiyou,2020-05-20,0,0,65,0,0,4,0
Santa Barbara,2020-05-20,23,4,717,11,1,60,27
Del Norte,2020-05-20,0,0,51,0,0,0,0
Trinity,2020-05-20,0,0,54,0,0,0,0
Tulare,2020-05-20,42,3,920,9,3,21,45
Napa,2020-05-20,1,0,387,1,1,6,1
Glenn,2020-05-20,0,0,0,0,0,0,0
Kern,2020-05-20,48,8,1735,21,2,66,56
Marin,2020-05-20,4,25,390,0,0,20,29
Modoc,2020-05-20,0,1,41,0,0,0,1
Mono,2020-05-20,0,0,17,0,0,2,0
San Diego,2020-05-20,335,69,6207,140,10,322,404
Sonoma,2020-05-20,2,34,871,2,2,52,36
Sacramento,2020-05-20,11,92,2378,3,14,106,103
Humboldt,2020-05-20,4,8,352,1,1,4,12
Butte,2020-05-20,4,1,448,2,0,20,5
Los Angeles,2020-05-20,1506,561,23670,452,87,1253,2067
Inyo,2020-05-20,0,0,42,0,0,2,0
Colusa,2020-05-20,0,0,88,0,0,6,0
Shasta,2020-05-20,0,0,667,0,0,6,0
Mendocino,2020-05-20,1,0,180,1,0,7,1
Riverside,2020-05-20,183,107,4010,67,28,144,290
Contra Costa,2020-05-20,9,73,1628,6,9,128,82
Lake,2020-05-20,0,2,110,0,0,3,2
Placer,2020-05-20,4,52,753,0,5,45,56
San Bernardino,2020-05-20,127,89,4821,51,14,213,216
Imperial,2020-05-20,80,3,214,22,0,8,83
Nevada,2020-05-20,0,0,116,0,0,9,0
San Luis Obispo,2020-05-20,2,6,526,1,2,21,8
Sutter,2020-05-20,0,0,14,0,0,0,0
Yuba,2020-05-20,1,0,445,0,0,11,1
Monterey,2020-05-20,10,0,811,4,0,103,10
Amador,2020-05-20,0,0,51,0,0,2,0
San Joaquin,2020-05-20,9,29,1366,3,6,27,38
El Dorado,2020-05-20,0,2,199,0,2,7,2
Calaveras,2020-05-20,0,0,50,0,0,10,0
Lassen,2020-05-20,0,1,25,0,0,0,1
Ventura,2020-05-20,36,26,1339,12,9,39,62
San Mateo,2020-05-20,37,37,1096,11,6,25,74
Madera,2020-05-20,0,4,528,0,0,21,4
Santa Cruz,2020-05-20,3,0,397,0,0,16,3
Orange,2020-05-20,275,113,7007,120,10,382,388
Ventura,2020-05-21,30,19,1329,12,3,44,49
San Mateo,2020-05-21,37,33,1096,10,4,26,70
Humboldt,2020-05-21,4,12,352,1,2,5,16
Sonoma,2020-05-21,4,31,871,3,5,49,35
Orange,2020-05-21,262,102,6993,119,11,401,364
El Dorado,2020-05-21,0,2,199,1,1,6,2
Trinity,2020-05-21,0,0,54,0,0,0,0
San Bernardino,2020-05-21,131,93,4821,47,16,225,224
Placer,2020-05-21,7,59,753,2,7,35,66
Kings,2020-05-21,21,4,199,5,1,2,25
Tuolumne,2020-05-21,0,0,151,0,0,2,0
Madera,2020-05-21,0,0,528,0,0,18,0
Riverside,2020-05-21,194,91,4020,64,18,129,285
Alameda,2020-05-21,77,162,2968,39,23,114,239
Tehama,2020-05-21,0,0,106,0,0,8,0
San Benito,2020-05-21,1,0,25,1,0,0,1
Imperial,2020-05-21,75,3,210,22,0,10,78
Colusa,2020-05-21,0,0,88,0,0,6,0
Los Angeles,2020-05-21,1491,614,23620,461,95,1199,2105
Yolo,2020-05-21,0,3,186,0,1,5,3
Tulare,2020-05-21,39,1,920,8,1,9,40
Stanislaus,2020-05-21,22,30,1369,3,5,82,52
Siskiyou,2020-05-21,0,0,65,0,0,4,0
Calaveras,2020-05-21,0,1,50,0,1,9,1
Mono,2020-05-21,0,0,17,0,0,2,0
Amador,2020-05-21,0,0,51,0,0,1,0
Napa,2020-05-21,1,0,387,1,1,0,1
Glenn,2020-05-21,0,0,0,0,0,0,0
Fresno,2020-05-21,61,57,2144,16,4,99,118
Inyo,2020-05-21,0,0,42,0,0,2,0
Monterey,2020-05-21,8,1,811,4,0,103,9
Del Norte,2020-05-21,0,0,51,0,0,1,0
Shasta,2020-05-21,0,0,667,0,0,5,0
Merced,2020-05-21,6,0,242,4,0,3,6
Butte,2020-05-21,8,1,448,2,1,17,9
Lassen,2020-05-21,0,1,25,0,0,0,1
Santa Barbara,2020-05-21,24,6,717,9,1,58,30
Marin,2020-05-21,4,29,390,0,0,18,33
San Joaquin,2020-05-21,8,23,1366,5,8,28,31
Kern,2020-05-21,44,10,1728,20,0,73,54
Yuba,2020-05-21,1,0,445,0,0,8,1
Sutter,2020-05-21,0,0,14,0,0,0,0
Mariposa,2020-05-21,0,0,30,0,0,0,0
Plumas,2020-05-21,0,0,45,0,0,0,0
Santa Cruz,2020-05-21,4,1,397,1,0,14,5
Nevada,2020-05-21,0,0,112,0,0,6,0
San Luis Obispo,2020-05-21,2,5,473,1,2,20,7
Contra Costa,2020-05-21,8,75,1628,6,11,118,83
Sacramento,2020-05-21,7,100,2409,4,14,108,107
Lake,2020-05-21,0,0,110,0,0,3,0
Modoc,2020-05-21,0,1,41,0,0,0,1
San Diego,2020-05-21,325,53,6180,139,6,313,378
Santa Clara,2020-05-21,39,60,3318,16,8,167,99
Solano,2020-05-21,18,35,707,7,6,45,53
Mendocino,2020-05-21,1,0,180,1,0,7,1
San Francisco,2020-05-21,43,37,2619,16,11,103,80
Santa Cruz,2020-05-22,4,1,397,1,0,11,5
San Luis Obispo,2020-05-22,2,1,469,1,1,21,3
Sonoma,2020-05-22,5,16,871,3,2,47,21
Santa Barbara,2020-05-22,20,4,717,7,2,60,24
Del Norte,2020-05-22,0,0,51,0,0,4,0
Ventura,2020-05-22,29,35,1345,12,5,42,64
Solano,2020-05-22,18,16,707,6,1,45,34
Marin,2020-05-22,3,3,390,1,1,15,6
Orange,2020-05-22,269,89,6993,127,18,397,358
Riverside,2020-05-22,195,115,4029,64,16,130,310
Lassen,2020-05-22,0,1,25,0,0,0,1
Shasta,2020-05-22,0,1,667,0,0,13,1
Contra Costa,2020-05-22,11,30,1628,5,6,113,41
Stanislaus,2020-05-22,23,11,1374,3,2,81,34
Merced,2020-05-22,6,1,242,4,0,4,7
San Diego,2020-05-22,331,50,6221,145,10,333,381
Mendocino,2020-05-22,1,0,180,1,0,6,1
San Joaquin,2020-05-22,9,26,1366,5,6,23,35
Plumas,2020-05-22,0,0,45,0,0,0,0
Butte,2020-05-22,7,1,448,2,0,17,8
Santa Clara,2020-05-22,36,19,3318,18,2,170,55
Siskiyou,2020-05-22,0,2,65,0,1,5,2
Kern,2020-05-22,45,8,1761,20,0,64,53
Yolo,2020-05-22,0,0,186,0,0,7,0
Inyo,2020-05-22,0,0,42,0,0,3,0
Trinity,2020-05-22,0,0,54,0,0,0,0
Mono,2020-05-22,0,0,17,0,0,2,0
San Mateo,2020-05-22,40,12,1096,14,0,40,52
Humboldt,2020-05-22,4,13,352,1,1,3,17
Glenn,2020-05-22,0,0,0,0,0,0,0
Madera,2020-05-22,1,0,528,0,0,21,1
El Dorado,2020-05-22,0,4,199,1,2,8,4
San Francisco,2020-05-22,43,29,2619,18,11,84,72
Tulare,2020-05-22,38,1,881,9,1,31,39
Sutter,2020-05-22,0,0,14,0,0,0,0
Napa,2020-05-22,1,7,387,1,0,0,8
Kings,2020-05-22,23,5,199,7,1,4,28
Tehama,2020-05-22,0,0,106,0,0,7,0
San Bernardino,2020-05-22,125,101,4821,44,11,218,226
Los Angeles,2020-05-22,1490,565,23628,470,102,1187,2055
Mariposa,2020-05-22,0,0,30,0,0,0,0
Monterey,2020-05-22,9,1,811,3,1,104,10
Colusa,2020-05-22,0,0,88,0,0,6,0
Imperial,2020-05-22,75,2,210,23,0,9,77
San Benito,2020-05-22,1,0,25,0,0,1,1
Lake,2020-05-22,0,2,110,0,0,3,2
Amador,2020-05-22,0,1,51,0,0,1,1
Tuolumne,2020-05-22,0,0,151,0,0,2,0
Nevada,2020-05-22,0,0,119,0,0,8,0
Calaveras,2020-05-22,0,0,50,0,0,9,0
Yuba,2020-05-22,1,0,445,0,0,4,1
Modoc,2020-05-22,0,1,41,0,0,0,1
Sacramento,2020-05-22,10,13,2400,2,2,106,23
Alameda,2020-05-22,79,81,2968,38,17,119,160
Placer,2020-05-22,6,20,753,3,5,42,26
Fresno,2020-05-22,64,30,2135,20,6,89,94
San Luis Obispo,2020-05-23,2,0,462,1,0,27,2
Plumas,2020-05-23,0,0,45,0,0,0,0
Sutter,2020-05-23,0,0,14,0,0,0,0
Glenn,2020-05-23,0,0,0,0,0,0,0
San Francisco,2020-05-23,45,28,2619,18,9,83,73
Modoc,2020-05-23,0,1,41,0,0,0,1
Shasta,2020-05-23,0,1,667,0,0,13,1
Nevada,2020-05-23,0,0,120,0,1,4,0
Kings,2020-05-23,25,3,199,7,1,4,28
Stanislaus,2020-05-23,23,15,1369,6,2,87,38
Fresno,2020-05-23,66,37,2137,21,6,85,103
Tulare,2020-05-23,40,1,920,9,1,13,41
Sacramento,2020-05-23,12,12,2388,3,0,101,24
Mendocino,2020-05-23,3,2,180,0,0,7,5
Sonoma,2020-05-23,5,17,871,3,2,49,22
Yolo,2020-05-23,0,0,186,1,1,0,0
Tehama,2020-05-23,0,0,106,0,0,6,0
Riverside,2020-05-23,193,95,3971,59,20,142,288
San Joaquin,2020-05-23,10,21,1366,5,8,21,31
Placer,2020-05-23,6,19,753,3,5,42,25
Napa,2020-05-23,1,1,387,1,0,2,2
Inyo,2020-05-23,0,0,42,0,0,4,0
Lassen,2020-05-23,0,0,25,0,0,0,0
San Diego,2020-05-23,304,82,6224,138,14,323,386
Contra Costa,2020-05-23,14,34,1628,6,6,100,48
Merced,2020-05-23,7,4,242,5,1,4,11
Del Norte,2020-05-23,0,0,51,0,0,0,0
Lake,2020-05-23,0,1,110,0,1,2,1
El Dorado,2020-05-23,1,5,199,1,5,3,6
Santa Barbara,2020-05-23,21,3,717,8,1,66,24
Siskiyou,2020-05-23,0,2,65,0,1,5,2
Solano,2020-05-23,18,14,707,6,0,43,32
San Bernardino,2020-05-23,134,100,4821,47,15,207,234
Humboldt,2020-05-23,4,13,352,1,1,3,17
Alameda,2020-05-23,80,78,2968,41,19,110,158
San Mateo,2020-05-23,39,11,1096,16,0,42,50
Santa Clara,2020-05-23,37,17,3318,18,1,178,54
Kern,2020-05-23,48,10,1727,22,2,78,58
Yuba,2020-05-23,1,0,445,0,0,9,1
Santa Cruz,2020-05-23,4,1,397,1,0,10,5
Marin,2020-05-23,2,4,390,1,2,15,6
Los Angeles,2020-05-23,1440,566,23605,462,104,1257,2006
Monterey,2020-05-23,7,1,811,3,1,104,8
Imperial,2020-05-23,75,2,210,23,0,9,77
Ventura,2020-05-23,29,25,1318,11,1,39,54
Tuolumne,2020-05-23,0,0,151,0,0,1,0
Calaveras,2020-05-23,0,0,50,0,0,9,0
Madera,2020-05-23,0,0,528,0,0,21,0
Colusa,2020-05-23,0,0,88,0,0,6,0
Orange,2020-05-23,278,94,6993,122,13,407,372
San Benito,2020-05-23,1,0,25,0,0,2,1
Mariposa,2020-05-23,0,0,30,0,0,0,0
Butte,2020-05-23,5,0,448,2,0,20,5
Trinity,2020-05-23,0,0,54,0,0,0,0
Mono,2020-05-23,0,0,17,0,0,2,0
Amador,2020-05-23,0,0,51,0,0,2,0
Placer,2020-05-24,5,21,753,3,6,39,26
Colusa,2020-05-24,0,0,88,0,0,6,0
Solano,2020-05-24,18,19,707,8,0,46,37
Santa Clara,2020-05-24,35,19,3318,16,2,195,54
San Francisco,2020-05-24,47,41,2619,20,10,97,88
Lassen,2020-05-24,0,0,25,0,0,0,0
Kings,2020-05-24,25,3,199,8,2,7,28
Monterey,2020-05-24,7,1,811,3,1,106,8
Siskiyou,2020-05-24,0,2,65,0,1,5,2
Sacramento,2020-05-24,9,17,2363,2,4,110,26
Humboldt,2020-05-24,4,3,352,1,0,5,7
Sutter,2020-05-24,0,0,14,0,0,0,0
Yuba,2020-05-24,1,0,445,0,0,13,1
Del Norte,2020-05-24,0,0,51,0,0,2,0
Contra Costa,2020-05-24,15,27,1628,6,5,102,42
Stanislaus,2020-05-24,22,15,1369,6,1,85,37
Marin,2020-05-24,2,4,390,1,2,13,6
Madera,2020-05-24,0,1,528,0,1,22,1
Modoc,2020-05-24,0,1,41,0,0,0,1
Sonoma,2020-05-24,6,16,871,3,3,50,22
Tulare,2020-05-24,42,2,920,10,1,13,44
Alameda,2020-05-24,88,61,2968,44,11,119,149
Inyo,2020-05-24,0,0,42,0,0,4,0
Merced,2020-05-24,7,5,242,5,0,5,12
San Bernardino,2020-05-24,139,103,4821,48,22,196,242
Ventura,2020-05-24,32,36,1331,13,5,46,68
Trinity,2020-05-24,0,0,54,0,0,0,0
Napa,2020-05-24,1,0,387,1,0,2,1
Amador,2020-05-24,0,0,51,0,0,0,0
San Luis Obispo,2020-05-24,2,1,461,1,0,28,3
Fresno,2020-05-24,66,40,2128,19,4,91,106
Los Angeles,2020-05-24,1443,547,23608,448,101,1227,1990
Plumas,2020-05-24,0,0,45,0,0,0,0
El Dorado,2020-05-24,1,4,199,1,4,4,5
Imperial,2020-05-24,77,4,210,23,0,9,81
Santa Barbara,2020-05-24,21,6,717,8,0,71,27
Tehama,2020-05-24,0,0,106,0,0,6,0
San Benito,2020-05-24,1,0,25,0,0,0,1
Mono,2020-05-24,0,0,17,0,0,2,0
Butte,2020-05-24,5,0,448,2,0,20,5
San Joaquin,2020-05-24,11,25,1366,6,5,17,36
Riverside,2020-05-24,188,80,3944,60,18,150,268
Mariposa,2020-05-24,0,0,30,0,0,0,0
Nevada,2020-05-24,0,0,121,0,2,1,0
Santa Cruz,2020-05-24,4,1,397,1,0,14,5
Glenn,2020-05-24,0,0,0,0,0,0,0
Kern,2020-05-24,53,4,1712,23,1,84,57
San Mateo,2020-05-24,39,13,1096,16,0,43,52
Calaveras,2020-05-24,0,1,50,0,0,10,1
San Diego,2020-05-24,310,60,6189,139,11,321,370
Orange,2020-05-24,286,102,6993,117,14,404,388
Mendocino,2020-05-24,3,2,180,0,0,7,5
Lake,2020-05-24,0,4,110,0,2,0,4
Yolo,2020-05-24,0,0,186,0,0,0,0
Tuolumne,2020-05-24,0,0,151,0,0,1,0
Shasta,2020-05-24,0,0,667,0,0,15,0
Inyo,2020-05-25,0,0,42,0,0,4,0
Tuolumne,2020-05-25,0,0,151,0,0,2,0
Alameda,2020-05-25,91,65,2968,40,20,115,156
Monterey,2020-05-25,10,0,811,3,0,106,10
Lassen,2020-05-25,0,0,25,0,0,0,0
Ventura,2020-05-25,33,30,1337,10,4,46,63
Los Angeles,2020-05-25,1477,564,23620,465,94,1453,2041
Calaveras,2020-05-25,0,1,50,0,0,10,1
Contra Costa,2020-05-25,13,35,1628,6,13,103,48
Tulare,2020-05-25,40,2,920,13,2,22,42
Shasta,2020-05-25,0,0,667,0,0,16,0
Lake,2020-05-25,0,1,110,0,0,2,1
Kings,2020-05-25,26,3,199,8,2,3,29
San Diego,2020-05-25,317,68,6158,139,21,385,385
Imperial,2020-05-25,69,6,210,23,0,9,75
Del Norte,2020-05-25,0,1,51,0,0,3,1
San Mateo,2020-05-25,44,13,1096,15,5,46,57
San Luis Obispo,2020-05-25,2,0,448,1,0,26,2
Napa,2020-05-25,1,0,387,1,0,4,1
El Dorado,2020-05-25,1,3,199,1,3,11,4
Placer,2020-05-25,5,20,753,3,6,47,25
Yolo,2020-05-25,1,0,186,0,0,4,1
Amador,2020-05-25,0,0,51,0,0,1,0
Santa Cruz,2020-05-25,4,3,397,1,0,15,7
Nevada,2020-05-25,0,0,120,0,1,6,0
Santa Barbara,2020-05-25,19,8,717,8,0,70,27
Solano,2020-05-25,21,20,707,11,4,44,41
Sacramento,2020-05-25,9,17,2381,2,29,116,26
Kern,2020-05-25,51,8,1707,25,1,77,59
Trinity,2020-05-25,0,0,54,0,0,0,0
Madera,2020-05-25,1,1,528,0,0,24,2
Sonoma,2020-05-25,5,22,871,3,6,46,27
Plumas,2020-05-25,0,0,45,0,0,0,0
Tehama,2020-05-25,0,0,106,0,0,3,0
Mariposa,2020-05-25,0,1,30,0,0,0,1
Colusa,2020-05-25,0,0,88,0,0,6,0
Merced,2020-05-25,6,4,242,4,1,10,10
Marin,2020-05-25,3,4,390,1,6,9,7
Modoc,2020-05-25,0,1,41,0,0,0,1
San Benito,2020-05-25,1,0,25,0,0,0,1
Mono,2020-05-25,0,0,17,0,0,2,0
Sutter,2020-05-25,0,0,14,0,0,0,0
Humboldt,2020-05-25,6,4,352,1,0,4,10
Orange,2020-05-25,300,94,6993,119,19,441,394
Mendocino,2020-05-25,2,0,180,1,0,5,2
Fresno,2020-05-25,66,38,2128,19,1,92,104
Riverside,2020-05-25,193,88,3959,63,15,159,281
Butte,2020-05-25,7,0,448,3,0,19,7
San Joaquin,2020-05-25,12,24,1366,6,4,22,36
Santa Clara,2020-05-25,32,20,3318,14,12,204,52
Stanislaus,2020-05-25,18,11,1369,6,4,79,29
Glenn,2020-05-25,0,0,0,0,0,0,0
San Bernardino,2020-05-25,138,116,4821,48,23,245,254
Siskiyou,2020-05-25,0,2,65,0,1,5,2
San Francisco,2020-05-25,40,41,2619,21,11,100,81
Yuba,2020-05-25,1,0,445,0,0,11,1
Mendocino,2020-05-26,3,1,180,1,0,4,4
Del Norte,2020-05-26,0,1,51,0,0,2,1
Siskiyou,2020-05-26,0,0,65,0,0,7,0
El Dorado,2020-05-26,0,2,199,0,2,8,2
Merced,2020-05-26,6,3,242,4,1,5,9
San Benito,2020-05-26,1,0,25,0,0,2,1
Colusa,2020-05-26,0,0,88,0,0,6,0
Mono,2020-05-26,0,0,17,0,0,2,0
Plumas,2020-05-26,0,0,45,0,0,0,0
San Bernardino,2020-05-26,154,125,4821,57,19,237,279
Los Angeles,2020-05-26,1477,610,23592,464,103,1449,2087
San Luis Obispo,2020-05-26,2,2,447,1,0,28,4
Amador,2020-05-26,0,0,51,0,0,3,0
Shasta,2020-05-26,1,0,667,0,0,13,1
Fresno,2020-05-26,69,29,2141,20,2,96,98
Stanislaus,2020-05-26,18,14,1369,7,5,85,32
Modoc,2020-05-26,0,1,41,0,0,0,1
Butte,2020-05-26,5,0,448,3,0,20,5
Trinity,2020-05-26,0,3,54,0,0,0,3
Nevada,2020-05-26,1,3,129,1,2,6,4
San Joaquin,2020-05-26,14,29,1366,6,8,24,43
Imperial,2020-05-26,69,8,210,22,0,10,77
Sonoma,2020-05-26,5,20,871,2,4,59,25
Glenn,2020-05-26,0,0,47,0,0,0,0
Placer,2020-05-26,6,21,753,3,5,43,27
Riverside,2020-05-26,207,102,3959,68,22,173,309
San Mateo,2020-05-26,45,9,1096,16,4,47,54
Inyo,2020-05-26,0,0,42,0,0,4,0
Yolo,2020-05-26,1,0,186,0,0,5,1
Orange,2020-05-26,301,117,6993,119,18,439,418
Humboldt,2020-05-26,5,5,352,1,1,3,10
Marin,2020-05-26,2,3,390,1,5,8,5
Contra Costa,2020-05-26,13,36,1628,6,14,115,49
Lake,2020-05-26,0,1,110,0,0,0,1
Sutter,2020-05-26,0,0,14,0,0,0,0
Yuba,2020-05-26,1,0,445,0,0,12,1
Tuolumne,2020-05-26,0,1,151,0,1,0,1
Alameda,2020-05-26,93,76,2968,37,20,124,169
Ventura,2020-05-26,34,28,1344,11,5,40,62
Tulare,2020-05-26,37,4,920,8,4,19,41
Solano,2020-05-26,19,16,707,9,2,45,35
Calaveras,2020-05-26,0,0,50,0,0,11,0
Monterey,2020-05-26,11,1,811,3,1,105,12
Tehama,2020-05-26,0,1,106,0,0,2,1
Madera,2020-05-26,1,4,528,0,0,22,5
San Diego,2020-05-26,325,58,6167,145,8,375,383
Santa Barbara,2020-05-26,18,5,717,8,2,84,23
Mariposa,2020-05-26,0,2,30,0,0,0,2
San Francisco,2020-05-26,40,47,2619,20,14,95,87
Sacramento,2020-05-26,9,9,2376,4,26,98,18
Lassen,2020-05-26,0,1,25,0,0,0,1
Kings,2020-05-26,24,3,199,8,2,2,27
Santa Clara,2020-05-26,33,20,3318,14,12,195,53
Kern,2020-05-26,59,7,1724,24,0,82,66
Santa Cruz,2020-05-26,4,1,397,1,0,14,5
Napa,2020-05-26,1,1,387,1,0,3,2
San Benito,2020-05-27,1,0,25,0,0,1,1
Fresno,2020-05-27,71,44,2143,19,4,93,115
Alameda,2020-05-27,95,69,2968,37,10,128,164
Merced,2020-05-27,6,2,242,4,0,3,8
San Joaquin,2020-05-27,14,23,1366,7,4,21,37
Mariposa,2020-05-27,0,2,30,0,0,0,2
Placer,2020-05-27,6,14,753,3,1,45,20
Lassen,2020-05-27,0,1,25,0,0,0,1
Shasta,2020-05-27,0,0,667,0,0,15,0
Sutter,2020-05-27,0,0,14,0,0,0,0
Tehama,2020-05-27,0,0,106,0,0,3,0
Santa Cruz,2020-05-27,3,0,397,1,0,15,3
Amador,2020-05-27,0,0,51,0,0,3,0
Mendocino,2020-05-27,3,1,180,1,1,3,4
Monterey,2020-05-27,11,0,811,3,0,100,11
Del Norte,2020-05-27,0,0,51,0,0,4,0
El Dorado,2020-05-27,1,2,199,1,2,7,3
Santa Clara,2020-05-27,28,24,3318,12,3,188,52
Yuba,2020-05-27,1,0,445,0,0,12,1
Mono,2020-05-27,0,0,17,0,0,2,0
Orange,2020-05-27,307,111,6993,125,19,403,418
Plumas,2020-05-27,0,0,45,0,0,0,0
Colusa,2020-05-27,0,0,88,0,0,6,0
Butte,2020-05-27,6,1,448,3,0,21,7
San Luis Obispo,2020-05-27,2,4,464,2,1,22,6
Santa Barbara,2020-05-27,22,5,717,9,2,94,27
Modoc,2020-05-27,0,0,41,0,0,0,0
Inyo,2020-05-27,0,0,42,0,0,4,0
Stanislaus,2020-05-27,17,8,1369,6,3,89,25
San Bernardino,2020-05-27,159,101,4821,54,19,222,260
Lake,2020-05-27,0,0,110,0,0,0,0
Sonoma,2020-05-27,9,22,871,3,2,51,31
Kings,2020-05-27,23,1,199,7,0,0,24
Napa,2020-05-27,1,1,387,1,0,2,2
Madera,2020-05-27,2,2,528,0,0,24,4
Los Angeles,2020-05-27,1462,628,23626,464,90,1275,2090
Humboldt,2020-05-27,5,4,352,1,0,3,9
San Mateo,2020-05-27,33,8,1096,16,3,46,41
Contra Costa,2020-05-27,11,30,1628,7,6,115,41
Sacramento,2020-05-27,8,21,2401,6,3,87,29
Kern,2020-05-27,63,5,1727,28,0,72,68
San Diego,2020-05-27,329,79,6215,144,12,315,408
Tulare,2020-05-27,36,5,920,10,3,13,41
Ventura,2020-05-27,28,24,1349,10,10,40,52
Trinity,2020-05-27,0,2,54,0,0,0,2
Nevada,2020-05-27,1,3,122,1,2,6,4
Tuolumne,2020-05-27,0,0,151,0,0,0,0
Marin,2020-05-27,1,1,390,1,0,10,2
Riverside,2020-05-27,199,114,4005,66,21,131,313
San Francisco,2020-05-27,40,42,2619,18,9,98,82
Calaveras,2020-05-27,0,0,50,0,0,11,0
Siskiyou,2020-05-27,0,3,65,0,1,5,3
Solano,2020-05-27,20,14,707,8,2,41,34
Glenn,2020-05-27,0,0,47,0,0,0,0
Imperial,2020-05-27,67,17,210,14,0,13,84
Yolo,2020-05-27,0,0,186,0,0,3,0
Napa,2020-05-28,1,1,387,1,0,1,2
Yolo,2020-05-28,0,0,186,0,0,8,0
San Luis Obispo,2020-05-28,2,0,475,2,0,24,2
Madera,2020-05-28,1,0,528,0,0,25,1
Marin,2020-05-28,3,7,390,1,0,14,10
Contra Costa,2020-05-28,13,38,1628,7,7,103,51
Lassen,2020-05-28,0,1,25,0,0,0,1
Butte,2020-05-28,5,1,448,3,0,22,6
San Francisco,2020-05-28,49,42,2619,20,9,83,91
Lake,2020-05-28,0,1,110,0,0,0,1
Los Angeles,2020-05-28,1415,639,23608,458,112,1275,2054
San Mateo,2020-05-28,39,10,1096,17,1,44,49
San Benito,2020-05-28,0,0,25,0,0,0,0
Sutter,2020-05-28,0,0,14,0,0,0,0
Mariposa,2020-05-28,0,2,30,0,0,0,2
Del Norte,2020-05-28,0,0,51,0,0,4,0
Glenn,2020-05-28,0,0,47,0,0,0,0
Trinity,2020-05-28,0,3,54,0,0,0,3
Inyo,2020-05-28,0,0,42,0,0,4,0
Siskiyou,2020-05-28,0,0,65,0,0,6,0
Plumas,2020-05-28,0,0,45,0,0,0,0
Alameda,2020-05-28,96,57,2968,44,13,106,153
San Joaquin,2020-05-28,15,25,1366,5,5,16,40
Mendocino,2020-05-28,3,0,180,1,0,4,3
Nevada,2020-05-28,1,2,128,1,1,5,3
Modoc,2020-05-28,0,0,41,0,0,0,0
Sonoma,2020-05-28,8,30,871,2,2,46,38
Fresno,2020-05-28,68,39,2131,16,2,82,107
Sacramento,2020-05-28,14,27,2395,8,4,95,41
Humboldt,2020-05-28,5,4,352,1,0,5,9
Amador,2020-05-28,0,1,51,0,0,4,1
Santa Cruz,2020-05-28,3,0,397,1,0,13,3
Imperial,2020-05-28,61,7,199,19,1,10,68
Yuba,2020-05-28,1,0,445,0,0,11,1
Mono,2020-05-28,0,0,40,0,0,2,0
Monterey,2020-05-28,11,0,811,3,0,101,11
Tulare,2020-05-28,37,2,920,10,1,8,39
San Bernardino,2020-05-28,156,87,4821,53,17,186,243
Kings,2020-05-28,25,0,199,7,0,2,25
Colusa,2020-05-28,0,0,88,0,0,6,0
Solano,2020-05-28,19,16,707,8,0,40,35
San Diego,2020-05-28,313,70,6238,137,16,317,383
Tuolumne,2020-05-28,0,0,151,0,0,2,0
El Dorado,2020-05-28,1,5,199,1,5,8,6
Placer,2020-05-28,5,18,753,3,3,33,23
Riverside,2020-05-28,202,99,4000,62,23,134,301
Tehama,2020-05-28,0,0,106,0,0,4,0
Santa Clara,2020-05-28,26,14,3318,13,2,180,40
Shasta,2020-05-28,0,0,667,0,0,9,0
Kern,2020-05-28,58,8,1744,25,0,77,66
Orange,2020-05-28,291,106,6993,119,13,403,397
Santa Barbara,2020-05-28,19,7,717,9,3,74,26
Calaveras,2020-05-28,1,0,50,1,0,10,1
Ventura,2020-05-28,28,19,1353,10,9,54,47
Merced,2020-05-28,6,2,242,4,0,4,8
Stanislaus,2020-05-28,15,8,1369,6,1,78,23
Colusa,2020-05-29,0,0,88,0,0,6,0
Stanislaus,2020-05-29,13,11,1370,7,2,75,24
Napa,2020-05-29,0,0,387,1,0,4,0
Kings,2020-05-29,27,1,199,7,0,2,28
Amador,2020-05-29,0,0,51,0,0,3,0
Yolo,2020-05-29,0,0,186,0,0,5,0
Tehama,2020-05-29,0,0,106,0,0,1,0
Ventura,2020-05-29,31,16,1352,10,6,47,47
San Mateo,2020-05-29,37,8,1096,14,1,47,45
Sutter,2020-05-29,0,0,14,0,0,0,0
Contra Costa,2020-05-29,15,35,1628,8,3,101,50
Sonoma,2020-05-29,7,37,871,2,6,51,44
San Luis Obispo,2020-05-29,3,5,469,3,3,13,8
Riverside,2020-05-29,191,79,3994,62,14,128,270
Lassen,2020-05-29,0,1,25,0,0,0,1
Merced,2020-05-29,6,7,242,4,1,5,13
Imperial,2020-05-29,60,4,192,17,1,11,64
Kern,2020-05-29,54,16,1741,28,1,70,70
El Dorado,2020-05-29,1,5,199,1,3,8,6
Los Angeles,2020-05-29,1402,570,23642,446,103,1258,1972
Inyo,2020-05-29,0,0,42,0,0,3,0
Sacramento,2020-05-29,14,23,2416,8,9,84,37
Tulare,2020-05-29,37,3,920,11,2,17,40
Alameda,2020-05-29,102,77,2968,42,12,118,179
San Diego,2020-05-29,300,58,6192,138,16,291,358
Glenn,2020-05-29,0,0,47,0,0,0,0
Fresno,2020-05-29,63,44,2145,17,5,86,107
Siskiyou,2020-05-29,1,0,65,0,0,5,1
San Benito,2020-05-29,0,0,25,0,0,1,0
San Bernardino,2020-05-29,134,95,4821,50,13,164,229
Santa Clara,2020-05-29,26,22,3318,13,1,182,48
Trinity,2020-05-29,0,0,54,0,0,0,0
Nevada,2020-05-29,0,2,130,0,0,8,2
Calaveras,2020-05-29,1,1,50,1,1,9,2
Shasta,2020-05-29,0,0,667,0,0,9,0
Mariposa,2020-05-29,0,2,30,0,0,0,2
Humboldt,2020-05-29,5,8,352,0,0,7,13
Tuolumne,2020-05-29,0,0,151,0,0,2,0
San Joaquin,2020-05-29,17,24,1366,5,6,17,41
Butte,2020-05-29,6,0,448,2,0,18,6
Madera,2020-05-29,0,0,528,0,0,22,0
Lake,2020-05-29,0,1,110,0,0,0,1
Mono,2020-05-29,0,0,40,0,0,2,0
Yuba,2020-05-29,1,0,445,0,0,11,1
Marin,2020-05-29,4,6,390,1,1,19,10
Monterey,2020-05-29,10,1,811,3,0,116,11
Plumas,2020-05-29,0,1,45,0,0,0,1
Orange,2020-05-29,262,62,6993,100,8,409,324
Santa Cruz,2020-05-29,3,9,397,1,0,18,12
Del Norte,2020-05-29,0,0,51,0,0,3,0
Placer,2020-05-29,8,15,753,4,1,35,23
Modoc,2020-05-29,0,0,41,0,0,0,0
Solano,2020-05-29,20,11,707,8,2,38,31
Santa Barbara,2020-05-29,16,11,717,8,4,76,27
Mendocino,2020-05-29,2,0,180,1,0,3,2
San Francisco,2020-05-29,49,16,2619,19,6,88,65
Lake,2020-05-30,0,0,110,0,0,0,0
Nevada,2020-05-30,0,1,126,0,0,8,1
San Diego,2020-05-30,311,86,6197,144,17,302,397
Napa,2020-05-30,0,4,387,0,2,1,4
Kern,2020-05-30,55,21,1564,29,2,72,76
Humboldt,2020-05-30,5,12,352,0,1,4,17
Madera,2020-05-30,1,2,528,0,0,17,3
Alameda,2020-05-30,105,41,2968,38,12,126,146
Glenn,2020-05-30,0,0,47,0,0,0,0
Del Norte,2020-05-30,0,0,51,0,0,3,0
Fresno,2020-05-30,70,48,2147,17,2,89,118
San Mateo,2020-05-30,44,13,1096,13,2,51,57
Shasta,2020-05-30,1,0,667,1,0,10,1
Siskiyou,2020-05-30,0,0,65,0,1,2,0
San Bernardino,2020-05-30,130,95,4821,52,12,203,225
Sonoma,2020-05-30,5,56,871,2,10,46,61
Los Angeles,2020-05-30,1357,577,23636,440,100,1288,1934
Sacramento,2020-05-30,14,23,2402,8,9,86,37
Plumas,2020-05-30,0,1,45,0,0,0,1
Orange,2020-05-30,291,131,6993,122,26,396,422
Merced,2020-05-30,7,7,242,3,1,4,14
Tulare,2020-05-30,37,2,920,12,2,19,39
Lassen,2020-05-30,0,1,25,0,0,0,1
Stanislaus,2020-05-30,14,8,1369,9,1,77,22
Sutter,2020-05-30,0,0,14,0,0,0,0
Amador,2020-05-30,0,0,51,0,0,4,0
Mariposa,2020-05-30,0,2,30,0,0,0,2
El Dorado,2020-05-30,1,6,199,1,6,8,7
Contra Costa,2020-05-30,14,32,1628,7,4,97,46
Marin,2020-05-30,3,5,390,1,0,18,8
Riverside,2020-05-30,185,84,3954,61,15,133,269
Modoc,2020-05-30,0,0,41,0,0,0,0
Santa Clara,2020-05-30,29,17,3318,11,0,175,46
Tehama,2020-05-30,0,0,106,0,0,8,0
Yolo,2020-05-30,0,0,186,0,0,3,0
Inyo,2020-05-30,0,0,42,0,0,3,0
Placer,2020-05-30,6,16,753,4,0,42,22
Monterey,2020-05-30,11,0,811,3,0,95,11
San Francisco,2020-05-30,47,17,2619,19,6,78,64
Mendocino,2020-05-30,2,0,180,1,0,4,2
Colusa,2020-05-30,0,0,88,0,0,6,0
San Benito,2020-05-30,0,0,25,0,0,2,0
Trinity,2020-05-30,0,0,54,0,0,0,0
Butte,2020-05-30,6,0,448,2,0,24,6
Solano,2020-05-30,18,11,707,7,2,39,29
Santa Barbara,2020-05-30,18,8,717,7,3,90,26
Imperial,2020-05-30,73,8,217,22,0,6,81
Tuolumne,2020-05-30,0,0,151,0,0,4,0
Mono,2020-05-30,0,0,40,0,0,2,0
San Joaquin,2020-05-30,19,23,1366,6,8,15,42
Santa Cruz,2020-05-30,3,9,397,1,0,18,12
San Luis Obispo,2020-05-30,3,2,464,3,0,13,5
Yuba,2020-05-30,1,0,445,0,0,12,1
Ventura,2020-05-30,26,20,1332,11,12,42,46
Kings,2020-05-30,27,1,199,9,0,0,28
Calaveras,2020-05-30,1,1,50,1,1,9,2
Orange,2020-05-31,283,124,6993,120,22,408,407
San Joaquin,2020-05-31,18,27,1366,6,8,18,45
San Francisco,2020-05-31,50,19,2619,22,4,91,69
Placer,2020-05-31,9,9,753,2,1,39,18
Sacramento,2020-05-31,16,18,2393,7,2,94,34
Contra Costa,2020-05-31,11,32,1628,6,6,94,43
Calaveras,2020-05-31,1,0,50,1,0,9,1
Tuolumne,2020-05-31,0,0,151,0,0,3,0
Solano,2020-05-31,19,10,707,5,1,38,29
San Luis Obispo,2020-05-31,3,1,455,3,1,20,4
Sonoma,2020-05-31,5,44,871,2,8,48,49
Siskiyou,2020-05-31,0,0,65,0,1,1,0
Mariposa,2020-05-31,0,0,30,0,0,0,0
San Diego,2020-05-31,306,92,6120,145,8,327,398
Kern,2020-05-31,59,16,1732,30,2,64,75
Merced,2020-05-31,6,5,242,3,1,5,11
El Dorado,2020-05-31,1,6,199,1,3,4,7
Lassen,2020-05-31,0,1,25,0,0,0,1
Inyo,2020-05-31,0,0,42,0,0,4,0
Humboldt,2020-05-31,4,6,352,0,0,8,10
Butte,2020-05-31,5,0,448,2,0,22,5
Ventura,2020-05-31,25,21,1329,11,5,40,46
Modoc,2020-05-31,0,0,41,0,0,0,0
Los Angeles,2020-05-31,1389,519,23606,416,95,1316,1908
Santa Cruz,2020-05-31,3,10,397,1,0,18,13
Santa Clara,2020-05-31,25,13,3318,9,2,196,38
Mono,2020-05-31,0,0,40,0,0,2,0
Fresno,2020-05-31,68,52,2138,18,10,83,120
Yolo,2020-05-31,0,0,186,0,0,3,0
Colusa,2020-05-31,0,1,88,0,0,6,1
Tehama,2020-05-31,0,0,106,0,0,7,0
San Bernardino,2020-05-31,136,73,4821,53,10,205,209
Mendocino,2020-05-31,1,0,180,1,0,2,1
Del Norte,2020-05-31,0,1,51,0,1,4,1
Sutter,2020-05-31,0,0,14,0,0,0,0
Nevada,2020-05-31,0,0,127,0,0,3,0
Trinity,2020-05-31,0,1,54,0,0,0,1
Alameda,2020-05-31,99,33,2968,37,8,131,132
Shasta,2020-05-31,1,0,667,1,0,11,1
Napa,2020-05-31,0,2,387,0,0,11,2
Monterey,2020-05-31,9,0,811,4,0,98,9
Yuba,2020-05-31,1,0,445,0,0,12,1
Lake,2020-05-31,1,0,110,0,0,0,1
Kings,2020-05-31,28,2,199,10,0,0,30
Stanislaus,2020-05-31,16,17,1369,6,2,85,33
Riverside,2020-05-31,195,99,3954,62,15,141,294
Glenn,2020-05-31,0,0,47,0,0,0,0
Marin,2020-05-31,2,6,390,1,0,17,8
Madera,2020-05-31,2,2,528,1,0,23,4
Santa Barbara,2020-05-31,22,4,717,7,2,89,26
Tulare,2020-05-31,35,1,920,12,1,13,36
Imperial,2020-05-31,73,7,217,22,0,6,80
Plumas,2020-05-31,0,1,45,0,0,0,1
San Benito,2020-05-31,0,0,25,0,0,2,0
San Mateo,2020-05-31,46,10,1096,26,1,39,56
Amador,2020-05-31,0,0,51,0,0,0,0
Colusa,2020-06-01,0,1,88,0,0,6,1
Shasta,2020-06-01,1,0,667,1,0,8,1
Glenn,2020-06-01,0,0,47,0,0,0,0
Santa Barbara,2020-06-01,25,4,717,7,3,80,29
Mono,2020-06-01,0,0,40,0,0,2,0
Tehama,2020-06-01,0,0,106,0,0,3,0
Madera,2020-06-01,2,1,528,1,0,22,3
El Dorado,2020-06-01,1,5,199,1,3,8,6
Merced,2020-06-01,5,3,242,3,0,5,8
Kings,2020-06-01,26,2,199,8,0,2,28
San Benito,2020-06-01,0,0,25,0,0,3,0
Santa Clara,2020-06-01,26,14,3318,9,2,192,40
San Mateo,2020-06-01,40,6,1096,11,0,42,46
Plumas,2020-06-01,0,0,45,0,0,0,0
San Luis Obispo,2020-06-01,3,3,454,3,0,22,6
Nevada,2020-06-01,0,1,131,0,0,6,1
Yuba,2020-06-01,1,0,445,0,0,14,1
Sutter,2020-06-01,0,0,14,0,0,0,0
Tuolumne,2020-06-01,0,0,151,0,0,0,0
Solano,2020-06-01,20,17,707,5,4,41,37
Imperial,2020-06-01,68,3,193,20,1,8,71
Santa Cruz,2020-06-01,3,1,397,2,1,18,4
Humboldt,2020-06-01,4,6,352,0,0,7,10
Contra Costa,2020-06-01,13,17,1628,8,5,100,30
Amador,2020-06-01,0,0,51,0,0,4,0
Monterey,2020-06-01,9,0,811,4,0,100,9
Los Angeles,2020-06-01,1422,596,23614,425,105,1305,2018
Sonoma,2020-06-01,5,62,871,2,5,50,67
Lake,2020-06-01,1,1,110,0,1,2,2
San Diego,2020-06-01,314,83,6121,150,16,317,397
Alameda,2020-06-01,97,51,2968,37,9,134,148
Lassen,2020-06-01,0,1,25,0,0,0,1
Ventura,2020-06-01,24,21,1317,8,5,36,45
Placer,2020-06-01,9,8,753,2,1,38,17
Fresno,2020-06-01,68,54,2142,17,6,393,122
Sacramento,2020-06-01,14,18,2409,8,5,103,32
Trinity,2020-06-01,0,1,54,0,0,0,1
Yolo,2020-06-01,0,0,186,0,0,4,0
Mendocino,2020-06-01,0,1,180,1,1,2,1
Calaveras,2020-06-01,1,0,50,1,0,9,1
Riverside,2020-06-01,203,104,3969,62,14,148,307
Stanislaus,2020-06-01,22,11,1369,7,1,79,33
Kern,2020-06-01,63,14,1722,30,3,69,77
Napa,2020-06-01,0,2,387,0,0,6,2
Orange,2020-06-01,292,113,6993,121,20,430,405
San Francisco,2020-06-01,45,29,2619,18,2,85,74
Butte,2020-06-01,4,0,448,1,1,17,4
Modoc,2020-06-01,0,0,41,0,0,0,0
Inyo,2020-06-01,0,0,42,0,0,4,0
Del Norte,2020-06-01,0,0,51,0,0,4,0
Marin,2020-06-01,2,3,390,0,1,22,5
Mariposa,2020-06-01,0,0,30,0,0,0,0
Tulare,2020-06-01,34,1,920,11,1,14,35
San Bernardino,2020-06-01,148,69,4821,62,17,186,217
Siskiyou,2020-06-01,0,3,65,0,1,5,3
San Joaquin,2020-06-01,23,25,1366,8,8,26,48
San Mateo,2020-06-02,42,17,1096,17,1,31,59
Butte,2020-06-02,4,2,448,1,0,15,6
Santa Clara,2020-06-02,26,23,3318,10,7,177,49
Trinity,2020-06-02,0,2,54,0,0,0,2
Mendocino,2020-06-02,1,0,180,1,0,4,1
Imperial,2020-06-02,66,1,237,18,0,8,67
Placer,2020-06-02,9,18,753,2,2,38,27
Solano,2020-06-02,16,16,707,4,5,41,32
Los Angeles,2020-06-02,1457,570,23620,439,85,1276,2027
Humboldt,2020-06-02,3,6,352,0,0,7,9
Kern,2020-06-02,67,15,1732,33,1,67,82
Riverside,2020-06-02,211,94,3979,66,14,127,305
Inyo,2020-06-02,0,0,42,0,0,4,0
Tulare,2020-06-02,32,2,920,10,2,25,34
Tehama,2020-06-02,0,0,106,0,0,4,0
Santa Cruz,2020-06-02,2,3,397,1,0,16,5
Del Norte,2020-06-02,0,0,51,0,0,2,0
Marin,2020-06-02,1,10,390,0,2,17,11
Sonoma,2020-06-02,3,69,871,2,5,52,72
Modoc,2020-06-02,0,0,41,0,0,0,0
Yuba,2020-06-02,1,0,445,0,0,15,1
Mariposa,2020-06-02,0,0,30,0,0,0,0
Lassen,2020-06-02,0,1,25,0,0,0,1
Glenn,2020-06-02,0,0,47,0,0,0,0
Kings,2020-06-02,31,1,199,8,0,6,32
Alameda,2020-06-02,92,68,2968,33,5,131,160
Plumas,2020-06-02,0,0,45,0,0,0,0
Sutter,2020-06-02,0,0,14,0,0,0,0
San Luis Obispo,2020-06-02,2,2,460,2,0,23,4
Sacramento,2020-06-02,17,25,2405,9,10,78,42
Madera,2020-06-02,6,4,528,2,0,19,10
San Diego,2020-06-02,297,72,6143,142,16,301,369
Merced,2020-06-02,4,2,242,3,0,2,6
Contra Costa,2020-06-02,15,41,1628,8,12,94,56
El Dorado,2020-06-02,1,7,199,1,5,2,8
Tuolumne,2020-06-02,0,0,151,0,0,1,0
Lake,2020-06-02,1,1,110,0,0,0,2
Nevada,2020-06-02,0,1,135,0,0,7,1
Calaveras,2020-06-02,1,0,50,1,0,8,1
Siskiyou,2020-06-02,0,3,65,0,1,5,3
San Benito,2020-06-02,0,0,25,0,0,2,0
Yolo,2020-06-02,0,0,186,0,0,2,0
Mono,2020-06-02,0,0,40,0,0,2,0
San Bernardino,2020-06-02,156,70,4821,63,13,189,226
San Francisco,2020-06-02,43,28,2647,18,8,76,71
Amador,2020-06-02,0,0,51,0,0,3,0
Colusa,2020-06-02,0,1,88,0,1,5,1
Fresno,2020-06-02,64,37,2126,16,2,90,101
Santa Barbara,2020-06-02,25,3,717,8,1,84,28
Napa,2020-06-02,0,2,387,0,0,6,2
Ventura,2020-06-02,25,21,1343,10,9,34,46
Shasta,2020-06-02,1,0,667,1,0,6,1
Orange,2020-06-02,306,92,6993,130,18,388,398
San Joaquin,2020-06-02,25,27,1366,9,6,20,52
Stanislaus,2020-06-02,25,11,1374,7,3,68,36
Monterey,2020-06-02,12,0,811,4,0,98,12
Butte,2020-06-03,4,0,448,0,0,22,4
San Francisco,2020-06-03,37,34,2647,17,4,80,71
Placer,2020-06-03,11,23,753,2,2,41,34
Napa,2020-06-03,0,2,387,0,0,5,2
San Benito,2020-06-03,0,0,25,0,0,2,0
Imperial,2020-06-03,69,4,237,17,0,6,73
Santa Barbara,2020-06-03,21,4,717,9,1,79,25
Marin,2020-06-03,1,10,390,0,3,19,11
Monterey,2020-06-03,12,0,811,4,0,96,12
Tuolumne,2020-06-03,0,0,151,0,0,0,0
Sutter,2020-06-03,0,0,14,0,0,0,0
Amador,2020-06-03,0,0,51,0,0,2,0
Sacramento,2020-06-03,19,33,2418,12,6,94,52
San Mateo,2020-06-03,43,23,1101,15,6,36,66
Contra Costa,2020-06-03,15,52,1628,4,12,101,67
Stanislaus,2020-06-03,27,14,1369,6,2,75,41
Santa Cruz,2020-06-03,2,1,397,1,0,12,3
Orange,2020-06-03,296,80,6993,124,10,387,376
Riverside,2020-06-03,221,101,4001,71,14,137,322
Colusa,2020-06-03,0,0,88,0,0,6,0
Yuba,2020-06-03,2,0,445,0,0,19,2
Mono,2020-06-03,0,0,40,0,0,1,0
Yolo,2020-06-03,0,0,186,0,0,3,0
San Luis Obispo,2020-06-03,2,1,466,2,1,21,3
Tehama,2020-06-03,0,0,106,0,0,5,0
Inyo,2020-06-03,0,0,42,0,0,4,0
Calaveras,2020-06-03,1,0,50,1,0,8,1
El Dorado,2020-06-03,1,6,199,1,5,10,7
Lassen,2020-06-03,0,1,25,0,0,0,1
Del Norte,2020-06-03,0,0,51,0,0,0,0
Siskiyou,2020-06-03,0,1,65,0,1,6,1
Ventura,2020-06-03,24,19,1337,9,4,34,43
San Joaquin,2020-06-03,28,32,1366,10,5,21,60
Alameda,2020-06-03,89,80,2968,32,6,144,169
Madera,2020-06-03,0,0,528,1,0,19,0
Santa Clara,2020-06-03,30,27,3318,8,6,184,57
Nevada,2020-06-03,0,0,131,0,0,6,0
Solano,2020-06-03,10,13,707,4,1,48,23
Mendocino,2020-06-03,1,0,180,1,0,3,1
Kern,2020-06-03,66,9,1759,35,1,74,75
Kings,2020-06-03,32,0,199,7,0,2,32
Tulare,2020-06-03,37,2,920,8,0,6,39
Trinity,2020-06-03,0,2,54,0,0,0,2
San Bernardino,2020-06-03,157,75,4821,67,18,178,232
Humboldt,2020-06-03,1,5,352,0,0,7,6
Glenn,2020-06-03,0,0,47,0,0,0,0
Los Angeles,2020-06-03,1488,502,23607,435,78,1239,1990
Modoc,2020-06-03,0,0,41,0,0,0,0
Sonoma,2020-06-03,3,76,871,2,8,50,79
San Diego,2020-06-03,295,75,6214,134,24,288,370
Shasta,2020-06-03,1,0,667,0,0,4,1
Fresno,2020-06-03,59,38,2126,16,3,88,97
Merced,2020-06-03,3,1,242,3,0,2,4
Lake,2020-06-03,1,0,110,0,0,2,1
Mariposa,2020-06-03,0,0,30,0,0,0,0
Plumas,2020-06-03,0,0,45,0,0,0,0
Monterey,2020-06-04,13,1,811,3,0,95,14
Mendocino,2020-06-04,1,0,180,1,1,2,1
Modoc,2020-06-04,0,0,41,0,0,0,0
Kings,2020-06-04,33,0,199,7,0,3,33
Tehama,2020-06-04,0,0,106,0,0,2,0
Los Angeles,2020-06-04,1462,586,23715,453,99,1249,2048
Merced,2020-06-04,3,4,242,3,0,4,7
Contra Costa,2020-06-04,18,70,1628,7,10,101,88
Mariposa,2020-06-04,0,0,30,0,0,0,0
Yuba,2020-06-04,3,0,445,1,0,14,3
Del Norte,2020-06-04,0,0,51,0,0,1,0
Marin,2020-06-04,2,8,390,0,3,13,10
Imperial,2020-06-04,74,3,237,18,0,4,77
El Dorado,2020-06-04,1,5,199,1,3,7,6
Mono,2020-06-04,0,0,40,0,0,2,0
Amador,2020-06-04,0,0,51,0,0,2,0
Tuolumne,2020-06-04,1,0,151,0,0,0,1
Lake,2020-06-04,2,2,110,0,1,1,4
Inyo,2020-06-04,0,0,42,0,0,2,0
Yolo,2020-06-04,0,0,186,0,0,0,0
San Benito,2020-06-04,0,0,25,0,0,2,0
Santa Cruz,2020-06-04,2,3,397,1,0,16,5
Butte,2020-06-04,4,0,448,0,0,22,4
Shasta,2020-06-04,2,0,667,0,0,5,2
Lassen,2020-06-04,0,1,25,0,0,0,1
San Diego,2020-06-04,297,82,6218,135,18,292,379
Calaveras,2020-06-04,0,0,50,0,0,10,0
San Luis Obispo,2020-06-04,2,0,464,2,0,23,2
Alameda,2020-06-04,82,92,2968,32,9,157,174
San Mateo,2020-06-04,35,18,1101,11,3,48,53
Napa,2020-06-04,0,3,397,0,1,0,3
Sacramento,2020-06-04,28,33,2423,14,7,103,61
Riverside,2020-06-04,226,91,4025,73,20,122,317
Santa Clara,2020-06-04,37,38,3318,14,7,176,75
San Bernardino,2020-06-04,168,70,4821,66,15,169,238
Ventura,2020-06-04,27,23,1333,7,5,34,50
Nevada,2020-06-04,0,0,125,0,0,5,0
Humboldt,2020-06-04,0,2,352,0,2,2,2
Trinity,2020-06-04,0,1,54,0,0,0,1
Sonoma,2020-06-04,4,54,871,2,7,51,58
Madera,2020-06-04,1,1,528,1,0,24,2
Sutter,2020-06-04,0,0,14,0,0,0,0
Placer,2020-06-04,11,35,753,2,3,47,46
Fresno,2020-06-04,66,35,2136,16,3,95,101
Santa Barbara,2020-06-04,28,10,717,9,2,65,38
Solano,2020-06-04,10,21,707,4,1,48,31
Glenn,2020-06-04,0,0,47,0,0,0,0
San Francisco,2020-06-04,41,21,2647,15,4,87,62
Tulare,2020-06-04,39,2,920,9,1,3,41
Siskiyou,2020-06-04,0,1,65,0,0,5,1
Colusa,2020-06-04,0,0,88,0,0,6,0
Stanislaus,2020-06-04,29,16,1369,7,3,78,45
Kern,2020-06-04,62,14,1756,34,1,78,76
Plumas,2020-06-04,0,0,45,0,0,0,0
Orange,2020-06-04,300,110,6993,123,18,393,410
San Joaquin,2020-06-04,28,27,1366,12,3,18,55
Sutter,2020-06-05,0,0,14,0,0,0,0
Glenn,2020-06-05,0,0,47,0,0,0,0
Lassen,2020-06-05,0,0,25,0,0,0,0
San Bernardino,2020-06-05,180,63,4821,61,14,140,243
Marin,2020-06-05,2,9,390,0,0,16,11
Sacramento,2020-06-05,35,37,2424,14,7,95,72
Lake,2020-06-05,1,0,110,0,0,2,1
Madera,2020-06-05,3,2,528,1,2,19,5
Tuolumne,2020-06-05,1,0,151,0,0,2,1
Kings,2020-06-05,31,0,199,7,0,1,31
Nevada,2020-06-05,0,2,130,0,0,4,2
San Benito,2020-06-05,0,0,25,0,0,1,0
Plumas,2020-06-05,0,0,45,0,0,0,0
Mendocino,2020-06-05,1,0,180,1,0,2,1
Imperial,2020-06-05,79,3,237,15,0,7,82
San Francisco,2020-06-05,42,22,2658,14,4,98,64
Del Norte,2020-06-05,0,0,51,0,0,2,0
Modoc,2020-06-05,0,0,41,0,0,0,0
Calaveras,2020-06-05,0,0,50,0,0,10,0
Santa Clara,2020-06-05,43,32,3375,18,6,206,75
Stanislaus,2020-06-05,25,14,1369,8,1,76,39
Riverside,2020-06-05,228,98,4023,75,24,129,326
El Dorado,2020-06-05,2,3,199,2,1,8,5
Placer,2020-06-05,11,21,753,4,3,49,32
San Luis Obispo,2020-06-05,3,3,483,2,0,27,6
San Diego,2020-06-05,299,69,6190,137,16,320,368
Yolo,2020-06-05,0,0,186,0,0,3,0
Mariposa,2020-06-05,0,0,30,0,0,0,0
Fresno,2020-06-05,67,30,2129,16,3,91,97
Humboldt,2020-06-05,0,1,352,0,0,1,1
Shasta,2020-06-05,0,0,667,0,0,4,0
Monterey,2020-06-05,14,1,811,3,0,92,15
Contra Costa,2020-06-05,17,46,1628,6,6,105,63
Alameda,2020-06-05,82,68,2968,30,10,154,150
Ventura,2020-06-05,29,21,1357,9,3,45,50
Merced,2020-06-05,4,1,242,2,0,3,5
Tulare,2020-06-05,39,2,920,7,0,8,41
Orange,2020-06-05,315,80,6973,131,11,401,395
Tehama,2020-06-05,0,0,106,0,0,4,0
Napa,2020-06-05,1,2,397,1,0,0,3
Yuba,2020-06-05,3,0,445,2,0,13,3
Sonoma,2020-06-05,3,69,871,2,8,54,72
Santa Cruz,2020-06-05,2,3,397,1,0,9,5
Trinity,2020-06-05,0,0,54,0,0,0,0
Santa Barbara,2020-06-05,29,8,717,9,3,82,37
Siskiyou,2020-06-05,0,1,65,0,0,6,1
Butte,2020-06-05,2,0,448,1,0,21,2
Los Angeles,2020-06-05,1451,547,23507,439,109,1210,1998
Kern,2020-06-05,62,16,1756,33,1,80,78
San Joaquin,2020-06-05,26,33,1366,13,4,14,59
San Mateo,2020-06-05,36,18,1101,8,2,47,54
Solano,2020-06-05,13,20,707,5,0,45,33
Colusa,2020-06-05,0,0,88,0,0,6,0
Inyo,2020-06-05,0,0,42,0,0,3,0
Amador,2020-06-05,0,0,51,0,0,2,0
Mono,2020-06-05,0,0,40,0,0,2,0
Lassen,2020-06-06,0,0,25,0,0,0,0
Monterey,2020-06-06,13,0,811,3,0,91,13
Merced,2020-06-06,5,0,242,2,0,4,5
Santa Barbara,2020-06-06,30,3,717,9,1,69,33
San Joaquin,2020-06-06,30,34,1366,13,3,16,64
Butte,2020-06-06,1,0,448,1,0,19,1
Kings,2020-06-06,26,1,199,9,1,4,27
El Dorado,2020-06-06,1,4,199,1,4,8,5
Sutter,2020-06-06,0,0,14,0,0,0,0
Yolo,2020-06-06,0,0,186,0,0,2,0
Inyo,2020-06-06,0,0,42,0,0,4,0
San Luis Obispo,2020-06-06,3,4,449,2,1,23,7
Solano,2020-06-06,12,16,707,4,1,47,28
Mono,2020-06-06,0,0,40,0,0,2,0
Napa,2020-06-06,1,3,397,1,0,0,4
Sacramento,2020-06-06,33,28,2414,15,7,90,61
Trinity,2020-06-06,0,0,54,0,0,0,0
Calaveras,2020-06-06,0,0,50,0,0,10,0
Tulare,2020-06-06,34,1,920,9,0,17,35
Imperial,2020-06-06,81,2,237,19,0,7,83
Orange,2020-06-06,309,67,6973,137,11,396,376
Alameda,2020-06-06,83,72,2968,30,11,156,155
Tuolumne,2020-06-06,0,0,151,0,0,2,0
Contra Costa,2020-06-06,18,43,1628,5,5,107,61
Marin,2020-06-06,3,6,390,0,1,18,9
Amador,2020-06-06,0,0,51,0,0,4,0
Tehama,2020-06-06,0,0,106,0,0,2,0
San Bernardino,2020-06-06,195,59,4821,69,15,147,254
Glenn,2020-06-06,0,0,47,0,0,0,0
Kern,2020-06-06,80,32,1756,33,3,89,112
San Diego,2020-06-06,285,76,6170,134,12,319,361
Yuba,2020-06-06,5,0,445,2,0,12,5
Ventura,2020-06-06,33,28,1333,9,8,40,61
Shasta,2020-06-06,0,0,667,0,0,8,0
Sonoma,2020-06-06,4,71,871,3,8,52,75
Placer,2020-06-06,10,24,753,4,3,44,34
Lake,2020-06-06,1,1,110,0,0,3,2
Santa Clara,2020-06-06,41,32,3375,16,7,202,73
Mariposa,2020-06-06,0,0,30,0,0,0,0
Madera,2020-06-06,5,3,528,1,0,22,8
San Benito,2020-06-06,0,0,25,0,0,3,0
Colusa,2020-06-06,0,0,88,0,2,4,0
San Mateo,2020-06-06,37,21,1101,7,0,53,58
Plumas,2020-06-06,0,0,45,0,0,0,0
Los Angeles,2020-06-06,1399,582,23617,418,88,1233,1981
Riverside,2020-06-06,220,89,3958,72,19,141,309
Siskiyou,2020-06-06,0,1,65,0,0,6,1
Nevada,2020-06-06,0,2,130,0,0,4,2
Del Norte,2020-06-06,0,0,51,0,0,1,0
Modoc,2020-06-06,0,0,41,0,0,0,0
Fresno,2020-06-06,70,41,2137,15,4,88,111
Mendocino,2020-06-06,1,0,180,1,0,2,1
Humboldt,2020-06-06,1,5,352,0,0,3,6
Santa Cruz,2020-06-06,1,3,397,1,0,11,4
Stanislaus,2020-06-06,26,9,1369,8,1,69,35
San Francisco,2020-06-06,41,24,2658,15,4,98,65
Fresno,2020-06-07,69,31,2139,16,4,97,100
Alameda,2020-06-07,92,74,2968,29,11,152,166
El Dorado,2020-06-07,2,4,199,2,1,9,6
San Francisco,2020-06-07,34,14,2337,13,1,88,48
Kern,2020-06-07,83,24,1756,34,4,82,107
Humboldt,2020-06-07,1,4,352,0,0,4,5
Inyo,2020-06-07,0,0,42,0,0,4,0
Mendocino,2020-06-07,1,0,180,1,0,2,1
Colusa,2020-06-07,0,0,88,0,1,5,0
Napa,2020-06-07,1,2,397,1,0,2,3
San Luis Obispo,2020-06-07,3,2,454,2,0,25,5
Lassen,2020-06-07,0,0,25,0,0,0,0
Trinity,2020-06-07,0,0,54,0,0,0,0
Lake,2020-06-07,0,0,110,0,0,4,0
Solano,2020-06-07,13,17,707,4,1,46,30
Yuba,2020-06-07,5,0,445,2,0,10,5
Yolo,2020-06-07,0,2,186,1,1,2,2
Tehama,2020-06-07,0,0,106,0,0,1,0
Kings,2020-06-07,27,1,199,9,1,4,28
Butte,2020-06-07,1,0,448,1,0,21,1
San Bernardino,2020-06-07,164,57,4821,72,11,158,221
San Benito,2020-06-07,0,0,25,0,0,2,0
San Joaquin,2020-06-07,39,24,1366,15,1,18,63
Santa Cruz,2020-06-07,1,3,397,1,0,11,4
Tuolumne,2020-06-07,0,0,151,0,0,3,0
Siskiyou,2020-06-07,0,0,65,0,0,5,0
Riverside,2020-06-07,217,79,3958,63,19,134,296
Mariposa,2020-06-07,0,0,30,0,0,0,0
Marin,2020-06-07,1,6,390,0,0,16,7
Del Norte,2020-06-07,0,1,51,0,1,1,1
Imperial,2020-06-07,87,1,237,18,0,7,88
Modoc,2020-06-07,0,0,41,0,0,0,0
Placer,2020-06-07,10,24,753,3,3,46,34
Merced,2020-06-07,5,2,242,2,1,4,7
Sutter,2020-06-07,0,0,14,0,0,0,0
Amador,2020-06-07,0,1,51,0,0,0,1
Mono,2020-06-07,0,0,40,0,0,2,0
Tulare,2020-06-07,28,0,729,8,0,4,28
Ventura,2020-06-07,39,32,1329,11,6,48,71
Orange,2020-06-07,322,77,6973,148,18,398,399
Monterey,2020-06-07,12,1,811,3,0,91,13
Plumas,2020-06-07,0,0,45,0,0,0,0
Nevada,2020-06-07,0,1,127,0,0,6,1
Glenn,2020-06-07,0,0,47,0,0,0,0
San Diego,2020-06-07,286,73,5907,131,16,333,359
Madera,2020-06-07,5,6,528,1,1,21,11
Sonoma,2020-06-07,5,66,871,3,9,49,71
Calaveras,2020-06-07,0,1,50,0,0,12,1
San Mateo,2020-06-07,37,20,1101,6,0,55,57
Stanislaus,2020-06-07,27,10,1369,9,0,73,37
Los Angeles,2020-06-07,1453,558,23659,428,91,1247,2011
Sacramento,2020-06-07,33,26,2399,14,8,90,59
Contra Costa,2020-06-07,23,44,1628,7,5,105,67
Santa Barbara,2020-06-07,20,3,717,6,1,66,23
Santa Clara,2020-06-07,38,31,3375,15,6,216,69
Shasta,2020-06-07,0,0,667,0,0,12,0
Santa Barbara,2020-06-08,22,6,717,8,2,66,28
Lassen,2020-06-08,0,0,25,0,0,0,0
Tehama,2020-06-08,0,0,106,0,0,5,0
Sutter,2020-06-08,0,0,14,0,0,0,0
Mariposa,2020-06-08,0,0,30,0,0,0,0
Glenn,2020-06-08,0,0,47,0,0,0,0
El Dorado,2020-06-08,1,5,235,1,2,11,6
Contra Costa,2020-06-08,20,35,1628,7,6,116,55
Monterey,2020-06-08,12,0,811,3,0,93,12
Sonoma,2020-06-08,5,74,871,3,10,47,79
Butte,2020-06-08,4,0,448,2,0,19,4
Merced,2020-06-08,5,3,242,2,1,5,8
Trinity,2020-06-08,0,3,54,0,0,0,3
Madera,2020-06-08,5,4,528,1,1,20,9
Plumas,2020-06-08,0,0,45,0,0,0,0
Marin,2020-06-08,2,0,390,2,0,16,2
Fresno,2020-06-08,70,37,2132,15,2,97,107
Humboldt,2020-06-08,1,6,352,0,0,3,7
Santa Clara,2020-06-08,44,17,3375,19,3,229,61
Shasta,2020-06-08,1,0,667,0,0,9,1
Kings,2020-06-08,24,1,199,8,1,2,25
Amador,2020-06-08,0,0,51,0,0,3,0
San Benito,2020-06-08,0,0,25,0,0,2,0
Imperial,2020-06-08,85,2,237,18,1,6,87
Colusa,2020-06-08,0,1,88,0,1,5,1
Santa Cruz,2020-06-08,1,1,397,0,0,17,2
Stanislaus,2020-06-08,26,13,1369,10,2,78,39
Mono,2020-06-08,0,0,40,0,0,2,0
San Bernardino,2020-06-08,197,54,4821,74,12,156,251
Los Angeles,2020-06-08,1458,595,23736,426,95,1301,2053
Inyo,2020-06-08,1,0,42,0,0,4,1
Solano,2020-06-08,13,15,707,3,2,47,28
San Joaquin,2020-06-08,43,27,1366,18,5,18,70
San Luis Obispo,2020-06-08,3,0,480,2,0,26,3
Nevada,2020-06-08,0,2,120,0,1,4,2
Calaveras,2020-06-08,0,0,50,0,0,10,0
Modoc,2020-06-08,0,0,41,0,0,0,0
Kern,2020-06-08,87,26,1756,29,5,81,113
Napa,2020-06-08,1,6,397,1,1,3,7
Sacramento,2020-06-08,37,24,2425,13,10,103,61
Riverside,2020-06-08,220,108,3987,71,18,128,328
Orange,2020-06-08,327,64,6976,149,11,410,391
Del Norte,2020-06-08,0,0,51,0,0,1,0
San Diego,2020-06-08,291,80,6122,143,23,332,371
Siskiyou,2020-06-08,0,0,65,0,0,6,0
Lake,2020-06-08,0,0,110,0,0,4,0
Tulare,2020-06-08,34,2,743,8,0,10,36
Yolo,2020-06-08,0,1,186,0,1,8,1
Alameda,2020-06-08,92,60,2968,31,12,144,152
Tuolumne,2020-06-08,0,0,151,0,0,5,0
Yuba,2020-06-08,5,0,445,2,0,17,5
San Mateo,2020-06-08,34,5,1101,5,0,54,39
Placer,2020-06-08,11,11,753,3,2,48,22
Mendocino,2020-06-08,1,0,180,1,0,2,1
Ventura,2020-06-08,42,27,1327,12,10,47,69
San Francisco,2020-06-08,32,11,2647,13,2,106,43
Sacramento,2020-06-09,33,19,2413,13,7,87,52
Tehama,2020-06-09,0,0,106,0,0,5,0
Amador,2020-06-09,0,0,51,0,0,0,0
San Bernardino,2020-06-09,205,71,4821,76,18,136,276
Fresno,2020-06-09,68,36,2132,15,1,92,104
Yuba,2020-06-09,4,0,445,2,0,14,4
Kings,2020-06-09,30,0,199,8,0,0,30
Merced,2020-06-09,4,0,242,2,0,4,4
San Diego,2020-06-09,299,74,6182,141,12,330,373
Tulare,2020-06-09,36,8,743,6,1,12,44
Humboldt,2020-06-09,1,8,352,0,1,4,9
Los Angeles,2020-06-09,1416,695,23627,410,97,1258,2111
Kern,2020-06-09,83,22,1742,30,4,75,105
Mariposa,2020-06-09,0,0,30,0,0,0,0
San Joaquin,2020-06-09,45,31,1366,18,7,17,76
Shasta,2020-06-09,1,0,667,0,0,9,1
Santa Cruz,2020-06-09,1,3,397,0,0,11,4
Sonoma,2020-06-09,5,70,871,3,4,49,75
Plumas,2020-06-09,0,0,45,0,0,0,0
Orange,2020-06-09,315,69,6976,146,19,390,384
Contra Costa,2020-06-09,21,40,1628,10,4,106,61
Ventura,2020-06-09,42,45,1350,10,11,41,87
Inyo,2020-06-09,1,0,42,0,0,4,1
San Benito,2020-06-09,0,0,25,0,0,2,0
Glenn,2020-06-09,1,0,47,0,0,0,1
San Mateo,2020-06-09,31,13,1101,6,3,47,44
El Dorado,2020-06-09,0,3,235,0,0,13,3
Napa,2020-06-09,0,6,397,0,0,1,6
Del Norte,2020-06-09,0,0,51,0,0,1,0
Calaveras,2020-06-09,0,0,50,0,0,9,0
Riverside,2020-06-09,227,106,3987,73,18,134,333
San Francisco,2020-06-09,37,12,2647,13,0,100,49
Alameda,2020-06-09,94,52,2968,32,9,137,146
Modoc,2020-06-09,0,0,41,0,0,0,0
Butte,2020-06-09,6,0,448,2,1,16,6
Santa Barbara,2020-06-09,25,7,717,7,2,64,32
Trinity,2020-06-09,0,2,54,0,0,0,2
Mono,2020-06-09,0,0,40,0,0,2,0
Stanislaus,2020-06-09,29,13,1369,13,4,78,42
Sutter,2020-06-09,0,0,14,0,0,0,0
Yolo,2020-06-09,0,1,186,1,1,2,1
Madera,2020-06-09,6,5,528,1,0,20,11
Nevada,2020-06-09,0,3,125,0,2,7,3
Siskiyou,2020-06-09,0,1,65,0,1,5,1
Mendocino,2020-06-09,1,0,180,1,0,1,1
Santa Clara,2020-06-09,41,18,3375,18,3,213,59
Placer,2020-06-09,10,12,753,2,2,49,22
Colusa,2020-06-09,0,0,88,0,0,6,0
Monterey,2020-06-09,13,0,811,3,0,92,13
Tuolumne,2020-06-09,0,0,151,0,0,3,0
Lassen,2020-06-09,0,0,25,0,0,0,0
Lake,2020-06-09,0,1,110,0,1,1,1
Imperial,2020-06-09,83,2,212,18,0,2,85
San Luis Obispo,2020-06-09,3,2,453,2,0,24,5
Solano,2020-06-09,17,25,707,5,2,44,42
Marin,2020-06-09,6,4,390,3,1,11,10
San Luis Obispo,2020-06-10,3,2,456,2,0,23,5
Kings,2020-06-10,30,1,199,9,1,2,31
Plumas,2020-06-10,0,0,45,0,0,0,0
Orange,2020-06-10,312,72,6976,143,10,392,384
Humboldt,2020-06-10,1,14,352,0,1,5,15
Sacramento,2020-06-10,36,26,2471,13,5,97,62
Mono,2020-06-10,0,0,40,0,0,2,0
Santa Cruz,2020-06-10,3,3,397,0,0,10,6
Stanislaus,2020-06-10,26,15,1369,11,4,83,41
Alameda,2020-06-10,88,46,2968,32,11,147,134
Monterey,2020-06-10,16,0,811,3,0,87,16
Mariposa,2020-06-10,0,0,30,0,0,0,0
Yuba,2020-06-10,5,1,445,2,0,10,6
El Dorado,2020-06-10,0,1,235,0,0,9,1
San Benito,2020-06-10,0,0,25,0,0,1,0
Butte,2020-06-10,7,23,448,3,6,17,30
San Diego,2020-06-10,286,76,6186,135,16,330,362
Santa Barbara,2020-06-10,26,5,717,6,0,68,31
Merced,2020-06-10,3,4,242,3,0,5,7
Lake,2020-06-10,0,2,110,0,0,1,2
Lassen,2020-06-10,0,0,25,0,0,0,0
Madera,2020-06-10,6,5,528,3,0,14,11
Ventura,2020-06-10,44,56,1347,10,7,56,100
Tehama,2020-06-10,0,0,106,0,0,7,0
Los Angeles,2020-06-10,1389,564,23634,403,109,1258,1953
San Bernardino,2020-06-10,171,76,4821,75,17,132,247
Riverside,2020-06-10,232,101,3987,71,15,127,333
Tulare,2020-06-10,38,5,780,5,3,10,43
Modoc,2020-06-10,0,0,41,0,0,0,0
Santa Clara,2020-06-10,40,22,3375,16,5,220,62
Nevada,2020-06-10,0,2,130,0,2,4,2
Tuolumne,2020-06-10,0,1,151,0,1,3,1
Trinity,2020-06-10,0,1,54,0,0,0,1
Colusa,2020-06-10,0,0,88,0,0,6,0
Glenn,2020-06-10,1,0,47,0,0,0,1
Yolo,2020-06-10,0,0,186,0,0,3,0
Solano,2020-06-10,18,15,707,4,1,46,33
San Joaquin,2020-06-10,45,38,1366,17,4,17,83
Marin,2020-06-10,8,3,390,3,0,10,11
Placer,2020-06-10,11,12,753,2,2,45,23
Amador,2020-06-10,0,0,51,0,0,3,0
San Mateo,2020-06-10,29,11,1049,7,2,50,40
San Francisco,2020-06-10,39,11,2647,14,0,95,50
Kern,2020-06-10,89,23,1742,32,10,77,112
Calaveras,2020-06-10,0,0,50,0,0,9,0
Contra Costa,2020-06-10,20,23,1628,10,6,111,43
Siskiyou,2020-06-10,0,0,65,0,0,4,0
Fresno,2020-06-10,67,35,2144,19,4,84,102
Mendocino,2020-06-10,1,0,180,1,0,3,1
Imperial,2020-06-10,79,0,212,16,0,2,79
Del Norte,2020-06-10,0,0,51,0,0,1,0
Sutter,2020-06-10,0,0,14,0,0,0,0
Shasta,2020-06-10,1,0,667,0,5,4,1
Napa,2020-06-10,1,5,397,0,1,0,6
Inyo,2020-06-10,1,0,42,0,0,4,1
Sonoma,2020-06-10,5,57,871,3,4,47,62
Madera,2020-06-11,7,4,528,3,1,5,11
Monterey,2020-06-11,17,0,811,5,0,85,17
Lake,2020-06-11,0,0,110,0,0,2,0
Marin,2020-06-11,8,2,390,3,0,13,10
Kern,2020-06-11,90,19,1742,29,2,83,109
San Francisco,2020-06-11,38,13,2647,14,1,86,51
Mariposa,2020-06-11,0,0,30,0,0,0,0
San Luis Obispo,2020-06-11,2,3,481,2,1,24,5
Santa Clara,2020-06-11,39,18,3375,18,2,215,57
Santa Cruz,2020-06-11,4,2,397,0,0,11,6
San Benito,2020-06-11,0,0,25,0,0,1,0
Solano,2020-06-11,19,12,707,6,2,43,31
Merced,2020-06-11,4,1,242,3,0,3,5
Amador,2020-06-11,0,0,51,0,0,2,0
Colusa,2020-06-11,0,0,88,0,0,6,0
Riverside,2020-06-11,238,68,4018,71,12,131,306
Santa Barbara,2020-06-11,30,7,717,8,0,64,37
Nevada,2020-06-11,0,2,127,0,2,4,2
Sutter,2020-06-11,0,0,14,0,0,0,0
Trinity,2020-06-11,0,0,54,0,0,0,0
San Bernardino,2020-06-11,194,77,4821,73,16,133,271
Tehama,2020-06-11,0,0,106,0,0,7,0
Plumas,2020-06-11,0,0,45,0,0,0,0
Inyo,2020-06-11,1,0,42,0,0,2,1
Mono,2020-06-11,0,1,40,0,0,2,1
Glenn,2020-06-11,1,0,47,0,0,0,1
Tuolumne,2020-06-11,0,0,151,0,0,0,0
Butte,2020-06-11,5,37,448,3,7,15,42
Imperial,2020-06-11,86,1,237,18,0,0,87
Contra Costa,2020-06-11,22,29,1628,11,4,112,51
Tulare,2020-06-11,35,6,780,7,0,11,41
Yuba,2020-06-11,5,1,445,2,0,6,6
Siskiyou,2020-06-11,0,0,65,0,0,4,0
Shasta,2020-06-11,2,0,667,0,0,8,2
San Mateo,2020-06-11,26,7,1089,7,0,50,33
Kings,2020-06-11,29,2,199,8,0,5,31
Alameda,2020-06-11,86,38,2968,32,7,145,124
Napa,2020-06-11,0,3,397,0,0,3,3
Mendocino,2020-06-11,0,0,180,0,0,3,0
Sonoma,2020-06-11,4,23,871,3,1,49,27
Los Angeles,2020-06-11,1397,576,23666,415,97,1220,1973
Ventura,2020-06-11,43,47,1360,11,10,46,90
San Joaquin,2020-06-11,42,25,1366,15,2,17,67
Orange,2020-06-11,325,67,6976,156,16,368,392
Yolo,2020-06-11,0,1,186,0,0,2,1
Del Norte,2020-06-11,0,1,51,0,0,3,1
Sacramento,2020-06-11,39,23,2501,13,5,105,62
Placer,2020-06-11,10,8,753,2,2,48,18
Lassen,2020-06-11,0,0,25,0,0,0,0
Modoc,2020-06-11,0,0,41,0,0,0,0
Humboldt,2020-06-11,1,8,352,0,0,2,9
San Diego,2020-06-11,277,75,6187,133,16,325,352
Calaveras,2020-06-11,0,0,50,0,0,8,0
Stanislaus,2020-06-11,29,18,1369,13,1,82,47
Fresno,2020-06-11,67,32,2142,17,1,79,99
El Dorado,2020-06-11,0,1,235,0,1,10,1
Butte,2020-06-12,5,0,448,3,0,20,5
Colusa,2020-06-12,0,0,88,0,0,6,0
Solano,2020-06-12,18,9,707,6,2,46,27
Imperial,2020-06-12,81,1,237,16,0,2,82
Calaveras,2020-06-12,0,0,50,0,0,10,0
Sonoma,2020-06-12,4,38,871,3,3,42,42
Marin,2020-06-12,8,3,390,3,1,12,11
Mono,2020-06-12,0,0,40,0,0,2,0
Humboldt,2020-06-12,1,13,352,0,2,0,14
Fresno,2020-06-12,69,33,2140,19,1,87,102
Tulare,2020-06-12,12,13,780,8,0,25,25
Modoc,2020-06-12,0,0,41,0,0,0,0
Nevada,2020-06-12,0,0,136,0,0,6,0
Merced,2020-06-12,5,1,242,3,0,3,6
Mariposa,2020-06-12,0,0,30,0,0,0,0
Tuolumne,2020-06-12,0,0,151,0,0,2,0
Siskiyou,2020-06-12,0,1,65,0,1,5,1
San Joaquin,2020-06-12,49,19,1366,16,1,16,68
San Francisco,2020-06-12,41,11,2647,15,1,91,52
Kern,2020-06-12,96,15,1742,36,1,72,111
Yolo,2020-06-12,0,0,186,0,0,4,0
Ventura,2020-06-12,46,63,1361,12,11,42,109
Napa,2020-06-12,0,8,397,0,1,1,8
Madera,2020-06-12,5,4,528,2,0,14,9
Lake,2020-06-12,0,2,110,0,2,0,2
Stanislaus,2020-06-12,34,34,1369,13,3,84,68
Monterey,2020-06-12,15,0,811,2,0,87,15
Placer,2020-06-12,7,8,753,1,1,46,15
Contra Costa,2020-06-12,22,20,1628,10,3,111,42
Lassen,2020-06-12,0,0,25,0,0,0,0
Plumas,2020-06-12,0,0,45,0,0,0,0
Del Norte,2020-06-12,0,0,51,0,0,4,0
Mendocino,2020-06-12,0,0,180,0,0,5,0
San Diego,2020-06-12,275,41,6210,131,13,328,316
Santa Barbara,2020-06-12,30,4,717,9,0,58,34
Trinity,2020-06-12,0,0,54,0,0,0,0
Alameda,2020-06-12,84,42,2968,35,6,120,126
El Dorado,2020-06-12,0,3,235,0,3,14,3
San Luis Obispo,2020-06-12,2,3,471,2,0,24,5
Amador,2020-06-12,0,0,51,0,0,0,0
Tehama,2020-06-12,0,1,106,0,1,6,1
Yuba,2020-06-12,6,0,445,2,0,9,6
Sutter,2020-06-12,0,0,14,0,0,0,0
San Mateo,2020-06-12,22,10,1089,7,1,51,32
Riverside,2020-06-12,236,83,4018,74,14,139,319
Kings,2020-06-12,34,0,199,10,0,5,34
San Benito,2020-06-12,0,0,25,0,0,1,0
Inyo,2020-06-12,1,0,42,0,0,3,1
Santa Clara,2020-06-12,43,17,3375,17,3,223,60
Sacramento,2020-06-12,35,32,2474,13,8,91,67
Glenn,2020-06-12,1,0,47,0,0,0,1
San Bernardino,2020-06-12,205,78,4821,77,16,138,283
Los Angeles,2020-06-12,1383,487,23655,414,78,1228,1870
Santa Cruz,2020-06-12,4,6,397,0,0,15,10
Orange,2020-06-12,311,117,6976,150,27,384,428
Shasta,2020-06-12,1,0,667,0,0,7,1
San Mateo,2020-06-13,18,9,1089,8,0,55,27
Yolo,2020-06-13,0,0,186,1,1,2,0
San Joaquin,2020-06-13,50,21,1366,17,3,10,71
Sacramento,2020-06-13,28,23,2444,11,5,84,51
Kings,2020-06-13,33,1,199,10,0,6,34
Santa Barbara,2020-06-13,36,6,717,7,3,58,42
Inyo,2020-06-13,1,0,42,0,0,2,1
El Dorado,2020-06-13,0,3,235,0,3,11,3
San Benito,2020-06-13,0,0,25,0,0,0,0
Fresno,2020-06-13,64,34,2140,21,3,83,98
Marin,2020-06-13,10,2,390,3,0,12,12
Nevada,2020-06-13,0,0,128,0,0,4,0
Santa Cruz,2020-06-13,4,5,397,0,0,10,9
Ventura,2020-06-13,44,50,1354,13,8,51,94
Solano,2020-06-13,17,5,707,6,1,49,22
Sonoma,2020-06-13,5,6,871,2,0,47,11
Lassen,2020-06-13,0,0,25,0,0,0,0
San Francisco,2020-06-13,41,9,2647,14,0,94,50
Calaveras,2020-06-13,0,0,50,0,0,12,0
Modoc,2020-06-13,0,0,41,0,0,0,0
Riverside,2020-06-13,235,101,3992,68,17,137,336
Del Norte,2020-06-13,0,0,51,0,0,2,0
Yuba,2020-06-13,6,0,445,2,0,14,6
San Luis Obispo,2020-06-13,2,6,449,2,1,23,8
Los Angeles,2020-06-13,1285,483,23688,399,84,1262,1768
Merced,2020-06-13,3,1,242,2,0,5,4
Stanislaus,2020-06-13,41,21,1369,19,1,86,62
Tulare,2020-06-13,9,27,780,7,1,6,36
Plumas,2020-06-13,0,0,45,0,0,0,0
Mono,2020-06-13,0,0,40,0,0,2,0
Humboldt,2020-06-13,1,13,352,0,2,0,14
Sutter,2020-06-13,0,0,14,0,0,0,0
Orange,2020-06-13,336,70,6976,150,14,402,406
San Diego,2020-06-13,284,58,6195,118,18,324,342
Imperial,2020-06-13,78,8,237,18,0,0,86
Alameda,2020-06-13,87,27,2968,33,3,150,114
Shasta,2020-06-13,1,0,667,0,0,6,1
Butte,2020-06-13,3,0,448,3,1,20,3
Amador,2020-06-13,0,0,51,0,0,3,0
Mariposa,2020-06-13,0,0,30,0,0,0,0
Colusa,2020-06-13,0,0,88,0,0,6,0
Contra Costa,2020-06-13,23,24,1628,8,6,108,47
Lake,2020-06-13,0,1,110,0,1,0,1
Siskiyou,2020-06-13,0,1,65,0,1,3,1
Santa Clara,2020-06-13,35,14,3423,12,3,211,49
Glenn,2020-06-13,1,0,47,0,0,0,1
Trinity,2020-06-13,0,1,54,0,0,0,1
Monterey,2020-06-13,15,3,811,2,0,91,18
Placer,2020-06-13,7,6,753,2,2,50,13
Kern,2020-06-13,79,28,1742,33,4,78,107
Tehama,2020-06-13,0,0,106,0,0,6,0
Mendocino,2020-06-13,0,0,180,0,0,5,0
San Bernardino,2020-06-13,204,81,4821,83,18,129,285
Tuolumne,2020-06-13,0,0,151,0,0,0,0
Madera,2020-06-13,6,2,528,2,0,8,8
Napa,2020-06-13,0,5,397,0,0,3,5
Marin,2020-06-14,9,2,390,3,0,12,11
Plumas,2020-06-14,0,0,45,0,0,0,0
Nevada,2020-06-14,0,1,128,0,1,4,1
San Joaquin,2020-06-14,49,25,1366,16,2,10,74
Calaveras,2020-06-14,0,0,50,0,0,10,0
Yolo,2020-06-14,0,0,186,1,1,2,0
Butte,2020-06-14,3,0,448,3,0,19,3
Sacramento,2020-06-14,30,21,2441,12,5,90,51
Alameda,2020-06-14,88,36,2968,33,9,149,124
San Luis Obispo,2020-06-14,2,10,449,2,4,20,12
Imperial,2020-06-14,79,11,237,20,0,0,90
Trinity,2020-06-14,0,0,54,0,0,0,0
San Francisco,2020-06-14,40,9,2647,13,2,96,49
Glenn,2020-06-14,1,0,47,0,0,0,1
Mono,2020-06-14,0,0,40,0,0,2,0
Monterey,2020-06-14,11,4,811,1,0,95,15
Mendocino,2020-06-14,0,0,180,0,0,4,0
Shasta,2020-06-14,0,0,667,0,0,7,0
Siskiyou,2020-06-14,0,1,65,0,1,3,1
Yuba,2020-06-14,7,0,445,3,0,13,7
Los Angeles,2020-06-14,1288,509,23703,397,80,1283,1797
San Mateo,2020-06-14,18,11,1089,9,1,51,29
Lassen,2020-06-14,0,0,25,0,0,0,0
Kern,2020-06-14,81,22,1742,32,3,76,103
Del Norte,2020-06-14,0,0,51,0,0,0,0
Napa,2020-06-14,2,1,397,0,1,2,3
Fresno,2020-06-14,58,35,2135,21,3,79,93
Modoc,2020-06-14,0,0,41,0,0,0,0
Sutter,2020-06-14,0,0,14,0,0,0,0
Riverside,2020-06-14,228,92,3992,70,19,120,320
Tehama,2020-06-14,0,0,106,0,0,6,0
San Diego,2020-06-14,282,84,6145,111,21,323,366
Placer,2020-06-14,7,6,753,2,2,49,13
Lake,2020-06-14,0,1,110,0,1,0,1
Kings,2020-06-14,38,2,199,9,0,3,40
Inyo,2020-06-14,0,0,42,0,0,3,0
Colusa,2020-06-14,0,0,88,0,0,6,0
Ventura,2020-06-14,42,47,1354,12,7,55,89
Merced,2020-06-14,3,1,242,2,0,5,4
Santa Barbara,2020-06-14,37,4,717,8,2,59,41
Santa Cruz,2020-06-14,3,6,397,0,0,12,9
Solano,2020-06-14,14,7,707,6,1,49,21
Santa Clara,2020-06-14,38,16,3423,12,3,204,54
San Bernardino,2020-06-14,206,89,4821,77,18,140,295
Amador,2020-06-14,0,0,51,0,0,1,0
El Dorado,2020-06-14,0,4,235,0,4,10,4
Stanislaus,2020-06-14,44,12,1369,16,1,87,56
San Benito,2020-06-14,0,0,25,0,0,0,0
Madera,2020-06-14,5,0,528,2,0,8,5
Sonoma,2020-06-14,5,29,871,2,0,52,34
Tuolumne,2020-06-14,0,0,151,0,0,0,0
Mariposa,2020-06-14,0,0,30,0,0,0,0
Tulare,2020-06-14,38,2,780,6,1,23,40
Contra Costa,2020-06-14,26,16,1628,9,3,121,42
Humboldt,2020-06-14,0,4,352,0,0,3,4
Orange,2020-06-14,321,100,6976,143,21,414,421
San Bernardino,2020-06-15,221,74,4821,77,18,149,295
Yuba,2020-06-15,6,0,445,2,0,16,6
Amador,2020-06-15,1,0,51,0,0,0,1
Sutter,2020-06-15,0,0,14,0,0,0,0
Glenn,2020-06-15,1,0,47,0,0,0,1
Sonoma,2020-06-15,6,30,871,3,0,46,36
Merced,2020-06-15,3,0,242,2,0,5,3
Santa Clara,2020-06-15,38,16,3423,12,3,239,54
Kings,2020-06-15,38,1,199,10,0,2,39
San Francisco,2020-06-15,37,8,2647,10,0,94,45
Tuolumne,2020-06-15,0,0,151,0,0,2,0
Madera,2020-06-15,5,2,528,2,0,7,7
Shasta,2020-06-15,0,0,667,0,0,9,0
Solano,2020-06-15,16,7,707,6,1,44,23
Contra Costa,2020-06-15,27,6,1628,7,2,115,33
Trinity,2020-06-15,0,0,54,0,0,0,0
Fresno,2020-06-15,61,25,2111,22,2,86,86
Tulare,2020-06-15,46,3,780,8,1,12,49
Santa Cruz,2020-06-15,2,3,397,0,0,8,5
Mariposa,2020-06-15,0,0,30,0,0,0,0
Siskiyou,2020-06-15,0,0,65,0,0,0,0
San Luis Obispo,2020-06-15,3,1,447,2,0,26,4
Butte,2020-06-15,3,2,448,3,1,14,5
Kern,2020-06-15,90,17,1742,38,3,78,107
Colusa,2020-06-15,0,0,88,0,0,6,0
Napa,2020-06-15,5,1,397,1,1,5,6
Mono,2020-06-15,0,0,40,0,0,2,0
Del Norte,2020-06-15,0,0,51,0,0,0,0
El Dorado,2020-06-15,0,2,235,0,2,6,2
Tehama,2020-06-15,0,0,106,0,0,7,0
San Benito,2020-06-15,0,0,25,0,0,0,0
Calaveras,2020-06-15,0,0,50,0,0,9,0
Santa Barbara,2020-06-15,42,7,717,9,0,63,49
Inyo,2020-06-15,0,0,42,0,0,2,0
Los Angeles,2020-06-15,1420,536,23659,404,88,1333,1956
Alameda,2020-06-15,98,31,2968,37,9,148,129
Orange,2020-06-15,346,79,6976,138,21,417,425
Riverside,2020-06-15,237,98,4071,65,16,136,335
Marin,2020-06-15,6,3,390,1,0,15,9
Ventura,2020-06-15,44,39,1350,13,7,55,83
Yolo,2020-06-15,0,0,186,0,0,3,0
Imperial,2020-06-15,79,3,237,19,0,2,82
San Joaquin,2020-06-15,46,13,1376,18,2,16,59
Lassen,2020-06-15,0,0,25,0,0,0,0
Nevada,2020-06-15,0,2,131,0,2,5,2
Stanislaus,2020-06-15,43,18,1364,15,1,88,61
San Mateo,2020-06-15,17,5,1089,6,1,50,22
Plumas,2020-06-15,0,0,45,0,0,0,0
Placer,2020-06-15,7,6,753,3,2,48,13
Monterey,2020-06-15,14,2,811,1,0,93,16
Modoc,2020-06-15,0,0,41,0,0,0,0
Mendocino,2020-06-15,0,1,180,0,1,5,1
Lake,2020-06-15,0,0,110,0,0,0,0
Humboldt,2020-06-15,0,5,352,0,1,2,5
Sacramento,2020-06-15,33,15,2428,15,5,104,48
San Diego,2020-06-15,294,66,6129,120,13,356,360
Modoc,2020-06-16,0,0,41,0,0,0,0
Nevada,2020-06-16,0,1,134,0,0,7,1
Fresno,2020-06-16,67,36,2129,21,3,86,103
Madera,2020-06-16,5,3,528,3,0,11,8
Kings,2020-06-16,47,0,199,10,0,2,47
San Luis Obispo,2020-06-16,5,8,471,2,5,27,13
Mariposa,2020-06-16,0,0,30,0,0,0,0
San Benito,2020-06-16,0,0,25,0,0,0,0
Tuolumne,2020-06-16,0,0,151,0,0,0,0
Monterey,2020-06-16,13,4,824,2,0,93,17
Lassen,2020-06-16,0,0,25,0,0,0,0
Imperial,2020-06-16,83,2,237,21,0,0,85
Santa Clara,2020-06-16,32,16,3423,12,3,228,48
Kern,2020-06-16,96,14,1742,39,2,80,110
Del Norte,2020-06-16,0,0,51,0,0,2,0
El Dorado,2020-06-16,0,1,235,0,1,7,1
San Mateo,2020-06-16,17,11,1089,6,1,54,28
Ventura,2020-06-16,47,45,1347,13,9,58,92
San Joaquin,2020-06-16,47,14,1376,18,2,20,61
Shasta,2020-06-16,0,0,667,0,0,9,0
Sonoma,2020-06-16,5,13,871,3,0,51,18
Calaveras,2020-06-16,0,0,50,0,0,9,0
Sacramento,2020-06-16,36,21,2457,13,8,87,57
Contra Costa,2020-06-16,26,14,1628,9,4,108,40
Solano,2020-06-16,17,8,707,5,2,45,25
Los Angeles,2020-06-16,1429,518,23667,412,87,1175,1947
San Francisco,2020-06-16,34,8,2647,8,0,91,42
Mendocino,2020-06-16,0,0,180,0,0,4,0
Santa Barbara,2020-06-16,42,8,717,13,1,57,50
Tulare,2020-06-16,49,4,780,11,0,24,53
Marin,2020-06-16,6,3,390,1,0,14,9
Amador,2020-06-16,1,0,51,0,0,3,1
Plumas,2020-06-16,0,0,45,0,0,0,0
Placer,2020-06-16,8,10,753,3,2,51,18
San Bernardino,2020-06-16,229,64,4821,77,13,156,293
Glenn,2020-06-16,1,0,47,0,0,0,1
Orange,2020-06-16,364,65,6976,151,18,455,429
San Diego,2020-06-16,289,54,6168,130,12,320,343
Yolo,2020-06-16,1,0,186,0,0,6,1
Merced,2020-06-16,6,2,242,3,0,5,8
Lake,2020-06-16,0,2,110,0,1,0,2
Santa Cruz,2020-06-16,3,1,397,0,0,7,4
Riverside,2020-06-16,257,84,4071,65,18,136,341
Tehama,2020-06-16,0,0,106,0,0,4,0
Alameda,2020-06-16,95,38,2968,36,12,142,133
Yuba,2020-06-16,6,0,445,2,0,17,6
Sutter,2020-06-16,0,0,14,0,0,0,0
Colusa,2020-06-16,0,1,88,0,0,6,1
Stanislaus,2020-06-16,50,14,1369,16,3,89,64
Inyo,2020-06-16,0,0,42,0,0,2,0
Butte,2020-06-16,3,0,448,3,0,10,3
Napa,2020-06-16,4,6,397,1,0,6,10
Trinity,2020-06-16,0,0,54,0,0,0,0
Mono,2020-06-16,0,0,40,0,0,2,0
Humboldt,2020-06-16,1,7,352,0,1,0,8
Siskiyou,2020-06-16,0,1,65,0,1,4,1
Orange,2020-06-17,351,74,6976,149,16,407,425
Madera,2020-06-17,4,3,528,4,1,7,7
Los Angeles,2020-06-17,1446,512,23646,414,61,1151,1958
Amador,2020-06-17,1,0,51,0,0,1,1
Marin,2020-06-17,7,1,390,2,1,9,8
Sacramento,2020-06-17,34,18,2395,14,5,77,52
Plumas,2020-06-17,0,0,45,0,0,0,0
Kern,2020-06-17,99,24,1412,45,0,31,123
Sonoma,2020-06-17,6,13,871,3,2,47,19
Tulare,2020-06-17,46,3,780,10,1,23,49
Butte,2020-06-17,3,0,448,3,0,4,3
Mendocino,2020-06-17,0,0,180,0,0,4,0
Fresno,2020-06-17,73,30,2138,16,1,81,103
Santa Barbara,2020-06-17,38,10,717,12,3,35,48
Tuolumne,2020-06-17,0,0,151,0,0,0,0
Santa Cruz,2020-06-17,3,4,397,0,3,9,7
Ventura,2020-06-17,37,64,1368,14,9,45,101
Merced,2020-06-17,6,4,242,3,0,3,10
Calaveras,2020-06-17,0,0,50,0,0,9,0
Yuba,2020-06-17,5,0,445,1,0,18,5
San Francisco,2020-06-17,35,9,2647,8,3,86,44
Inyo,2020-06-17,0,0,42,0,0,3,0
Yolo,2020-06-17,2,0,186,0,0,6,2
San Luis Obispo,2020-06-17,4,3,365,2,1,73,7
Napa,2020-06-17,3,6,397,0,0,6,9
Glenn,2020-06-17,1,0,47,0,0,0,1
Tehama,2020-06-17,0,0,106,0,0,6,0
Lake,2020-06-17,0,1,110,0,0,0,1
Stanislaus,2020-06-17,49,25,1369,14,3,84,74
El Dorado,2020-06-17,0,2,88,0,0,11,2
Santa Clara,2020-06-17,37,18,3438,15,0,204,55
San Bernardino,2020-06-17,233,64,4821,76,12,146,297
Sutter,2020-06-17,0,0,14,0,0,0,0
Solano,2020-06-17,13,6,707,4,0,52,19
Del Norte,2020-06-17,0,0,51,0,0,2,0
San Benito,2020-06-17,0,0,25,0,0,0,0
Mariposa,2020-06-17,0,0,30,0,0,0,0
Riverside,2020-06-17,285,94,4071,75,19,91,379
Colusa,2020-06-17,0,0,88,0,0,6,0
Humboldt,2020-06-17,0,3,352,0,1,0,3
Contra Costa,2020-06-17,23,9,1628,10,3,96,32
Modoc,2020-06-17,0,0,41,0,0,0,0
Lassen,2020-06-17,0,0,25,0,0,0,0
Imperial,2020-06-17,86,3,237,20,0,0,89
San Diego,2020-06-17,283,60,6235,130,17,324,343
Monterey,2020-06-17,15,2,824,2,1,85,17
San Joaquin,2020-06-17,50,11,1376,18,1,23,61
Siskiyou,2020-06-17,1,3,65,1,0,2,4
Trinity,2020-06-17,0,2,54,0,0,0,2
Placer,2020-06-17,6,10,753,2,1,51,16
Shasta,2020-06-17,0,0,667,0,0,12,0
Kings,2020-06-17,48,1,199,10,0,4,49
Mono,2020-06-17,0,0,40,0,0,2,0
Nevada,2020-06-17,2,0,145,0,0,9,2
Alameda,2020-06-17,90,47,2968,36,13,135,137
San Mateo,2020-06-17,14,6,1089,6,1,50,20
Madera,2020-06-18,10,6,528,5,1,11,16
San Diego,2020-06-18,288,63,6190,136,15,313,351
San Luis Obispo,2020-06-18,6,2,450,3,0,19,8
Mariposa,2020-06-18,0,0,30,0,0,0,0
Contra Costa,2020-06-18,25,18,1628,10,4,146,43
Solano,2020-06-18,18,11,707,5,0,53,29
Marin,2020-06-18,5,1,390,2,0,9,6
Kern,2020-06-18,89,14,1742,41,0,87,103
Inyo,2020-06-18,0,0,42,0,0,2,0
Nevada,2020-06-18,2,1,123,0,0,9,3
Los Angeles,2020-06-18,1406,494,23644,403,88,1195,1900
Modoc,2020-06-18,0,0,41,0,0,0,0
Trinity,2020-06-18,0,2,54,0,0,0,2
Kings,2020-06-18,48,2,199,10,0,1,50
Imperial,2020-06-18,72,1,237,16,0,6,73
Placer,2020-06-18,12,7,753,3,2,60,19
Shasta,2020-06-18,1,0,667,0,0,8,1
Merced,2020-06-18,12,5,242,3,0,6,17
Glenn,2020-06-18,1,0,47,0,0,0,1
Tehama,2020-06-18,0,0,106,0,0,4,0
Tulare,2020-06-18,47,4,780,8,0,11,51
Napa,2020-06-18,4,3,397,0,0,5,7
Calaveras,2020-06-18,0,1,50,0,0,8,1
Siskiyou,2020-06-18,1,0,65,1,0,4,1
Yuba,2020-06-18,4,0,445,1,0,8,4
Tuolumne,2020-06-18,0,0,151,0,0,0,0
Fresno,2020-06-18,72,26,2131,13,0,70,98
San Mateo,2020-06-18,15,9,1089,6,2,59,24
San Benito,2020-06-18,0,0,25,0,0,1,0
Humboldt,2020-06-18,0,3,352,0,1,4,3
Riverside,2020-06-18,292,129,4017,76,21,97,421
Santa Cruz,2020-06-18,2,2,397,1,0,10,4
San Joaquin,2020-06-18,56,20,1376,22,5,23,76
Santa Clara,2020-06-18,38,11,3438,17,2,205,49
Monterey,2020-06-18,20,1,824,5,0,89,21
Sonoma,2020-06-18,5,11,871,3,1,64,16
Del Norte,2020-06-18,0,0,51,0,0,2,0
San Bernardino,2020-06-18,253,60,4821,87,8,156,313
Colusa,2020-06-18,0,0,88,0,0,6,0
Ventura,2020-06-18,40,37,1372,13,10,39,77
San Francisco,2020-06-18,33,12,2647,8,2,155,45
Butte,2020-06-18,4,0,448,2,0,6,4
Plumas,2020-06-18,0,0,45,0,0,0,0
Sacramento,2020-06-18,34,13,2462,13,1,180,47
Stanislaus,2020-06-18,56,37,1369,21,3,88,93
Orange,2020-06-18,335,87,6976,141,15,412,422
Santa Barbara,2020-06-18,42,6,717,14,1,33,48
Alameda,2020-06-18,77,53,2968,38,16,195,130
Sutter,2020-06-18,0,0,14,0,0,0,0
Mono,2020-06-18,0,0,40,0,0,2,0
Lassen,2020-06-18,0,0,25,0,0,0,0
Lake,2020-06-18,0,2,110,0,0,1,2
Mendocino,2020-06-18,0,0,180,0,0,4,0
Amador,2020-06-18,1,1,51,1,0,1,2
Yolo,2020-06-18,2,1,186,0,0,4,3
El Dorado,2020-06-18,0,3,227,0,3,8,3
Imperial,2020-06-19,80,0,237,17,0,5,80
Glenn,2020-06-19,0,0,47,0,0,0,0
Marin,2020-06-19,5,0,390,3,0,12,5
Placer,2020-06-19,11,11,753,3,2,65,22
Humboldt,2020-06-19,0,1,352,0,1,1,1
Tehama,2020-06-19,0,0,106,0,0,1,0
Colusa,2020-06-19,0,0,88,0,0,6,0
Solano,2020-06-19,17,7,707,6,0,49,24
Sonoma,2020-06-19,4,4,871,3,1,57,8
San Benito,2020-06-19,0,0,25,0,0,2,0
Tuolumne,2020-06-19,0,0,151,0,0,2,0
San Luis Obispo,2020-06-19,5,2,440,3,0,15,7
Napa,2020-06-19,3,8,397,0,0,4,11
Los Angeles,2020-06-19,1426,494,23649,408,73,1197,1920
Merced,2020-06-19,9,1,242,3,0,5,10
Sutter,2020-06-19,0,0,14,0,0,0,0
Mariposa,2020-06-19,0,0,30,0,0,0,0
San Bernardino,2020-06-19,261,57,4821,90,9,147,318
Amador,2020-06-19,0,0,51,0,0,2,0
Kings,2020-06-19,49,1,199,10,0,4,50
Yuba,2020-06-19,4,0,445,1,0,7,4
El Dorado,2020-06-19,0,3,235,0,3,9,3
Fresno,2020-06-19,64,37,2135,16,2,72,101
Riverside,2020-06-19,296,90,4013,72,25,91,386
Sacramento,2020-06-19,37,17,2479,16,5,180,54
Modoc,2020-06-19,0,0,41,0,0,0,0
Shasta,2020-06-19,1,0,667,1,0,1,1
Lassen,2020-06-19,0,0,25,0,0,0,0
Santa Cruz,2020-06-19,4,4,397,1,2,7,8
Mendocino,2020-06-19,1,3,180,0,0,4,4
Contra Costa,2020-06-19,30,11,1628,9,1,150,41
Kern,2020-06-19,93,10,1742,38,0,87,103
Nevada,2020-06-19,2,3,123,0,0,5,5
Siskiyou,2020-06-19,1,0,65,1,0,3,1
Butte,2020-06-19,4,1,448,2,1,9,5
Del Norte,2020-06-19,0,0,51,0,0,5,0
Orange,2020-06-19,344,66,6976,138,11,420,410
San Mateo,2020-06-19,15,5,1089,5,0,61,20
Plumas,2020-06-19,0,0,45,0,0,0,0
San Diego,2020-06-19,294,65,6214,143,10,302,359
San Joaquin,2020-06-19,59,15,1376,19,2,56,74
Yolo,2020-06-19,2,0,186,0,0,4,2
Ventura,2020-06-19,43,38,1348,13,7,39,81
Monterey,2020-06-19,18,1,824,5,0,87,19
Lake,2020-06-19,0,0,110,0,0,1,0
Trinity,2020-06-19,0,4,54,0,0,0,4
Inyo,2020-06-19,0,0,42,0,0,2,0
San Francisco,2020-06-19,30,9,2647,8,4,151,39
Calaveras,2020-06-19,0,1,50,0,0,9,1
Stanislaus,2020-06-19,59,34,1364,23,4,86,93
Tulare,2020-06-19,48,2,780,12,0,9,50
Madera,2020-06-19,10,1,528,5,0,11,11
Alameda,2020-06-19,80,57,2968,36,20,192,137
Mono,2020-06-19,0,0,40,0,0,2,0
Santa Barbara,2020-06-19,46,4,717,17,1,53,50
Santa Clara,2020-06-19,39,21,3438,18,3,209,60
Inyo,2020-06-20,0,0,42,0,0,3,0
El Dorado,2020-06-20,0,2,235,0,2,9,2
Stanislaus,2020-06-20,67,30,1364,23,4,97,97
Contra Costa,2020-06-20,34,17,1628,8,6,145,51
Calaveras,2020-06-20,1,1,50,0,1,9,2
Orange,2020-06-20,363,83,6976,142,25,410,446
Modoc,2020-06-20,0,0,41,0,0,0,0
Fresno,2020-06-20,71,44,2134,14,3,80,115
San Benito,2020-06-20,0,0,25,0,0,3,0
San Diego,2020-06-20,280,50,6169,138,10,308,330
Sonoma,2020-06-20,5,0,871,3,0,92,5
Riverside,2020-06-20,297,69,3959,77,23,113,366
San Mateo,2020-06-20,15,6,1089,7,0,62,21
Del Norte,2020-06-20,0,0,51,0,0,5,0
Mendocino,2020-06-20,0,0,180,0,0,6,0
Los Angeles,2020-06-20,1453,516,23631,408,87,1276,1969
Santa Barbara,2020-06-20,52,5,717,16,1,46,57
Napa,2020-06-20,2,8,397,0,0,5,10
Kern,2020-06-20,103,13,1742,42,0,89,116
Shasta,2020-06-20,1,0,667,1,0,3,1
Lassen,2020-06-20,0,0,25,0,0,0,0
Trinity,2020-06-20,0,4,54,0,0,0,4
Tuolumne,2020-06-20,0,0,151,0,0,4,0
Humboldt,2020-06-20,0,1,352,0,1,4,1
Lake,2020-06-20,0,0,110,0,0,1,0
Glenn,2020-06-20,0,0,47,0,0,0,0
Sutter,2020-06-20,0,0,14,0,0,0,0
Colusa,2020-06-20,0,0,88,0,0,6,0
Alameda,2020-06-20,77,44,2968,33,12,203,121
Tulare,2020-06-20,47,2,780,10,1,8,49
Merced,2020-06-20,9,1,242,3,1,3,10
Monterey,2020-06-20,19,0,824,5,0,81,19
Marin,2020-06-20,5,0,390,3,0,9,5
San Luis Obispo,2020-06-20,5,4,464,2,1,22,9
Mariposa,2020-06-20,0,0,30,0,0,0,0
Mono,2020-06-20,0,0,40,0,0,2,0
Imperial,2020-06-20,89,0,237,20,0,4,89
Yuba,2020-06-20,3,0,445,1,0,11,3
Amador,2020-06-20,0,0,51,0,0,1,0
Plumas,2020-06-20,0,0,45,0,0,0,0
Yolo,2020-06-20,3,0,186,1,0,3,3
Placer,2020-06-20,10,11,753,2,2,62,21
San Joaquin,2020-06-20,67,20,1376,23,5,61,87
Santa Cruz,2020-06-20,4,3,397,2,0,9,7
Sacramento,2020-06-20,39,14,2452,19,4,171,53
Butte,2020-06-20,3,0,448,3,0,11,3
Ventura,2020-06-20,47,26,1352,13,3,40,73
San Bernardino,2020-06-20,252,78,4821,94,5,149,330
Siskiyou,2020-06-20,1,0,65,1,0,4,1
San Francisco,2020-06-20,32,24,2647,10,5,140,56
Santa Clara,2020-06-20,41,14,3438,20,1,212,55
Madera,2020-06-20,8,2,528,3,0,8,10
Kings,2020-06-20,44,0,199,8,0,2,44
Solano,2020-06-20,22,10,707,7,0,47,32
Tehama,2020-06-20,0,0,106,0,0,2,0
Nevada,2020-06-20,3,3,123,1,0,4,6
Lake,2020-06-21,0,1,110,0,0,2,1
Fresno,2020-06-21,73,31,2126,18,2,83,104
Alameda,2020-06-21,76,43,2968,30,12,203,119
Kern,2020-06-21,108,17,1742,41,0,90,125
Mariposa,2020-06-21,0,0,30,0,0,0,0
San Diego,2020-06-21,277,49,6088,137,15,330,326
Imperial,2020-06-21,95,0,237,21,0,1,95
Orange,2020-06-21,361,85,6976,142,29,406,446
Plumas,2020-06-21,0,0,45,0,0,0,0
Inyo,2020-06-21,0,0,42,0,0,3,0
San Joaquin,2020-06-21,81,21,1376,24,2,58,102
Trinity,2020-06-21,0,3,54,0,0,0,3
San Mateo,2020-06-21,18,9,1089,8,1,63,27
San Francisco,2020-06-21,37,7,2647,12,1,149,44
Yuba,2020-06-21,3,0,445,2,0,11,3
Sonoma,2020-06-21,4,3,871,3,0,62,7
Humboldt,2020-06-21,0,1,352,0,1,3,1
Solano,2020-06-21,20,9,707,8,1,45,29
Santa Cruz,2020-06-21,5,4,397,2,0,11,9
Sacramento,2020-06-21,46,15,2450,22,6,184,61
Los Angeles,2020-06-21,1515,486,23624,412,80,1316,2001
Glenn,2020-06-21,0,0,47,0,0,0,0
Lassen,2020-06-21,0,0,25,0,0,0,0
San Bernardino,2020-06-21,270,74,4821,97,11,159,344
El Dorado,2020-06-21,0,2,235,0,2,8,2
Sutter,2020-06-21,0,0,14,0,0,0,0
Santa Barbara,2020-06-21,46,8,717,19,2,43,54
San Benito,2020-06-21,0,0,25,0,0,3,0
Napa,2020-06-21,5,3,397,0,0,5,8
Nevada,2020-06-21,3,4,123,2,0,3,7
Tuolumne,2020-06-21,0,0,151,0,0,5,0
Placer,2020-06-21,11,9,753,1,1,56,20
San Luis Obispo,2020-06-21,4,2,461,2,0,26,6
Amador,2020-06-21,0,1,51,0,1,0,1
Ventura,2020-06-21,51,37,1345,14,10,37,88
Del Norte,2020-06-21,0,0,51,0,0,6,0
Santa Clara,2020-06-21,40,21,3438,21,0,229,61
Tehama,2020-06-21,0,0,106,0,0,5,0
Riverside,2020-06-21,299,106,3960,87,23,105,405
Monterey,2020-06-21,18,0,824,6,0,82,18
Marin,2020-06-21,9,2,390,3,0,10,11
Yolo,2020-06-21,3,1,186,1,1,0,4
Mono,2020-06-21,0,0,40,0,0,2,0
Colusa,2020-06-21,0,1,88,0,0,6,1
Contra Costa,2020-06-21,35,16,1628,10,7,147,51
Mendocino,2020-06-21,0,0,180,0,0,10,0
Shasta,2020-06-21,2,1,667,1,1,2,3
Madera,2020-06-21,7,0,528,3,0,12,7
Merced,2020-06-21,9,3,242,3,0,3,12
Stanislaus,2020-06-21,70,21,1369,24,3,96,91
Calaveras,2020-06-21,0,1,50,0,0,10,1
Tulare,2020-06-21,49,5,780,10,1,13,54
Siskiyou,2020-06-21,1,0,65,1,0,4,1
Kings,2020-06-21,45,0,199,7,0,3,45
Butte,2020-06-21,6,0,448,5,0,10,6
Modoc,2020-06-21,0,0,41,0,0,0,0
Kern,2020-06-22,115,14,1742,44,0,89,129
San Joaquin,2020-06-22,91,50,1376,22,5,58,141
Butte,2020-06-22,6,3,448,3,2,11,9
Siskiyou,2020-06-22,1,0,65,1,0,4,1
Nevada,2020-06-22,3,3,128,2,1,3,6
Inyo,2020-06-22,0,0,42,0,0,3,0
Del Norte,2020-06-22,0,0,51,0,0,6,0
Yolo,2020-06-22,1,0,186,1,0,0,1
Monterey,2020-06-22,20,1,824,7,0,91,21
Plumas,2020-06-22,0,0,45,0,0,0,0
Lassen,2020-06-22,0,0,25,0,0,0,0
Trinity,2020-06-22,0,2,54,0,0,0,2
Mono,2020-06-22,0,0,40,0,0,2,0
Mendocino,2020-06-22,0,0,180,0,0,10,0
San Diego,2020-06-22,286,60,6067,137,18,357,346
Santa Cruz,2020-06-22,6,4,397,2,0,13,10
San Luis Obispo,2020-06-22,4,3,445,3,1,21,7
Contra Costa,2020-06-22,32,19,1579,10,3,164,51
Glenn,2020-06-22,0,0,47,0,0,0,0
San Bernardino,2020-06-22,301,84,4821,109,14,128,385
Sonoma,2020-06-22,6,1,871,4,1,58,7
San Benito,2020-06-22,0,0,25,0,0,1,0
Fresno,2020-06-22,83,39,2125,18,1,82,122
Amador,2020-06-22,0,0,51,0,0,0,0
Napa,2020-06-22,5,5,397,1,1,6,10
Sacramento,2020-06-22,46,8,2458,19,1,181,54
Tuolumne,2020-06-22,0,0,151,0,0,4,0
Solano,2020-06-22,19,7,707,7,1,46,26
Tehama,2020-06-22,0,0,106,0,0,4,0
Placer,2020-06-22,11,9,753,2,0,58,20
Imperial,2020-06-22,95,0,237,17,0,0,95
Santa Clara,2020-06-22,48,16,3438,25,0,229,64
Tulare,2020-06-22,53,4,780,10,0,6,57
Alameda,2020-06-22,78,34,2968,30,8,196,112
Yuba,2020-06-22,4,0,445,3,0,6,4
Madera,2020-06-22,6,1,528,2,0,15,7
Lake,2020-06-22,0,0,110,0,0,2,0
Humboldt,2020-06-22,0,1,352,0,0,3,1
Stanislaus,2020-06-22,73,19,1374,26,3,86,92
Santa Barbara,2020-06-22,51,7,717,20,1,36,58
Calaveras,2020-06-22,0,0,50,0,0,10,0
Shasta,2020-06-22,2,0,667,1,0,4,2
Kings,2020-06-22,47,0,199,8,0,1,47
Los Angeles,2020-06-22,1556,534,23612,406,76,1398,2090
Sutter,2020-06-22,0,0,14,0,0,0,0
Orange,2020-06-22,376,90,6976,152,24,413,466
Merced,2020-06-22,7,2,242,3,0,4,9
Modoc,2020-06-22,0,0,41,0,0,0,0
El Dorado,2020-06-22,1,0,235,1,0,7,1
Ventura,2020-06-22,49,56,1342,14,13,38,105
Marin,2020-06-22,11,2,390,4,0,14,13
San Francisco,2020-06-22,40,7,2337,12,2,140,47
San Mateo,2020-06-22,19,4,1089,9,1,60,23
Riverside,2020-06-22,316,107,3960,90,19,104,423
Mariposa,2020-06-22,0,0,30,0,0,0,0
Colusa,2020-06-22,0,1,88,0,0,6,1
Mono,2020-06-23,0,0,40,0,0,2,0
San Diego,2020-06-23,312,58,6183,146,11,338,370
Ventura,2020-06-23,54,40,1350,14,9,40,94
Madera,2020-06-23,7,0,528,1,0,15,7
Del Norte,2020-06-23,1,0,51,1,0,4,1
Fresno,2020-06-23,91,48,2133,22,0,83,139
Glenn,2020-06-23,0,0,47,0,0,0,0
Tehama,2020-06-23,0,0,106,0,0,5,0
Alameda,2020-06-23,86,42,2968,33,11,196,128
Siskiyou,2020-06-23,1,0,65,1,0,2,1
Sacramento,2020-06-23,50,15,2477,18,0,171,65
Los Angeles,2020-06-23,1633,626,23601,416,100,1301,2259
Kings,2020-06-23,51,0,199,9,0,1,51
Mariposa,2020-06-23,0,0,30,0,0,0,0
San Luis Obispo,2020-06-23,5,2,461,2,1,19,7
Solano,2020-06-23,23,3,707,7,0,46,26
Marin,2020-06-23,12,2,390,3,1,15,14
Orange,2020-06-23,406,79,6976,154,20,395,485
Placer,2020-06-23,10,3,753,2,0,62,13
Merced,2020-06-23,9,3,242,3,0,4,12
Modoc,2020-06-23,0,0,41,0,0,0,0
Plumas,2020-06-23,0,0,45,0,0,0,0
Amador,2020-06-23,0,0,51,0,0,0,0
Santa Cruz,2020-06-23,6,3,397,1,0,12,9
Lassen,2020-06-23,0,0,25,0,0,0,0
Monterey,2020-06-23,21,2,824,7,0,88,23
Tulare,2020-06-23,56,5,780,11,0,16,61
Contra Costa,2020-06-23,37,15,1579,8,2,159,52
Santa Clara,2020-06-23,57,15,3438,31,0,225,72
Butte,2020-06-23,7,0,448,4,0,12,7
Nevada,2020-06-23,3,2,126,2,0,4,5
El Dorado,2020-06-23,1,2,235,1,2,6,3
Tuolumne,2020-06-23,1,0,151,0,0,5,1
Sonoma,2020-06-23,9,5,871,7,3,56,14
San Francisco,2020-06-23,45,8,2647,16,2,145,53
Colusa,2020-06-23,0,1,88,0,0,6,1
Santa Barbara,2020-06-23,53,8,717,22,2,33,61
Yolo,2020-06-23,1,0,186,1,0,2,1
Kern,2020-06-23,118,15,1742,43,1,87,133
Inyo,2020-06-23,0,0,42,0,0,3,0
San Mateo,2020-06-23,22,5,1089,8,2,62,27
Stanislaus,2020-06-23,82,16,1374,27,2,84,98
Trinity,2020-06-23,0,1,54,0,0,0,1
Napa,2020-06-23,7,7,397,0,1,3,14
Imperial,2020-06-23,93,0,237,18,0,2,93
San Joaquin,2020-06-23,89,20,1376,23,3,61,109
San Benito,2020-06-23,0,0,25,0,0,1,0
Yuba,2020-06-23,6,1,445,1,0,10,7
Calaveras,2020-06-23,0,1,50,0,0,12,1
Humboldt,2020-06-23,1,1,352,1,0,1,2
San Bernardino,2020-06-23,311,130,4821,111,22,130,441
Riverside,2020-06-23,315,119,4010,92,23,98,434
Mendocino,2020-06-23,0,0,180,0,0,7,0
Lake,2020-06-23,0,1,110,0,1,0,1
Sutter,2020-06-23,0,0,14,0,0,0,0
Shasta,2020-06-23,3,0,667,1,0,5,3
Del Norte,2020-06-24,1,0,51,1,0,0,1
Marin,2020-06-24,14,2,390,5,0,9,16
Mono,2020-06-24,0,0,40,0,0,2,0
Lake,2020-06-24,0,1,110,0,0,0,1
Amador,2020-06-24,0,0,51,0,0,1,0
Sutter,2020-06-24,0,0,14,0,0,0,0
Tehama,2020-06-24,0,0,106,0,0,5,0
San Francisco,2020-06-24,46,9,2647,17,3,105,55
Merced,2020-06-24,14,3,242,4,0,2,17
Napa,2020-06-24,6,1,397,4,1,0,7
Colusa,2020-06-24,1,0,88,0,0,6,1
Kern,2020-06-24,118,14,1742,44,2,80,132
San Joaquin,2020-06-24,89,33,1376,25,3,52,122
Calaveras,2020-06-24,0,0,50,0,0,11,0
Humboldt,2020-06-24,1,2,352,1,1,2,3
Santa Clara,2020-06-24,65,13,3438,31,0,215,78
Glenn,2020-06-24,0,0,47,0,0,0,0
Monterey,2020-06-24,21,4,824,9,0,81,25
Riverside,2020-06-24,312,125,4010,95,27,100,437
Santa Barbara,2020-06-24,54,3,717,20,1,53,57
Trinity,2020-06-24,0,2,54,0,0,0,2
Kings,2020-06-24,54,0,199,9,0,0,54
Shasta,2020-06-24,3,0,667,1,0,7,3
Modoc,2020-06-24,0,0,41,0,0,0,0
Inyo,2020-06-24,0,1,42,0,0,4,1
Stanislaus,2020-06-24,85,17,1374,31,0,81,102
Imperial,2020-06-24,82,0,237,14,0,2,82
Placer,2020-06-24,8,8,753,2,1,54,16
Fresno,2020-06-24,93,46,2113,22,2,86,139
Yolo,2020-06-24,5,0,186,4,0,0,5
Sonoma,2020-06-24,7,1,871,4,1,55,8
San Benito,2020-06-24,0,0,25,0,0,1,0
Tulare,2020-06-24,56,3,780,9,0,6,59
Siskiyou,2020-06-24,1,0,65,1,0,3,1
San Bernardino,2020-06-24,331,101,4821,113,12,131,432
El Dorado,2020-06-24,1,0,235,1,0,7,1
Sacramento,2020-06-24,61,16,2491,14,4,97,77
San Luis Obispo,2020-06-24,6,5,484,2,1,37,11
Mariposa,2020-06-24,0,0,30,0,0,0,0
Santa Cruz,2020-06-24,6,3,397,1,0,12,9
Nevada,2020-06-24,3,0,139,3,0,4,3
Lassen,2020-06-24,0,0,25,0,0,0,0
Ventura,2020-06-24,52,34,1360,15,8,53,86
Madera,2020-06-24,9,4,528,2,0,15,13
Alameda,2020-06-24,89,41,2968,31,9,147,130
Yuba,2020-06-24,5,0,445,1,0,7,5
San Mateo,2020-06-24,24,5,1089,8,3,50,29
San Diego,2020-06-24,333,50,6195,152,15,335,383
Los Angeles,2020-06-24,1676,607,23580,430,93,1259,2283
Mendocino,2020-06-24,0,0,180,0,0,6,0
Orange,2020-06-24,437,106,6976,161,25,385,543
Butte,2020-06-24,6,1,448,4,1,8,7
Plumas,2020-06-24,0,0,45,0,0,0,0
Tuolumne,2020-06-24,0,0,151,0,0,5,0
Solano,2020-06-24,26,2,707,6,0,44,28
Contra Costa,2020-06-24,39,19,1579,9,4,165,58
Alameda,2020-06-25,91,49,2968,34,10,147,140
Tehama,2020-06-25,0,0,106,0,0,5,0
Sutter,2020-06-25,0,0,14,0,0,0,0
Shasta,2020-06-25,4,1,667,1,1,1,5
Marin,2020-06-25,14,2,390,5,1,13,16
Imperial,2020-06-25,76,1,237,16,0,6,77
Tulare,2020-06-25,55,4,835,11,0,7,59
Lake,2020-06-25,0,2,110,0,2,1,2
Lassen,2020-06-25,0,0,25,0,0,0,0
Kern,2020-06-25,123,14,1742,49,2,78,137
Ventura,2020-06-25,60,38,1357,16,6,57,98
Glenn,2020-06-25,0,0,47,0,0,0,0
Santa Cruz,2020-06-25,6,7,397,1,1,9,13
Sonoma,2020-06-25,7,4,871,4,2,54,11
Madera,2020-06-25,9,4,528,3,0,10,13
Del Norte,2020-06-25,1,0,51,1,0,1,1
Kings,2020-06-25,57,0,199,8,0,4,57
Inyo,2020-06-25,0,0,42,0,0,4,0
San Diego,2020-06-25,368,57,6148,154,14,294,425
Fresno,2020-06-25,103,44,2022,23,3,74,147
Siskiyou,2020-06-25,1,0,65,1,0,5,1
El Dorado,2020-06-25,1,0,235,1,0,11,1
Tuolumne,2020-06-25,1,0,151,0,0,1,1
Amador,2020-06-25,0,0,51,0,0,1,0
Monterey,2020-06-25,17,7,824,9,2,78,24
Contra Costa,2020-06-25,42,18,1579,12,3,147,60
Butte,2020-06-25,6,0,448,2,0,5,6
Placer,2020-06-25,8,8,753,2,1,50,16
Solano,2020-06-25,25,4,707,7,1,45,29
Napa,2020-06-25,5,0,397,4,0,5,5
Calaveras,2020-06-25,1,1,50,1,0,9,2
San Francisco,2020-06-25,44,10,2647,13,4,104,54
Orange,2020-06-25,451,95,6976,166,23,383,546
Modoc,2020-06-25,0,0,41,0,0,0,0
San Joaquin,2020-06-25,101,36,1384,25,7,50,137
San Luis Obispo,2020-06-25,7,1,477,4,0,35,8
Sacramento,2020-06-25,73,24,2491,20,4,93,97
Santa Clara,2020-06-25,68,14,3438,26,0,186,82
Yolo,2020-06-25,6,0,186,4,0,1,6
Santa Barbara,2020-06-25,55,4,717,24,2,50,59
Plumas,2020-06-25,0,0,45,0,0,0,0
San Benito,2020-06-25,0,0,25,0,0,1,0
Yuba,2020-06-25,6,0,445,2,0,8,6
Nevada,2020-06-25,3,1,121,3,1,3,4
San Mateo,2020-06-25,22,5,1089,10,1,49,27
Mendocino,2020-06-25,0,0,180,0,0,4,0
Mono,2020-06-25,0,0,40,0,0,2,0
Riverside,2020-06-25,319,141,4010,105,23,86,460
Colusa,2020-06-25,1,0,88,0,0,6,1
San Bernardino,2020-06-25,338,98,4821,116,11,119,436
Humboldt,2020-06-25,1,2,352,1,2,1,3
Los Angeles,2020-06-25,1698,539,23520,440,78,1234,2237
Merced,2020-06-25,13,1,242,6,0,1,14
Trinity,2020-06-25,0,2,54,0,0,0,2
Stanislaus,2020-06-25,93,21,1374,34,1,94,114
Mariposa,2020-06-25,0,0,30,0,0,0,0
Riverside,2020-06-26,339,135,4028,98,19,103,474
Solano,2020-06-26,28,5,707,8,0,39,33
Nevada,2020-06-26,1,5,124,1,1,4,6
Ventura,2020-06-26,62,38,1355,18,6,57,100
Amador,2020-06-26,0,0,51,0,0,0,0
San Bernardino,2020-06-26,349,97,4821,122,11,115,446
San Luis Obispo,2020-06-26,7,1,471,2,0,36,8
Sutter,2020-06-26,0,0,14,0,0,0,0
Siskiyou,2020-06-26,0,0,65,0,0,3,0
Tehama,2020-06-26,0,0,106,0,0,5,0
Yuba,2020-06-26,5,1,445,1,0,15,6
Calaveras,2020-06-26,1,1,50,1,0,10,2
Monterey,2020-06-26,17,2,824,10,0,81,19
Kings,2020-06-26,58,0,199,6,0,6,58
Glenn,2020-06-26,0,1,47,0,0,0,1
Sacramento,2020-06-26,73,10,2510,19,2,78,83
Merced,2020-06-26,15,0,242,5,0,4,15
Alameda,2020-06-26,92,41,2968,35,9,123,133
San Francisco,2020-06-26,54,14,2647,18,4,89,68
Mariposa,2020-06-26,0,0,30,0,0,0,0
Butte,2020-06-26,6,0,448,1,0,11,6
Mendocino,2020-06-26,0,0,180,0,0,6,0
Santa Clara,2020-06-26,66,16,3438,26,0,188,82
Shasta,2020-06-26,5,1,667,2,0,3,6
Modoc,2020-06-26,0,1,41,0,0,0,1
Plumas,2020-06-26,0,0,45,0,0,0,0
Del Norte,2020-06-26,1,0,51,1,0,2,1
Inyo,2020-06-26,0,0,42,0,0,4,0
San Diego,2020-06-26,362,65,6176,158,13,310,427
Orange,2020-06-26,467,93,6976,179,20,396,560
Marin,2020-06-26,13,8,390,5,0,13,21
Stanislaus,2020-06-26,101,21,1369,35,2,84,122
Lassen,2020-06-26,0,0,25,0,0,0,0
Trinity,2020-06-26,0,1,54,0,0,0,1
El Dorado,2020-06-26,1,0,235,1,0,9,1
Mono,2020-06-26,0,0,40,0,0,1,0
Contra Costa,2020-06-26,42,23,1579,10,2,132,65
San Benito,2020-06-26,0,0,25,0,0,1,0
Imperial,2020-06-26,71,3,237,15,0,10,74
Tulare,2020-06-26,58,8,835,12,0,11,66
Placer,2020-06-26,8,5,753,3,0,33,13
Colusa,2020-06-26,1,0,88,0,0,6,1
Humboldt,2020-06-26,2,3,352,0,0,2,5
Kern,2020-06-26,136,11,1742,46,2,73,147
Fresno,2020-06-26,107,50,2018,24,4,73,157
Madera,2020-06-26,11,2,528,0,0,15,13
San Mateo,2020-06-26,20,1,1089,8,0,55,21
Yolo,2020-06-26,6,0,186,4,0,3,6
Santa Cruz,2020-06-26,8,6,397,1,0,9,14
Lake,2020-06-26,0,1,110,0,1,1,1
Tuolumne,2020-06-26,1,0,151,0,0,2,1
Sonoma,2020-06-26,8,4,871,4,1,50,12
Los Angeles,2020-06-26,1717,579,23565,446,79,1289,2296
Santa Barbara,2020-06-26,53,6,717,20,1,74,59
Napa,2020-06-26,6,1,397,5,0,6,7
San Joaquin,2020-06-26,116,36,1430,29,6,44,152
Santa Clara,2020-06-27,77,18,3438,28,1,185,95
Trinity,2020-06-27,0,1,54,0,0,0,1
San Luis Obispo,2020-06-27,8,3,470,2,0,38,11
San Benito,2020-06-27,0,0,25,0,0,2,0
Yuba,2020-06-27,6,0,445,1,0,8,6
Del Norte,2020-06-27,1,0,51,0,0,0,1
Humboldt,2020-06-27,1,3,352,0,1,1,4
Shasta,2020-06-27,5,0,667,1,0,3,5
Sacramento,2020-06-27,77,17,2438,20,8,79,94
Tehama,2020-06-27,0,0,106,0,0,3,0
San Bernardino,2020-06-27,353,79,4821,130,9,124,432
San Francisco,2020-06-27,56,16,2647,21,4,103,72
Merced,2020-06-27,15,0,242,6,0,3,15
Mendocino,2020-06-27,0,0,180,0,0,5,0
San Joaquin,2020-06-27,126,28,1430,30,7,47,154
San Mateo,2020-06-27,23,4,1089,8,1,54,27
Mono,2020-06-27,0,0,40,0,0,2,0
Solano,2020-06-27,31,5,707,9,0,39,36
Ventura,2020-06-27,65,41,1348,16,9,46,106
Monterey,2020-06-27,19,2,824,11,0,84,21
Contra Costa,2020-06-27,38,25,1579,10,3,130,63
Butte,2020-06-27,5,0,448,2,0,5,5
Santa Barbara,2020-06-27,60,5,717,21,1,70,65
Imperial,2020-06-27,77,2,237,17,0,8,79
Riverside,2020-06-27,340,145,3980,108,23,88,485
Lake,2020-06-27,0,3,110,0,2,0,3
Placer,2020-06-27,11,3,753,3,0,36,14
Plumas,2020-06-27,0,0,45,0,0,0,0
Orange,2020-06-27,492,103,6976,170,22,401,595
Lassen,2020-06-27,0,0,25,0,0,0,0
Siskiyou,2020-06-27,0,0,65,0,0,5,0
Sutter,2020-06-27,0,0,14,0,0,0,0
Kings,2020-06-27,54,1,199,6,0,5,55
Tuolumne,2020-06-27,1,1,151,0,1,3,2
Madera,2020-06-27,12,10,528,0,0,15,22
El Dorado,2020-06-27,1,1,235,1,1,9,2
Fresno,2020-06-27,111,53,2016,27,2,73,164
Calaveras,2020-06-27,1,0,50,1,0,9,1
Yolo,2020-06-27,5,1,186,1,1,4,6
Santa Cruz,2020-06-27,9,6,397,1,0,4,15
Glenn,2020-06-27,0,1,47,0,0,0,1
Modoc,2020-06-27,0,0,41,0,0,0,0
Napa,2020-06-27,7,1,397,5,0,1,8
Nevada,2020-06-27,1,3,126,1,1,7,4
Amador,2020-06-27,0,0,51,0,0,0,0
Sonoma,2020-06-27,10,3,871,5,3,49,13
Marin,2020-06-27,12,2,390,5,0,16,14
Mariposa,2020-06-27,0,0,30,0,0,0,0
Colusa,2020-06-27,1,1,88,0,0,6,2
Tulare,2020-06-27,54,7,835,10,0,13,61
Los Angeles,2020-06-27,1710,606,23683,443,80,1244,2316
Stanislaus,2020-06-27,98,31,1364,33,2,86,129
Kern,2020-06-27,142,34,1742,42,10,70,176
Alameda,2020-06-27,99,40,2968,36,11,115,139
Inyo,2020-06-27,0,0,42,0,0,3,0
San Diego,2020-06-27,363,74,5950,154,14,320,437
Lassen,2020-06-28,0,0,25,0,0,0,0
Riverside,2020-06-28,367,115,3976,106,18,96,482
Los Angeles,2020-06-28,1783,682,23562,469,97,1320,2465
San Luis Obispo,2020-06-28,8,2,458,2,0,38,10
Alameda,2020-06-28,102,39,2968,35,10,124,141
Calaveras,2020-06-28,1,1,50,1,0,10,2
Kings,2020-06-28,53,1,199,6,0,1,54
Yuba,2020-06-28,7,0,445,1,0,17,7
El Dorado,2020-06-28,1,3,235,1,3,6,4
San Mateo,2020-06-28,27,5,1089,11,0,54,32
Orange,2020-06-28,485,110,6976,175,18,417,595
Placer,2020-06-28,13,5,753,4,0,33,18
Siskiyou,2020-06-28,0,0,65,0,0,4,0
Modoc,2020-06-28,0,0,41,0,0,0,0
Marin,2020-06-28,15,4,390,5,0,16,19
Lake,2020-06-28,2,0,110,2,0,1,2
Kern,2020-06-28,146,9,1742,53,1,75,155
Nevada,2020-06-28,1,3,125,1,2,2,4
Yolo,2020-06-28,3,1,186,1,1,1,4
Shasta,2020-06-28,8,2,667,1,0,7,10
Ventura,2020-06-28,66,32,1348,21,8,62,98
Santa Cruz,2020-06-28,9,10,397,0,0,7,19
Napa,2020-06-28,7,3,397,5,2,6,10
Colusa,2020-06-28,0,0,88,0,0,6,0
Santa Clara,2020-06-28,83,22,3438,32,1,187,105
Tulare,2020-06-28,66,5,835,12,0,5,71
Madera,2020-06-28,9,7,528,0,1,15,16
Inyo,2020-06-28,0,0,42,0,0,3,0
Fresno,2020-06-28,118,48,2012,30,1,68,166
Mariposa,2020-06-28,0,0,30,0,0,0,0
San Francisco,2020-06-28,59,10,2647,22,3,103,69
San Bernardino,2020-06-28,376,83,4821,135,12,124,459
Amador,2020-06-28,0,0,51,0,0,0,0
Stanislaus,2020-06-28,108,28,1365,36,2,83,136
Sonoma,2020-06-28,11,1,871,6,1,48,12
Sutter,2020-06-28,0,0,14,0,0,0,0
Mendocino,2020-06-28,0,0,180,0,0,5,0
Merced,2020-06-28,19,0,242,6,0,2,19
Tehama,2020-06-28,0,0,106,0,0,2,0
San Diego,2020-06-28,373,85,5865,160,18,314,458
Del Norte,2020-06-28,1,1,51,1,1,0,2
Contra Costa,2020-06-28,32,18,1579,13,5,130,50
San Benito,2020-06-28,0,0,25,0,0,3,0
Solano,2020-06-28,30,5,707,7,0,39,35
Plumas,2020-06-28,0,0,45,0,0,0,0
Santa Barbara,2020-06-28,66,3,717,21,0,73,69
Humboldt,2020-06-28,1,3,352,0,1,1,4
Imperial,2020-06-28,72,2,237,17,0,1,74
Butte,2020-06-28,5,0,448,2,0,4,5
Trinity,2020-06-28,0,4,54,0,0,0,4
Sacramento,2020-06-28,87,19,2435,21,9,70,106
San Joaquin,2020-06-28,129,31,1430,34,6,52,160
Glenn,2020-06-28,0,1,47,0,0,0,1
Mono,2020-06-28,0,0,40,0,0,2,0
Tuolumne,2020-06-28,1,0,151,0,0,1,1
Monterey,2020-06-28,26,0,824,10,0,79,26
Orange,2020-06-29,510,114,6976,176,24,410,624
Santa Clara,2020-06-29,87,18,3438,31,2,190,105
Colusa,2020-06-29,0,0,88,0,0,6,0
San Benito,2020-06-29,0,0,25,0,0,1,0
Solano,2020-06-29,39,5,707,8,0,42,44
Inyo,2020-06-29,0,0,42,0,0,2,0
Tuolumne,2020-06-29,1,0,151,0,0,0,1
Riverside,2020-06-29,405,102,4001,109,21,111,507
El Dorado,2020-06-29,1,1,235,1,1,9,2
Butte,2020-06-29,6,1,448,2,1,9,7
Tulare,2020-06-29,74,6,835,13,0,12,80
Lake,2020-06-29,2,0,110,2,0,1,2
Los Angeles,2020-06-29,1889,622,23622,504,91,1239,2511
Madera,2020-06-29,9,6,528,0,0,16,15
Merced,2020-06-29,16,2,242,6,0,3,18
Marin,2020-06-29,25,4,390,8,1,8,29
Sacramento,2020-06-29,98,32,2430,28,6,80,130
Santa Cruz,2020-06-29,10,6,397,1,0,12,16
Amador,2020-06-29,1,0,51,1,0,1,1
Calaveras,2020-06-29,1,1,50,1,0,10,2
Santa Barbara,2020-06-29,62,8,717,19,2,79,70
Monterey,2020-06-29,33,2,824,7,1,84,35
Ventura,2020-06-29,74,37,1346,26,4,45,111
Siskiyou,2020-06-29,0,0,65,0,0,4,0
Nevada,2020-06-29,3,4,127,2,1,1,7
Fresno,2020-06-29,116,54,2005,30,2,76,170
Glenn,2020-06-29,0,0,47,0,0,0,0
San Luis Obispo,2020-06-29,9,6,455,2,1,42,15
Imperial,2020-06-29,70,2,237,16,0,5,72
San Francisco,2020-06-29,63,16,2647,22,4,120,79
Lassen,2020-06-29,0,0,25,0,0,0,0
Stanislaus,2020-06-29,113,29,1363,35,3,74,142
Yolo,2020-06-29,3,1,186,1,0,1,4
Sonoma,2020-06-29,11,1,871,7,1,50,12
Del Norte,2020-06-29,1,0,51,1,0,0,1
Kern,2020-06-29,151,9,1742,53,2,74,160
San Mateo,2020-06-29,33,8,1089,15,1,55,41
Trinity,2020-06-29,0,5,54,0,0,0,5
Kings,2020-06-29,55,1,199,6,0,2,56
Tehama,2020-06-29,0,0,106,0,0,1,0
Sutter,2020-06-29,0,0,14,0,0,0,0
San Diego,2020-06-29,395,98,5848,156,26,324,493
Mendocino,2020-06-29,0,0,180,0,0,3,0
Humboldt,2020-06-29,0,3,352,0,1,2,3
Yuba,2020-06-29,8,0,445,3,0,11,8
Mariposa,2020-06-29,0,0,30,0,0,0,0
Modoc,2020-06-29,0,0,41,0,0,0,0
Alameda,2020-06-29,111,35,2968,38,6,138,146
Plumas,2020-06-29,0,0,45,0,0,0,0
Contra Costa,2020-06-29,37,24,1579,14,5,142,61
Placer,2020-06-29,13,9,753,4,1,33,22
Napa,2020-06-29,7,3,397,6,2,0,10
Mono,2020-06-29,0,0,40,0,0,2,0
Shasta,2020-06-29,9,3,667,1,0,7,12
San Bernardino,2020-06-29,393,85,4821,138,10,140,478
San Joaquin,2020-06-29,133,26,1430,35,3,53,159
Santa Barbara,2020-06-30,64,6,717,20,1,73,70
Los Angeles,2020-06-30,1893,645,23639,526,102,1170,2538
Lassen,2020-06-30,0,0,25,0,0,0,0
Imperial,2020-06-30,72,2,237,18,0,3,74
Calaveras,2020-06-30,1,2,50,1,1,10,3
Mariposa,2020-06-30,0,0,30,0,0,0,0
Mono,2020-06-30,0,0,40,0,0,2,0
Tuolumne,2020-06-30,1,0,151,0,0,1,1
Colusa,2020-06-30,1,2,88,0,0,6,3
San Francisco,2020-06-30,68,12,2647,28,5,113,80
El Dorado,2020-06-30,3,1,235,1,1,3,4
Madera,2020-06-30,8,2,528,0,0,17,10
Sonoma,2020-06-30,11,4,871,7,1,50,15
Del Norte,2020-06-30,1,0,51,1,0,0,1
San Luis Obispo,2020-06-30,9,3,456,3,1,42,12
Alameda,2020-06-30,116,41,2968,43,6,143,157
Lake,2020-06-30,3,2,110,1,2,1,5
Siskiyou,2020-06-30,0,0,65,0,0,6,0
Modoc,2020-06-30,0,0,41,0,0,0,0
Yuba,2020-06-30,5,0,445,3,0,8,5
Shasta,2020-06-30,10,2,667,2,0,9,12
Inyo,2020-06-30,0,0,42,0,0,3,0
Riverside,2020-06-30,419,112,4001,117,21,105,531
Orange,2020-06-30,542,120,6976,192,20,386,662
Tehama,2020-06-30,0,0,106,0,0,1,0
Sacramento,2020-06-30,106,21,2451,29,2,86,127
Mendocino,2020-06-30,0,0,180,0,0,4,0
Solano,2020-06-30,41,5,707,13,0,36,46
Kern,2020-06-30,163,12,1742,60,1,69,175
Plumas,2020-06-30,0,0,45,0,0,0,0
Kings,2020-06-30,41,0,199,4,0,2,41
San Bernardino,2020-06-30,406,85,4821,142,21,120,491
Nevada,2020-06-30,4,3,121,2,0,4,7
Sutter,2020-06-30,0,0,14,0,0,0,0
Monterey,2020-06-30,36,5,824,7,0,89,41
Fresno,2020-06-30,129,42,2016,33,4,74,171
San Mateo,2020-06-30,40,7,1089,18,1,49,47
Amador,2020-06-30,1,1,51,1,0,0,2
Placer,2020-06-30,13,11,753,4,1,35,24
San Joaquin,2020-06-30,140,56,1430,37,8,42,196
Stanislaus,2020-06-30,118,52,1363,35,4,78,170
Santa Cruz,2020-06-30,10,6,397,1,0,15,16
Tulare,2020-06-30,73,6,835,14,0,11,79
Contra Costa,2020-06-30,41,20,1579,17,6,140,61
Merced,2020-06-30,15,1,242,4,1,3,16
Butte,2020-06-30,6,0,448,2,0,9,6
San Benito,2020-06-30,1,0,25,0,0,0,1
Napa,2020-06-30,7,2,397,7,1,1,9
Glenn,2020-06-30,0,0,47,0,0,0,0
San Diego,2020-06-30,391,62,6164,158,15,335,453
Yolo,2020-06-30,4,1,186,1,1,0,5
Humboldt,2020-06-30,1,3,352,0,1,1,4
Trinity,2020-06-30,0,0,54,0,0,0,0
Santa Clara,2020-06-30,81,12,3438,33,1,177,93
Ventura,2020-06-30,76,43,1346,22,12,43,119
Marin,2020-06-30,25,4,390,10,1,5,29
Sacramento,2020-07-01,109,27,2491,31,7,89,136
Imperial,2020-07-01,79,2,237,19,0,6,81
Madera,2020-07-01,15,7,528,5,1,17,22
Marin,2020-07-01,30,2,390,12,0,5,32
Alameda,2020-07-01,123,47,2968,43,12,141,170
Siskiyou,2020-07-01,0,0,65,0,0,3,0
Riverside,2020-07-01,431,116,4014,123,20,106,547
Placer,2020-07-01,13,20,753,4,1,28,33
San Diego,2020-07-01,398,64,6183,159,16,319,462
Tulare,2020-07-01,78,5,835,15,0,9,83
Contra Costa,2020-07-01,50,21,1579,19,7,143,71
San Joaquin,2020-07-01,128,35,1430,37,7,47,163
Merced,2020-07-01,17,9,242,4,2,5,26
Santa Barbara,2020-07-01,62,4,717,24,0,62,66
Santa Cruz,2020-07-01,10,0,397,1,0,21,10
Glenn,2020-07-01,0,0,47,0,0,0,0
San Bernardino,2020-07-01,428,88,4564,151,19,95,516
Calaveras,2020-07-01,2,0,50,2,0,8,2
Tuolumne,2020-07-01,3,0,151,1,0,0,3
Napa,2020-07-01,7,1,397,7,1,41,8
Lassen,2020-07-01,0,0,25,0,0,0,0
Humboldt,2020-07-01,1,3,352,1,1,2,4
Kern,2020-07-01,164,14,1742,58,0,70,178
Orange,2020-07-01,556,149,5725,193,34,346,705
Amador,2020-07-01,1,1,51,1,0,0,2
Mendocino,2020-07-01,0,0,180,0,0,4,0
Mariposa,2020-07-01,0,0,30,0,0,0,0
Los Angeles,2020-07-01,1937,643,21731,537,95,1092,2580
Stanislaus,2020-07-01,121,61,1372,38,6,82,182
Solano,2020-07-01,48,9,707,13,0,36,57
Del Norte,2020-07-01,1,0,51,0,0,0,1
Yolo,2020-07-01,4,1,186,1,1,1,5
Fresno,2020-07-01,125,24,2028,32,5,80,149
Kings,2020-07-01,40,1,199,6,1,3,41
Ventura,2020-07-01,79,38,1328,24,8,47,117
Inyo,2020-07-01,0,0,42,0,0,4,0
Tehama,2020-07-01,0,0,106,0,0,4,0
Plumas,2020-07-01,0,0,45,0,0,0,0
Santa Clara,2020-07-01,82,18,3438,35,5,168,100
San Mateo,2020-07-01,45,10,1089,20,1,51,55
San Francisco,2020-07-01,71,14,2647,31,2,110,85
Monterey,2020-07-01,41,2,824,10,0,81,43
El Dorado,2020-07-01,5,1,235,4,1,4,6
Sutter,2020-07-01,0,0,14,0,0,0,0
Mono,2020-07-01,0,0,40,0,0,2,0
Modoc,2020-07-01,0,2,41,0,0,0,2
Lake,2020-07-01,3,0,110,1,0,1,3
Shasta,2020-07-01,7,1,667,2,0,6,8
Sonoma,2020-07-01,13,4,871,4,1,51,17
San Benito,2020-07-01,1,0,25,0,0,1,1
San Luis Obispo,2020-07-01,8,6,472,3,1,40,14
Nevada,2020-07-01,4,2,122,2,0,4,6
Trinity,2020-07-01,0,0,54,0,0,0,0
Butte,2020-07-01,7,2,428,1,2,3,9
Yuba,2020-07-01,8,1,445,2,1,7,9
Colusa,2020-07-01,0,2,88,0,0,6,2
San Francisco,2020-07-02,66,16,2647,30,1,102,82
Lassen,2020-07-02,1,0,25,0,0,0,1
Placer,2020-07-02,17,22,753,4,0,24,39
El Dorado,2020-07-02,3,2,235,1,2,7,5
Tehama,2020-07-02,0,0,106,0,0,1,0
San Benito,2020-07-02,1,0,25,0,0,1,1
Mariposa,2020-07-02,0,0,30,0,0,0,0
Trinity,2020-07-02,0,0,54,0,0,0,0
Tuolumne,2020-07-02,4,0,151,1,0,1,4
San Joaquin,2020-07-02,151,42,1430,37,6,54,193
Monterey,2020-07-02,36,1,824,9,1,84,37
Santa Cruz,2020-07-02,10,3,397,3,0,28,13
Sacramento,2020-07-02,128,21,2492,34,6,82,149
Imperial,2020-07-02,86,3,237,17,1,6,89
Kings,2020-07-02,38,1,199,7,1,1,39
Mono,2020-07-02,0,0,40,0,0,2,0
Madera,2020-07-02,17,1,528,2,0,21,18
Stanislaus,2020-07-02,133,76,1372,35,13,83,209
Amador,2020-07-02,1,0,51,1,0,0,1
San Bernardino,2020-07-02,438,91,4793,156,13,85,529
Santa Barbara,2020-07-02,64,6,717,24,1,61,70
Orange,2020-07-02,584,132,6694,187,21,326,716
Shasta,2020-07-02,7,1,667,2,0,8,8
Sutter,2020-07-02,0,0,14,0,0,0,0
Nevada,2020-07-02,5,1,114,3,0,4,6
Ventura,2020-07-02,80,42,1363,28,12,54,122
Los Angeles,2020-07-02,1933,679,23057,546,86,1153,2612
Solano,2020-07-02,39,9,707,13,1,38,48
Napa,2020-07-02,7,2,397,3,0,43,9
Kern,2020-07-02,173,33,1742,56,1,67,206
Riverside,2020-07-02,465,111,4014,120,17,92,576
Humboldt,2020-07-02,1,0,352,1,0,2,1
Contra Costa,2020-07-02,56,20,1579,19,5,140,76
Butte,2020-07-02,9,3,428,4,2,3,12
Yuba,2020-07-02,8,3,445,2,1,16,11
Inyo,2020-07-02,0,0,42,0,0,3,0
Siskiyou,2020-07-02,0,0,65,0,0,0,0
Marin,2020-07-02,27,3,390,8,0,12,30
Lake,2020-07-02,3,1,110,1,0,1,4
San Diego,2020-07-02,380,79,6182,146,13,337,459
Mendocino,2020-07-02,0,0,180,0,0,2,0
Merced,2020-07-02,19,4,242,4,1,2,23
Yolo,2020-07-02,6,3,186,0,0,4,9
Fresno,2020-07-02,128,17,2029,34,1,68,145
Santa Clara,2020-07-02,91,16,3438,33,2,172,107
Calaveras,2020-07-02,0,3,50,0,2,9,3
Del Norte,2020-07-02,1,0,51,0,0,1,1
Tulare,2020-07-02,77,2,835,12,0,23,79
Sonoma,2020-07-02,12,3,871,3,1,50,15
Plumas,2020-07-02,0,0,45,0,0,0,0
Modoc,2020-07-02,0,0,41,0,0,0,0
Alameda,2020-07-02,141,52,2968,45,10,129,193
San Luis Obispo,2020-07-02,8,7,475,4,0,40,15
Colusa,2020-07-02,0,2,88,0,0,6,2
Glenn,2020-07-02,0,1,47,0,0,0,1
San Mateo,2020-07-02,52,4,1089,15,0,49,56
Fresno,2020-07-03,133,21,2092,37,0,77,154
Santa Cruz,2020-07-03,11,6,397,3,0,26,17
Yolo,2020-07-03,7,2,186,1,1,1,9
Tuolumne,2020-07-03,1,0,151,1,0,0,1
Merced,2020-07-03,20,6,242,4,1,3,26
Madera,2020-07-03,10,9,528,5,1,8,19
Imperial,2020-07-03,83,2,298,18,0,17,85
Napa,2020-07-03,6,2,397,4,0,43,8
Marin,2020-07-03,28,3,392,8,0,11,31
Shasta,2020-07-03,8,1,667,2,0,7,9
Santa Barbara,2020-07-03,71,4,763,21,1,68,75
Mendocino,2020-07-03,0,0,180,0,0,1,0
Siskiyou,2020-07-03,0,0,65,0,0,2,0
Riverside,2020-07-03,472,99,4103,121,11,107,571
San Luis Obispo,2020-07-03,8,3,476,4,0,39,11
Ventura,2020-07-03,85,38,1549,26,5,56,123
San Benito,2020-07-03,1,0,25,0,0,0,1
San Mateo,2020-07-03,56,4,1119,17,0,57,60
Butte,2020-07-03,7,2,428,4,0,6,9
Mariposa,2020-07-03,0,0,30,0,0,0,0
Tulare,2020-07-03,75,3,835,12,0,25,78
Plumas,2020-07-03,0,0,45,0,0,0,0
Lassen,2020-07-03,1,0,65,0,0,0,1
Santa Clara,2020-07-03,84,16,3438,36,2,171,100
Mono,2020-07-03,0,0,40,0,0,2,0
San Joaquin,2020-07-03,165,41,1430,40,4,45,206
Amador,2020-07-03,1,0,51,1,0,1,1
Kern,2020-07-03,189,14,1832,67,0,80,203
Del Norte,2020-07-03,1,0,51,0,0,0,1
Humboldt,2020-07-03,1,0,352,1,0,2,1
Lake,2020-07-03,3,0,110,1,0,2,3
Sacramento,2020-07-03,129,15,2486,34,5,80,144
Calaveras,2020-07-03,0,0,50,0,0,12,0
Monterey,2020-07-03,35,1,845,8,0,85,36
Solano,2020-07-03,38,9,707,14,1,35,47
Nevada,2020-07-03,4,1,96,2,1,7,5
Kings,2020-07-03,39,1,199,7,1,0,40
San Diego,2020-07-03,367,68,6316,148,9,318,435
Glenn,2020-07-03,0,1,47,0,0,0,1
Sonoma,2020-07-03,15,3,862,3,1,48,18
Trinity,2020-07-03,0,0,54,0,0,0,0
San Bernardino,2020-07-03,451,88,4834,155,14,87,539
Yuba,2020-07-03,9,1,445,3,0,17,10
Stanislaus,2020-07-03,137,73,1367,34,8,78,210
Los Angeles,2020-07-03,1947,696,23965,549,101,1189,2643
Sutter,2020-07-03,0,0,14,0,0,0,0
Placer,2020-07-03,19,26,753,3,0,29,45
San Francisco,2020-07-03,70,15,2647,27,2,107,85
Modoc,2020-07-03,0,0,41,0,0,0,0
Colusa,2020-07-03,0,0,88,0,0,6,0
Inyo,2020-07-03,0,0,42,0,0,4,0
Tehama,2020-07-03,0,0,106,0,0,1,0
Orange,2020-07-03,594,150,7401,193,24,320,744
Contra Costa,2020-07-03,54,21,1579,20,3,141,75
El Dorado,2020-07-03,3,1,235,2,1,8,4
Alameda,2020-07-03,157,51,2968,46,9,126,208
Lassen,2020-07-04,1,0,65,0,0,0,1
Siskiyou,2020-07-04,0,0,65,0,0,3,0
Del Norte,2020-07-04,1,0,51,0,0,0,1
Sutter,2020-07-04,0,0,14,0,0,0,0
Merced,2020-07-04,23,1,242,3,0,4,24
Imperial,2020-07-04,87,4,298,19,0,16,91
Ventura,2020-07-04,82,22,1549,30,5,50,104
Contra Costa,2020-07-04,59,22,1562,25,4,135,81
Colusa,2020-07-04,0,0,88,0,0,6,0
Madera,2020-07-04,15,12,528,2,0,21,27
Mendocino,2020-07-04,0,1,180,0,0,2,1
Yolo,2020-07-04,9,0,186,2,0,1,9
Calaveras,2020-07-04,0,1,50,0,0,11,1
San Bernardino,2020-07-04,461,96,4834,158,16,117,557
Santa Barbara,2020-07-04,69,7,763,21,3,73,76
Santa Clara,2020-07-04,83,18,3438,36,2,186,101
Humboldt,2020-07-04,1,0,352,1,0,2,1
Tuolumne,2020-07-04,1,0,151,0,0,6,1
Mariposa,2020-07-04,0,0,30,0,0,0,0
Kings,2020-07-04,46,2,199,6,2,2,48
Alameda,2020-07-04,146,44,2968,44,8,137,190
Orange,2020-07-04,624,148,7401,197,18,403,772
Kern,2020-07-04,204,16,1832,67,0,80,220
Lake,2020-07-04,3,1,110,0,1,2,4
Trinity,2020-07-04,0,0,54,0,0,0,0
Plumas,2020-07-04,0,0,45,0,0,0,0
Butte,2020-07-04,8,0,408,5,0,4,8
Tehama,2020-07-04,0,0,106,0,0,0,0
Stanislaus,2020-07-04,147,75,1367,40,4,85,222
El Dorado,2020-07-04,2,2,235,2,2,7,4
Tulare,2020-07-04,78,2,835,11,0,17,80
Monterey,2020-07-04,38,1,845,8,0,88,39
Riverside,2020-07-04,485,115,4070,123,17,120,600
Nevada,2020-07-04,5,2,93,1,1,3,7
Modoc,2020-07-04,0,0,41,0,0,0,0
Fresno,2020-07-04,139,23,2094,38,0,78,162
Mono,2020-07-04,0,0,40,0,0,2,0
Solano,2020-07-04,38,7,707,11,0,44,45
San Benito,2020-07-04,1,0,25,0,0,0,1
San Joaquin,2020-07-04,155,39,1430,46,5,50,194
Amador,2020-07-04,1,0,51,1,0,0,1
Placer,2020-07-04,19,27,753,3,1,37,46
Santa Cruz,2020-07-04,10,5,397,2,0,25,15
Los Angeles,2020-07-04,1921,653,23943,540,84,1336,2574
Sonoma,2020-07-04,18,8,862,5,1,51,26
Shasta,2020-07-04,8,1,667,3,0,7,9
Yuba,2020-07-04,10,2,445,5,1,13,12
San Francisco,2020-07-04,68,14,2647,26,1,102,82
Inyo,2020-07-04,0,0,42,0,0,4,0
Napa,2020-07-04,6,1,397,4,0,0,7
San Mateo,2020-07-04,46,4,1057,16,0,63,50
Glenn,2020-07-04,0,1,47,0,0,0,1
San Luis Obispo,2020-07-04,8,4,476,4,1,38,12
San Diego,2020-07-04,372,73,6267,156,11,344,445
Marin,2020-07-04,29,1,392,8,0,9,30
Sacramento,2020-07-04,142,25,2465,42,8,87,167
Calaveras,2020-07-05,0,2,50,0,1,10,2
Alameda,2020-07-05,146,37,2968,48,10,134,183
Yolo,2020-07-05,7,1,186,1,1,0,8
El Dorado,2020-07-05,2,0,235,2,0,7,2
San Mateo,2020-07-05,45,8,1050,15,0,67,53
Sutter,2020-07-05,0,0,14,0,0,0,0
Modoc,2020-07-05,0,0,41,0,0,0,0
Lake,2020-07-05,3,1,110,0,0,2,4
Santa Clara,2020-07-05,84,26,3438,33,2,198,110
Mariposa,2020-07-05,0,0,30,0,0,0,0
Kings,2020-07-05,45,2,199,7,1,5,47
Contra Costa,2020-07-05,49,39,1579,21,7,150,88
Tuolumne,2020-07-05,0,0,151,0,0,2,0
Trinity,2020-07-05,0,0,54,0,0,0,0
Placer,2020-07-05,22,19,753,4,4,35,41
Siskiyou,2020-07-05,0,1,65,0,0,5,1
Plumas,2020-07-05,0,0,45,0,0,0,0
Santa Cruz,2020-07-05,10,9,397,2,0,30,19
Santa Barbara,2020-07-05,67,6,763,18,3,72,73
Kern,2020-07-05,210,12,1832,64,0,74,222
Amador,2020-07-05,1,0,51,1,0,0,1
Sacramento,2020-07-05,148,21,2428,41,5,89,169
Lassen,2020-07-05,1,0,65,0,0,0,1
Solano,2020-07-05,39,8,707,11,1,40,47
Monterey,2020-07-05,38,2,845,6,0,91,40
Riverside,2020-07-05,498,116,4065,130,18,130,614
San Bernardino,2020-07-05,484,81,4834,164,11,112,565
Nevada,2020-07-05,4,5,89,1,1,3,9
Glenn,2020-07-05,0,1,47,0,0,0,1
Yuba,2020-07-05,14,2,445,6,1,6,16
Shasta,2020-07-05,6,1,667,3,0,5,7
San Benito,2020-07-05,0,0,25,0,0,0,0
Ventura,2020-07-05,77,26,1549,26,7,39,103
Merced,2020-07-05,24,0,242,4,0,3,24
Colusa,2020-07-05,0,0,88,0,0,6,0
Marin,2020-07-05,32,8,392,9,2,7,40
San Joaquin,2020-07-05,158,30,1430,39,2,45,188
Sonoma,2020-07-05,20,10,862,6,3,52,30
Humboldt,2020-07-05,1,1,352,1,0,2,2
Napa,2020-07-05,6,1,397,4,0,5,7
Stanislaus,2020-07-05,154,59,1367,46,4,88,213
Madera,2020-07-05,17,4,528,3,1,18,21
Orange,2020-07-05,634,158,7401,203,23,418,792
Los Angeles,2020-07-05,1969,676,23936,527,102,1295,2645
San Diego,2020-07-05,374,67,6250,158,16,350,441
Imperial,2020-07-05,89,4,298,20,0,15,93
Mendocino,2020-07-05,0,0,180,0,0,2,0
Fresno,2020-07-05,140,23,2090,39,1,81,163
Tulare,2020-07-05,78,2,835,9,0,17,80
San Luis Obispo,2020-07-05,10,7,451,3,2,41,17
Tehama,2020-07-05,0,0,106,0,0,1,0
Inyo,2020-07-05,0,1,42,0,1,3,1
Mono,2020-07-05,0,0,40,0,0,2,0
Butte,2020-07-05,10,0,408,6,0,1,10
San Francisco,2020-07-05,73,11,2647,25,1,122,84
Del Norte,2020-07-05,1,0,51,0,0,2,1
Lake,2020-07-06,3,3,110,0,1,2,6
San Joaquin,2020-07-06,168,74,1430,43,4,46,242
Tuolumne,2020-07-06,1,0,151,0,0,3,1
Riverside,2020-07-06,520,138,4110,130,16,124,658
San Francisco,2020-07-06,68,12,2647,27,1,120,80
Colusa,2020-07-06,0,0,88,0,0,6,0
Santa Barbara,2020-07-06,72,8,763,21,2,68,80
Los Angeles,2020-07-06,2004,666,23927,529,103,1334,2670
Sonoma,2020-07-06,22,11,862,8,5,48,33
Orange,2020-07-06,659,180,7416,224,26,406,839
Madera,2020-07-06,26,6,528,4,0,22,32
San Luis Obispo,2020-07-06,11,2,453,3,2,40,13
San Benito,2020-07-06,0,0,25,0,0,0,0
Del Norte,2020-07-06,1,0,51,0,0,2,1
Inyo,2020-07-06,0,1,42,0,1,3,1
Tehama,2020-07-06,0,0,106,0,0,1,0
Contra Costa,2020-07-06,57,27,1579,22,8,143,84
Plumas,2020-07-06,0,1,45,0,0,0,1
Santa Clara,2020-07-06,88,16,3438,33,2,195,104
Yolo,2020-07-06,9,0,186,2,0,0,9
Kern,2020-07-06,211,12,1832,60,1,85,223
Sutter,2020-07-06,0,0,14,0,0,0,0
Placer,2020-07-06,26,15,753,5,5,30,41
Mendocino,2020-07-06,0,0,180,0,0,6,0
Nevada,2020-07-06,3,3,114,1,0,6,6
Mono,2020-07-06,0,0,40,0,0,2,0
Yuba,2020-07-06,20,1,445,7,1,14,21
Imperial,2020-07-06,89,2,298,20,0,18,91
San Mateo,2020-07-06,48,7,1052,13,2,72,55
Siskiyou,2020-07-06,0,0,65,0,0,4,0
Alameda,2020-07-06,142,45,2968,50,10,132,187
Shasta,2020-07-06,5,1,671,3,0,9,6
Santa Cruz,2020-07-06,11,2,397,2,0,29,13
Merced,2020-07-06,22,2,242,5,1,4,24
Fresno,2020-07-06,148,14,2094,31,1,89,162
Sacramento,2020-07-06,157,15,2589,41,5,87,172
Solano,2020-07-06,38,5,707,15,1,35,43
El Dorado,2020-07-06,2,0,235,2,0,5,2
Monterey,2020-07-06,35,2,845,9,0,84,37
Ventura,2020-07-06,92,28,1549,30,8,47,120
Marin,2020-07-06,34,5,392,7,1,9,39
Butte,2020-07-06,12,1,466,7,1,1,13
Calaveras,2020-07-06,0,3,50,0,2,8,3
Mariposa,2020-07-06,0,0,30,0,0,0,0
Tulare,2020-07-06,81,5,835,11,2,8,86
Amador,2020-07-06,1,0,51,1,0,2,1
Stanislaus,2020-07-06,160,46,1372,41,5,99,206
Humboldt,2020-07-06,1,2,352,1,0,4,3
Napa,2020-07-06,7,0,397,6,0,5,7
Glenn,2020-07-06,0,1,47,0,0,0,1
Trinity,2020-07-06,0,0,54,0,0,0,0
San Bernardino,2020-07-06,501,73,4834,160,10,129,574
San Diego,2020-07-06,384,72,6614,159,16,339,456
Modoc,2020-07-06,0,0,41,0,0,0,0
Lassen,2020-07-06,1,0,65,0,0,0,1
Kings,2020-07-06,49,3,199,7,1,0,52
Trinity,2020-07-07,0,0,54,0,0,0,0
Tehama,2020-07-07,0,0,106,0,0,2,0
Los Angeles,2020-07-07,2037,792,23880,522,108,1368,2829
El Dorado,2020-07-07,2,1,235,2,1,9,3
Lake,2020-07-07,1,0,110,0,0,2,1
Alameda,2020-07-07,145,45,2968,51,13,133,190
Modoc,2020-07-07,0,0,41,0,0,0,0
San Joaquin,2020-07-07,168,41,1430,40,8,52,209
Fresno,2020-07-07,164,13,2090,38,0,71,177
Mendocino,2020-07-07,0,0,180,0,0,3,0
Sutter,2020-07-07,0,0,14,0,0,0,0
Orange,2020-07-07,679,138,7416,234,17,401,817
Del Norte,2020-07-07,1,0,51,0,0,2,1
Imperial,2020-07-07,93,0,298,20,0,16,93
Mariposa,2020-07-07,0,0,30,0,0,0,0
San Luis Obispo,2020-07-07,14,5,457,3,0,41,19
Plumas,2020-07-07,0,1,45,0,0,0,1
Tuolumne,2020-07-07,2,0,151,0,0,5,2
Stanislaus,2020-07-07,166,49,1372,45,6,89,215
Placer,2020-07-07,27,28,753,5,0,27,55
Sacramento,2020-07-07,155,18,2875,46,3,79,173
Santa Barbara,2020-07-07,80,9,763,23,2,66,89
Monterey,2020-07-07,37,2,845,10,0,90,39
Contra Costa,2020-07-07,55,31,1579,19,7,142,86
San Francisco,2020-07-07,72,16,2647,25,1,107,88
Solano,2020-07-07,36,8,707,15,2,39,44
Nevada,2020-07-07,1,1,82,1,0,6,2
Mono,2020-07-07,0,0,40,0,0,2,0
Colusa,2020-07-07,0,1,88,0,0,6,1
Kern,2020-07-07,203,20,1832,56,2,86,223
Ventura,2020-07-07,87,29,1549,33,5,48,116
Riverside,2020-07-07,508,143,4110,122,14,124,651
San Benito,2020-07-07,1,0,25,0,0,0,1
Sonoma,2020-07-07,24,9,862,9,2,43,33
Humboldt,2020-07-07,1,2,352,0,0,3,3
Kings,2020-07-07,52,2,199,7,0,7,54
Lassen,2020-07-07,0,0,65,0,0,0,0
Shasta,2020-07-07,2,3,671,1,2,8,5
San Diego,2020-07-07,406,73,6649,154,12,311,479
Yuba,2020-07-07,21,1,445,6,0,17,22
Marin,2020-07-07,36,8,392,8,0,16,44
Glenn,2020-07-07,0,1,47,0,0,0,1
San Bernardino,2020-07-07,511,68,4832,166,9,160,579
Calaveras,2020-07-07,0,0,50,0,0,9,0
Yolo,2020-07-07,8,0,186,3,0,0,8
Napa,2020-07-07,7,1,397,7,0,1,8
San Mateo,2020-07-07,53,7,1052,11,2,66,60
Santa Cruz,2020-07-07,13,3,397,3,0,26,16
Amador,2020-07-07,1,1,51,1,0,3,2
Santa Clara,2020-07-07,98,16,3438,42,2,172,114
Siskiyou,2020-07-07,0,0,65,0,0,6,0
Merced,2020-07-07,21,2,242,4,1,4,23
Madera,2020-07-07,20,8,340,5,1,17,28
Tulare,2020-07-07,78,7,835,10,1,17,85
Butte,2020-07-07,14,1,466,6,1,3,15
Inyo,2020-07-07,0,1,42,0,1,3,1
Calaveras,2020-07-08,0,0,50,0,0,9,0
Plumas,2020-07-08,0,0,45,0,0,0,0
Santa Barbara,2020-07-08,75,11,763,23,1,52,86
Orange,2020-07-08,691,124,7416,236,17,373,815
Trinity,2020-07-08,0,0,54,0,0,0,0
Sutter,2020-07-08,0,0,14,0,0,0,0
San Francisco,2020-07-08,73,15,2647,25,3,110,88
Sonoma,2020-07-08,24,11,862,6,1,50,35
Tehama,2020-07-08,0,0,106,0,0,4,0
San Luis Obispo,2020-07-08,14,4,460,3,0,39,18
Butte,2020-07-08,13,1,492,7,0,5,14
Kern,2020-07-08,215,12,1832,58,0,81,227
Marin,2020-07-08,33,10,392,8,1,15,43
Mono,2020-07-08,0,0,40,0,0,2,0
Lassen,2020-07-08,0,1,65,0,0,0,1
Imperial,2020-07-08,84,1,298,18,0,4,85
Placer,2020-07-08,28,28,753,6,1,26,56
Alameda,2020-07-08,140,48,2968,55,8,127,188
Modoc,2020-07-08,0,0,41,0,0,0,0
Amador,2020-07-08,1,0,51,1,0,3,1
El Dorado,2020-07-08,3,0,235,3,0,6,3
Lake,2020-07-08,1,2,110,0,1,0,3
Sacramento,2020-07-08,152,25,2913,43,3,79,177
Inyo,2020-07-08,0,1,42,0,1,2,1
Yolo,2020-07-08,11,0,186,6,0,4,11
Ventura,2020-07-08,85,26,1549,32,5,44,111
Mendocino,2020-07-08,0,0,180,0,0,3,0
Tuolumne,2020-07-08,2,1,151,0,0,4,3
Santa Cruz,2020-07-08,13,5,397,3,0,30,18
Del Norte,2020-07-08,0,0,51,0,0,1,0
Shasta,2020-07-08,6,1,671,3,0,10,7
Mariposa,2020-07-08,0,0,30,0,0,0,0
Stanislaus,2020-07-08,170,45,1372,50,5,81,215
Fresno,2020-07-08,172,34,2098,40,3,74,206
San Mateo,2020-07-08,51,9,1050,14,1,64,60
Tulare,2020-07-08,78,2,835,9,1,22,80
Merced,2020-07-08,19,3,242,3,0,2,22
Humboldt,2020-07-08,0,0,352,0,0,6,0
San Benito,2020-07-08,2,0,25,0,0,0,2
Siskiyou,2020-07-08,0,0,65,0,0,6,0
San Bernardino,2020-07-08,505,94,4838,148,5,162,599
San Joaquin,2020-07-08,186,58,1430,45,9,49,244
Monterey,2020-07-08,43,1,845,9,0,89,44
Colusa,2020-07-08,0,1,88,0,0,6,1
Santa Clara,2020-07-08,107,18,3438,48,3,192,125
Madera,2020-07-08,27,6,340,5,0,20,33
Glenn,2020-07-08,0,1,47,0,0,0,1
Contra Costa,2020-07-08,68,39,1579,20,7,136,107
Nevada,2020-07-08,1,1,101,1,0,6,2
Yuba,2020-07-08,20,0,445,5,0,16,20
San Diego,2020-07-08,407,76,6682,157,14,305,483
Solano,2020-07-08,37,8,707,10,4,42,45
Riverside,2020-07-08,515,149,4104,117,10,121,664
Los Angeles,2020-07-08,1995,822,23875,524,101,1311,2817
Napa,2020-07-08,8,0,397,5,0,2,8
Kings,2020-07-08,51,1,199,6,0,0,52
Modoc,2020-07-09,0,0,41,0,0,0,0
Orange,2020-07-09,672,128,7401,227,24,402,800
Imperial,2020-07-09,77,0,298,16,0,9,77
Solano,2020-07-09,39,8,707,11,3,45,47
Alameda,2020-07-09,133,52,2968,53,13,128,185
Napa,2020-07-09,9,0,387,5,0,2,9
Trinity,2020-07-09,0,0,54,0,0,0,0
Kings,2020-07-09,56,1,199,6,0,2,57
Kern,2020-07-09,217,10,1822,61,1,83,227
Sutter,2020-07-09,0,0,14,0,0,0,0
Butte,2020-07-09,16,0,492,10,0,5,16
Marin,2020-07-09,32,6,392,9,0,20,38
Ventura,2020-07-09,81,22,1549,30,6,48,103
Shasta,2020-07-09,5,1,671,3,0,10,6
San Bernardino,2020-07-09,522,78,4838,160,6,165,600
Del Norte,2020-07-09,0,0,51,0,0,2,0
Amador,2020-07-09,1,0,51,1,0,0,1
Yolo,2020-07-09,15,0,186,5,0,1,15
Madera,2020-07-09,23,7,340,4,0,18,30
Calaveras,2020-07-09,0,0,50,0,0,9,0
Santa Cruz,2020-07-09,13,3,397,3,0,18,16
Tuolumne,2020-07-09,0,0,151,0,0,4,0
Santa Clara,2020-07-09,112,23,3438,45,4,193,135
Tulare,2020-07-09,72,2,835,9,1,31,74
Los Angeles,2020-07-09,2032,817,23906,548,107,1368,2849
San Joaquin,2020-07-09,189,55,1430,49,6,41,244
Sonoma,2020-07-09,25,5,862,4,0,53,30
Colusa,2020-07-09,0,0,88,0,0,6,0
San Francisco,2020-07-09,76,18,2647,28,1,109,94
San Mateo,2020-07-09,47,11,1053,14,1,65,58
Santa Barbara,2020-07-09,73,9,763,25,2,53,82
Contra Costa,2020-07-09,77,35,1579,24,4,140,112
Placer,2020-07-09,27,21,753,4,3,27,48
Glenn,2020-07-09,0,0,47,0,0,0,0
Lassen,2020-07-09,0,1,65,0,0,0,1
Monterey,2020-07-09,46,1,845,9,0,93,47
Stanislaus,2020-07-09,167,61,1372,52,4,74,228
Fresno,2020-07-09,179,50,2216,38,4,74,229
Mendocino,2020-07-09,0,0,180,0,0,4,0
Merced,2020-07-09,22,11,242,4,0,4,33
Tehama,2020-07-09,0,0,106,0,0,4,0
Humboldt,2020-07-09,0,1,352,0,0,16,1
San Diego,2020-07-09,404,85,6675,151,16,309,489
Inyo,2020-07-09,0,1,42,0,1,2,1
Yuba,2020-07-09,16,1,445,3,0,8,17
Siskiyou,2020-07-09,0,0,65,0,0,5,0
Plumas,2020-07-09,0,0,45,0,0,0,0
Mariposa,2020-07-09,0,0,33,0,0,0,0
Mono,2020-07-09,0,0,40,0,0,2,0
San Luis Obispo,2020-07-09,10,5,461,3,2,35,15
Sacramento,2020-07-09,150,31,2927,45,3,87,181
San Benito,2020-07-09,3,0,25,1,0,1,3
Lake,2020-07-09,1,1,110,0,1,0,2
El Dorado,2020-07-09,3,0,235,0,0,9,3
Nevada,2020-07-09,1,2,91,1,0,3,3
Riverside,2020-07-09,528,162,4104,116,15,129,690
Kings,2020-07-10,57,1,199,6,0,2,58
Santa Cruz,2020-07-10,13,4,397,3,0,18,17
Inyo,2020-07-10,0,0,42,0,0,2,0
Imperial,2020-07-10,74,0,298,16,0,9,74
Yuba,2020-07-10,20,0,445,4,0,8,20
Del Norte,2020-07-10,0,0,51,0,0,2,0
Sutter,2020-07-10,0,0,14,0,0,0,0
Lake,2020-07-10,2,1,110,0,1,1,3
Amador,2020-07-10,1,1,51,1,0,1,2
Plumas,2020-07-10,0,0,45,0,0,0,0
Fresno,2020-07-10,186,49,2222,39,7,71,235
Modoc,2020-07-10,0,0,41,0,0,0,0
Merced,2020-07-10,30,8,242,5,1,4,38
San Benito,2020-07-10,4,0,25,1,0,2,4
Mendocino,2020-07-10,2,0,180,0,0,7,2
Ventura,2020-07-10,79,26,1549,28,4,52,105
San Luis Obispo,2020-07-10,12,5,468,4,0,40,17
Mariposa,2020-07-10,0,0,33,0,0,0,0
Orange,2020-07-10,671,114,7401,231,23,390,785
Sacramento,2020-07-10,157,19,2908,51,5,93,176
Los Angeles,2020-07-10,2093,684,23901,547,84,1327,2777
Tuolumne,2020-07-10,2,0,151,0,0,4,2
Trinity,2020-07-10,0,0,54,0,0,0,0
Marin,2020-07-10,30,6,392,9,1,20,36
Mono,2020-07-10,0,0,40,0,0,2,0
Placer,2020-07-10,31,18,753,5,3,25,49
Napa,2020-07-10,7,0,387,5,0,2,7
Santa Barbara,2020-07-10,72,9,763,25,1,73,81
Calaveras,2020-07-10,0,0,50,0,0,10,0
Santa Clara,2020-07-10,117,25,3438,46,4,181,142
Madera,2020-07-10,29,12,340,8,3,14,41
Stanislaus,2020-07-10,172,59,1393,46,6,87,231
Lassen,2020-07-10,0,1,65,0,0,0,1
Tulare,2020-07-10,69,2,835,9,0,33,71
Butte,2020-07-10,16,0,492,10,0,1,16
Sonoma,2020-07-10,28,8,862,5,2,53,36
Contra Costa,2020-07-10,83,24,1579,24,5,136,107
Riverside,2020-07-10,532,149,4123,116,14,146,681
Yolo,2020-07-10,12,3,186,3,3,4,15
Glenn,2020-07-10,0,0,47,0,0,0,0
Kern,2020-07-10,234,16,1822,64,0,112,250
Colusa,2020-07-10,0,0,88,0,0,6,0
Tehama,2020-07-10,0,0,106,0,0,3,0
Nevada,2020-07-10,1,1,93,1,0,6,2
San Mateo,2020-07-10,48,14,1056,14,4,56,62
Solano,2020-07-10,41,5,707,10,1,38,46
San Joaquin,2020-07-10,194,50,1430,53,9,36,244
Shasta,2020-07-10,5,1,671,3,0,18,6
San Diego,2020-07-10,411,79,6687,159,14,313,490
San Bernardino,2020-07-10,558,84,4838,157,10,197,642
Siskiyou,2020-07-10,1,1,65,0,0,6,2
El Dorado,2020-07-10,2,0,235,2,0,7,2
San Francisco,2020-07-10,76,21,2647,33,1,104,97
Monterey,2020-07-10,48,0,845,10,0,95,48
Humboldt,2020-07-10,0,1,352,0,0,5,1
Alameda,2020-07-10,137,46,2968,53,9,122,183
Amador,2020-07-11,0,0,51,0,0,3,0
Orange,2020-07-11,675,111,7401,233,18,378,786
San Benito,2020-07-11,3,0,25,0,0,2,3
Lake,2020-07-11,3,1,110,0,1,1,4
Tuolumne,2020-07-11,1,0,151,1,0,1,1
Kings,2020-07-11,65,0,199,6,0,2,65
Inyo,2020-07-11,0,0,42,0,0,2,0
Riverside,2020-07-11,511,136,4068,123,10,148,647
San Joaquin,2020-07-11,188,44,1430,53,8,33,232
Stanislaus,2020-07-11,172,46,1393,45,4,75,218
Ventura,2020-07-11,83,17,1549,29,5,48,100
Shasta,2020-07-11,3,2,671,1,2,4,5
Trinity,2020-07-11,0,0,54,0,0,0,0
Sutter,2020-07-11,0,0,14,0,0,0,0
Merced,2020-07-11,27,7,242,4,1,3,34
Calaveras,2020-07-11,0,0,50,0,0,9,0
Mono,2020-07-11,0,0,40,0,0,2,0
Madera,2020-07-11,25,11,340,4,2,14,36
Santa Barbara,2020-07-11,76,5,763,25,0,56,81
Imperial,2020-07-11,76,0,298,17,0,10,76
Colusa,2020-07-11,0,2,88,0,0,6,2
Yolo,2020-07-11,11,0,186,6,0,0,11
Napa,2020-07-11,8,0,387,4,0,4,8
Mendocino,2020-07-11,2,0,180,0,0,7,2
Del Norte,2020-07-11,0,0,51,0,0,0,0
San Francisco,2020-07-11,79,18,2647,34,1,112,97
Tulare,2020-07-11,74,3,835,9,1,23,77
San Diego,2020-07-11,385,81,6441,141,17,300,466
Nevada,2020-07-11,2,0,100,1,0,6,2
Lassen,2020-07-11,0,3,65,0,0,0,3
San Luis Obispo,2020-07-11,9,2,463,4,0,40,11
Los Angeles,2020-07-11,2056,713,23980,566,84,1352,2769
Modoc,2020-07-11,0,0,41,0,0,0,0
Tehama,2020-07-11,1,0,106,1,0,0,1
Monterey,2020-07-11,42,0,845,10,0,94,42
Kern,2020-07-11,249,24,1822,59,1,82,273
El Dorado,2020-07-11,2,0,235,2,0,9,2
Yuba,2020-07-11,21,0,445,4,0,14,21
Mariposa,2020-07-11,0,0,33,0,0,0,0
San Mateo,2020-07-11,50,9,1054,15,2,54,59
Siskiyou,2020-07-11,1,0,65,0,0,6,1
Humboldt,2020-07-11,0,1,352,0,0,5,1
Placer,2020-07-11,35,26,776,6,4,27,61
Santa Clara,2020-07-11,121,20,3432,48,5,173,141
San Bernardino,2020-07-11,564,88,4838,165,11,145,652
Butte,2020-07-11,15,1,492,9,1,0,16
Plumas,2020-07-11,0,0,45,0,0,0,0
Sonoma,2020-07-11,25,8,862,4,1,55,33
Fresno,2020-07-11,197,42,2223,38,4,78,239
Santa Cruz,2020-07-11,13,4,397,3,0,18,17
Solano,2020-07-11,41,11,707,11,2,38,52
Marin,2020-07-11,31,4,392,9,1,21,35
Contra Costa,2020-07-11,79,24,1579,21,5,124,103
Alameda,2020-07-11,144,44,2968,48,12,121,188
Glenn,2020-07-11,0,1,47,0,0,0,1
Sacramento,2020-07-11,157,23,2874,47,11,82,180
Modoc,2020-07-12,0,0,41,0,0,0,0
Riverside,2020-07-12,513,122,4062,139,9,186,635
Santa Barbara,2020-07-12,76,8,763,22,1,57,84
Solano,2020-07-12,43,8,707,10,0,37,51
Yolo,2020-07-12,11,0,186,4,0,2,11
Contra Costa,2020-07-12,79,26,1579,22,5,125,105
Stanislaus,2020-07-12,188,42,1397,40,4,69,230
Mariposa,2020-07-12,0,0,33,0,0,0,0
Fresno,2020-07-12,203,38,2208,38,4,65,241
Butte,2020-07-12,16,1,492,8,1,2,17
San Joaquin,2020-07-12,202,35,1430,53,8,38,237
Orange,2020-07-12,674,84,7401,235,10,443,758
Mono,2020-07-12,0,0,40,0,0,2,0
Monterey,2020-07-12,43,0,845,10,0,93,43
Amador,2020-07-12,0,0,51,0,0,3,0
Sonoma,2020-07-12,25,9,862,5,2,50,34
Kern,2020-07-12,238,17,1822,57,0,86,255
El Dorado,2020-07-12,3,0,235,3,0,5,3
Plumas,2020-07-12,0,0,45,0,0,0,0
San Bernardino,2020-07-12,587,82,4838,166,12,177,669
Ventura,2020-07-12,92,17,1549,31,5,45,109
Sutter,2020-07-12,0,0,14,0,0,0,0
Imperial,2020-07-12,73,0,298,17,0,9,73
Alameda,2020-07-12,150,37,2968,50,9,139,187
San Luis Obispo,2020-07-12,9,4,459,4,0,42,13
Trinity,2020-07-12,0,0,54,0,0,0,0
Lassen,2020-07-12,0,2,65,0,0,0,2
Napa,2020-07-12,8,0,387,5,0,0,8
Nevada,2020-07-12,1,0,96,0,0,5,1
Merced,2020-07-12,34,4,242,4,1,3,38
Lake,2020-07-12,3,1,110,0,1,0,4
Colusa,2020-07-12,0,4,88,0,0,6,4
San Mateo,2020-07-12,51,14,1057,13,4,55,65
Calaveras,2020-07-12,0,2,50,0,0,10,2
Marin,2020-07-12,29,1,392,9,1,23,30
Del Norte,2020-07-12,0,0,51,0,0,4,0
Kings,2020-07-12,64,0,199,6,0,2,64
Mendocino,2020-07-12,2,0,180,0,0,7,2
Madera,2020-07-12,27,8,340,3,0,27,35
Tulare,2020-07-12,86,3,835,10,1,13,89
San Benito,2020-07-12,2,0,25,0,0,3,2
Los Angeles,2020-07-12,2103,670,23868,565,78,1502,2773
Inyo,2020-07-12,0,0,42,0,0,2,0
Tuolumne,2020-07-12,2,0,151,0,0,5,2
Placer,2020-07-12,38,25,776,6,5,20,63
Glenn,2020-07-12,0,1,47,0,0,0,1
Tehama,2020-07-12,1,1,106,0,1,1,2
Siskiyou,2020-07-12,2,0,65,0,0,6,2
Santa Clara,2020-07-12,129,20,3432,49,4,189,149
Humboldt,2020-07-12,0,2,352,0,0,5,2
San Diego,2020-07-12,389,78,6398,148,11,370,467
San Francisco,2020-07-12,80,14,2647,34,2,122,94
Sacramento,2020-07-12,175,25,2860,58,9,87,200
Santa Cruz,2020-07-12,12,5,397,2,0,23,17
Yuba,2020-07-12,19,0,445,5,0,10,19
Shasta,2020-07-12,3,0,671,2,0,3,3
Fresno,2020-07-13,212,40,2218,46,4,59,252
Orange,2020-07-13,712,83,7401,237,14,425,795
Kern,2020-07-13,240,13,1822,62,0,71,253
Los Angeles,2020-07-13,2193,612,23866,576,92,1367,2805
Plumas,2020-07-13,0,0,45,0,0,0,0
San Francisco,2020-07-13,89,20,2647,32,1,126,109
Santa Barbara,2020-07-13,81,7,763,27,1,60,88
Amador,2020-07-13,1,0,51,1,0,3,1
Yolo,2020-07-13,12,0,186,7,0,3,12
Solano,2020-07-13,48,7,707,12,1,37,55
Modoc,2020-07-13,0,1,41,0,0,0,1
Mendocino,2020-07-13,0,0,180,0,0,11,0
Stanislaus,2020-07-13,182,58,1388,41,1,74,240
Glenn,2020-07-13,0,0,47,0,0,0,0
Mono,2020-07-13,0,0,40,0,0,1,0
Calaveras,2020-07-13,0,3,50,0,2,10,3
Trinity,2020-07-13,0,0,54,0,0,0,0
Placer,2020-07-13,40,27,766,8,3,25,67
Sacramento,2020-07-13,176,25,2863,61,7,66,201
Nevada,2020-07-13,2,1,106,0,0,5,3
Napa,2020-07-13,9,2,387,6,1,4,11
Kings,2020-07-13,62,0,199,6,0,0,62
Santa Clara,2020-07-13,139,27,3433,48,3,190,166
Marin,2020-07-13,29,0,392,8,0,27,29
Madera,2020-07-13,31,7,340,3,0,11,38
Riverside,2020-07-13,538,124,4092,136,13,177,662
Sutter,2020-07-13,0,0,14,0,0,0,0
Alameda,2020-07-13,152,48,2968,52,9,144,200
Mariposa,2020-07-13,0,0,33,0,0,0,0
San Luis Obispo,2020-07-13,10,4,459,4,0,44,14
Del Norte,2020-07-13,0,1,51,0,0,0,1
San Benito,2020-07-13,2,0,25,0,0,3,2
San Mateo,2020-07-13,56,26,1057,11,5,59,82
Ventura,2020-07-13,99,25,1549,31,5,54,124
Santa Cruz,2020-07-13,16,4,397,2,0,37,20
Lassen,2020-07-13,0,1,65,0,0,0,1
Shasta,2020-07-13,3,1,671,2,0,4,4
Humboldt,2020-07-13,0,1,352,0,0,6,1
San Diego,2020-07-13,383,75,6392,147,16,360,458
Tulare,2020-07-13,89,3,835,9,0,13,92
San Bernardino,2020-07-13,616,64,4838,174,5,168,680
Yuba,2020-07-13,19,0,445,4,0,12,19
San Joaquin,2020-07-13,205,42,1430,52,4,39,247
Monterey,2020-07-13,49,2,845,10,0,93,51
Inyo,2020-07-13,0,0,42,0,0,4,0
El Dorado,2020-07-13,2,0,235,2,0,8,2
Siskiyou,2020-07-13,2,0,65,0,0,8,2
Merced,2020-07-13,33,1,242,4,1,3,34
Imperial,2020-07-13,81,0,298,22,0,7,81
Tuolumne,2020-07-13,1,0,151,0,0,4,1
Sonoma,2020-07-13,27,11,858,7,3,40,38
Tehama,2020-07-13,1,0,106,1,0,1,1
Lake,2020-07-13,4,2,110,1,1,1,6
Butte,2020-07-13,15,2,492,9,0,4,17
Colusa,2020-07-13,0,4,88,0,0,6,4
Contra Costa,2020-07-13,84,26,1579,25,5,134,110
Del Norte,2020-07-14,0,1,51,0,0,0,1
Orange,2020-07-14,722,87,7401,238,9,404,809
San Joaquin,2020-07-14,197,39,1430,51,8,34,236
Shasta,2020-07-14,4,1,671,3,0,15,5
Kings,2020-07-14,68,1,199,8,1,0,69
Mendocino,2020-07-14,0,0,180,0,0,8,0
Humboldt,2020-07-14,0,1,352,0,0,6,1
Santa Barbara,2020-07-14,81,10,763,29,0,56,91
Kern,2020-07-14,245,9,1822,62,0,77,254
Siskiyou,2020-07-14,4,0,65,0,0,5,4
Riverside,2020-07-14,550,166,4129,141,15,166,716
San Diego,2020-07-14,394,88,6674,149,19,349,482
Monterey,2020-07-14,49,1,845,9,0,89,50
Marin,2020-07-14,32,2,392,9,0,26,34
Tuolumne,2020-07-14,3,0,151,0,0,3,3
Yolo,2020-07-14,14,8,186,8,0,3,22
Calaveras,2020-07-14,0,4,50,0,3,9,4
Colusa,2020-07-14,1,2,88,0,0,6,3
Sacramento,2020-07-14,169,26,2879,56,6,72,195
Tehama,2020-07-14,1,0,106,1,0,0,1
Merced,2020-07-14,35,2,242,7,0,6,37
Lassen,2020-07-14,0,1,65,0,0,0,1
Santa Clara,2020-07-14,143,26,3435,52,3,155,169
Trinity,2020-07-14,0,0,54,0,0,0,0
Santa Cruz,2020-07-14,14,6,397,3,0,31,20
Los Angeles,2020-07-14,2173,726,23862,579,96,1297,2899
Yuba,2020-07-14,20,0,445,5,0,9,20
Contra Costa,2020-07-14,84,28,1579,24,8,128,112
Stanislaus,2020-07-14,192,46,1393,44,2,77,238
Alameda,2020-07-14,158,46,2968,56,8,144,204
Modoc,2020-07-14,0,0,41,0,0,0,0
Ventura,2020-07-14,101,19,1549,31,6,46,120
San Francisco,2020-07-14,90,15,2647,31,0,110,105
Placer,2020-07-14,45,27,770,10,3,12,72
Sutter,2020-07-14,0,0,14,0,0,0,0
San Mateo,2020-07-14,59,18,1057,12,2,55,77
El Dorado,2020-07-14,2,0,235,2,0,9,2
Lake,2020-07-14,2,0,110,0,0,2,2
Mono,2020-07-14,0,0,40,0,0,2,0
Napa,2020-07-14,8,0,387,3,0,3,8
Glenn,2020-07-14,0,0,47,0,0,0,0
Amador,2020-07-14,2,0,51,1,0,1,2
Nevada,2020-07-14,1,1,98,0,0,2,2
San Luis Obispo,2020-07-14,7,3,468,4,1,39,10
Butte,2020-07-14,17,1,492,9,0,0,18
San Bernardino,2020-07-14,603,73,4838,174,5,158,676
Sonoma,2020-07-14,30,11,858,9,2,39,41
Imperial,2020-07-14,83,2,298,23,1,6,85
Solano,2020-07-14,46,6,707,10,1,45,52
Plumas,2020-07-14,0,0,45,0,0,0,0
Tulare,2020-07-14,86,3,835,7,0,14,89
Madera,2020-07-14,30,10,340,3,0,18,40
Inyo,2020-07-14,0,0,42,0,0,3,0
Fresno,2020-07-14,219,51,2045,44,4,56,270
San Benito,2020-07-14,2,0,25,0,0,3,2
Mariposa,2020-07-14,0,0,33,0,0,0,0
El Dorado,2020-07-15,2,1,235,2,1,8,3
Colusa,2020-07-15,2,2,88,0,0,6,4
Contra Costa,2020-07-15,81,36,1579,27,10,136,117
Humboldt,2020-07-15,0,3,352,0,1,3,3
Inyo,2020-07-15,0,0,42,0,0,4,0
Shasta,2020-07-15,4,1,671,3,0,20,5
Plumas,2020-07-15,0,0,45,0,0,0,0
Mono,2020-07-15,0,0,40,0,0,2,0
San Benito,2020-07-15,1,0,25,0,0,1,1
Modoc,2020-07-15,0,1,41,0,0,0,1
San Diego,2020-07-15,401,99,6670,144,19,348,500
Napa,2020-07-15,9,0,387,4,0,0,9
Trinity,2020-07-15,0,0,54,0,0,0,0
Fresno,2020-07-15,229,45,1890,42,5,60,274
Ventura,2020-07-15,105,46,1549,29,6,44,151
Imperial,2020-07-15,89,1,298,25,1,4,90
Los Angeles,2020-07-15,2122,729,23884,557,100,1322,2851
Sonoma,2020-07-15,33,10,858,12,2,41,43
Siskiyou,2020-07-15,3,0,65,0,0,4,3
Sutter,2020-07-15,0,0,14,0,0,0,0
Yuba,2020-07-15,19,1,445,5,0,9,20
Tehama,2020-07-15,1,0,106,1,0,3,1
Kings,2020-07-15,72,2,199,10,1,1,74
Monterey,2020-07-15,51,1,845,11,0,89,52
Madera,2020-07-15,28,4,340,3,0,19,32
Kern,2020-07-15,236,14,1822,67,1,68,250
Mendocino,2020-07-15,2,0,180,2,0,11,2
Solano,2020-07-15,46,4,707,12,0,45,50
Yolo,2020-07-15,14,7,186,4,6,1,21
Placer,2020-07-15,45,24,770,10,1,16,69
Mariposa,2020-07-15,0,0,33,0,0,0,0
San Bernardino,2020-07-15,589,67,4766,176,6,148,656
Tuolumne,2020-07-15,2,0,151,0,0,1,2
Amador,2020-07-15,1,1,51,0,1,1,2
Santa Clara,2020-07-15,146,37,3434,52,7,144,183
Alameda,2020-07-15,159,43,2968,58,10,143,202
Sacramento,2020-07-15,184,20,2984,58,5,73,204
Glenn,2020-07-15,0,0,47,0,0,0,0
San Francisco,2020-07-15,95,13,2647,32,0,114,108
Del Norte,2020-07-15,0,0,51,0,0,0,0
Lassen,2020-07-15,0,1,65,0,0,0,1
Lake,2020-07-15,1,0,110,1,0,2,1
Stanislaus,2020-07-15,193,42,1393,45,2,76,235
Nevada,2020-07-15,3,4,109,0,1,1,7
Calaveras,2020-07-15,0,3,50,0,3,9,3
San Mateo,2020-07-15,56,21,1057,12,4,57,77
Marin,2020-07-15,29,1,392,7,0,28,30
Riverside,2020-07-15,531,151,4141,134,14,158,682
Tulare,2020-07-15,88,4,835,7,0,29,92
Orange,2020-07-15,711,102,7428,245,11,378,813
Santa Barbara,2020-07-15,77,9,763,26,0,60,86
Butte,2020-07-15,17,2,492,6,1,5,19
San Luis Obispo,2020-07-15,9,2,465,4,0,34,11
Santa Cruz,2020-07-15,12,1,397,2,0,27,13
Merced,2020-07-15,33,3,242,7,0,6,36
San Joaquin,2020-07-15,246,28,1430,55,4,38,274
Napa,2020-07-16,8,0,387,4,0,0,8
Tuolumne,2020-07-16,3,0,151,0,0,1,3
San Benito,2020-07-16,1,0,25,0,0,2,1
Solano,2020-07-16,51,5,707,17,1,36,56
Santa Barbara,2020-07-16,74,10,763,26,0,62,84
Yuba,2020-07-16,17,2,445,5,0,9,19
Contra Costa,2020-07-16,86,34,1579,29,7,131,120
Santa Cruz,2020-07-16,11,1,397,2,0,30,12
Placer,2020-07-16,51,30,771,8,1,30,81
Tehama,2020-07-16,1,0,106,1,0,2,1
Siskiyou,2020-07-16,2,1,65,0,1,4,3
Madera,2020-07-16,19,5,340,6,0,13,24
Del Norte,2020-07-16,0,0,51,0,0,0,0
Fresno,2020-07-16,242,39,1901,45,3,65,281
San Francisco,2020-07-16,90,17,2647,27,0,117,107
Orange,2020-07-16,682,119,7428,235,13,391,801
Amador,2020-07-16,2,1,51,0,0,0,3
Sutter,2020-07-16,0,0,14,0,0,0,0
Colusa,2020-07-16,1,1,88,0,0,6,2
Marin,2020-07-16,26,3,392,7,2,27,29
Sacramento,2020-07-16,185,33,2920,59,8,76,218
Kings,2020-07-16,78,2,199,7,1,2,80
Yolo,2020-07-16,14,0,186,11,0,0,14
Lake,2020-07-16,2,2,110,1,2,2,4
Glenn,2020-07-16,0,1,47,0,0,0,1
Kern,2020-07-16,245,28,1822,68,0,65,273
Stanislaus,2020-07-16,200,53,1393,49,2,77,253
San Joaquin,2020-07-16,193,40,1430,54,4,39,233
Mariposa,2020-07-16,0,0,33,0,0,0,0
Ventura,2020-07-16,104,31,1549,30,5,43,135
San Luis Obispo,2020-07-16,10,2,477,5,0,37,12
Mendocino,2020-07-16,5,0,180,3,0,10,5
El Dorado,2020-07-16,2,3,235,2,3,9,5
Trinity,2020-07-16,0,0,54,0,0,0,0
Inyo,2020-07-16,0,0,42,0,0,4,0
Riverside,2020-07-16,535,140,4131,130,15,158,675
Shasta,2020-07-16,3,0,671,1,0,13,3
Butte,2020-07-16,18,1,492,7,0,2,19
Lassen,2020-07-16,0,1,65,0,0,0,1
Calaveras,2020-07-16,0,0,50,0,0,10,0
Mono,2020-07-16,0,0,40,0,0,2,0
Tulare,2020-07-16,86,7,835,7,1,26,93
Imperial,2020-07-16,94,1,298,23,1,5,95
Modoc,2020-07-16,0,0,41,0,0,0,0
Nevada,2020-07-16,0,1,100,0,0,1,1
Sonoma,2020-07-16,32,14,858,14,1,39,46
Santa Clara,2020-07-16,147,36,3433,50,5,158,183
Monterey,2020-07-16,54,0,845,11,0,84,54
Los Angeles,2020-07-16,2188,719,23989,604,93,1325,2907
San Mateo,2020-07-16,61,19,1057,15,4,59,80
Alameda,2020-07-16,164,47,2968,50,6,142,211
Plumas,2020-07-16,0,0,45,0,0,0,0
Humboldt,2020-07-16,1,3,352,0,0,6,4
San Diego,2020-07-16,388,110,6692,142,24,337,498
Merced,2020-07-16,32,4,242,6,1,2,36
San Bernardino,2020-07-16,600,76,4766,180,8,143,676
Merced,2020-07-17,33,0,242,6,0,3,33
San Bernardino,2020-07-17,625,55,4766,174,7,149,680
San Francisco,2020-07-17,89,16,2647,26,1,112,105
San Joaquin,2020-07-17,192,40,1430,59,4,38,232
Yolo,2020-07-17,17,0,186,11,0,0,17
Del Norte,2020-07-17,0,0,51,0,0,6,0
Calaveras,2020-07-17,0,0,50,0,0,10,0
Fresno,2020-07-17,240,44,1898,48,7,56,284
Tuolumne,2020-07-17,4,1,151,0,0,1,5
Stanislaus,2020-07-17,208,59,1399,50,5,85,267
El Dorado,2020-07-17,3,3,235,2,2,8,6
Solano,2020-07-17,52,5,707,19,0,38,57
Tulare,2020-07-17,73,10,835,10,1,28,83
Modoc,2020-07-17,0,0,41,0,0,0,0
Riverside,2020-07-17,515,179,4108,133,24,151,694
Kern,2020-07-17,252,30,1822,72,3,67,282
Butte,2020-07-17,16,1,492,4,0,4,17
Santa Barbara,2020-07-17,74,14,763,26,1,63,88
Mendocino,2020-07-17,9,1,180,6,0,8,10
Tehama,2020-07-17,1,0,106,1,0,2,1
Yuba,2020-07-17,19,2,445,5,0,10,21
Sonoma,2020-07-17,38,21,858,15,2,32,59
Contra Costa,2020-07-17,89,27,1579,31,1,132,116
Sutter,2020-07-17,0,0,14,0,0,0,0
Lassen,2020-07-17,0,0,65,0,0,0,0
Shasta,2020-07-17,4,1,671,1,0,21,5
Sacramento,2020-07-17,196,26,2913,57,5,71,222
Siskiyou,2020-07-17,2,0,65,0,0,13,2
Santa Clara,2020-07-17,153,31,3432,46,4,160,184
Imperial,2020-07-17,97,2,298,25,2,3,99
Los Angeles,2020-07-17,2216,660,23968,571,73,1380,2876
Plumas,2020-07-17,0,0,45,0,0,0,0
Alameda,2020-07-17,157,49,2968,48,5,149,206
San Luis Obispo,2020-07-17,13,7,467,6,0,34,20
Marin,2020-07-17,29,4,392,9,0,24,33
Kings,2020-07-17,79,2,199,7,1,2,81
Napa,2020-07-17,5,0,387,3,0,4,5
Trinity,2020-07-17,0,0,54,0,0,0,0
Humboldt,2020-07-17,1,2,352,0,1,9,3
Monterey,2020-07-17,45,1,845,11,0,89,46
Placer,2020-07-17,48,28,753,8,2,29,76
Madera,2020-07-17,33,7,340,4,0,14,40
Mono,2020-07-17,0,1,40,0,0,2,1
Orange,2020-07-17,692,92,7428,232,12,377,784
Inyo,2020-07-17,0,1,42,0,0,3,1
Lake,2020-07-17,2,2,110,0,2,2,4
Amador,2020-07-17,1,1,51,0,0,0,2
Ventura,2020-07-17,95,43,1550,31,7,44,138
San Diego,2020-07-17,402,107,6699,153,20,358,509
San Benito,2020-07-17,2,0,25,0,0,2,2
Glenn,2020-07-17,0,1,47,0,0,0,1
Santa Cruz,2020-07-17,11,10,397,2,1,27,21
San Mateo,2020-07-17,60,20,1060,17,1,55,80
Colusa,2020-07-17,1,1,88,0,0,6,2
Mariposa,2020-07-17,0,0,33,0,0,0,0
Nevada,2020-07-17,1,1,84,1,1,3,2
Santa Barbara,2020-07-18,82,9,763,25,0,63,91
Plumas,2020-07-18,0,0,45,0,0,0,0
Mono,2020-07-18,0,1,40,0,0,2,1
El Dorado,2020-07-18,3,0,235,2,0,7,3
Ventura,2020-07-18,92,31,1550,29,7,50,123
Sutter,2020-07-18,0,0,14,0,0,0,0
San Joaquin,2020-07-18,205,32,1430,62,3,39,237
Orange,2020-07-18,665,64,7428,214,9,400,729
Madera,2020-07-18,26,10,340,3,0,9,36
Tuolumne,2020-07-18,4,1,151,0,0,4,5
Mendocino,2020-07-18,9,1,180,1,0,13,10
Placer,2020-07-18,48,22,759,8,1,26,70
Siskiyou,2020-07-18,2,0,65,0,0,4,2
Lake,2020-07-18,1,2,110,0,2,2,3
Stanislaus,2020-07-18,205,52,1395,51,2,73,257
Sonoma,2020-07-18,37,13,858,13,1,32,50
Fresno,2020-07-18,261,36,1898,51,5,58,297
Los Angeles,2020-07-18,2232,608,23972,585,81,1398,2840
Santa Cruz,2020-07-18,11,9,397,2,1,26,20
Contra Costa,2020-07-18,82,30,1579,27,2,152,112
San Mateo,2020-07-18,67,17,1058,17,1,62,84
Tulare,2020-07-18,80,6,835,11,0,25,86
Inyo,2020-07-18,0,1,42,0,0,2,1
Humboldt,2020-07-18,1,1,352,0,0,10,2
Trinity,2020-07-18,0,0,54,0,0,0,0
Yuba,2020-07-18,18,0,445,5,0,13,18
Shasta,2020-07-18,4,0,671,1,0,17,4
Kern,2020-07-18,253,24,1822,66,2,67,277
Colusa,2020-07-18,1,1,88,0,0,6,2
Imperial,2020-07-18,92,1,298,24,1,6,93
Alameda,2020-07-18,163,63,2968,49,4,151,226
Napa,2020-07-18,8,4,387,3,0,1,12
San Bernardino,2020-07-18,611,88,4766,183,11,156,699
San Francisco,2020-07-18,91,16,2647,29,2,107,107
Amador,2020-07-18,1,1,51,0,0,0,2
Santa Clara,2020-07-18,149,45,3432,43,5,163,194
Sacramento,2020-07-18,195,28,2878,66,3,72,223
Glenn,2020-07-18,0,1,47,0,0,0,1
Marin,2020-07-18,31,2,392,10,1,20,33
Tehama,2020-07-18,0,0,106,0,0,2,0
Del Norte,2020-07-18,0,0,51,0,0,6,0
Yolo,2020-07-18,18,1,186,10,1,2,19
Lassen,2020-07-18,0,0,65,0,0,0,0
Mariposa,2020-07-18,0,0,33,0,0,0,0
Modoc,2020-07-18,0,0,41,0,0,0,0
San Luis Obispo,2020-07-18,13,1,467,5,0,41,14
Merced,2020-07-18,35,0,242,4,0,3,35
Solano,2020-07-18,51,6,707,19,0,41,57
Nevada,2020-07-18,1,2,94,1,1,8,3
San Benito,2020-07-18,3,0,25,0,0,0,3
Calaveras,2020-07-18,1,5,50,1,3,8,6
Butte,2020-07-18,23,0,492,7,0,4,23
San Diego,2020-07-18,396,91,6446,144,14,376,487
Riverside,2020-07-18,507,170,4108,131,22,166,677
Monterey,2020-07-18,43,1,845,12,0,89,44
Kings,2020-07-18,78,2,199,7,1,3,80
Yolo,2020-07-19,13,0,186,8,0,2,13
Placer,2020-07-19,47,17,754,9,0,23,64
Ventura,2020-07-19,91,27,1550,28,8,54,118
Lassen,2020-07-19,0,0,65,0,0,0,0
Butte,2020-07-19,22,1,492,7,0,5,23
Calaveras,2020-07-19,1,1,50,1,0,8,2
Plumas,2020-07-19,0,0,45,0,0,0,0
Inyo,2020-07-19,0,1,42,0,0,2,1
Santa Cruz,2020-07-19,12,10,397,3,3,26,22
Glenn,2020-07-19,0,1,47,0,0,0,1
Los Angeles,2020-07-19,2218,616,23943,577,93,1443,2834
Stanislaus,2020-07-19,209,39,1390,55,1,61,248
Mono,2020-07-19,0,1,40,0,0,1,1
Napa,2020-07-19,6,0,387,1,0,1,6
Tuolumne,2020-07-19,4,1,151,0,0,4,5
San Mateo,2020-07-19,68,12,1058,18,1,52,80
El Dorado,2020-07-19,3,1,235,1,1,10,4
Tehama,2020-07-19,0,0,106,0,0,4,0
Riverside,2020-07-19,507,161,4032,131,27,156,668
Kern,2020-07-19,248,22,1822,64,2,78,270
Kings,2020-07-19,78,2,199,7,1,3,80
Merced,2020-07-19,35,1,242,6,0,1,36
Del Norte,2020-07-19,0,2,51,0,1,1,2
San Bernardino,2020-07-19,613,61,4766,194,6,169,674
Orange,2020-07-19,666,81,7428,213,14,423,747
Marin,2020-07-19,32,3,392,11,0,25,35
Shasta,2020-07-19,4,0,671,1,0,17,4
San Francisco,2020-07-19,96,13,2647,31,2,113,109
San Joaquin,2020-07-19,210,38,1432,63,3,41,248
Imperial,2020-07-19,95,1,298,24,0,2,96
Monterey,2020-07-19,43,2,845,11,0,94,45
Alameda,2020-07-19,159,69,2968,53,10,128,228
Siskiyou,2020-07-19,2,0,65,0,0,6,2
San Benito,2020-07-19,3,0,25,0,0,2,3
Colusa,2020-07-19,2,1,88,0,0,6,3
San Diego,2020-07-19,390,92,6387,142,16,368,482
Mendocino,2020-07-19,9,2,180,2,0,13,11
Contra Costa,2020-07-19,88,33,1579,29,3,137,121
Madera,2020-07-19,30,18,340,9,3,14,48
Solano,2020-07-19,51,8,707,19,0,37,59
Yuba,2020-07-19,18,0,445,2,0,20,18
Humboldt,2020-07-19,1,1,352,0,0,9,2
Sacramento,2020-07-19,204,37,2863,70,7,75,241
Santa Barbara,2020-07-19,82,6,763,26,0,67,88
Lake,2020-07-19,1,1,110,0,0,3,2
Amador,2020-07-19,2,0,51,0,0,0,2
Sutter,2020-07-19,0,0,14,0,0,0,0
Trinity,2020-07-19,0,0,54,0,0,0,0
Mariposa,2020-07-19,0,0,33,0,0,0,0
Modoc,2020-07-19,0,0,41,0,0,0,0
Tulare,2020-07-19,84,8,835,13,0,28,92
Nevada,2020-07-19,1,2,103,1,1,7,3
Santa Clara,2020-07-19,157,47,3432,45,4,196,204
Fresno,2020-07-19,269,38,781,50,4,52,307
San Luis Obispo,2020-07-19,11,6,463,5,1,38,17
Sonoma,2020-07-19,36,14,858,13,2,32,50
Sonoma,2020-07-20,41,15,858,14,3,31,56
San Diego,2020-07-20,402,97,6611,151,21,365,499
Amador,2020-07-20,2,0,51,0,0,0,2
Inyo,2020-07-20,0,2,42,0,0,2,2
Mendocino,2020-07-20,8,2,180,1,0,7,10
Yolo,2020-07-20,12,0,186,7,0,13,12
Merced,2020-07-20,44,3,242,8,0,5,47
Plumas,2020-07-20,0,0,45,0,0,0,0
Orange,2020-07-20,700,73,7428,234,13,404,773
Tuolumne,2020-07-20,4,0,151,1,0,3,4
Lassen,2020-07-20,0,0,65,0,0,0,0
Sacramento,2020-07-20,212,33,2907,59,9,106,245
Lake,2020-07-20,0,0,110,0,0,3,0
Mono,2020-07-20,1,0,40,1,0,1,1
Calaveras,2020-07-20,3,0,50,1,0,9,3
Del Norte,2020-07-20,0,1,51,0,0,1,1
Sutter,2020-07-20,0,0,14,0,0,0,0
Siskiyou,2020-07-20,2,0,65,0,0,5,2
San Mateo,2020-07-20,71,11,1054,18,2,56,82
Santa Cruz,2020-07-20,12,8,397,4,0,28,20
Los Angeles,2020-07-20,2207,670,23351,594,90,1412,2877
Butte,2020-07-20,24,2,492,9,1,6,26
Solano,2020-07-20,52,6,707,17,0,43,58
Kings,2020-07-20,75,2,199,6,1,3,77
San Benito,2020-07-20,2,0,25,0,0,1,2
Stanislaus,2020-07-20,210,51,1390,55,2,65,261
Tulare,2020-07-20,87,9,835,12,1,19,96
Yuba,2020-07-20,16,0,445,3,0,13,16
Trinity,2020-07-20,0,0,54,0,0,0,0
Madera,2020-07-20,32,11,340,10,1,18,43
Humboldt,2020-07-20,0,1,352,0,1,4,1
Monterey,2020-07-20,41,3,845,12,0,88,44
Contra Costa,2020-07-20,93,31,1579,36,4,143,124
Modoc,2020-07-20,0,0,41,0,0,0,0
Santa Clara,2020-07-20,168,41,3432,50,4,198,209
San Bernardino,2020-07-20,607,69,4766,190,5,178,676
San Joaquin,2020-07-20,220,50,1430,71,8,44,270
Colusa,2020-07-20,2,2,88,0,0,6,4
San Luis Obispo,2020-07-20,11,4,422,4,1,38,15
Nevada,2020-07-20,1,1,124,1,0,2,2
Glenn,2020-07-20,0,1,47,0,0,0,1
Marin,2020-07-20,29,4,392,10,0,20,33
Placer,2020-07-20,52,21,753,10,2,26,73
San Francisco,2020-07-20,95,10,2647,28,1,120,105
Fresno,2020-07-20,283,53,781,52,6,46,336
Ventura,2020-07-20,92,34,1550,28,8,48,126
Napa,2020-07-20,8,2,387,2,1,6,10
Alameda,2020-07-20,171,59,2968,51,8,121,230
Mariposa,2020-07-20,0,0,33,0,0,0,0
Riverside,2020-07-20,536,171,4093,135,22,160,707
Shasta,2020-07-20,4,0,671,2,0,2,4
Tehama,2020-07-20,0,0,106,0,0,5,0
Imperial,2020-07-20,95,2,298,23,1,3,97
El Dorado,2020-07-20,2,1,235,2,1,8,3
Kern,2020-07-20,277,23,1773,65,2,91,300
Santa Barbara,2020-07-20,85,11,479,29,1,69,96
Siskiyou,2020-07-21,0,0,65,0,0,4,0
Tuolumne,2020-07-21,3,0,151,1,0,4,3
Yuba,2020-07-21,22,2,445,6,1,12,24
San Mateo,2020-07-21,72,8,1052,20,2,50,80
San Francisco,2020-07-21,96,25,2505,28,1,115,121
Sacramento,2020-07-21,213,56,2901,69,10,80,269
Contra Costa,2020-07-21,101,40,1579,39,6,132,141
Modoc,2020-07-21,0,0,41,0,0,0,0
Calaveras,2020-07-21,2,2,50,1,1,8,4
San Joaquin,2020-07-21,216,44,1430,65,7,43,260
Del Norte,2020-07-21,0,0,51,0,0,1,0
Riverside,2020-07-21,528,160,4096,143,18,112,688
Plumas,2020-07-21,0,3,45,0,0,0,3
Humboldt,2020-07-21,0,3,352,0,2,2,3
Stanislaus,2020-07-21,221,45,1390,55,2,74,266
Monterey,2020-07-21,45,3,845,10,0,84,48
Lassen,2020-07-21,0,0,65,0,0,0,0
Tehama,2020-07-21,0,0,106,0,0,5,0
San Bernardino,2020-07-21,606,118,4766,181,13,157,724
Tulare,2020-07-21,93,11,835,17,1,15,104
Sutter,2020-07-21,0,0,14,0,0,0,0
Kern,2020-07-21,280,26,1726,66,1,99,306
San Luis Obispo,2020-07-21,11,6,455,4,0,33,17
Madera,2020-07-21,45,13,350,13,1,22,58
Lake,2020-07-21,0,0,110,0,0,1,0
San Benito,2020-07-21,4,0,25,2,0,0,4
Yolo,2020-07-21,10,8,186,6,0,13,18
Alameda,2020-07-21,176,63,2968,52,10,116,239
Glenn,2020-07-21,0,2,47,0,0,0,2
Inyo,2020-07-21,0,1,42,0,0,3,1
Amador,2020-07-21,3,1,51,1,0,1,4
Ventura,2020-07-21,98,37,1550,27,4,42,135
Mendocino,2020-07-21,6,2,180,1,0,7,8
El Dorado,2020-07-21,2,1,235,2,1,8,3
Napa,2020-07-21,10,0,387,3,0,0,10
Kings,2020-07-21,80,1,199,9,1,1,81
Santa Barbara,2020-07-21,86,8,793,27,1,67,94
Placer,2020-07-21,53,33,753,11,6,17,86
Santa Clara,2020-07-21,170,46,3433,51,6,163,216
Mariposa,2020-07-21,0,0,33,0,0,0,0
Sonoma,2020-07-21,40,18,858,9,6,36,58
Santa Cruz,2020-07-21,19,14,397,5,1,25,33
Mono,2020-07-21,1,0,40,1,0,1,1
Fresno,2020-07-21,296,56,1929,59,2,44,352
Merced,2020-07-21,50,1,242,9,0,3,51
Colusa,2020-07-21,0,0,88,0,0,6,0
Imperial,2020-07-21,89,1,298,20,0,8,90
Nevada,2020-07-21,1,2,107,1,0,2,3
Shasta,2020-07-21,3,0,671,1,0,3,3
Solano,2020-07-21,51,5,707,20,1,41,56
Marin,2020-07-21,31,6,392,9,0,21,37
Butte,2020-07-21,27,1,492,9,0,7,28
Orange,2020-07-21,699,74,7403,233,10,400,773
Los Angeles,2020-07-21,2210,620,23798,623,94,1252,2830
San Diego,2020-07-21,401,84,6676,149,17,328,485
Trinity,2020-07-21,0,0,54,0,0,0,0
Kern,2020-07-22,257,16,1251,57,1,17,273
El Dorado,2020-07-22,2,1,153,2,1,7,3
Los Angeles,2020-07-22,1928,542,16107,556,82,827,2470
Placer,2020-07-22,53,35,449,13,3,-46,88
Napa,2020-07-22,11,4,277,4,0,2,15
Santa Barbara,2020-07-22,85,7,333,26,1,9,92
Colusa,2020-07-22,1,0,48,0,0,0,1
San Mateo,2020-07-22,70,13,646,16,3,-9,83
Mariposa,2020-07-22,0,0,19,0,0,0,0
Monterey,2020-07-22,41,2,763,11,1,-110,43
Ventura,2020-07-22,93,46,1462,24,9,25,139
San Benito,2020-07-22,2,0,25,1,0,1,2
Lassen,2020-07-22,0,1,25,0,0,0,1
Trinity,2020-07-22,0,0,25,0,0,0,0
Humboldt,2020-07-22,0,0,301,0,0,3,0
Inyo,2020-07-22,0,0,0,0,0,0,0
Siskiyou,2020-07-22,0,0,31,0,0,3,0
Alameda,2020-07-22,166,75,1539,52,7,-8,241
Madera,2020-07-22,48,22,360,11,4,16,70
Tulare,2020-07-22,105,6,186,18,1,12,111
Mono,2020-07-22,1,0,17,1,0,1,1
Nevada,2020-07-22,2,1,121,1,0,1,3
Marin,2020-07-22,32,3,267,8,0,5,35
Sonoma,2020-07-22,38,11,143,5,2,-9,49
Tuolumne,2020-07-22,5,1,151,1,1,1,6
Stanislaus,2020-07-22,232,52,928,51,7,-5,284
Mendocino,2020-07-22,5,0,150,1,0,0,5
Glenn,2020-07-22,0,0,0,0,0,0,0
San Bernardino,2020-07-22,586,102,3268,197,15,185,688
Modoc,2020-07-22,0,0,37,0,0,0,0
San Joaquin,2020-07-22,221,46,1195,66,6,2,267
Del Norte,2020-07-22,0,0,52,0,0,3,0
Contra Costa,2020-07-22,106,41,954,39,3,-11,147
Santa Clara,2020-07-22,180,37,2781,50,3,60,217
Imperial,2020-07-22,78,0,261,21,0,3,78
San Diego,2020-07-22,351,82,4897,128,14,222,433
Calaveras,2020-07-22,2,0,25,1,0,4,2
Yuba,2020-07-22,22,3,457,8,1,7,25
Yolo,2020-07-22,13,1,186,8,0,0,14
Sacramento,2020-07-22,236,57,1298,65,10,-19,293
Fresno,2020-07-22,295,57,1358,63,3,2,352
Riverside,2020-07-22,534,139,4061,155,28,66,673
Shasta,2020-07-22,4,0,392,2,0,6,4
San Luis Obispo,2020-07-22,12,5,458,4,1,21,17
Lake,2020-07-22,0,2,98,0,1,2,2
Solano,2020-07-22,57,10,306,20,0,-18,67
Amador,2020-07-22,2,1,51,0,0,2,3
Butte,2020-07-22,26,1,410,8,1,-2,27
Sutter,2020-07-22,0,0,0,0,0,0,0
Kings,2020-07-22,77,1,199,8,1,0,78
Santa Cruz,2020-07-22,7,7,255,4,0,15,14
Merced,2020-07-22,53,4,247,9,0,1,57
Orange,2020-07-22,690,61,4940,233,7,465,751
San Francisco,2020-07-22,96,17,2071,30,1,56,113
Tehama,2020-07-22,0,0,106,0,0,4,0
Plumas,2020-07-22,0,0,0,0,0,0,0
Mariposa,2020-07-23,0,0,19,0,0,0,0
Alameda,2020-07-23,201,82,2073,47,9,90,283
Inyo,2020-07-23,0,1,29,0,0,0,1
Riverside,2020-07-23,523,138,3044,159,27,123,661
Fresno,2020-07-23,297,79,1506,67,4,11,376
Humboldt,2020-07-23,0,1,259,0,0,1,1
San Luis Obispo,2020-07-23,9,7,450,4,0,21,16
Contra Costa,2020-07-23,108,45,1478,35,4,39,153
Santa Cruz,2020-07-23,17,20,255,4,1,17,37
Stanislaus,2020-07-23,232,55,1105,52,6,31,287
Sonoma,2020-07-23,41,24,738,9,5,7,65
Santa Barbara,2020-07-23,78,6,673,25,2,62,84
Del Norte,2020-07-23,0,0,51,0,0,2,0
El Dorado,2020-07-23,1,2,153,1,2,12,3
Sacramento,2020-07-23,239,70,1800,69,10,61,309
San Francisco,2020-07-23,97,17,2272,28,0,100,114
Napa,2020-07-23,13,3,277,4,0,1,16
Tuolumne,2020-07-23,3,0,151,1,0,3,3
Glenn,2020-07-23,0,2,47,0,0,0,2
San Joaquin,2020-07-23,215,32,1193,61,3,4,247
Lassen,2020-07-23,0,1,25,0,0,0,1
Merced,2020-07-23,50,7,247,11,0,4,57
Shasta,2020-07-23,4,0,661,2,0,1,4
Marin,2020-07-23,29,2,325,6,1,10,31
Madera,2020-07-23,52,12,360,12,0,18,64
Ventura,2020-07-23,97,39,1437,20,12,24,136
Tulare,2020-07-23,110,5,240,21,0,31,115
Lake,2020-07-23,0,2,98,0,0,3,2
Sutter,2020-07-23,0,0,0,0,0,0,0
Amador,2020-07-23,0,0,51,0,0,1,0
Kings,2020-07-23,74,1,199,9,1,0,75
Nevada,2020-07-23,2,2,121,1,1,5,4
Placer,2020-07-23,57,30,789,11,4,28,87
San Bernardino,2020-07-23,600,104,3525,187,14,172,704
Calaveras,2020-07-23,2,0,25,1,0,5,2
Trinity,2020-07-23,0,0,25,0,0,0,0
San Diego,2020-07-23,356,86,5455,123,20,224,442
Butte,2020-07-23,31,0,452,11,0,5,31
Mono,2020-07-23,1,0,17,1,0,1,1
Mendocino,2020-07-23,5,1,150,1,0,0,6
Modoc,2020-07-23,0,0,37,0,0,0,0
Plumas,2020-07-23,0,0,10,0,0,0,0
Yuba,2020-07-23,24,2,457,8,1,10,26
Imperial,2020-07-23,80,0,261,21,0,9,80
Yolo,2020-07-23,15,1,186,7,0,8,16
San Mateo,2020-07-23,68,12,806,18,2,15,80
Tehama,2020-07-23,0,0,106,0,0,6,0
Kern,2020-07-23,269,24,1251,75,0,26,293
Siskiyou,2020-07-23,0,0,31,0,0,2,0
Solano,2020-07-23,57,20,591,15,1,14,77
San Benito,2020-07-23,3,0,25,1,0,0,3
Santa Clara,2020-07-23,183,40,3130,53,5,105,223
Orange,2020-07-23,652,59,5076,215,8,446,711
Monterey,2020-07-23,41,1,763,11,0,26,42
Los Angeles,2020-07-23,2016,582,16525,595,75,830,2598
Colusa,2020-07-23,0,2,48,0,0,0,2
San Diego,2020-07-24,347,73,5526,121,14,252,420
Calaveras,2020-07-24,1,1,33,0,1,6,2
Sonoma,2020-07-24,40,16,740,9,3,7,56
Kings,2020-07-24,73,1,199,9,1,1,74
Lassen,2020-07-24,0,0,25,0,0,0,0
Stanislaus,2020-07-24,206,39,1116,49,5,33,245
Trinity,2020-07-24,0,0,25,0,0,0,0
Imperial,2020-07-24,77,0,261,21,0,5,77
Tuolumne,2020-07-24,4,1,84,1,0,2,5
San Francisco,2020-07-24,95,15,2077,26,3,77,110
Humboldt,2020-07-24,0,6,269,0,1,1,6
Lake,2020-07-24,0,1,65,0,1,2,1
Sacramento,2020-07-24,233,47,1762,71,22,82,280
Del Norte,2020-07-24,0,0,51,0,0,2,0
Los Angeles,2020-07-24,2033,595,17054,622,81,846,2628
Riverside,2020-07-24,489,109,3378,165,22,59,598
Glenn,2020-07-24,0,2,47,0,0,0,2
Napa,2020-07-24,11,1,277,4,0,0,12
Marin,2020-07-24,24,1,321,6,1,9,25
San Mateo,2020-07-24,62,13,821,17,0,16,75
Plumas,2020-07-24,0,0,42,0,0,0,0
Yolo,2020-07-24,11,1,96,6,0,1,12
San Bernardino,2020-07-24,607,108,3889,177,15,159,715
Modoc,2020-07-24,0,0,37,0,0,0,0
Inyo,2020-07-24,2,0,29,0,0,3,2
Yuba,2020-07-24,21,4,457,8,1,7,25
Santa Barbara,2020-07-24,80,5,666,24,1,53,85
Merced,2020-07-24,49,2,218,13,0,3,51
Ventura,2020-07-24,95,44,1305,22,11,55,139
Santa Cruz,2020-07-24,18,21,255,5,1,10,39
Solano,2020-07-24,52,16,589,16,1,14,68
Fresno,2020-07-24,311,65,1501,65,4,13,376
Siskiyou,2020-07-24,0,0,31,0,0,3,0
Tehama,2020-07-24,0,0,59,0,0,5,0
Placer,2020-07-24,52,29,745,13,3,34,81
Butte,2020-07-24,28,1,452,10,0,9,29
Monterey,2020-07-24,47,2,763,12,0,23,49
Nevada,2020-07-24,1,1,129,0,0,2,2
Shasta,2020-07-24,5,0,561,2,0,6,5
Alameda,2020-07-24,188,65,2035,51,6,111,253
Orange,2020-07-24,685,91,5584,203,17,383,776
Mariposa,2020-07-24,0,0,19,0,0,0,0
El Dorado,2020-07-24,1,0,149,1,2,14,1
Madera,2020-07-24,58,8,360,13,0,16,66
San Joaquin,2020-07-24,221,39,1047,69,7,18,260
Mendocino,2020-07-24,6,0,150,2,0,5,6
San Luis Obispo,2020-07-24,12,3,457,4,0,18,15
Amador,2020-07-24,0,0,51,0,0,1,0
Santa Clara,2020-07-24,180,46,3092,51,4,111,226
San Benito,2020-07-24,6,0,25,1,0,0,6
Contra Costa,2020-07-24,97,50,1425,36,5,48,147
Colusa,2020-07-24,1,2,48,0,0,0,3
Sutter,2020-07-24,0,0,0,0,0,0,0
Mono,2020-07-24,1,0,17,1,0,1,1
Tulare,2020-07-24,111,4,240,22,0,13,115
Kern,2020-07-24,254,26,1343,71,3,33,280
San Mateo,2020-07-25,72,10,805,19,1,16,82
Lake,2020-07-25,0,1,65,0,1,4,1
Inyo,2020-07-25,1,0,29,0,0,3,1
Yuba,2020-07-25,21,3,457,7,0,5,24
Trinity,2020-07-25,0,0,25,0,0,0,0
Alameda,2020-07-25,180,67,2025,58,7,105,247
Shasta,2020-07-25,5,0,561,1,0,4,5
Fresno,2020-07-25,298,59,1490,65,5,27,357
Colusa,2020-07-25,2,0,48,0,0,0,2
Orange,2020-07-25,687,67,6095,201,9,387,754
Sacramento,2020-07-25,239,46,2494,76,6,77,285
Los Angeles,2020-07-25,2017,535,18946,582,89,930,2552
Santa Cruz,2020-07-25,17,22,255,4,2,12,39
Stanislaus,2020-07-25,205,43,1199,51,1,33,248
Ventura,2020-07-25,90,33,1292,24,7,59,123
San Benito,2020-07-25,6,0,25,1,0,0,6
Imperial,2020-07-25,77,1,261,23,0,5,78
Riverside,2020-07-25,483,127,3469,154,22,77,610
Glenn,2020-07-25,0,2,47,0,0,0,2
Kern,2020-07-25,248,29,1398,62,2,39,277
Placer,2020-07-25,60,32,748,12,6,30,92
Tulare,2020-07-25,111,3,240,21,0,12,114
Kings,2020-07-25,84,1,199,9,1,3,85
Nevada,2020-07-25,0,2,114,0,0,5,2
Lassen,2020-07-25,0,0,25,0,0,0,0
Mendocino,2020-07-25,7,0,150,2,0,5,7
San Luis Obispo,2020-07-25,16,2,457,5,0,18,18
Marin,2020-07-25,22,1,308,8,1,9,23
San Joaquin,2020-07-25,224,25,1099,73,6,30,249
El Dorado,2020-07-25,1,0,153,1,0,15,1
Merced,2020-07-25,53,0,255,11,0,6,53
Yolo,2020-07-25,12,0,96,5,0,3,12
Siskiyou,2020-07-25,0,0,56,0,0,5,0
San Francisco,2020-07-25,93,25,1987,26,5,79,118
Contra Costa,2020-07-25,99,34,1402,37,5,45,133
Plumas,2020-07-25,0,0,51,0,0,0,0
Humboldt,2020-07-25,0,1,327,0,0,1,1
Calaveras,2020-07-25,0,0,33,0,0,7,0
Amador,2020-07-25,1,0,51,0,0,1,1
Monterey,2020-07-25,43,4,763,8,1,27,47
Butte,2020-07-25,26,2,452,9,0,9,28
Modoc,2020-07-25,0,0,37,0,0,0,0
Del Norte,2020-07-25,0,0,51,0,0,2,0
Solano,2020-07-25,45,14,580,17,1,4,59
San Bernardino,2020-07-25,638,100,4509,195,10,131,738
Santa Barbara,2020-07-25,79,3,666,24,0,54,82
Tuolumne,2020-07-25,2,0,84,1,0,0,2
Madera,2020-07-25,55,9,360,10,1,16,64
Tehama,2020-07-25,0,0,59,0,0,4,0
Mariposa,2020-07-25,0,0,19,0,0,0,0
Santa Clara,2020-07-25,176,56,3088,55,4,100,232
Napa,2020-07-25,14,3,359,6,0,2,17
Mono,2020-07-25,1,0,17,1,0,1,1
Sonoma,2020-07-25,48,18,769,10,3,7,66
San Diego,2020-07-25,354,88,6329,119,10,268,442
Sutter,2020-07-25,0,0,0,0,0,0,0
Amador,2020-07-26,2,0,51,0,0,2,2
Modoc,2020-07-26,0,0,37,0,0,0,0
Humboldt,2020-07-26,0,3,314,0,0,4,3
Monterey,2020-07-26,39,3,763,9,1,27,42
Placer,2020-07-26,57,29,749,14,4,29,86
Lake,2020-07-26,0,0,65,0,0,4,0
Madera,2020-07-26,52,12,360,8,1,19,64
Nevada,2020-07-26,1,2,112,1,0,5,3
Tehama,2020-07-26,0,0,59,0,0,4,0
Mono,2020-07-26,1,0,17,0,0,1,1
Merced,2020-07-26,61,3,253,13,0,3,64
Riverside,2020-07-26,488,142,3413,146,21,87,630
Ventura,2020-07-26,85,29,1293,25,5,53,114
San Diego,2020-07-26,369,89,6316,115,11,297,458
Sonoma,2020-07-26,46,15,766,11,2,9,61
Tulare,2020-07-26,102,0,564,21,0,17,102
Inyo,2020-07-26,1,0,29,0,0,4,1
Kern,2020-07-26,260,21,1369,64,3,39,281
Solano,2020-07-26,48,16,567,18,1,8,64
Marin,2020-07-26,21,2,307,8,0,11,23
Shasta,2020-07-26,7,0,561,1,0,5,7
Del Norte,2020-07-26,0,0,51,0,0,2,0
Santa Cruz,2020-07-26,14,19,255,4,3,12,33
Santa Clara,2020-07-26,171,46,3087,59,3,87,217
Tuolumne,2020-07-26,2,0,84,1,0,0,2
El Dorado,2020-07-26,2,1,153,2,1,14,3
Contra Costa,2020-07-26,103,27,1392,40,2,48,130
Trinity,2020-07-26,0,0,25,0,0,0,0
San Francisco,2020-07-26,99,18,2000,30,6,89,117
Fresno,2020-07-26,302,62,1491,52,5,22,364
Colusa,2020-07-26,2,0,48,0,0,0,2
Alameda,2020-07-26,188,69,2174,62,12,96,257
Mendocino,2020-07-26,7,1,150,2,0,2,8
Yuba,2020-07-26,25,3,457,7,0,7,28
Sacramento,2020-07-26,246,47,2331,78,12,103,293
Los Angeles,2020-07-26,2051,570,19906,596,81,912,2621
Siskiyou,2020-07-26,0,3,56,0,1,4,3
Kings,2020-07-26,85,1,199,10,1,0,86
San Benito,2020-07-26,6,0,25,1,0,1,6
Plumas,2020-07-26,0,0,51,0,0,0,0
Napa,2020-07-26,13,2,359,4,0,13,15
San Bernardino,2020-07-26,609,104,4522,195,8,136,713
Calaveras,2020-07-26,0,1,33,0,1,5,1
Mariposa,2020-07-26,0,0,19,0,0,0,0
Imperial,2020-07-26,75,2,261,26,0,2,77
San Joaquin,2020-07-26,227,36,1050,79,14,16,263
Stanislaus,2020-07-26,209,39,1299,48,0,35,248
Yolo,2020-07-26,13,0,96,5,0,1,13
Sutter,2020-07-26,0,0,0,0,0,0,0
San Luis Obispo,2020-07-26,13,4,471,4,0,22,17
Santa Barbara,2020-07-26,80,5,666,25,1,62,85
Butte,2020-07-26,22,1,451,8,0,10,23
San Mateo,2020-07-26,70,9,795,16,0,42,79
Orange,2020-07-26,661,46,6078,204,9,377,707
Glenn,2020-07-26,0,2,47,0,0,0,2
Lassen,2020-07-26,0,0,25,0,0,0,0
San Bernardino,2020-07-27,595,93,4516,179,14,210,688
Mariposa,2020-07-27,0,0,19,0,0,0,0
Del Norte,2020-07-27,0,0,52,0,0,2,0
Alameda,2020-07-27,198,51,2142,65,10,98,249
Riverside,2020-07-27,487,122,3463,143,24,93,609
Butte,2020-07-27,25,1,451,8,1,11,26
Inyo,2020-07-27,1,0,29,0,0,4,1
Tuolumne,2020-07-27,1,0,84,0,0,2,1
Placer,2020-07-27,57,40,744,15,6,27,97
El Dorado,2020-07-27,3,0,153,2,0,12,3
Lassen,2020-07-27,0,0,25,0,0,0,0
Sacramento,2020-07-27,253,50,2467,81,8,101,303
Modoc,2020-07-27,0,0,41,0,0,0,0
Marin,2020-07-27,22,3,309,7,0,11,25
Santa Clara,2020-07-27,175,48,3087,61,5,126,223
Kings,2020-07-27,85,1,199,10,1,0,86
Colusa,2020-07-27,0,0,48,0,0,0,0
San Benito,2020-07-27,6,0,25,1,0,0,6
San Joaquin,2020-07-27,233,27,1046,75,5,23,260
San Luis Obispo,2020-07-27,13,2,471,4,1,20,15
San Mateo,2020-07-27,71,15,729,17,1,24,86
Nevada,2020-07-27,1,0,108,1,0,5,1
Lake,2020-07-27,1,1,65,0,0,4,2
Yolo,2020-07-27,13,0,96,6,0,10,13
Trinity,2020-07-27,0,0,25,0,0,0,0
Stanislaus,2020-07-27,204,46,1171,50,4,26,250
San Francisco,2020-07-27,101,17,1989,34,1,95,118
Merced,2020-07-27,64,0,253,13,0,4,64
Sutter,2020-07-27,0,0,0,0,0,0,0
Tehama,2020-07-27,0,0,59,0,0,5,0
Yuba,2020-07-27,24,3,457,6,0,11,27
Fresno,2020-07-27,297,48,1470,51,7,26,345
Orange,2020-07-27,640,45,6182,203,9,383,685
Santa Cruz,2020-07-27,14,19,255,4,1,17,33
Monterey,2020-07-27,39,0,763,7,0,30,39
Mono,2020-07-27,2,0,17,1,0,1,2
Sonoma,2020-07-27,42,17,691,10,2,3,59
Napa,2020-07-27,11,2,359,4,0,13,13
Kern,2020-07-27,255,20,1389,69,1,51,275
Shasta,2020-07-27,8,0,561,1,0,4,8
Solano,2020-07-27,46,19,566,16,2,8,65
Contra Costa,2020-07-27,105,31,1386,38,7,48,136
Calaveras,2020-07-27,1,1,33,1,1,6,2
San Diego,2020-07-27,343,89,5889,108,8,287,432
Mendocino,2020-07-27,6,2,150,1,0,0,8
Plumas,2020-07-27,0,1,51,0,0,0,1
Ventura,2020-07-27,86,29,1297,24,8,53,115
Tulare,2020-07-27,104,3,227,20,0,4,107
Madera,2020-07-27,55,5,360,10,0,15,60
Glenn,2020-07-27,0,2,47,0,0,0,2
Los Angeles,2020-07-27,2045,554,18716,576,93,901,2599
Amador,2020-07-27,3,0,51,1,0,1,3
Imperial,2020-07-27,81,1,261,27,0,2,82
Santa Barbara,2020-07-27,79,8,666,24,1,59,87
Siskiyou,2020-07-27,1,2,56,1,1,4,3
Humboldt,2020-07-27,0,3,314,0,1,6,3
Lassen,2020-07-28,0,0,25,0,0,0,0
San Bernardino,2020-07-28,608,102,4688,180,12,190,710
San Diego,2020-07-28,392,110,6710,129,20,274,502
San Benito,2020-07-28,7,0,25,2,0,0,7
Yolo,2020-07-28,12,0,98,6,0,4,12
Plumas,2020-07-28,0,1,51,0,0,0,1
Sacramento,2020-07-28,265,49,2440,81,7,84,314
Del Norte,2020-07-28,0,0,51,0,0,1,0
Merced,2020-07-28,52,1,240,12,0,4,53
Yuba,2020-07-28,20,0,457,6,0,12,20
Kern,2020-07-28,265,14,1472,76,1,34,279
Shasta,2020-07-28,10,0,561,1,0,6,10
San Luis Obispo,2020-07-28,13,4,477,4,0,17,17
Madera,2020-07-28,49,4,360,8,0,17,53
Mendocino,2020-07-28,5,1,150,1,0,0,6
Solano,2020-07-28,48,12,572,17,1,6,60
Lake,2020-07-28,0,1,65,0,0,3,1
Kings,2020-07-28,75,0,199,9,0,1,75
Sutter,2020-07-28,0,0,0,0,0,0,0
Fresno,2020-07-28,284,49,1478,65,4,13,333
Inyo,2020-07-28,1,0,29,0,0,4,1
Napa,2020-07-28,11,2,359,4,0,13,13
San Francisco,2020-07-28,107,16,1921,37,2,27,123
Siskiyou,2020-07-28,1,0,56,1,0,4,1
Glenn,2020-07-28,0,2,47,0,0,0,2
Tuolumne,2020-07-28,1,0,84,0,0,2,1
Orange,2020-07-28,626,81,6238,204,11,354,707
Mono,2020-07-28,1,0,17,1,0,1,1
Ventura,2020-07-28,87,45,1307,22,11,40,132
Riverside,2020-07-28,490,142,3523,153,22,161,632
El Dorado,2020-07-28,1,0,153,1,0,7,1
Calaveras,2020-07-28,1,0,33,1,0,7,1
Santa Clara,2020-07-28,181,43,3142,56,6,118,224
Modoc,2020-07-28,0,0,41,0,0,0,0
Marin,2020-07-28,23,0,310,7,0,10,23
Butte,2020-07-28,26,2,451,11,1,6,28
Mariposa,2020-07-28,0,0,19,0,0,0,0
Santa Cruz,2020-07-28,10,9,255,5,1,14,19
Imperial,2020-07-28,77,0,261,24,0,1,77
Tehama,2020-07-28,0,0,59,0,0,6,0
Los Angeles,2020-07-28,2022,575,20025,550,71,918,2597
Santa Barbara,2020-07-28,89,7,666,29,2,53,96
Placer,2020-07-28,59,32,735,14,2,26,91
Humboldt,2020-07-28,0,5,314,0,1,5,5
Nevada,2020-07-28,1,1,122,0,0,4,2
Sonoma,2020-07-28,60,11,588,20,2,7,71
Tulare,2020-07-28,105,7,227,20,0,4,112
San Joaquin,2020-07-28,231,40,1018,74,7,21,271
Alameda,2020-07-28,213,43,2343,64,3,114,256
Colusa,2020-07-28,0,0,48,0,0,0,0
Contra Costa,2020-07-28,108,39,1403,35,4,44,147
Amador,2020-07-28,3,1,51,1,0,0,4
San Mateo,2020-07-28,64,10,668,16,0,19,74
Trinity,2020-07-28,0,0,25,0,0,0,0
Stanislaus,2020-07-28,192,38,1175,50,5,25,230
Monterey,2020-07-28,43,1,763,15,1,30,44
Santa Barbara,2020-07-29,85,7,666,28,2,55,92
Mendocino,2020-07-29,5,1,150,1,0,2,6
Riverside,2020-07-29,475,104,3455,167,21,92,579
Contra Costa,2020-07-29,110,35,1427,37,4,47,145
Lassen,2020-07-29,0,0,25,0,0,0,0
San Luis Obispo,2020-07-29,18,3,477,4,0,16,21
Modoc,2020-07-29,0,0,41,0,0,0,0
San Benito,2020-07-29,3,1,25,1,1,2,4
Sonoma,2020-07-29,56,15,746,22,3,13,71
Fresno,2020-07-29,292,36,1479,67,3,13,328
Glenn,2020-07-29,0,2,47,0,0,0,2
San Diego,2020-07-29,366,82,6144,122,17,248,448
Napa,2020-07-29,10,0,359,5,0,13,10
Placer,2020-07-29,59,28,733,13,3,28,87
Marin,2020-07-29,23,0,315,9,0,7,23
San Francisco,2020-07-29,109,14,1991,39,2,44,123
Kings,2020-07-29,71,0,199,10,0,2,71
Lake,2020-07-29,0,0,66,0,0,3,0
Inyo,2020-07-29,1,0,29,0,0,4,1
Merced,2020-07-29,49,1,253,8,0,4,50
Del Norte,2020-07-29,0,0,51,0,0,0,0
Colusa,2020-07-29,0,1,48,0,0,0,1
El Dorado,2020-07-29,3,0,287,2,0,16,3
Mono,2020-07-29,1,0,17,1,0,1,1
Humboldt,2020-07-29,0,3,324,0,0,4,3
Sutter,2020-07-29,0,0,0,0,0,0,0
Trinity,2020-07-29,0,0,25,0,0,0,0
Imperial,2020-07-29,67,0,261,23,0,1,67
Stanislaus,2020-07-29,198,50,1223,49,4,28,248
Siskiyou,2020-07-29,1,0,56,1,0,5,1
Los Angeles,2020-07-29,2002,566,20193,578,57,877,2568
Tehama,2020-07-29,0,0,59,0,0,4,0
Plumas,2020-07-29,0,0,51,0,0,0,0
Santa Clara,2020-07-29,187,54,3403,58,6,103,241
Tuolumne,2020-07-29,1,0,84,0,0,2,1
Orange,2020-07-29,592,85,6225,189,12,360,677
Calaveras,2020-07-29,1,0,33,1,0,6,1
San Mateo,2020-07-29,64,15,697,16,2,14,79
Yolo,2020-07-29,11,0,96,5,0,7,11
Solano,2020-07-29,44,17,564,16,3,6,61
Amador,2020-07-29,5,0,51,2,0,1,5
Butte,2020-07-29,27,0,451,8,0,5,27
Sacramento,2020-07-29,277,62,2529,83,8,79,339
Alameda,2020-07-29,204,58,2401,59,10,94,262
Santa Cruz,2020-07-29,14,8,256,5,1,16,22
Tulare,2020-07-29,97,10,673,19,0,9,107
Madera,2020-07-29,54,6,360,11,1,15,60
Ventura,2020-07-29,78,35,1297,25,5,43,113
Yuba,2020-07-29,19,0,457,8,0,7,19
Mariposa,2020-07-29,0,0,19,0,0,0,0
San Joaquin,2020-07-29,233,41,1019,78,10,17,274
Kern,2020-07-29,215,15,1391,63,0,46,230
Nevada,2020-07-29,1,1,104,1,0,4,2
San Bernardino,2020-07-29,562,88,4566,176,16,165,650
Shasta,2020-07-29,10,0,561,2,0,5,10
Monterey,2020-07-29,53,1,763,17,0,15,54
San Joaquin,2020-07-30,215,52,1014,71,5,20,267
Stanislaus,2020-07-30,211,37,1226,49,3,30,248
Butte,2020-07-30,30,1,451,9,1,2,31
Tulare,2020-07-30,95,4,669,16,0,7,99
Merced,2020-07-30,49,3,253,10,1,9,52
Fresno,2020-07-30,313,40,1481,58,2,15,353
Modoc,2020-07-30,0,0,41,0,0,0,0
San Mateo,2020-07-30,58,10,702,22,2,15,68
Inyo,2020-07-30,0,0,29,0,0,3,0
Sutter,2020-07-30,0,0,0,0,0,0,0
Nevada,2020-07-30,1,1,125,1,0,5,2
Mono,2020-07-30,1,0,17,1,0,1,1
Glenn,2020-07-30,0,2,47,0,0,0,2
Del Norte,2020-07-30,0,0,51,0,0,0,0
Calaveras,2020-07-30,0,0,33,0,0,8,0
Imperial,2020-07-30,51,5,261,21,1,1,56
Plumas,2020-07-30,0,0,51,0,0,0,0
Sonoma,2020-07-30,50,10,631,18,1,7,60
San Francisco,2020-07-30,101,18,2025,38,1,53,119
Lassen,2020-07-30,0,0,25,0,0,0,0
Mendocino,2020-07-30,5,0,150,0,0,4,5
Tuolumne,2020-07-30,2,1,84,1,0,1,3
Yolo,2020-07-30,11,0,96,7,0,8,11
Tehama,2020-07-30,0,0,59,0,0,5,0
Los Angeles,2020-07-30,1904,553,20167,569,58,872,2457
Santa Clara,2020-07-30,180,44,3108,51,6,118,224
Amador,2020-07-30,4,1,52,2,0,0,5
Marin,2020-07-30,23,2,311,9,0,11,25
Kern,2020-07-30,230,17,1391,76,2,40,247
Trinity,2020-07-30,0,1,25,0,0,0,1
Orange,2020-07-30,593,62,6210,191,9,300,655
Colusa,2020-07-30,0,3,48,0,0,0,3
Mariposa,2020-07-30,0,0,19,0,0,0,0
Santa Barbara,2020-07-30,87,3,666,26,0,60,90
Solano,2020-07-30,38,16,564,14,2,6,54
Alameda,2020-07-30,198,47,2454,60,6,92,245
San Luis Obispo,2020-07-30,16,2,477,4,0,17,18
Monterey,2020-07-30,53,3,757,16,1,20,56
Madera,2020-07-30,56,5,360,11,1,20,61
Santa Cruz,2020-07-30,15,12,255,4,0,14,27
Contra Costa,2020-07-30,106,38,1434,36,6,47,144
Sacramento,2020-07-30,281,48,2452,91,7,79,329
San Bernardino,2020-07-30,596,81,4530,187,10,111,677
Humboldt,2020-07-30,0,1,260,0,0,4,1
Riverside,2020-07-30,452,93,3391,153,14,99,545
Siskiyou,2020-07-30,1,3,56,1,0,3,4
Placer,2020-07-30,59,37,730,12,0,27,96
Ventura,2020-07-30,80,39,1300,22,8,47,119
Napa,2020-07-30,12,0,359,5,0,15,12
El Dorado,2020-07-30,1,0,235,1,0,16,1
San Benito,2020-07-30,3,0,25,1,0,1,3
San Diego,2020-07-30,348,72,6268,120,13,258,420
Shasta,2020-07-30,10,0,561,3,0,5,10
Kings,2020-07-30,74,0,199,9,0,3,74
Yuba,2020-07-30,17,0,457,7,0,6,17
Lake,2020-07-30,0,0,66,0,0,2,0
Orange,2020-07-31,546,38,6260,169,5,309,584
Kern,2020-07-31,239,17,1391,75,3,28,256
San Francisco,2020-07-31,102,19,2002,36,1,51,121
Shasta,2020-07-31,8,0,448,3,0,6,8
Trinity,2020-07-31,0,2,25,0,0,0,2
Siskiyou,2020-07-31,1,3,56,1,0,4,4
Solano,2020-07-31,41,18,567,15,2,6,59
Santa Clara,2020-07-31,196,35,3104,56,6,92,231
Fresno,2020-07-31,309,34,1486,59,1,14,343
San Joaquin,2020-07-31,221,39,922,71,5,14,260
El Dorado,2020-07-31,2,2,235,1,2,14,4
Sacramento,2020-07-31,265,41,2475,90,7,79,306
Riverside,2020-07-31,447,94,3159,145,18,94,541
Humboldt,2020-07-31,0,4,263,0,1,5,4
Santa Cruz,2020-07-31,12,9,255,3,0,13,21
Sonoma,2020-07-31,39,14,506,16,1,3,53
San Mateo,2020-07-31,55,9,705,20,2,14,64
Mendocino,2020-07-31,8,0,150,0,0,0,8
Plumas,2020-07-31,0,0,51,0,0,0,0
Imperial,2020-07-31,50,0,261,20,0,3,50
Mariposa,2020-07-31,0,0,19,0,0,0,0
Colusa,2020-07-31,1,1,48,0,0,0,2
Alameda,2020-07-31,202,49,2486,58,5,102,251
Placer,2020-07-31,60,29,731,14,3,31,89
San Diego,2020-07-31,315,66,6614,109,11,269,381
Tulare,2020-07-31,98,7,714,15,0,8,105
Butte,2020-07-31,25,1,451,9,0,2,26
Glenn,2020-07-31,0,2,47,0,0,0,2
Yuba,2020-07-31,20,1,457,7,0,4,21
Monterey,2020-07-31,45,2,757,15,0,16,47
Santa Barbara,2020-07-31,86,3,666,23,0,47,89
Nevada,2020-07-31,2,3,116,1,0,8,5
Yolo,2020-07-31,6,1,96,6,1,5,7
Modoc,2020-07-31,0,0,41,0,0,0,0
Marin,2020-07-31,27,3,315,6,1,7,30
Del Norte,2020-07-31,0,1,53,0,0,0,1
Napa,2020-07-31,13,1,359,7,0,15,14
San Benito,2020-07-31,1,0,25,1,0,1,1
Los Angeles,2020-07-31,1856,516,20401,575,53,864,2372
Madera,2020-07-31,55,12,274,14,0,3,67
Ventura,2020-07-31,85,40,1314,25,9,45,125
Kings,2020-07-31,72,0,199,9,0,1,72
Stanislaus,2020-07-31,221,42,1226,52,2,34,263
Sutter,2020-07-31,0,0,0,0,0,0,0
Inyo,2020-07-31,0,0,29,0,0,4,0
Contra Costa,2020-07-31,107,45,1448,39,4,50,152
San Bernardino,2020-07-31,568,82,4442,184,8,117,650
Tehama,2020-07-31,0,1,59,0,1,5,1
Lassen,2020-07-31,0,2,25,0,0,0,2
Lake,2020-07-31,0,2,66,0,1,2,2
Calaveras,2020-07-31,0,0,33,0,0,7,0
San Luis Obispo,2020-07-31,12,5,463,4,1,18,17
Merced,2020-07-31,51,0,253,10,0,9,51
Tuolumne,2020-07-31,2,0,84,0,0,0,2
Amador,2020-07-31,5,0,51,2,0,2,5
Mono,2020-07-31,1,0,17,1,0,1,1
Monterey,2020-08-01,43,1,757,16,0,18,44
Sacramento,2020-08-01,267,35,2466,91,7,86,302
Placer,2020-08-01,58,34,732,15,4,29,92
Mono,2020-08-01,1,0,17,0,0,2,1
Del Norte,2020-08-01,0,0,52,0,0,3,0
El Dorado,2020-08-01,2,2,189,2,2,4,4
San Mateo,2020-08-01,55,9,709,18,2,17,64
Sonoma,2020-08-01,43,13,478,16,1,6,56
San Joaquin,2020-08-01,216,53,1019,77,5,17,269
Tuolumne,2020-08-01,2,0,84,0,0,0,2
San Luis Obispo,2020-08-01,13,5,463,4,0,20,18
Kern,2020-08-01,232,17,1391,77,3,30,249
Trinity,2020-08-01,0,2,25,0,0,0,2
Nevada,2020-08-01,1,4,116,0,0,8,5
Alameda,2020-08-01,198,50,2478,56,7,99,248
Napa,2020-08-01,10,0,359,6,2,16,10
Madera,2020-08-01,54,7,274,12,0,3,61
Fresno,2020-08-01,293,39,1505,58,3,12,332
Lassen,2020-08-01,0,2,25,0,0,0,2
Sutter,2020-08-01,0,0,0,0,0,0,0
Glenn,2020-08-01,0,2,47,0,0,0,2
Tulare,2020-08-01,108,9,714,19,0,10,117
Humboldt,2020-08-01,0,4,263,0,1,4,4
Siskiyou,2020-08-01,1,2,56,1,0,4,3
Inyo,2020-08-01,0,0,29,0,0,4,0
Riverside,2020-08-01,435,111,3282,139,18,98,546
Yuba,2020-08-01,20,1,457,7,0,4,21
San Francisco,2020-08-01,105,14,2005,39,1,52,119
Marin,2020-08-01,28,6,319,6,1,9,34
Lake,2020-08-01,1,0,66,0,0,2,1
Los Angeles,2020-08-01,1784,557,19238,544,61,908,2341
Santa Barbara,2020-08-01,82,5,666,23,0,75,87
Solano,2020-08-01,48,18,576,15,2,9,66
Plumas,2020-08-01,0,0,51,0,0,0,0
Yolo,2020-08-01,8,1,96,7,0,3,9
San Benito,2020-08-01,4,0,25,1,0,0,4
Shasta,2020-08-01,8,0,448,3,0,6,8
San Bernardino,2020-08-01,567,85,3802,186,11,164,652
Imperial,2020-08-01,47,1,261,21,0,3,48
Contra Costa,2020-08-01,100,48,1451,37,6,52,148
Ventura,2020-08-01,83,42,1310,23,8,45,125
Butte,2020-08-01,29,2,451,11,0,11,31
Amador,2020-08-01,6,0,51,2,0,0,6
Calaveras,2020-08-01,0,0,33,0,0,8,0
Stanislaus,2020-08-01,216,37,1223,51,4,30,253
Merced,2020-08-01,52,0,253,10,0,9,52
Santa Clara,2020-08-01,183,33,3226,57,3,110,216
Modoc,2020-08-01,0,0,41,0,0,0,0
Tehama,2020-08-01,0,1,59,0,1,5,1
Mendocino,2020-08-01,8,0,150,0,0,0,8
San Diego,2020-08-01,312,72,6156,107,18,282,384
Colusa,2020-08-01,1,2,48,0,0,0,3
Kings,2020-08-01,72,0,199,9,0,1,72
Santa Cruz,2020-08-01,12,9,255,3,0,8,21
Orange,2020-08-01,554,64,5764,171,8,306,618
Mariposa,2020-08-01,0,0,19,0,0,0,0
Solano,2020-08-02,50,11,562,18,0,6,61
El Dorado,2020-08-02,2,0,189,2,0,5,2
San Diego,2020-08-02,305,70,6123,113,10,304,375
Los Angeles,2020-08-02,1757,506,19088,545,55,952,2263
Alameda,2020-08-02,194,42,2434,55,9,91,236
Sonoma,2020-08-02,42,17,479,14,2,6,59
Humboldt,2020-08-02,0,4,258,0,1,4,4
Contra Costa,2020-08-02,101,39,1442,38,7,60,140
Merced,2020-08-02,52,3,253,11,1,8,55
Colusa,2020-08-02,1,0,48,0,0,0,1
Madera,2020-08-02,48,7,274,15,0,3,55
San Joaquin,2020-08-02,213,45,922,65,1,21,258
San Benito,2020-08-02,3,0,25,0,0,0,3
San Francisco,2020-08-02,98,11,1992,35,3,51,109
San Mateo,2020-08-02,55,12,683,19,2,23,67
Butte,2020-08-02,27,1,451,8,0,10,28
Imperial,2020-08-02,53,0,261,21,0,2,53
Mendocino,2020-08-02,12,0,150,0,0,9,12
Kings,2020-08-02,73,1,199,8,1,3,74
Lassen,2020-08-02,0,1,25,0,0,0,1
Ventura,2020-08-02,82,37,1314,18,7,44,119
Orange,2020-08-02,555,50,5723,175,8,316,605
Siskiyou,2020-08-02,1,2,25,1,0,0,3
Sacramento,2020-08-02,262,33,2319,83,8,91,295
Santa Clara,2020-08-02,185,36,3225,57,4,93,221
Riverside,2020-08-02,425,87,3237,133,20,95,512
Mono,2020-08-02,1,0,17,0,0,2,1
Glenn,2020-08-02,0,2,47,0,0,0,2
Lake,2020-08-02,2,0,65,0,0,3,2
Santa Barbara,2020-08-02,88,6,666,25,0,48,94
Yolo,2020-08-02,8,0,96,4,0,4,8
Fresno,2020-08-02,295,33,1527,61,6,18,328
Amador,2020-08-02,12,0,51,4,0,0,12
Plumas,2020-08-02,0,0,51,0,0,0,0
Monterey,2020-08-02,44,3,757,16,0,15,47
Trinity,2020-08-02,0,0,25,0,0,0,0
Inyo,2020-08-02,3,0,29,0,0,4,3
Kern,2020-08-02,321,12,1292,72,4,35,333
Tulare,2020-08-02,101,7,714,14,0,3,108
Del Norte,2020-08-02,0,0,52,0,0,4,0
Yuba,2020-08-02,23,0,265,6,0,10,23
Marin,2020-08-02,26,3,320,6,0,8,29
Napa,2020-08-02,7,0,359,3,0,19,7
Sutter,2020-08-02,0,0,0,0,0,0,0
Tehama,2020-08-02,0,0,59,0,0,5,0
Mariposa,2020-08-02,0,0,19,0,0,0,0
Modoc,2020-08-02,0,0,41,0,0,0,0
Shasta,2020-08-02,8,0,561,3,0,4,8
Placer,2020-08-02,57,39,732,11,2,29,96
San Luis Obispo,2020-08-02,13,3,452,5,0,21,16
Calaveras,2020-08-02,0,0,50,0,0,8,0
Stanislaus,2020-08-02,205,47,1230,49,4,25,252
San Bernardino,2020-08-02,575,67,3899,193,5,116,642
Santa Cruz,2020-08-02,12,9,276,3,0,12,21
Nevada,2020-08-02,0,0,29,0,0,4,0
Tuolumne,2020-08-02,2,0,84,0,0,1,2
Sacramento,2020-08-03,274,34,2452,87,3,90,308
Stanislaus,2020-08-03,215,43,1212,48,4,38,258
San Benito,2020-08-03,3,0,25,1,0,2,3
Solano,2020-08-03,44,12,553,17,1,6,56
Colusa,2020-08-03,1,0,48,0,0,0,1
Fresno,2020-08-03,297,39,1538,59,3,19,336
Mendocino,2020-08-03,10,0,150,0,0,11,10
Placer,2020-08-03,62,28,733,14,5,28,90
Tuolumne,2020-08-03,2,1,84,0,0,1,3
Alameda,2020-08-03,193,49,2334,55,6,84,242
Mariposa,2020-08-03,0,0,19,0,0,0,0
Modoc,2020-08-03,0,0,41,0,0,0,0
Mono,2020-08-03,0,0,17,0,0,2,0
Trinity,2020-08-03,0,1,25,0,0,0,1
Tulare,2020-08-03,105,5,714,17,1,10,110
Orange,2020-08-03,539,66,5814,167,12,306,605
Sonoma,2020-08-03,41,17,480,13,1,7,58
Santa Clara,2020-08-03,171,31,3201,52,2,110,202
Riverside,2020-08-03,450,93,3278,133,19,88,543
El Dorado,2020-08-03,3,0,189,1,0,12,3
Contra Costa,2020-08-03,99,40,1410,42,12,53,139
San Luis Obispo,2020-08-03,11,1,477,4,0,21,12
Napa,2020-08-03,9,7,359,3,0,22,16
Lassen,2020-08-03,0,1,25,0,0,0,1
Plumas,2020-08-03,0,0,51,0,0,0,0
Lake,2020-08-03,0,0,65,0,0,8,0
Del Norte,2020-08-03,0,1,52,0,0,3,1
Humboldt,2020-08-03,0,2,264,0,0,7,2
Madera,2020-08-03,46,14,274,13,0,2,60
Amador,2020-08-03,10,1,51,4,0,0,11
Inyo,2020-08-03,3,0,29,0,0,4,3
Ventura,2020-08-03,88,41,1306,19,7,45,129
Marin,2020-08-03,23,5,313,5,1,12,28
San Bernardino,2020-08-03,561,76,3822,188,10,126,637
Los Angeles,2020-08-03,1768,541,19242,537,68,915,2309
Calaveras,2020-08-03,0,0,33,0,0,8,0
Monterey,2020-08-03,47,3,757,19,0,11,50
Kern,2020-08-03,222,24,1392,80,7,43,246
Kings,2020-08-03,71,0,199,6,0,4,71
San Francisco,2020-08-03,89,15,1709,34,2,123,104
Sutter,2020-08-03,0,0,0,0,0,0,0
Yuba,2020-08-03,21,0,265,5,0,13,21
Shasta,2020-08-03,7,0,434,3,0,8,7
Glenn,2020-08-03,0,2,47,0,0,0,2
Santa Barbara,2020-08-03,82,7,666,25,0,43,89
Tehama,2020-08-03,0,0,59,0,0,5,0
San Joaquin,2020-08-03,222,31,1020,67,5,22,253
Santa Cruz,2020-08-03,15,11,276,3,3,11,26
Merced,2020-08-03,56,2,253,14,0,5,58
Nevada,2020-08-03,0,2,109,0,1,9,2
Siskiyou,2020-08-03,1,0,56,1,0,5,1
Yolo,2020-08-03,7,0,96,6,0,4,7
Imperial,2020-08-03,56,0,261,25,0,2,56
San Mateo,2020-08-03,58,15,682,14,3,26,73
San Diego,2020-08-03,294,67,6136,103,14,323,361
Butte,2020-08-03,26,0,451,8,0,10,26
San Diego,2020-08-04,311,93,6044,111,19,311,404
Napa,2020-08-04,9,1,359,3,0,21,10
Los Angeles,2020-08-04,1741,556,19053,508,57,887,2297
Fresno,2020-08-04,295,41,1557,55,5,13,336
Sacramento,2020-08-04,262,48,2462,87,6,89,310
San Joaquin,2020-08-04,214,67,1014,54,10,21,281
Monterey,2020-08-04,51,1,757,17,1,20,52
San Luis Obispo,2020-08-04,12,4,477,4,1,23,16
Modoc,2020-08-04,0,0,41,0,0,0,0
Del Norte,2020-08-04,0,0,51,0,0,4,0
Solano,2020-08-04,42,11,558,16,2,4,53
Amador,2020-08-04,10,0,51,3,0,1,10
Stanislaus,2020-08-04,219,52,1219,50,3,21,271
San Bernardino,2020-08-04,541,58,3810,174,6,131,599
San Mateo,2020-08-04,54,12,692,12,2,27,66
San Benito,2020-08-04,3,0,25,1,0,1,3
Kern,2020-08-04,212,21,1435,66,2,44,233
Butte,2020-08-04,23,0,451,11,0,7,23
Colusa,2020-08-04,2,3,48,0,0,0,5
Marin,2020-08-04,21,5,312,5,0,9,26
Yuba,2020-08-04,22,0,265,5,0,10,22
Mono,2020-08-04,0,0,17,0,0,1,0
Santa Clara,2020-08-04,171,29,3230,53,1,104,200
Glenn,2020-08-04,0,2,47,0,0,0,2
Ventura,2020-08-04,81,29,1306,21,6,39,110
Merced,2020-08-04,50,1,254,14,0,5,51
Sutter,2020-08-04,0,0,0,0,0,0,0
Inyo,2020-08-04,1,0,29,0,0,4,1
Contra Costa,2020-08-04,95,41,1427,43,9,57,136
Orange,2020-08-04,536,44,5762,172,7,309,580
Kings,2020-08-04,70,0,199,9,0,1,70
Alameda,2020-08-04,196,54,2363,53,10,93,250
Placer,2020-08-04,65,38,731,15,4,25,103
Santa Cruz,2020-08-04,12,9,276,6,1,12,21
Nevada,2020-08-04,1,1,91,0,0,12,2
Mendocino,2020-08-04,12,0,150,0,0,8,12
Plumas,2020-08-04,0,0,51,0,0,0,0
Tulare,2020-08-04,114,4,714,15,2,6,118
Calaveras,2020-08-04,1,1,33,0,0,8,2
Yolo,2020-08-04,5,1,96,5,0,8,6
Mariposa,2020-08-04,0,0,19,0,0,0,0
Madera,2020-08-04,46,3,274,14,1,2,49
Lake,2020-08-04,0,1,65,0,0,4,1
Siskiyou,2020-08-04,1,0,56,0,0,5,1
El Dorado,2020-08-04,2,1,189,0,0,11,3
Trinity,2020-08-04,0,4,25,0,0,0,4
Imperial,2020-08-04,47,0,261,20,0,4,47
Humboldt,2020-08-04,0,2,267,0,0,7,2
Sonoma,2020-08-04,42,15,485,11,1,10,57
Lassen,2020-08-04,0,0,25,0,0,0,0
Santa Barbara,2020-08-04,81,3,666,25,0,42,84
Riverside,2020-08-04,411,100,3247,134,20,79,511
San Francisco,2020-08-04,92,12,1772,33,1,69,104
Tehama,2020-08-04,0,0,59,0,0,7,0
Tuolumne,2020-08-04,3,0,84,0,0,0,3
Shasta,2020-08-04,5,0,437,3,0,3,5
Nevada,2020-08-05,1,2,121,0,0,10,3
San Francisco,2020-08-05,80,14,1848,30,0,76,94
San Joaquin,2020-08-05,206,48,1012,65,23,21,254
Kings,2020-08-05,73,1,193,9,1,8,74
Marin,2020-08-05,21,2,317,6,0,9,23
Glenn,2020-08-05,0,2,47,0,0,0,2
Los Angeles,2020-08-05,1680,602,19541,502,81,865,2282
Orange,2020-08-05,517,75,5991,171,8,319,592
Alameda,2020-08-05,190,56,2414,49,7,98,246
San Diego,2020-08-05,295,76,6159,100,12,314,371
San Mateo,2020-08-05,49,13,696,19,3,22,62
Tehama,2020-08-05,0,0,59,0,0,3,0
Lake,2020-08-05,1,1,65,0,1,2,2
Imperial,2020-08-05,47,0,261,19,0,4,47
Humboldt,2020-08-05,0,1,261,0,0,7,1
Santa Barbara,2020-08-05,84,0,666,29,0,39,84
Sutter,2020-08-05,0,0,0,0,0,0,0
Santa Clara,2020-08-05,168,31,3167,51,1,116,199
Fresno,2020-08-05,296,40,1574,56,4,14,336
Mono,2020-08-05,1,0,17,0,0,1,1
Placer,2020-08-05,67,39,740,12,3,26,106
Contra Costa,2020-08-05,89,37,1437,40,7,47,126
Madera,2020-08-05,45,5,274,13,0,1,50
Riverside,2020-08-05,415,93,3422,128,12,85,508
Lassen,2020-08-05,0,0,25,0,0,0,0
Inyo,2020-08-05,1,0,29,0,0,4,1
San Bernardino,2020-08-05,541,76,3783,170,7,128,617
Yolo,2020-08-05,10,0,96,7,0,4,10
Monterey,2020-08-05,52,1,691,17,1,22,53
Mariposa,2020-08-05,0,0,19,0,0,0,0
Shasta,2020-08-05,7,0,440,3,0,33,7
San Luis Obispo,2020-08-05,12,5,477,5,1,21,17
Stanislaus,2020-08-05,223,57,1219,55,5,9,280
San Benito,2020-08-05,2,0,25,1,0,0,2
Calaveras,2020-08-05,1,3,33,0,3,8,4
Merced,2020-08-05,51,0,254,13,0,5,51
Ventura,2020-08-05,79,38,1318,26,5,37,117
Modoc,2020-08-05,0,0,41,0,0,0,0
Tuolumne,2020-08-05,2,1,84,0,0,1,3
Plumas,2020-08-05,0,0,51,0,0,0,0
Sacramento,2020-08-05,262,48,2474,88,5,79,310
Butte,2020-08-05,26,3,451,10,0,5,29
Tulare,2020-08-05,98,6,714,15,2,7,104
Trinity,2020-08-05,0,2,25,0,0,0,2
Solano,2020-08-05,45,15,557,17,4,5,60
El Dorado,2020-08-05,2,1,189,1,1,4,3
Sonoma,2020-08-05,43,5,545,10,1,8,48
Colusa,2020-08-05,1,4,48,0,0,0,5
Siskiyou,2020-08-05,0,0,56,0,0,2,0
Kern,2020-08-05,222,7,1279,76,0,72,229
Amador,2020-08-05,6,0,51,3,0,1,6
Santa Cruz,2020-08-05,12,6,276,3,0,9,18
Del Norte,2020-08-05,0,0,51,0,0,3,0
Napa,2020-08-05,8,0,345,3,0,20,8
Yuba,2020-08-05,25,0,265,5,0,8,25
Mendocino,2020-08-05,13,0,150,1,0,7,13
San Francisco,2020-08-06,85,9,1820,31,1,60,94
Los Angeles,2020-08-06,1610,581,19413,499,73,836,2191
Orange,2020-08-06,511,47,5980,177,6,306,558
Mono,2020-08-06,1,0,17,1,0,0,1
Yolo,2020-08-06,10,0,96,7,0,4,10
Sacramento,2020-08-06,250,59,2464,81,10,93,309
Santa Barbara,2020-08-06,82,6,666,27,2,39,88
San Luis Obispo,2020-08-06,11,3,451,4,0,21,14
Tehama,2020-08-06,2,0,59,1,0,2,2
Kern,2020-08-06,217,12,1297,72,0,45,229
Tulare,2020-08-06,98,3,714,11,1,10,101
Alameda,2020-08-06,175,50,2407,52,7,98,225
San Joaquin,2020-08-06,196,26,1011,63,6,17,222
Mariposa,2020-08-06,0,0,19,0,0,0,0
Trinity,2020-08-06,0,0,25,0,0,0,0
Modoc,2020-08-06,0,0,41,0,0,0,0
Calaveras,2020-08-06,2,1,33,2,0,5,3
Mendocino,2020-08-06,14,0,150,2,0,5,14
San Diego,2020-08-06,283,59,6023,95,12,295,342
Placer,2020-08-06,63,36,740,10,1,31,99
Del Norte,2020-08-06,0,5,51,0,2,3,5
Siskiyou,2020-08-06,0,1,56,0,1,2,1
Lassen,2020-08-06,0,0,25,0,0,0,0
Sutter,2020-08-06,0,0,0,0,0,0,0
Glenn,2020-08-06,0,2,47,0,0,0,2
San Bernardino,2020-08-06,530,71,3791,169,6,123,601
Monterey,2020-08-06,51,1,710,18,1,19,52
Plumas,2020-08-06,0,0,35,0,0,0,0
Lake,2020-08-06,1,1,65,0,1,1,2
Marin,2020-08-06,24,3,309,6,0,8,27
Shasta,2020-08-06,7,0,422,2,0,8,7
Humboldt,2020-08-06,1,1,260,0,0,7,2
San Mateo,2020-08-06,45,16,685,16,1,31,61
Yuba,2020-08-06,28,0,265,7,0,8,28
Sonoma,2020-08-06,37,14,515,10,2,6,51
Napa,2020-08-06,8,1,359,4,1,20,9
Ventura,2020-08-06,81,33,1314,23,8,37,114
Nevada,2020-08-06,2,0,105,0,0,3,2
Colusa,2020-08-06,3,2,48,0,0,0,5
Fresno,2020-08-06,292,43,1579,55,6,17,335
Contra Costa,2020-08-06,98,35,1435,43,3,46,133
Merced,2020-08-06,55,3,254,15,1,3,58
Riverside,2020-08-06,409,106,3391,125,14,87,515
Tuolumne,2020-08-06,2,2,84,0,1,1,4
El Dorado,2020-08-06,3,0,189,1,0,6,3
Stanislaus,2020-08-06,216,58,1243,51,7,10,274
Santa Cruz,2020-08-06,12,13,276,3,2,11,25
Kings,2020-08-06,73,0,193,8,0,10,73
Inyo,2020-08-06,1,0,29,0,0,4,1
Madera,2020-08-06,46,4,274,9,0,6,50
Butte,2020-08-06,23,1,451,8,0,6,24
Amador,2020-08-06,8,0,51,3,0,1,8
Imperial,2020-08-06,49,0,261,17,0,5,49
Santa Clara,2020-08-06,175,21,3072,53,2,101,196
Solano,2020-08-06,40,15,561,16,2,6,55
San Benito,2020-08-06,2,1,25,1,0,1,3
Merced,2020-08-07,59,0,253,15,0,0,59
San Luis Obispo,2020-08-07,12,4,451,3,0,21,16
San Diego,2020-08-07,279,67,6017,91,19,301,346
Tulare,2020-08-07,102,3,714,16,1,16,105
Del Norte,2020-08-07,1,4,52,0,2,2,5
Contra Costa,2020-08-07,99,28,1430,42,4,45,127
Mono,2020-08-07,1,0,17,1,0,1,1
Mendocino,2020-08-07,17,0,150,9,0,7,17
Placer,2020-08-07,63,39,733,12,0,26,102
Alameda,2020-08-07,167,47,2393,51,9,87,214
Lake,2020-08-07,4,0,65,4,0,2,4
Calaveras,2020-08-07,2,0,33,2,0,4,2
Nevada,2020-08-07,2,0,113,0,0,8,2
Humboldt,2020-08-07,1,6,260,0,2,8,7
Tehama,2020-08-07,2,0,59,2,0,2,2
Butte,2020-08-07,20,0,451,8,0,9,20
Monterey,2020-08-07,48,3,710,20,0,22,51
San Benito,2020-08-07,2,0,25,1,0,3,2
San Mateo,2020-08-07,42,16,695,12,2,27,58
Inyo,2020-08-07,2,0,29,0,0,4,2
Napa,2020-08-07,7,3,359,4,3,17,10
Riverside,2020-08-07,382,105,3419,118,14,99,487
Santa Clara,2020-08-07,170,20,3047,55,2,99,190
Lassen,2020-08-07,0,0,25,0,0,0,0
Santa Cruz,2020-08-07,13,5,276,4,0,12,18
Amador,2020-08-07,7,0,51,3,0,2,7
Plumas,2020-08-07,0,0,35,0,0,0,0
Orange,2020-08-07,491,51,5706,167,8,247,542
San Bernardino,2020-08-07,493,60,3786,157,8,136,553
Colusa,2020-08-07,5,2,48,0,0,0,7
San Francisco,2020-08-07,79,11,1832,30,0,54,90
Trinity,2020-08-07,0,0,25,0,0,0,0
Imperial,2020-08-07,48,0,261,16,0,6,48
Santa Barbara,2020-08-07,80,6,666,29,1,40,86
Madera,2020-08-07,41,9,274,9,0,6,50
El Dorado,2020-08-07,3,0,189,2,0,9,3
Solano,2020-08-07,39,18,552,16,1,7,57
Fresno,2020-08-07,279,45,1555,57,3,8,324
Sacramento,2020-08-07,259,74,2456,84,13,84,333
Kings,2020-08-07,71,0,193,18,0,9,71
Tuolumne,2020-08-07,6,4,84,6,3,2,10
Marin,2020-08-07,24,2,313,5,0,8,26
Modoc,2020-08-07,0,0,41,0,0,0,0
Glenn,2020-08-07,0,2,47,0,0,0,2
Stanislaus,2020-08-07,211,44,1249,48,3,22,255
Mariposa,2020-08-07,0,0,19,0,0,0,0
Ventura,2020-08-07,82,22,1314,32,6,36,104
Siskiyou,2020-08-07,0,1,56,0,1,4,1
Yolo,2020-08-07,6,0,96,5,0,6,6
Yuba,2020-08-07,30,0,265,24,0,9,30
San Joaquin,2020-08-07,171,14,1022,73,0,13,185
Los Angeles,2020-08-07,1568,478,18941,519,64,814,2046
Sutter,2020-08-07,0,0,0,0,0,0,0
Kern,2020-08-07,214,15,1300,87,0,43,229
Shasta,2020-08-07,6,0,427,1,0,8,6
Sonoma,2020-08-07,36,2,532,10,1,7,38
Tehama,2020-08-08,2,0,59,2,0,4,2
San Luis Obispo,2020-08-08,12,4,451,4,0,19,16
Nevada,2020-08-08,3,0,103,0,0,4,3
Monterey,2020-08-08,48,0,710,21,0,20,48
Sonoma,2020-08-08,36,13,547,10,2,7,49
Madera,2020-08-08,46,19,274,9,0,4,65
Butte,2020-08-08,23,0,451,7,0,12,23
Contra Costa,2020-08-08,98,21,1434,38,4,44,119
Mariposa,2020-08-08,1,0,19,0,0,0,1
Ventura,2020-08-08,78,27,1318,21,9,43,105
Modoc,2020-08-08,0,0,41,0,0,0,0
Colusa,2020-08-08,6,2,48,0,0,0,8
Solano,2020-08-08,37,20,553,16,1,4,57
Lake,2020-08-08,0,1,66,0,1,3,1
Calaveras,2020-08-08,2,1,33,2,1,5,3
Inyo,2020-08-08,1,0,29,0,0,4,1
Marin,2020-08-08,19,0,319,6,0,8,19
Orange,2020-08-08,487,63,5660,163,11,333,550
Humboldt,2020-08-08,1,5,260,0,2,5,6
Los Angeles,2020-08-08,1514,513,19208,476,66,820,2027
Riverside,2020-08-08,373,77,3316,114,13,108,450
Shasta,2020-08-08,4,0,427,1,0,6,4
San Francisco,2020-08-08,77,11,1800,29,2,63,88
Plumas,2020-08-08,0,0,35,0,0,0,0
Santa Cruz,2020-08-08,13,7,276,3,0,12,20
Alameda,2020-08-08,163,45,2376,58,6,92,208
San Bernardino,2020-08-08,485,69,3755,153,8,137,554
Fresno,2020-08-08,287,40,1563,54,0,13,327
Yuba,2020-08-08,26,0,265,7,0,9,26
Tuolumne,2020-08-08,1,3,84,0,2,0,4
Kings,2020-08-08,63,0,193,7,0,12,63
Mendocino,2020-08-08,13,0,150,1,0,7,13
El Dorado,2020-08-08,4,1,189,3,1,5,5
Imperial,2020-08-08,48,0,261,14,0,8,48
San Benito,2020-08-08,3,0,25,1,0,3,3
Napa,2020-08-08,6,0,359,2,0,19,6
Santa Clara,2020-08-08,176,27,3040,57,6,109,203
Tulare,2020-08-08,94,1,714,11,0,16,95
Siskiyou,2020-08-08,0,1,56,0,1,4,1
Merced,2020-08-08,57,0,253,13,0,4,57
Lassen,2020-08-08,0,0,25,0,0,0,0
San Diego,2020-08-08,267,56,6149,90,11,324,323
San Mateo,2020-08-08,45,16,683,12,3,30,61
Trinity,2020-08-08,0,0,25,0,0,0,0
Santa Barbara,2020-08-08,84,8,666,31,0,41,92
Yolo,2020-08-08,8,0,96,5,0,2,8
Sutter,2020-08-08,0,0,0,0,0,0,0
Amador,2020-08-08,8,0,51,2,0,1,8
Del Norte,2020-08-08,1,1,52,1,0,0,2
Kern,2020-08-08,219,14,1292,74,0,35,233
San Joaquin,2020-08-08,167,11,1016,64,1,21,178
Placer,2020-08-08,66,27,737,13,1,28,93
Sacramento,2020-08-08,263,62,2435,87,6,96,325
Stanislaus,2020-08-08,200,45,1248,48,2,19,245
Glenn,2020-08-08,0,2,47,0,0,0,2
Mono,2020-08-08,1,0,17,1,0,1,1
Sonoma,2020-08-09,36,8,552,10,2,8,44
Santa Clara,2020-08-09,184,27,3042,57,4,116,211
Sutter,2020-08-09,0,0,0,0,0,0,0
Sacramento,2020-08-09,261,65,2443,82,11,104,326
Plumas,2020-08-09,0,0,35,0,0,0,0
Calaveras,2020-08-09,2,2,33,2,1,5,4
San Luis Obispo,2020-08-09,17,4,451,6,0,20,21
San Joaquin,2020-08-09,176,12,1017,65,2,15,188
Trinity,2020-08-09,0,0,25,0,0,0,0
Tulare,2020-08-09,86,3,714,11,0,19,89
Marin,2020-08-09,16,1,321,5,0,10,17
San Diego,2020-08-09,265,59,6135,92,12,346,324
Yuba,2020-08-09,27,1,265,7,0,9,28
Colusa,2020-08-09,6,1,48,0,0,0,7
Placer,2020-08-09,65,25,727,13,3,27,90
Solano,2020-08-09,42,15,546,19,2,4,57
Napa,2020-08-09,8,2,359,5,0,19,10
Kings,2020-08-09,59,0,193,5,0,12,59
Tehama,2020-08-09,2,0,59,2,0,2,2
Santa Barbara,2020-08-09,77,5,666,31,0,41,82
Merced,2020-08-09,52,0,253,13,0,7,52
San Mateo,2020-08-09,39,17,682,12,2,29,56
Nevada,2020-08-09,3,0,89,0,0,4,3
Butte,2020-08-09,20,1,451,7,1,11,21
Alameda,2020-08-09,169,45,2340,55,2,92,214
Lake,2020-08-09,0,2,65,0,1,2,2
Orange,2020-08-09,468,53,5631,152,10,255,521
Los Angeles,2020-08-09,1524,468,19199,490,59,819,1992
El Dorado,2020-08-09,3,0,189,2,0,8,3
San Francisco,2020-08-09,82,16,1740,31,2,70,98
Del Norte,2020-08-09,1,0,51,1,0,0,1
Madera,2020-08-09,46,8,274,8,3,7,54
Riverside,2020-08-09,359,95,3300,112,10,123,454
Kern,2020-08-09,212,17,1282,72,0,37,229
Stanislaus,2020-08-09,191,35,1244,49,2,21,226
Imperial,2020-08-09,44,4,261,14,1,7,48
Ventura,2020-08-09,77,25,1318,21,6,47,102
San Benito,2020-08-09,4,0,25,1,0,3,4
Amador,2020-08-09,8,1,51,3,0,2,9
Yolo,2020-08-09,9,0,96,4,0,4,9
Tuolumne,2020-08-09,0,0,84,0,0,0,0
Modoc,2020-08-09,0,0,41,0,0,0,0
Glenn,2020-08-09,0,2,47,0,0,0,2
Siskiyou,2020-08-09,0,1,56,0,1,5,1
Shasta,2020-08-09,4,0,427,1,0,5,4
Contra Costa,2020-08-09,104,37,1429,39,4,46,141
Mariposa,2020-08-09,1,0,19,0,0,0,1
Santa Cruz,2020-08-09,13,10,276,4,2,12,23
San Bernardino,2020-08-09,486,67,3742,152,6,155,553
Humboldt,2020-08-09,1,6,256,0,3,5,7
Mono,2020-08-09,1,0,17,0,0,2,1
Lassen,2020-08-09,0,0,25,0,0,0,0
Fresno,2020-08-09,286,29,1547,53,0,13,315
Monterey,2020-08-09,45,4,710,18,0,16,49
Inyo,2020-08-09,1,1,29,0,0,4,2
Mendocino,2020-08-09,14,0,150,1,0,6,14
Trinity,2020-08-10,0,0,25,0,0,0,0
Mendocino,2020-08-10,15,0,150,2,0,8,15
Imperial,2020-08-10,39,0,261,13,1,7,39
Santa Barbara,2020-08-10,79,8,666,31,1,46,87
Calaveras,2020-08-10,3,1,33,2,1,5,4
Tulare,2020-08-10,98,7,714,11,1,17,105
Marin,2020-08-10,18,2,319,3,1,10,20
Santa Clara,2020-08-10,187,18,3034,56,2,118,205
Merced,2020-08-10,50,1,253,15,0,3,51
San Bernardino,2020-08-10,468,81,3769,152,8,149,549
Placer,2020-08-10,65,34,736,13,4,29,99
San Diego,2020-08-10,262,62,6132,95,18,345,324
Shasta,2020-08-10,3,0,427,1,0,9,3
Colusa,2020-08-10,5,2,48,0,0,0,7
Siskiyou,2020-08-10,0,1,56,0,0,6,1
Alameda,2020-08-10,166,38,2330,56,2,90,204
Glenn,2020-08-10,0,2,47,0,0,0,2
San Francisco,2020-08-10,84,12,1747,28,4,76,96
Fresno,2020-08-10,273,37,1555,58,1,10,310
Los Angeles,2020-08-10,1538,446,19164,493,58,850,1984
Kern,2020-08-10,202,24,1280,71,2,35,226
Amador,2020-08-10,7,1,51,2,0,2,8
Mono,2020-08-10,1,0,17,1,0,1,1
Nevada,2020-08-10,4,1,89,1,0,5,5
Plumas,2020-08-10,0,0,35,0,0,0,0
Orange,2020-08-10,441,71,5632,141,13,272,512
Mariposa,2020-08-10,0,0,19,0,0,0,0
Stanislaus,2020-08-10,205,65,1249,55,5,19,270
El Dorado,2020-08-10,4,0,189,4,0,6,4
Kings,2020-08-10,58,0,193,4,0,13,58
San Luis Obispo,2020-08-10,19,3,451,4,0,21,22
San Mateo,2020-08-10,41,19,671,10,2,30,60
Ventura,2020-08-10,79,33,1302,23,4,45,112
Del Norte,2020-08-10,1,1,51,1,0,2,2
Riverside,2020-08-10,358,92,3318,112,8,110,450
Inyo,2020-08-10,2,2,29,0,0,3,4
Yuba,2020-08-10,24,1,265,7,0,8,25
Napa,2020-08-10,8,2,359,5,0,18,10
Humboldt,2020-08-10,2,6,263,0,2,4,8
Monterey,2020-08-10,44,5,710,18,0,18,49
San Joaquin,2020-08-10,171,7,1013,62,1,19,178
Lake,2020-08-10,0,2,65,0,0,6,2
Sonoma,2020-08-10,35,8,493,10,3,3,43
Tehama,2020-08-10,2,0,59,2,0,1,2
Modoc,2020-08-10,0,0,41,0,0,0,0
Sutter,2020-08-10,0,0,0,0,0,0,0
Lassen,2020-08-10,0,0,25,0,0,0,0
Madera,2020-08-10,38,15,274,9,3,5,53
Butte,2020-08-10,19,0,451,8,0,4,19
Contra Costa,2020-08-10,99,30,1427,36,4,50,129
Sacramento,2020-08-10,265,48,2466,81,8,93,313
Tuolumne,2020-08-10,1,0,84,0,0,0,1
Solano,2020-08-10,38,15,528,18,2,5,53
Yolo,2020-08-10,8,0,96,5,0,4,8
Santa Cruz,2020-08-10,14,7,276,5,1,12,21
San Benito,2020-08-10,6,0,25,1,0,3,6
Sutter,2020-08-11,0,0,0,0,0,0,0
Nevada,2020-08-11,2,2,90,0,1,7,4
Amador,2020-08-11,7,2,51,2,0,1,9
San Joaquin,2020-08-11,165,16,1012,54,2,26,181
Placer,2020-08-11,67,24,741,14,3,31,91
Colusa,2020-08-11,5,2,48,0,0,0,7
Calaveras,2020-08-11,3,0,33,2,0,5,3
Butte,2020-08-11,18,0,451,10,0,5,18
Marin,2020-08-11,14,0,321,4,0,11,14
Fresno,2020-08-11,273,31,1551,56,1,8,304
Kings,2020-08-11,59,0,193,5,0,12,59
Los Angeles,2020-08-11,1481,470,19342,481,66,871,1951
Trinity,2020-08-11,0,0,25,0,0,0,0
Kern,2020-08-11,204,11,1282,73,1,29,215
San Diego,2020-08-11,263,73,6146,99,20,325,336
Napa,2020-08-11,8,0,359,4,0,19,8
San Francisco,2020-08-11,88,14,1745,31,6,63,102
Sacramento,2020-08-11,260,31,2495,83,4,94,291
Riverside,2020-08-11,335,101,3358,106,14,114,436
Lassen,2020-08-11,0,0,25,0,0,0,0
Merced,2020-08-11,44,1,254,14,0,5,45
Mono,2020-08-11,1,0,17,1,0,1,1
San Luis Obispo,2020-08-11,17,4,451,4,0,21,21
Sonoma,2020-08-11,43,10,503,12,0,4,53
San Benito,2020-08-11,5,0,25,1,0,1,5
San Mateo,2020-08-11,47,14,685,11,1,27,61
Shasta,2020-08-11,2,2,427,2,0,8,4
Orange,2020-08-11,440,66,5709,141,11,230,506
Alameda,2020-08-11,170,53,2362,59,7,90,223
Siskiyou,2020-08-11,0,0,56,0,0,5,0
San Bernardino,2020-08-11,472,56,3903,162,11,139,528
Inyo,2020-08-11,1,2,29,0,0,3,3
Humboldt,2020-08-11,2,3,268,0,0,3,5
Mariposa,2020-08-11,0,0,19,0,0,0,0
Santa Barbara,2020-08-11,75,14,666,26,5,40,89
Tulare,2020-08-11,86,8,714,11,1,11,94
Contra Costa,2020-08-11,95,27,1449,34,3,47,122
Modoc,2020-08-11,0,0,41,0,0,0,0
Plumas,2020-08-11,0,1,35,0,0,0,1
Mendocino,2020-08-11,14,0,150,3,0,6,14
Yolo,2020-08-11,9,0,96,3,0,5,9
Monterey,2020-08-11,54,5,710,16,1,19,59
Santa Clara,2020-08-11,170,25,3051,49,3,115,195
Stanislaus,2020-08-11,197,65,1249,51,4,15,262
El Dorado,2020-08-11,2,0,189,2,0,6,2
Tuolumne,2020-08-11,1,0,84,0,0,1,1
Yuba,2020-08-11,26,0,265,6,0,7,26
Lake,2020-08-11,0,2,65,0,0,6,2
Tehama,2020-08-11,2,2,59,0,2,2,4
Madera,2020-08-11,44,11,274,8,1,7,55
Ventura,2020-08-11,79,34,1309,25,4,46,113
Santa Cruz,2020-08-11,13,8,277,5,0,11,21
Del Norte,2020-08-11,2,1,52,1,0,1,3
Glenn,2020-08-11,0,2,47,0,0,0,2
Imperial,2020-08-11,36,1,261,12,0,14,37
Solano,2020-08-11,41,11,552,16,2,5,52
Sutter,2020-08-12,0,0,0,0,0,0,0
San Francisco,2020-08-12,92,21,1804,31,4,53,113
Colusa,2020-08-12,5,2,48,0,0,0,7
Madera,2020-08-12,37,9,274,6,0,7,46
Yuba,2020-08-12,26,1,265,6,0,8,27
Lake,2020-08-12,0,1,65,0,0,2,1
San Diego,2020-08-12,244,76,6163,98,18,298,320
Orange,2020-08-12,438,42,5738,143,6,211,480
San Joaquin,2020-08-12,155,17,1015,50,2,27,172
San Mateo,2020-08-12,49,14,684,11,1,25,63
Riverside,2020-08-12,307,84,3370,94,12,117,391
Trinity,2020-08-12,0,0,25,0,0,0,0
San Bernardino,2020-08-12,468,81,3962,159,12,137,549
Butte,2020-08-12,18,0,451,11,0,2,18
Santa Cruz,2020-08-12,12,12,276,3,1,11,24
Kern,2020-08-12,187,15,1286,75,2,31,202
Tuolumne,2020-08-12,2,0,84,0,0,4,2
Marin,2020-08-12,11,4,321,4,0,8,15
Placer,2020-08-12,62,34,739,14,3,28,96
Mendocino,2020-08-12,16,0,150,4,0,4,16
Tehama,2020-08-12,2,0,59,2,0,1,2
Alameda,2020-08-12,172,46,2371,57,3,77,218
Lassen,2020-08-12,0,0,25,0,0,0,0
Glenn,2020-08-12,0,2,47,0,0,0,2
Shasta,2020-08-12,4,0,438,2,0,3,4
Stanislaus,2020-08-12,186,48,1250,50,4,19,234
Los Angeles,2020-08-12,1415,472,19364,460,56,842,1887
Humboldt,2020-08-12,3,2,266,1,1,4,5
Modoc,2020-08-12,0,0,41,0,0,0,0
Inyo,2020-08-12,1,2,29,1,0,3,3
Siskiyou,2020-08-12,0,1,56,0,0,3,1
Imperial,2020-08-12,41,0,259,15,0,10,41
Napa,2020-08-12,6,0,351,3,0,24,6
Kings,2020-08-12,51,0,193,6,0,9,51
Contra Costa,2020-08-12,100,28,1452,36,7,41,128
Santa Barbara,2020-08-12,73,6,666,26,1,42,79
Mariposa,2020-08-12,0,0,19,0,0,0,0
Amador,2020-08-12,5,0,51,2,0,2,5
Fresno,2020-08-12,260,39,1568,57,2,9,299
Yolo,2020-08-12,8,0,96,6,0,4,8
Merced,2020-08-12,43,1,253,12,1,5,44
El Dorado,2020-08-12,2,0,189,2,0,8,2
Sacramento,2020-08-12,253,38,2481,85,6,81,291
Santa Clara,2020-08-12,167,25,3079,50,1,109,192
Tulare,2020-08-12,84,6,714,8,1,11,90
San Luis Obispo,2020-08-12,17,6,451,5,0,18,23
Ventura,2020-08-12,76,29,1319,26,6,40,105
Solano,2020-08-12,37,9,555,15,1,4,46
Del Norte,2020-08-12,2,0,51,2,0,0,2
Mono,2020-08-12,1,0,17,1,0,1,1
Nevada,2020-08-12,6,1,116,3,0,7,7
Plumas,2020-08-12,0,0,35,0,0,0,0
Sonoma,2020-08-12,38,10,519,11,2,8,48
Monterey,2020-08-12,46,4,710,16,1,19,50
Calaveras,2020-08-12,2,0,33,1,0,6,2
San Benito,2020-08-12,6,0,25,2,0,0,6
Contra Costa,2020-08-13,97,15,1445,39,2,40,112
Mariposa,2020-08-13,0,0,19,0,0,0,0
San Joaquin,2020-08-13,145,14,1013,52,3,30,159
Trinity,2020-08-13,0,0,25,0,0,0,0
Butte,2020-08-13,21,0,451,10,0,2,21
Madera,2020-08-13,31,9,274,5,0,10,40
Stanislaus,2020-08-13,197,65,1318,57,8,9,262
Santa Clara,2020-08-13,171,20,3135,57,2,98,191
Sutter,2020-08-13,0,0,0,0,0,0,0
Monterey,2020-08-13,54,3,729,18,0,21,57
Humboldt,2020-08-13,2,4,268,1,1,6,6
Glenn,2020-08-13,0,2,47,0,0,0,2
Mono,2020-08-13,1,0,17,1,0,0,1
San Francisco,2020-08-13,97,13,1777,33,1,59,110
Inyo,2020-08-13,4,1,29,2,0,2,5
Nevada,2020-08-13,3,2,116,0,0,4,5
San Bernardino,2020-08-13,481,70,3947,155,7,152,551
Alameda,2020-08-13,165,40,2359,61,4,89,205
San Diego,2020-08-13,244,65,6389,93,19,309,309
Fresno,2020-08-13,250,37,1583,54,2,9,287
Kern,2020-08-13,172,16,1308,78,2,37,188
Mendocino,2020-08-13,15,0,150,4,0,8,15
Solano,2020-08-13,41,8,551,16,0,5,49
Shasta,2020-08-13,6,0,438,1,0,2,6
Imperial,2020-08-13,35,0,259,13,0,14,35
Tehama,2020-08-13,0,0,59,0,0,5,0
Riverside,2020-08-13,314,89,4371,91,12,117,403
Marin,2020-08-13,9,1,326,4,1,9,10
Lake,2020-08-13,0,0,65,0,0,3,0
Santa Cruz,2020-08-13,11,12,276,2,1,12,23
Merced,2020-08-13,44,1,253,13,0,4,45
Kings,2020-08-13,49,2,193,6,0,10,51
Amador,2020-08-13,7,0,51,2,0,3,7
Los Angeles,2020-08-13,1393,520,19575,456,72,977,1913
Santa Barbara,2020-08-13,68,4,666,22,1,43,72
Yolo,2020-08-13,5,0,96,4,0,5,5
Siskiyou,2020-08-13,0,1,56,0,0,3,1
Napa,2020-08-13,6,0,359,3,0,20,6
San Mateo,2020-08-13,49,17,699,14,2,27,66
Lassen,2020-08-13,0,0,25,0,0,0,0
El Dorado,2020-08-13,2,0,189,2,0,7,2
Plumas,2020-08-13,0,0,35,0,0,0,0
Ventura,2020-08-13,75,30,1321,28,7,48,105
Tuolumne,2020-08-13,2,0,84,0,0,1,2
Calaveras,2020-08-13,12,1,312,3,0,26,13
Modoc,2020-08-13,0,0,41,0,0,0,0
Del Norte,2020-08-13,1,0,51,1,0,1,1
San Benito,2020-08-13,8,0,25,2,0,1,8
Sonoma,2020-08-13,42,4,504,11,0,7,46
Tulare,2020-08-13,86,4,682,8,1,13,90
Sacramento,2020-08-13,240,29,2556,87,5,97,269
Placer,2020-08-13,53,23,736,13,2,28,76
Colusa,2020-08-13,5,0,48,0,0,0,5
Orange,2020-08-13,436,50,5713,152,11,225,486
Yuba,2020-08-13,25,0,265,5,0,7,25
San Luis Obispo,2020-08-13,15,3,451,5,0,20,18
Del Norte,2020-08-14,0,4,52,0,1,1,4
Stanislaus,2020-08-14,192,51,1308,55,8,13,243
Humboldt,2020-08-14,2,4,268,1,1,6,6
Shasta,2020-08-14,7,0,447,2,0,4,7
Calaveras,2020-08-14,3,1,33,2,0,5,4
El Dorado,2020-08-14,1,0,189,1,0,10,1
Merced,2020-08-14,41,3,253,13,1,6,44
Trinity,2020-08-14,0,0,25,0,0,0,0
Santa Barbara,2020-08-14,63,4,666,21,1,46,67
San Joaquin,2020-08-14,149,17,1012,54,4,25,166
Santa Cruz,2020-08-14,9,12,276,2,0,10,21
Inyo,2020-08-14,4,0,29,1,0,4,4
Sutter,2020-08-14,0,0,0,0,0,0,0
Placer,2020-08-14,53,22,740,12,2,28,75
Amador,2020-08-14,7,1,51,1,0,4,8
Kern,2020-08-14,172,14,1305,75,1,24,186
Contra Costa,2020-08-14,93,23,1442,37,2,51,116
San Francisco,2020-08-14,94,13,1820,34,1,62,107
Nevada,2020-08-14,2,0,115,0,0,4,2
Butte,2020-08-14,20,0,451,10,0,1,20
Plumas,2020-08-14,0,0,35,0,0,0,0
Mono,2020-08-14,1,0,17,1,0,0,1
Colusa,2020-08-14,5,1,48,0,0,0,6
Tehama,2020-08-14,1,0,59,1,0,2,1
San Diego,2020-08-14,227,73,6548,90,13,334,300
Alameda,2020-08-14,172,38,2358,61,7,92,210
Imperial,2020-08-14,36,1,259,12,0,13,37
Lake,2020-08-14,0,0,65,0,0,4,0
Tulare,2020-08-14,77,5,682,10,0,13,82
Tuolumne,2020-08-14,2,1,84,0,1,1,3
Sacramento,2020-08-14,249,31,2537,85,4,95,280
San Benito,2020-08-14,9,0,25,2,0,1,9
Santa Clara,2020-08-14,164,16,3139,57,3,95,180
Marin,2020-08-14,13,6,329,4,1,13,19
Madera,2020-08-14,30,17,274,6,3,5,47
San Luis Obispo,2020-08-14,17,3,451,5,0,22,20
Napa,2020-08-14,5,3,359,3,0,19,8
Fresno,2020-08-14,249,23,1595,55,2,11,272
Ventura,2020-08-14,78,22,1321,29,5,52,100
Monterey,2020-08-14,48,2,729,17,0,16,50
Yolo,2020-08-14,4,0,96,2,0,4,4
Sonoma,2020-08-14,45,9,564,13,2,6,54
Los Angeles,2020-08-14,1357,556,19573,441,75,865,1913
Glenn,2020-08-14,0,2,47,0,0,0,2
Modoc,2020-08-14,0,0,41,0,0,0,0
Orange,2020-08-14,434,60,5616,138,12,221,494
Yuba,2020-08-14,27,1,265,5,0,8,28
Solano,2020-08-14,49,6,564,18,1,5,55
Lassen,2020-08-14,0,1,25,0,0,0,1
Mendocino,2020-08-14,13,0,150,4,0,7,13
Siskiyou,2020-08-14,0,1,56,0,0,4,1
San Mateo,2020-08-14,58,10,697,15,2,28,68
San Bernardino,2020-08-14,475,61,3769,145,13,141,536
Kings,2020-08-14,40,2,193,5,0,12,42
Riverside,2020-08-14,315,95,3365,86,15,108,410
Mariposa,2020-08-14,0,0,19,0,0,0,0
Humboldt,2020-08-15,2,6,263,1,1,7,8
Tehama,2020-08-15,1,0,59,1,0,4,1
Sacramento,2020-08-15,249,45,2532,83,7,102,294
Plumas,2020-08-15,0,0,35,0,0,0,0
Mendocino,2020-08-15,10,1,150,4,0,5,11
Mono,2020-08-15,1,0,17,0,0,1,1
San Diego,2020-08-15,221,52,6625,83,9,324,273
Tuolumne,2020-08-15,2,1,84,0,1,2,3
Tulare,2020-08-15,68,3,667,10,0,7,71
Napa,2020-08-15,6,4,359,4,0,18,10
Inyo,2020-08-15,3,0,29,0,0,4,3
Colusa,2020-08-15,2,0,48,0,0,0,2
Shasta,2020-08-15,9,0,561,3,0,8,9
Calaveras,2020-08-15,2,0,33,1,0,5,2
Orange,2020-08-15,422,73,5800,133,13,220,495
Kern,2020-08-15,175,11,1307,71,0,27,186
San Mateo,2020-08-15,57,17,677,15,0,30,74
Del Norte,2020-08-15,0,1,52,0,0,3,1
Nevada,2020-08-15,2,0,115,0,0,1,2
Stanislaus,2020-08-15,198,49,1308,60,5,12,247
Merced,2020-08-15,34,0,253,13,0,8,34
Siskiyou,2020-08-15,0,0,56,0,0,0,0
San Francisco,2020-08-15,94,24,1782,40,5,51,118
Glenn,2020-08-15,0,2,47,0,0,0,2
Sonoma,2020-08-15,48,3,557,14,0,4,51
Los Angeles,2020-08-15,1341,573,19553,442,85,837,1914
Modoc,2020-08-15,0,0,41,0,0,0,0
Yolo,2020-08-15,4,0,96,2,0,3,4
Amador,2020-08-15,7,0,51,1,0,4,7
Madera,2020-08-15,28,26,274,7,1,6,54
San Luis Obispo,2020-08-15,18,3,451,6,0,23,21
Santa Barbara,2020-08-15,62,4,666,22,0,46,66
Santa Cruz,2020-08-15,9,9,276,3,0,10,18
Monterey,2020-08-15,52,1,729,16,0,23,53
San Joaquin,2020-08-15,140,24,1014,48,5,34,164
El Dorado,2020-08-15,2,0,189,2,0,11,2
Mariposa,2020-08-15,0,0,19,0,0,0,0
Kings,2020-08-15,42,3,193,5,0,11,45
Riverside,2020-08-15,302,82,3325,94,11,100,384
Placer,2020-08-15,58,22,742,14,5,34,80
Alameda,2020-08-15,181,48,2381,65,12,88,229
Contra Costa,2020-08-15,95,24,1450,36,7,46,119
Butte,2020-08-15,20,0,451,10,0,5,20
Santa Clara,2020-08-15,170,8,3117,56,1,95,178
Lassen,2020-08-15,0,1,25,0,0,0,1
Yuba,2020-08-15,27,0,265,5,0,9,27
Sutter,2020-08-15,0,0,0,0,0,0,0
Lake,2020-08-15,0,1,66,0,0,4,1
Marin,2020-08-15,15,4,330,4,2,9,19
Fresno,2020-08-15,245,30,1549,54,5,16,275
Ventura,2020-08-15,71,27,1308,25,8,47,98
San Bernardino,2020-08-15,445,96,3781,134,18,148,541
Imperial,2020-08-15,36,1,259,12,0,14,37
San Benito,2020-08-15,9,0,25,2,0,1,9
Trinity,2020-08-15,0,0,25,0,0,0,0
Solano,2020-08-15,42,3,567,18,0,9,45
Butte,2020-08-16,21,0,451,9,0,4,21
Shasta,2020-08-16,9,0,561,3,0,7,9
Kern,2020-08-16,171,10,1289,70,0,25,181
Inyo,2020-08-16,3,0,29,0,0,4,3
San Francisco,2020-08-16,85,23,1740,34,4,62,108
Glenn,2020-08-16,0,2,47,0,0,0,2
El Dorado,2020-08-16,2,0,189,2,0,8,2
Marin,2020-08-16,13,5,331,4,2,9,18
Sonoma,2020-08-16,47,8,552,13,1,2,55
Santa Cruz,2020-08-16,10,12,276,3,1,13,22
Trinity,2020-08-16,0,0,25,0,0,0,0
Plumas,2020-08-16,0,0,35,0,0,0,0
Fresno,2020-08-16,235,39,1573,56,3,11,274
Humboldt,2020-08-16,2,4,259,1,1,7,6
Kings,2020-08-16,45,0,193,7,0,9,45
San Mateo,2020-08-16,58,13,670,16,0,27,71
Madera,2020-08-16,31,19,274,9,0,5,50
Siskiyou,2020-08-16,0,0,56,0,0,4,0
San Bernardino,2020-08-16,437,90,3764,130,18,149,527
Ventura,2020-08-16,71,28,1306,23,8,51,99
Mariposa,2020-08-16,0,0,19,0,0,0,0
Imperial,2020-08-16,35,1,259,14,0,8,36
San Luis Obispo,2020-08-16,22,3,451,7,0,21,25
Amador,2020-08-16,7,0,51,2,0,3,7
Lassen,2020-08-16,0,0,25,0,0,0,0
Merced,2020-08-16,0,36,253,0,12,5,36
Modoc,2020-08-16,0,0,41,0,0,0,0
Contra Costa,2020-08-16,98,31,1463,36,6,41,129
Tehama,2020-08-16,1,0,59,1,0,5,1
Monterey,2020-08-16,54,2,729,16,0,21,56
Calaveras,2020-08-16,2,1,33,1,1,6,3
Alameda,2020-08-16,188,56,2371,63,10,93,244
Riverside,2020-08-16,296,97,3340,90,14,92,393
Placer,2020-08-16,63,20,738,14,2,31,83
Napa,2020-08-16,8,0,359,2,0,17,8
Tuolumne,2020-08-16,1,2,84,0,1,2,3
Yuba,2020-08-16,27,1,265,4,0,9,28
Mono,2020-08-16,0,0,17,0,0,1,0
Colusa,2020-08-16,2,1,48,0,0,0,3
San Diego,2020-08-16,216,74,6615,93,12,324,290
Yolo,2020-08-16,5,0,96,3,0,5,5
Sacramento,2020-08-16,251,48,2598,80,8,99,299
Nevada,2020-08-16,1,1,108,0,0,4,2
Orange,2020-08-16,414,64,5716,132,17,209,478
Lake,2020-08-16,0,1,65,0,1,2,1
Mendocino,2020-08-16,9,0,150,4,0,8,9
Sutter,2020-08-16,0,0,0,0,0,0,0
Tulare,2020-08-16,68,2,667,9,0,14,70
Santa Barbara,2020-08-16,59,1,666,22,1,52,60
San Joaquin,2020-08-16,146,26,1007,50,6,36,172
San Benito,2020-08-16,9,0,25,1,0,2,9
Solano,2020-08-16,40,6,570,16,1,7,46
Santa Clara,2020-08-16,173,11,3074,53,2,99,184
Stanislaus,2020-08-16,188,63,1306,60,5,15,251
Los Angeles,2020-08-16,1352,555,19678,436,85,881,1907
Del Norte,2020-08-16,0,1,51,0,0,3,1
Inyo,2020-08-17,4,0,30,0,0,4,4
Santa Cruz,2020-08-17,12,15,276,3,1,14,27
Alameda,2020-08-17,205,52,2335,69,10,82,257
Glenn,2020-08-17,0,2,47,0,0,0,2
Lake,2020-08-17,0,1,65,0,0,1,1
Santa Barbara,2020-08-17,59,3,666,21,0,55,62
San Bernardino,2020-08-17,441,80,3851,130,16,138,521
Stanislaus,2020-08-17,196,65,1300,59,3,13,261
Madera,2020-08-17,25,13,274,6,2,7,38
Merced,2020-08-17,33,1,253,11,0,7,34
Imperial,2020-08-17,36,1,259,13,0,14,37
Butte,2020-08-17,22,0,451,9,0,5,22
Riverside,2020-08-17,300,100,3304,89,15,91,400
Kern,2020-08-17,170,13,1297,70,0,31,183
Sutter,2020-08-17,0,0,0,0,0,0,0
Kings,2020-08-17,44,1,193,6,0,10,45
Calaveras,2020-08-17,2,1,33,1,1,5,3
Fresno,2020-08-17,235,40,1593,59,4,11,275
Siskiyou,2020-08-17,0,0,56,0,0,2,0
Solano,2020-08-17,39,6,560,19,1,6,45
Lassen,2020-08-17,0,0,25,0,0,0,0
San Luis Obispo,2020-08-17,20,3,451,6,0,25,23
San Mateo,2020-08-17,57,14,681,15,1,22,71
Yolo,2020-08-17,6,0,96,5,0,5,6
Nevada,2020-08-17,1,2,127,0,0,7,3
Trinity,2020-08-17,0,0,25,0,0,0,0
Tehama,2020-08-17,1,0,59,1,0,7,1
Placer,2020-08-17,65,25,732,11,2,30,90
Colusa,2020-08-17,2,0,48,0,0,0,2
Santa Clara,2020-08-17,170,18,3060,51,1,123,188
Contra Costa,2020-08-17,97,29,1456,34,7,43,126
Tuolumne,2020-08-17,1,0,84,0,0,3,1
Modoc,2020-08-17,0,0,41,0,0,0,0
San Francisco,2020-08-17,83,26,1740,35,4,71,109
Del Norte,2020-08-17,0,0,51,0,0,3,0
Mariposa,2020-08-17,0,0,19,0,0,0,0
Napa,2020-08-17,6,0,359,4,0,22,6
Humboldt,2020-08-17,2,2,274,1,0,6,4
Sacramento,2020-08-17,250,44,2533,81,7,110,294
Los Angeles,2020-08-17,1378,518,19489,435,69,854,1896
El Dorado,2020-08-17,0,0,189,0,0,8,0
Mono,2020-08-17,0,0,17,0,0,2,0
Ventura,2020-08-17,70,26,1298,25,6,47,96
Plumas,2020-08-17,0,0,35,0,0,0,0
San Joaquin,2020-08-17,144,25,1013,51,4,30,169
Monterey,2020-08-17,62,1,729,19,0,23,63
San Benito,2020-08-17,9,0,25,1,0,2,9
Mendocino,2020-08-17,9,0,150,4,0,7,9
Tulare,2020-08-17,68,3,682,12,0,17,71
Marin,2020-08-17,13,4,324,6,2,8,17
Amador,2020-08-17,7,0,51,2,0,2,7
Sonoma,2020-08-17,44,8,507,12,4,5,52
Yuba,2020-08-17,27,1,265,5,0,10,28
Orange,2020-08-17,409,82,5727,124,12,225,491
Shasta,2020-08-17,8,0,569,4,0,6,8
San Diego,2020-08-17,229,74,6618,97,23,335,303
Monterey,2020-08-18,58,1,729,20,0,17,59
Santa Clara,2020-08-18,173,11,3101,54,1,108,184
Lassen,2020-08-18,0,0,25,0,0,0,0
Amador,2020-08-18,6,0,51,1,0,2,6
Contra Costa,2020-08-18,96,34,1473,28,5,47,130
Butte,2020-08-18,24,0,451,8,0,0,24
San Luis Obispo,2020-08-18,15,2,451,5,0,21,17
Mendocino,2020-08-18,9,0,150,4,0,8,9
Riverside,2020-08-18,301,108,3389,97,13,84,409
Merced,2020-08-18,36,3,254,12,1,7,39
Shasta,2020-08-18,6,0,561,4,0,5,6
Humboldt,2020-08-18,0,7,261,0,2,3,7
Santa Cruz,2020-08-18,10,10,276,2,0,16,20
Yuba,2020-08-18,26,0,265,4,0,11,26
Modoc,2020-08-18,0,0,41,0,0,0,0
Alameda,2020-08-18,200,50,2375,70,5,92,250
Sonoma,2020-08-18,43,5,514,11,1,5,48
Del Norte,2020-08-18,0,0,51,0,0,3,0
Madera,2020-08-18,29,11,274,7,0,5,40
Imperial,2020-08-18,35,0,259,13,0,5,35
Calaveras,2020-08-18,3,2,33,2,1,3,5
Plumas,2020-08-18,0,0,35,0,0,0,0
Orange,2020-08-18,419,76,5733,124,14,215,495
San Bernardino,2020-08-18,440,89,3870,125,12,148,529
Glenn,2020-08-18,0,2,47,0,0,0,2
San Diego,2020-08-18,238,87,6637,85,20,305,325
Sacramento,2020-08-18,248,57,2582,81,7,104,305
San Benito,2020-08-18,10,1,25,2,0,1,11
Tuolumne,2020-08-18,1,0,84,0,0,3,1
San Mateo,2020-08-18,53,15,696,14,1,26,68
Stanislaus,2020-08-18,183,58,1306,58,5,8,241
Los Angeles,2020-08-18,1378,591,19641,433,55,864,1969
Mariposa,2020-08-18,0,0,19,0,0,0,0
El Dorado,2020-08-18,1,0,189,1,0,11,1
San Francisco,2020-08-18,96,36,1766,37,5,51,132
Marin,2020-08-18,13,6,324,4,2,7,19
Siskiyou,2020-08-18,0,0,56,0,0,4,0
Trinity,2020-08-18,0,0,25,0,0,0,0
Mono,2020-08-18,0,0,17,0,0,2,0
Tulare,2020-08-18,59,4,682,12,0,17,63
Sutter,2020-08-18,0,0,0,0,0,0,0
Lake,2020-08-18,0,2,65,0,0,5,2
Kings,2020-08-18,41,2,193,5,1,9,43
Yolo,2020-08-18,7,1,96,3,1,4,8
Placer,2020-08-18,64,34,736,11,3,30,98
Colusa,2020-08-18,2,1,48,0,0,0,3
Nevada,2020-08-18,0,2,108,0,0,2,2
Solano,2020-08-18,43,6,565,17,0,7,49
Ventura,2020-08-18,79,37,1308,27,8,52,116
San Joaquin,2020-08-18,150,22,1012,54,4,22,172
Tehama,2020-08-18,1,0,59,1,0,6,1
Fresno,2020-08-18,233,27,1578,62,1,11,260
Inyo,2020-08-18,3,2,29,0,0,4,5
Santa Barbara,2020-08-18,62,8,666,22,3,50,70
Napa,2020-08-18,6,0,359,2,0,25,6
Kern,2020-08-18,158,11,1298,68,0,42,169
San Bernardino,2020-08-19,418,82,3862,123,7,146,500
San Mateo,2020-08-19,53,7,691,13,0,30,60
Nevada,2020-08-19,0,1,135,0,0,3,1
Los Angeles,2020-08-19,1347,551,19790,428,53,852,1898
Madera,2020-08-19,27,9,274,8,0,5,36
Mono,2020-08-19,0,0,17,0,0,2,0
Contra Costa,2020-08-19,93,24,1476,26,3,42,117
Lassen,2020-08-19,0,0,25,0,0,0,0
Santa Clara,2020-08-19,164,20,3130,46,2,112,184
Kern,2020-08-19,167,12,1319,66,0,39,179
Glenn,2020-08-19,0,2,47,0,0,0,2
Ventura,2020-08-19,77,48,1317,31,9,49,125
Mariposa,2020-08-19,0,0,19,0,0,0,0
Orange,2020-08-19,400,59,5788,118,8,223,459
Modoc,2020-08-19,0,0,41,0,0,0,0
Mendocino,2020-08-19,6,0,150,3,0,7,6
Yuba,2020-08-19,26,0,265,4,0,10,26
Sutter,2020-08-19,0,0,0,0,0,0,0
Kings,2020-08-19,40,2,193,7,1,7,42
El Dorado,2020-08-19,1,0,189,1,0,9,1
Solano,2020-08-19,41,5,577,18,0,6,46
Calaveras,2020-08-19,3,1,33,2,0,5,4
Sonoma,2020-08-19,40,6,526,10,1,7,46
Monterey,2020-08-19,51,0,729,18,0,16,51
San Benito,2020-08-19,9,0,25,1,0,2,9
Placer,2020-08-19,61,33,744,9,2,28,94
Siskiyou,2020-08-19,0,0,56,0,0,4,0
Trinity,2020-08-19,0,0,25,0,0,0,0
Tulare,2020-08-19,60,3,682,12,0,15,63
Riverside,2020-08-19,267,121,6028,90,18,89,388
Shasta,2020-08-19,6,0,561,4,0,7,6
San Joaquin,2020-08-19,149,25,1013,54,3,28,174
Butte,2020-08-19,23,0,451,7,0,8,23
Yolo,2020-08-19,7,0,96,3,0,3,7
Colusa,2020-08-19,2,2,48,0,0,0,4
Santa Barbara,2020-08-19,54,7,666,20,3,51,61
Tuolumne,2020-08-19,1,0,84,0,0,3,1
San Diego,2020-08-19,232,48,6742,91,13,283,280
Del Norte,2020-08-19,0,0,51,0,0,5,0
Imperial,2020-08-19,28,0,259,11,0,11,28
San Luis Obispo,2020-08-19,15,4,451,5,0,19,19
Tehama,2020-08-19,2,0,59,2,0,4,2
Napa,2020-08-19,5,1,359,3,1,19,6
Humboldt,2020-08-19,0,2,267,0,0,4,2
Lake,2020-08-19,1,0,65,1,0,5,1
Inyo,2020-08-19,2,2,29,0,0,4,4
Stanislaus,2020-08-19,177,45,1308,57,5,13,222
San Francisco,2020-08-19,95,38,1864,39,6,47,133
Alameda,2020-08-19,202,56,2410,68,4,95,258
Merced,2020-08-19,36,3,253,13,1,5,39
Sacramento,2020-08-19,229,57,2553,77,7,112,286
Amador,2020-08-19,4,0,51,0,0,1,4
Fresno,2020-08-19,245,28,1592,61,3,15,273
Marin,2020-08-19,12,5,324,5,0,6,17
Plumas,2020-08-19,0,0,35,0,0,0,0
Santa Cruz,2020-08-19,12,13,276,2,0,11,25
Amador,2020-08-20,4,0,51,0,0,0,4
Del Norte,2020-08-20,0,3,51,0,2,2,3
Lassen,2020-08-20,0,0,25,0,0,0,0
Tulare,2020-08-20,63,3,715,13,0,14,66
Alameda,2020-08-20,204,50,2438,73,4,91,254
Inyo,2020-08-20,2,0,29,0,0,4,2
Contra Costa,2020-08-20,91,29,1478,25,3,47,120
Orange,2020-08-20,397,46,5738,117,9,211,443
Modoc,2020-08-20,0,0,41,0,0,0,0
Trinity,2020-08-20,0,0,25,0,0,0,0
Riverside,2020-08-20,252,123,3414,81,21,105,375
Kings,2020-08-20,43,1,193,9,0,5,44
Madera,2020-08-20,27,11,274,7,1,6,38
Yuba,2020-08-20,25,0,265,4,0,9,25
Lake,2020-08-20,0,0,65,0,0,4,0
Humboldt,2020-08-20,0,2,267,0,0,4,2
Sonoma,2020-08-20,40,6,571,10,0,4,46
San Joaquin,2020-08-20,141,37,1011,48,3,28,178
Butte,2020-08-20,25,0,451,5,0,5,25
Yolo,2020-08-20,10,0,96,9,0,4,10
Santa Clara,2020-08-20,155,30,3110,46,5,101,185
San Luis Obispo,2020-08-20,17,2,451,5,0,19,19
Shasta,2020-08-20,5,0,561,4,0,7,5
San Benito,2020-08-20,8,0,25,1,0,2,8
Mariposa,2020-08-20,1,0,19,0,0,0,1
San Francisco,2020-08-20,106,19,1867,41,3,53,125
Mendocino,2020-08-20,5,0,150,2,0,6,5
Marin,2020-08-20,11,8,324,5,2,7,19
Solano,2020-08-20,43,5,567,18,1,4,48
Imperial,2020-08-20,29,0,259,13,0,6,29
Monterey,2020-08-20,45,1,729,15,0,22,46
Santa Barbara,2020-08-20,54,9,666,18,1,51,63
Tuolumne,2020-08-20,1,0,84,0,0,2,1
San Diego,2020-08-20,220,64,6642,89,12,302,284
Los Angeles,2020-08-20,1280,509,19794,420,58,823,1789
Sutter,2020-08-20,0,0,0,0,0,0,0
Kern,2020-08-20,171,12,1308,61,1,38,183
San Bernardino,2020-08-20,386,75,3878,116,11,137,461
El Dorado,2020-08-20,2,1,189,2,1,8,3
Siskiyou,2020-08-20,0,0,56,0,0,4,0
Sacramento,2020-08-20,232,46,2516,77,7,92,278
Fresno,2020-08-20,246,27,1578,60,3,14,273
Placer,2020-08-20,64,28,744,11,2,31,92
Santa Cruz,2020-08-20,12,6,276,1,1,10,18
Colusa,2020-08-20,3,2,48,0,0,0,5
Plumas,2020-08-20,0,0,35,0,0,0,0
Mono,2020-08-20,0,0,17,0,0,2,0
Stanislaus,2020-08-20,180,40,1309,58,4,15,220
Glenn,2020-08-20,0,2,47,0,0,0,2
Calaveras,2020-08-20,4,1,33,1,1,3,5
Ventura,2020-08-20,73,57,1318,30,15,42,130
San Mateo,2020-08-20,56,9,701,19,1,26,65
Tehama,2020-08-20,2,0,59,2,0,3,2
Nevada,2020-08-20,2,1,123,0,0,2,3
Napa,2020-08-20,2,1,208,2,0,15,3
Merced,2020-08-20,33,1,253,15,1,4,34
Stanislaus,2020-08-21,178,56,1308,54,6,14,234
Del Norte,2020-08-21,0,3,51,0,2,2,3
Contra Costa,2020-08-21,100,16,1482,27,1,57,116
Modoc,2020-08-21,0,0,41,0,0,0,0
Trinity,2020-08-21,0,0,25,0,0,0,0
Lake,2020-08-21,0,2,65,0,0,2,2
Amador,2020-08-21,4,0,51,0,0,0,4
Tuolumne,2020-08-21,1,1,84,0,0,3,2
Solano,2020-08-21,42,4,556,15,0,9,46
Sacramento,2020-08-21,224,45,2501,72,7,90,269
Alameda,2020-08-21,207,53,2459,69,8,82,260
Plumas,2020-08-21,0,0,35,0,0,0,0
Placer,2020-08-21,53,24,741,13,3,29,77
San Joaquin,2020-08-21,140,24,1011,51,5,26,164
Merced,2020-08-21,33,0,253,13,0,6,33
Kern,2020-08-21,152,11,1289,58,1,33,163
Calaveras,2020-08-21,4,2,33,1,1,4,6
Sonoma,2020-08-21,39,5,522,9,0,6,44
San Mateo,2020-08-21,58,8,689,21,0,28,66
Riverside,2020-08-21,247,105,3381,84,13,94,352
Butte,2020-08-21,19,0,451,5,0,8,19
Siskiyou,2020-08-21,0,0,56,0,0,5,0
Monterey,2020-08-21,49,1,729,15,0,22,50
El Dorado,2020-08-21,2,1,189,1,0,11,3
Santa Cruz,2020-08-21,11,7,276,1,3,15,18
San Francisco,2020-08-21,98,20,1856,34,3,59,118
San Diego,2020-08-21,220,66,6626,91,14,282,286
Imperial,2020-08-21,29,0,259,11,0,9,29
Yolo,2020-08-21,9,1,96,8,0,4,10
Yuba,2020-08-21,26,0,265,6,0,9,26
San Bernardino,2020-08-21,365,81,3908,117,10,157,446
Santa Barbara,2020-08-21,52,7,666,21,2,46,59
San Luis Obispo,2020-08-21,15,1,451,5,0,18,16
Santa Clara,2020-08-21,155,23,3134,45,4,97,178
Humboldt,2020-08-21,1,6,249,1,1,5,7
Colusa,2020-08-21,1,3,48,0,0,0,4
Ventura,2020-08-21,74,44,1312,39,12,40,118
San Benito,2020-08-21,8,0,25,2,0,1,8
Inyo,2020-08-21,1,0,29,0,0,4,1
Tulare,2020-08-21,58,3,715,11,0,17,61
Madera,2020-08-21,30,12,274,9,0,5,42
Shasta,2020-08-21,5,0,561,2,0,6,5
Lassen,2020-08-21,0,0,25,0,0,0,0
Fresno,2020-08-21,246,37,1600,59,4,14,283
Mono,2020-08-21,0,0,17,0,0,2,0
Tehama,2020-08-21,1,0,59,1,0,3,1
Glenn,2020-08-21,0,2,47,0,0,0,2
Marin,2020-08-21,13,3,320,5,0,7,16
Sutter,2020-08-21,0,0,0,0,0,0,0
Mendocino,2020-08-21,5,0,150,2,0,7,5
Napa,2020-08-21,3,0,208,3,0,13,3
Orange,2020-08-21,392,56,5786,110,8,217,448
Nevada,2020-08-21,3,1,135,0,0,2,4
Kings,2020-08-21,38,1,193,10,0,4,39
Mariposa,2020-08-21,1,0,19,0,0,0,1
Los Angeles,2020-08-21,1247,479,20155,412,54,817,1726
Lassen,2020-08-22,0,0,25,0,0,0,0
Glenn,2020-08-22,0,2,47,0,0,0,2
Ventura,2020-08-22,81,36,1320,29,10,37,117
Contra Costa,2020-08-22,99,19,1470,26,2,55,118
Yuba,2020-08-22,17,1,265,4,0,8,18
Santa Cruz,2020-08-22,11,3,276,1,0,14,14
Del Norte,2020-08-22,0,2,51,0,1,2,2
Amador,2020-08-22,3,1,51,0,0,1,4
Lake,2020-08-22,0,0,65,0,0,3,0
San Joaquin,2020-08-22,135,15,1007,43,0,34,150
San Bernardino,2020-08-22,351,68,3855,109,9,157,419
Marin,2020-08-22,15,4,331,6,1,8,19
Mariposa,2020-08-22,0,0,19,0,0,0,0
San Benito,2020-08-22,7,0,25,2,0,0,7
Siskiyou,2020-08-22,0,0,56,0,0,5,0
Fresno,2020-08-22,246,29,1581,59,1,8,275
Los Angeles,2020-08-22,1219,482,19781,389,55,856,1701
San Mateo,2020-08-22,56,11,680,13,2,22,67
Inyo,2020-08-22,0,0,29,0,0,4,0
Stanislaus,2020-08-22,171,52,1307,57,2,13,223
Merced,2020-08-22,32,1,253,13,0,2,33
Kings,2020-08-22,36,3,193,8,0,5,39
Trinity,2020-08-22,0,0,25,0,0,0,0
Kern,2020-08-22,155,8,1291,57,0,39,163
San Diego,2020-08-22,222,49,6642,87,13,282,271
Santa Clara,2020-08-22,152,18,3112,43,1,101,170
Tuolumne,2020-08-22,1,0,84,0,0,3,1
Sutter,2020-08-22,0,0,0,0,0,0,0
Orange,2020-08-22,380,46,5769,111,5,203,426
Riverside,2020-08-22,233,86,3352,83,15,107,319
Mono,2020-08-22,0,0,17,0,0,2,0
Yolo,2020-08-22,6,0,96,4,0,5,6
Colusa,2020-08-22,2,0,48,0,0,0,2
Sacramento,2020-08-22,230,40,2471,69,8,104,270
Alameda,2020-08-22,196,52,2434,65,9,86,248
Tulare,2020-08-22,61,5,682,11,0,11,66
Nevada,2020-08-22,3,2,113,0,0,2,5
Placer,2020-08-22,49,19,743,15,1,30,68
Santa Barbara,2020-08-22,54,4,666,19,0,51,58
Calaveras,2020-08-22,4,2,33,2,0,5,6
Modoc,2020-08-22,0,0,41,0,0,0,0
Mendocino,2020-08-22,3,0,150,1,0,4,3
Monterey,2020-08-22,46,1,729,16,0,18,47
Madera,2020-08-22,31,6,274,6,0,6,37
Humboldt,2020-08-22,1,4,271,1,1,2,5
San Luis Obispo,2020-08-22,16,0,451,4,0,19,16
El Dorado,2020-08-22,2,0,189,1,0,11,2
Tehama,2020-08-22,1,0,59,1,0,0,1
Imperial,2020-08-22,31,0,259,13,0,10,31
Napa,2020-08-22,4,1,208,4,0,13,5
Butte,2020-08-22,24,0,451,8,0,7,24
San Francisco,2020-08-22,90,19,1837,34,2,58,109
Plumas,2020-08-22,0,0,35,0,0,0,0
Shasta,2020-08-22,7,1,561,3,1,8,8
Solano,2020-08-22,39,2,549,14,1,7,41
Sonoma,2020-08-22,39,10,512,10,1,5,49
Sacramento,2020-08-23,218,33,2402,66,7,96,251
Sutter,2020-08-23,0,0,0,0,0,0,0
Monterey,2020-08-23,42,1,729,15,0,19,43
Santa Cruz,2020-08-23,11,2,276,1,1,12,13
Modoc,2020-08-23,0,0,41,0,0,0,0
Napa,2020-08-23,5,0,208,1,0,13,5
Sonoma,2020-08-23,40,9,483,6,1,4,49
San Diego,2020-08-23,211,78,6630,84,16,302,289
Santa Barbara,2020-08-23,51,9,666,21,2,53,60
Orange,2020-08-23,388,58,5739,116,8,225,446
Ventura,2020-08-23,79,32,1315,25,11,38,111
Los Angeles,2020-08-23,1200,467,19582,375,59,892,1667
San Benito,2020-08-23,6,0,25,2,0,1,6
Merced,2020-08-23,30,1,253,13,0,1,31
San Joaquin,2020-08-23,133,27,1003,39,2,32,160
Butte,2020-08-23,21,0,451,7,0,11,21
Nevada,2020-08-23,3,2,132,0,0,4,5
Inyo,2020-08-23,0,0,29,0,0,4,0
Fresno,2020-08-23,246,27,1575,57,2,17,273
Placer,2020-08-23,47,15,733,15,1,28,62
Yolo,2020-08-23,7,0,96,5,0,6,7
Humboldt,2020-08-23,1,4,271,1,1,2,5
Solano,2020-08-23,43,2,546,15,0,5,45
Tuolumne,2020-08-23,1,0,84,0,0,6,1
San Luis Obispo,2020-08-23,15,1,451,5,1,20,16
Riverside,2020-08-23,224,116,3270,82,16,103,340
San Francisco,2020-08-23,92,17,1823,37,4,69,109
Contra Costa,2020-08-23,95,16,1450,27,2,61,111
Tulare,2020-08-23,51,6,682,12,0,15,57
Imperial,2020-08-23,33,1,259,10,0,5,34
Mariposa,2020-08-23,0,0,19,0,0,0,0
Lassen,2020-08-23,0,0,25,0,0,0,0
Calaveras,2020-08-23,5,2,33,2,0,5,7
El Dorado,2020-08-23,1,0,189,1,0,10,1
Stanislaus,2020-08-23,157,50,1303,53,3,16,207
Lake,2020-08-23,0,1,66,0,0,5,1
Alameda,2020-08-23,187,46,2419,64,6,97,233
Colusa,2020-08-23,1,0,48,0,0,0,1
Yuba,2020-08-23,18,1,265,4,0,14,19
San Mateo,2020-08-23,57,8,673,14,4,21,65
Plumas,2020-08-23,0,0,35,0,0,0,0
Shasta,2020-08-23,7,0,561,3,0,7,7
Siskiyou,2020-08-23,0,0,56,0,0,4,0
Del Norte,2020-08-23,0,0,51,0,0,2,0
Tehama,2020-08-23,1,0,59,1,0,3,1
Marin,2020-08-23,14,5,319,7,0,5,19
Madera,2020-08-23,27,17,274,9,0,4,44
Kings,2020-08-23,35,3,193,8,0,6,38
Mendocino,2020-08-23,3,0,150,1,0,5,3
Santa Clara,2020-08-23,154,15,3102,42,0,99,169
Amador,2020-08-23,3,0,51,0,0,2,3
San Bernardino,2020-08-23,356,71,3841,98,5,176,427
Mono,2020-08-23,0,0,18,0,0,1,0
Kern,2020-08-23,148,6,1296,53,0,42,154
Trinity,2020-08-23,0,0,25,0,0,0,0
Glenn,2020-08-23,0,2,47,0,0,0,2
Trinity,2020-08-24,0,0,25,0,0,0,0
Riverside,2020-08-24,222,96,3309,79,15,94,318
Butte,2020-08-24,24,0,451,8,0,10,24
Lassen,2020-08-24,0,0,25,0,0,0,0
Modoc,2020-08-24,0,0,41,0,0,0,0
Siskiyou,2020-08-24,0,0,56,0,0,4,0
Inyo,2020-08-24,0,0,29,0,0,4,0
Del Norte,2020-08-24,0,2,51,0,1,1,2
San Diego,2020-08-24,228,81,6610,83,16,302,309
San Benito,2020-08-24,7,0,25,2,0,1,7
Yuba,2020-08-24,17,1,265,3,0,18,18
Los Angeles,2020-08-24,1186,450,19226,373,53,917,1636
Fresno,2020-08-24,244,28,1590,54,0,20,272
Stanislaus,2020-08-24,161,52,1294,41,3,16,213
Tuolumne,2020-08-24,1,1,84,0,0,6,2
Merced,2020-08-24,29,1,253,12,0,2,30
Kings,2020-08-24,33,2,193,4,1,10,35
San Luis Obispo,2020-08-24,11,2,451,5,0,21,13
San Mateo,2020-08-24,61,9,683,13,1,22,70
Kern,2020-08-24,154,7,1302,56,0,40,161
Contra Costa,2020-08-24,91,19,1452,29,2,58,110
Santa Cruz,2020-08-24,11,10,276,1,1,9,21
Marin,2020-08-24,13,4,314,5,0,4,17
Mendocino,2020-08-24,2,0,150,1,0,8,2
Alameda,2020-08-24,179,48,2396,69,7,92,227
San Francisco,2020-08-24,95,22,1806,35,3,75,117
Sutter,2020-08-24,0,0,0,0,0,0,0
Humboldt,2020-08-24,1,4,271,1,1,2,5
El Dorado,2020-08-24,1,0,189,1,0,9,1
Mariposa,2020-08-24,0,0,19,0,0,0,0
Colusa,2020-08-24,1,0,48,0,0,0,1
Sonoma,2020-08-24,42,4,531,9,0,5,46
Santa Barbara,2020-08-24,54,4,666,23,1,45,58
Ventura,2020-08-24,76,25,1321,36,7,33,101
San Joaquin,2020-08-24,131,22,1003,39,4,28,153
Napa,2020-08-24,5,1,208,1,0,13,6
Mono,2020-08-24,0,0,17,0,0,2,0
Shasta,2020-08-24,7,0,561,3,0,5,7
Glenn,2020-08-24,0,2,47,0,0,0,2
Tulare,2020-08-24,49,8,686,12,0,16,57
Lake,2020-08-24,0,0,66,0,0,6,0
San Bernardino,2020-08-24,335,67,3914,109,5,184,402
Nevada,2020-08-24,3,2,127,0,0,3,5
Sacramento,2020-08-24,221,35,2458,64,3,111,256
Imperial,2020-08-24,33,0,259,9,0,4,33
Santa Clara,2020-08-24,147,16,3064,41,2,119,163
Monterey,2020-08-24,40,1,729,14,1,24,41
Placer,2020-08-24,44,28,737,15,6,27,72
Calaveras,2020-08-24,5,1,33,2,1,4,6
Madera,2020-08-24,24,6,274,7,2,8,30
Amador,2020-08-24,4,0,51,0,0,4,4
Solano,2020-08-24,39,2,538,12,1,7,41
Yolo,2020-08-24,8,0,96,4,0,8,8
Orange,2020-08-24,385,74,5748,113,15,242,459
Tehama,2020-08-24,0,0,59,0,0,4,0
Plumas,2020-08-24,0,0,35,0,0,0,0
Kern,2020-08-25,155,3,1308,58,0,41,158
Humboldt,2020-08-25,1,0,257,1,0,6,1
Tehama,2020-08-25,0,0,59,0,0,4,0
Kings,2020-08-25,34,1,193,4,0,9,35
Mono,2020-08-25,0,0,17,0,0,2,0
Ventura,2020-08-25,72,30,1318,36,6,41,102
Sacramento,2020-08-25,222,33,2475,58,4,111,255
Colusa,2020-08-25,1,3,48,0,0,0,4
Butte,2020-08-25,17,1,451,6,1,6,18
Trinity,2020-08-25,0,0,25,0,0,0,0
Napa,2020-08-25,5,1,208,1,0,13,6
San Joaquin,2020-08-25,131,22,1003,39,2,33,153
San Francisco,2020-08-25,89,19,1837,34,5,72,108
San Diego,2020-08-25,235,88,6631,84,16,273,323
Madera,2020-08-25,24,7,274,8,2,7,31
Merced,2020-08-25,25,0,253,9,0,7,25
Mariposa,2020-08-25,0,0,19,0,0,0,0
Calaveras,2020-08-25,4,4,33,3,1,4,8
Alameda,2020-08-25,179,50,2398,65,7,89,229
Marin,2020-08-25,15,4,314,3,0,6,19
Lake,2020-08-25,1,1,65,0,0,5,2
Shasta,2020-08-25,5,0,561,1,0,4,5
San Benito,2020-08-25,6,0,25,2,0,1,6
Monterey,2020-08-25,42,0,729,14,0,25,42
Tuolumne,2020-08-25,2,0,84,0,0,6,2
Lassen,2020-08-25,0,0,25,0,0,0,0
Stanislaus,2020-08-25,159,52,1294,37,5,19,211
San Luis Obispo,2020-08-25,12,1,451,5,0,18,13
Siskiyou,2020-08-25,0,0,56,0,0,5,0
San Bernardino,2020-08-25,321,59,3869,100,6,169,380
Placer,2020-08-25,41,26,737,16,4,26,67
Orange,2020-08-25,399,68,5809,113,9,194,467
Los Angeles,2020-08-25,1168,517,19881,375,49,894,1685
Contra Costa,2020-08-25,89,14,1452,32,2,51,103
Glenn,2020-08-25,0,2,47,0,0,0,2
Yuba,2020-08-25,20,0,265,4,0,14,20
Riverside,2020-08-25,225,84,3376,78,13,91,309
Fresno,2020-08-25,230,26,1593,53,1,16,256
Amador,2020-08-25,3,0,51,0,0,6,3
Inyo,2020-08-25,0,0,29,0,0,4,0
Modoc,2020-08-25,0,0,41,0,0,0,0
Plumas,2020-08-25,0,0,35,0,0,0,0
Santa Cruz,2020-08-25,8,9,276,1,0,8,17
Tulare,2020-08-25,51,5,686,12,0,11,56
Mendocino,2020-08-25,3,0,150,1,0,8,3
Santa Clara,2020-08-25,148,12,3068,44,0,115,160
Sonoma,2020-08-25,43,6,514,11,2,4,49
El Dorado,2020-08-25,1,1,189,1,1,8,2
Sutter,2020-08-25,0,0,0,0,0,0,0
Solano,2020-08-25,34,3,546,9,0,7,37
Del Norte,2020-08-25,0,0,51,0,0,4,0
San Mateo,2020-08-25,50,11,680,13,3,19,61
Nevada,2020-08-25,2,0,119,0,0,4,2
Imperial,2020-08-25,34,1,259,11,0,1,35
Yolo,2020-08-25,7,0,97,3,0,9,7
Santa Barbara,2020-08-25,52,8,666,22,1,42,60
Tulare,2020-08-26,61,6,686,12,0,10,67
Napa,2020-08-26,6,1,208,1,0,0,7
San Joaquin,2020-08-26,137,24,1008,38,0,76,161
Yolo,2020-08-26,7,0,97,4,0,7,7
Los Angeles,2020-08-26,1168,466,20280,364,53,893,1634
San Bernardino,2020-08-26,318,49,3893,102,4,159,367
Glenn,2020-08-26,0,2,47,0,0,0,2
San Mateo,2020-08-26,51,10,693,12,1,26,61
San Francisco,2020-08-26,87,12,1868,37,7,54,99
Contra Costa,2020-08-26,88,21,1483,34,1,57,109
San Diego,2020-08-26,228,88,6649,83,23,264,316
Madera,2020-08-26,23,12,274,9,0,6,35
Merced,2020-08-26,24,3,253,9,0,6,27
Fresno,2020-08-26,218,39,1584,49,3,15,257
Modoc,2020-08-26,0,0,41,0,0,0,0
Sacramento,2020-08-26,215,39,2480,59,6,111,254
Trinity,2020-08-26,0,0,25,0,0,0,0
Orange,2020-08-26,372,51,5810,112,4,214,423
Del Norte,2020-08-26,0,0,51,0,0,3,0
Yuba,2020-08-26,19,1,265,4,0,11,20
Sutter,2020-08-26,0,0,0,0,0,0,0
Shasta,2020-08-26,4,0,561,0,0,10,4
Butte,2020-08-26,20,1,451,8,1,6,21
Mariposa,2020-08-26,0,0,19,0,0,0,0
Tuolumne,2020-08-26,2,0,84,0,0,4,2
El Dorado,2020-08-26,1,1,189,1,1,9,2
Amador,2020-08-26,2,0,51,0,0,5,2
Plumas,2020-08-26,0,0,29,0,0,0,0
Monterey,2020-08-26,39,1,729,15,0,21,40
Santa Clara,2020-08-26,142,19,2987,46,3,105,161
Santa Cruz,2020-08-26,8,10,276,1,1,13,18
Ventura,2020-08-26,74,31,1321,31,3,45,105
Imperial,2020-08-26,31,2,259,12,0,9,33
San Luis Obispo,2020-08-26,13,5,451,5,2,19,18
Calaveras,2020-08-26,4,1,33,3,0,4,5
San Benito,2020-08-26,4,0,25,2,0,1,4
Nevada,2020-08-26,1,1,132,0,0,3,2
Colusa,2020-08-26,1,2,48,0,0,0,3
Lassen,2020-08-26,0,0,25,0,0,0,0
Kings,2020-08-26,34,1,193,3,0,10,35
Kern,2020-08-26,140,2,1317,50,0,43,142
Marin,2020-08-26,17,2,318,2,1,8,19
Lake,2020-08-26,1,1,65,0,1,4,2
Solano,2020-08-26,37,2,489,9,0,6,39
Sonoma,2020-08-26,39,4,533,9,1,5,43
Alameda,2020-08-26,190,48,2416,69,9,78,238
Santa Barbara,2020-08-26,40,3,666,21,0,42,43
Inyo,2020-08-26,0,0,29,0,0,4,0
Stanislaus,2020-08-26,159,31,1309,38,2,18,190
Mono,2020-08-26,0,0,17,0,0,2,0
Humboldt,2020-08-26,1,1,269,1,0,5,2
Mendocino,2020-08-26,3,0,150,1,0,3,3
Placer,2020-08-26,38,16,741,12,2,27,54
Riverside,2020-08-26,226,95,3376,81,14,97,321
Tehama,2020-08-26,0,0,59,0,0,0,0
Siskiyou,2020-08-26,0,0,56,0,0,5,0
Yolo,2020-08-27,6,0,96,2,0,10,6
Plumas,2020-08-27,0,0,35,0,0,0,0
Yuba,2020-08-27,18,3,265,4,0,9,21
Mariposa,2020-08-27,0,0,19,0,0,0,0
San Diego,2020-08-27,227,72,6664,79,16,274,299
Riverside,2020-08-27,223,87,3346,82,16,97,310
Shasta,2020-08-27,4,0,561,1,0,11,4
Solano,2020-08-27,33,2,546,9,0,6,35
Monterey,2020-08-27,38,1,729,15,0,21,39
Santa Barbara,2020-08-27,40,2,666,19,0,51,42
Glenn,2020-08-27,0,2,47,0,0,0,2
Fresno,2020-08-27,215,34,1604,46,2,10,249
Ventura,2020-08-27,78,24,1321,35,6,40,102
Sonoma,2020-08-27,40,4,546,11,0,6,44
Tulare,2020-08-27,51,3,686,15,0,12,54
Butte,2020-08-27,19,0,451,6,0,5,19
Tehama,2020-08-27,0,0,59,0,0,1,0
San Mateo,2020-08-27,52,8,696,14,1,33,60
Marin,2020-08-27,10,9,323,1,1,11,19
Lake,2020-08-27,1,1,65,0,0,2,2
Modoc,2020-08-27,0,0,41,0,0,0,0
Amador,2020-08-27,4,0,51,0,0,3,4
Nevada,2020-08-27,2,0,117,0,0,2,2
Inyo,2020-08-27,0,0,29,0,0,4,0
Kern,2020-08-27,147,3,1306,53,0,44,150
Siskiyou,2020-08-27,0,0,56,0,0,3,0
Napa,2020-08-27,5,1,208,1,0,12,6
Trinity,2020-08-27,0,0,25,0,0,0,0
Colusa,2020-08-27,10,0,48,0,0,0,10
Mono,2020-08-27,0,0,17,0,0,2,0
Santa Clara,2020-08-27,140,18,3003,44,2,97,158
Lassen,2020-08-27,0,0,25,0,0,0,0
Imperial,2020-08-27,32,1,259,12,0,9,33
Los Angeles,2020-08-27,1116,449,20182,356,46,889,1565
Sutter,2020-08-27,0,0,0,0,0,0,0
Tuolumne,2020-08-27,2,0,84,0,0,1,2
Stanislaus,2020-08-27,166,39,1304,39,3,15,205
El Dorado,2020-08-27,1,2,189,1,1,9,3
Merced,2020-08-27,22,4,254,10,0,2,26
San Bernardino,2020-08-27,306,55,3862,107,7,148,361
San Luis Obispo,2020-08-27,12,5,451,3,1,22,17
Alameda,2020-08-27,198,47,2445,67,20,77,245
Placer,2020-08-27,38,21,743,13,4,28,59
Sacramento,2020-08-27,207,30,2467,55,5,110,237
San Benito,2020-08-27,3,0,25,2,0,1,3
Calaveras,2020-08-27,3,1,33,2,1,4,4
Contra Costa,2020-08-27,99,22,1485,37,1,48,121
Kings,2020-08-27,33,0,193,4,0,8,33
Madera,2020-08-27,24,20,274,10,2,3,44
Orange,2020-08-27,351,49,5830,98,5,212,400
San Joaquin,2020-08-27,137,21,1009,38,1,40,158
Del Norte,2020-08-27,0,0,51,0,0,2,0
Humboldt,2020-08-27,1,2,264,1,1,3,3
Santa Cruz,2020-08-27,7,8,276,1,1,12,15
Mendocino,2020-08-27,5,0,150,0,0,3,5
San Francisco,2020-08-27,79,12,1848,36,5,53,91
Tuolumne,2020-08-28,2,0,84,0,0,1,2
San Bernardino,2020-08-28,305,49,3851,111,4,159,354
Santa Barbara,2020-08-28,44,9,666,18,1,45,53
Riverside,2020-08-28,216,81,3322,72,15,92,297
Solano,2020-08-28,31,5,536,8,0,7,36
Yolo,2020-08-28,6,0,96,1,0,12,6
Alameda,2020-08-28,202,46,2456,63,7,89,248
San Luis Obispo,2020-08-28,14,2,451,3,0,19,16
San Diego,2020-08-28,223,59,6645,79,7,271,282
Humboldt,2020-08-28,1,1,268,1,1,3,2
Santa Clara,2020-08-28,139,15,3021,51,2,98,154
Modoc,2020-08-28,0,0,41,0,0,0,0
Madera,2020-08-28,25,12,274,8,0,2,37
Lassen,2020-08-28,0,0,25,0,0,0,0
Kern,2020-08-28,130,4,1302,49,0,45,134
Los Angeles,2020-08-28,1089,423,19935,344,53,881,1512
El Dorado,2020-08-28,0,0,189,0,0,12,0
Merced,2020-08-28,24,2,254,9,2,1,26
Santa Cruz,2020-08-28,9,6,276,1,1,12,15
Imperial,2020-08-28,32,0,259,9,0,11,32
Shasta,2020-08-28,3,0,561,1,0,8,3
Placer,2020-08-28,41,21,742,14,4,27,62
Ventura,2020-08-28,71,24,1309,33,3,45,95
Yuba,2020-08-28,18,2,265,4,0,7,20
Mendocino,2020-08-28,5,0,150,0,0,3,5
Del Norte,2020-08-28,0,0,51,0,0,3,0
Napa,2020-08-28,3,0,208,1,0,13,3
Siskiyou,2020-08-28,0,0,56,0,0,4,0
Contra Costa,2020-08-28,92,28,1461,35,3,42,120
Butte,2020-08-28,19,0,451,6,0,4,19
Mono,2020-08-28,0,0,17,0,0,2,0
Sacramento,2020-08-28,202,28,2489,57,7,108,230
Amador,2020-08-28,4,0,51,1,0,4,4
Lake,2020-08-28,1,2,65,0,1,2,3
Kings,2020-08-28,32,0,193,4,0,8,32
Marin,2020-08-28,14,1,321,1,0,12,15
San Francisco,2020-08-28,74,18,1868,27,4,58,92
Glenn,2020-08-28,0,0,47,0,0,0,0
Colusa,2020-08-28,11,1,48,0,0,0,12
San Joaquin,2020-08-28,124,20,1006,35,1,39,144
Inyo,2020-08-28,0,0,29,0,0,4,0
Fresno,2020-08-28,201,27,1600,43,1,13,228
San Mateo,2020-08-28,41,12,690,12,1,28,53
Mariposa,2020-08-28,0,0,19,0,0,0,0
Monterey,2020-08-28,31,0,729,17,0,20,31
Calaveras,2020-08-28,2,0,33,2,0,6,2
Trinity,2020-08-28,0,0,25,0,0,0,0
Plumas,2020-08-28,0,0,35,0,0,0,0
Sutter,2020-08-28,0,0,0,0,0,0,0
Nevada,2020-08-28,2,0,125,0,0,4,2
Sonoma,2020-08-28,38,9,556,11,1,8,47
San Benito,2020-08-28,2,0,25,2,0,1,2
Tehama,2020-08-28,1,0,59,0,0,4,1
Stanislaus,2020-08-28,156,34,1299,37,3,20,190
Orange,2020-08-28,341,46,5764,99,7,226,387
Tulare,2020-08-28,51,4,686,13,0,12,55
Nevada,2020-08-29,2,0,121,0,0,2,2
San Bernardino,2020-08-29,292,42,3828,103,5,167,334
Yolo,2020-08-29,5,0,96,2,0,6,5
Solano,2020-08-29,34,6,536,8,1,8,40
Stanislaus,2020-08-29,145,39,1301,36,3,27,184
Lassen,2020-08-29,0,0,25,0,0,0,0
Mariposa,2020-08-29,0,0,19,0,0,0,0
Santa Barbara,2020-08-29,43,5,666,18,2,52,48
San Luis Obispo,2020-08-29,12,3,451,4,2,17,15
Sutter,2020-08-29,0,0,0,0,0,0,0
Sonoma,2020-08-29,34,5,532,9,2,9,39
San Mateo,2020-08-29,41,12,697,12,4,27,53
Shasta,2020-08-29,4,0,561,1,0,9,4
Glenn,2020-08-29,0,0,47,0,0,0,0
Mendocino,2020-08-29,2,0,150,0,0,5,2
Monterey,2020-08-29,31,0,729,16,0,20,31
Orange,2020-08-29,329,48,5754,99,8,250,377
Tulare,2020-08-29,51,2,664,12,0,13,53
El Dorado,2020-08-29,1,0,189,1,0,11,1
San Francisco,2020-08-29,74,11,1839,26,3,52,85
Butte,2020-08-29,17,0,451,5,0,3,17
Plumas,2020-08-29,0,0,35,0,0,0,0
Yuba,2020-08-29,20,0,265,3,0,13,20
Contra Costa,2020-08-29,95,10,1451,32,0,45,105
Napa,2020-08-29,2,1,208,0,0,11,3
Kings,2020-08-29,32,0,193,3,0,9,32
Inyo,2020-08-29,0,0,29,0,0,4,0
Trinity,2020-08-29,0,0,25,0,0,0,0
Siskiyou,2020-08-29,0,0,56,0,0,4,0
Modoc,2020-08-29,0,0,41,0,0,0,0
Marin,2020-08-29,11,3,318,12,0,11,14
Humboldt,2020-08-29,1,1,268,1,1,2,2
Del Norte,2020-08-29,0,1,51,0,0,4,1
Amador,2020-08-29,1,0,51,0,0,3,1
Calaveras,2020-08-29,2,1,33,2,1,4,3
Tuolumne,2020-08-29,2,0,84,0,0,2,2
Santa Clara,2020-08-29,144,22,3019,50,2,102,166
San Benito,2020-08-29,2,0,25,2,0,1,2
Lake,2020-08-29,1,0,65,0,0,4,1
Kern,2020-08-29,118,6,1303,41,0,46,124
San Diego,2020-08-29,230,73,6631,80,12,294,303
Merced,2020-08-29,25,2,253,9,0,4,27
Alameda,2020-08-29,188,44,2426,58,6,76,232
Colusa,2020-08-29,10,1,48,0,0,0,11
Riverside,2020-08-29,217,88,3283,74,9,99,305
Madera,2020-08-29,27,9,274,8,1,3,36
Santa Cruz,2020-08-29,8,9,276,1,1,10,17
San Joaquin,2020-08-29,109,24,1007,33,3,43,133
Los Angeles,2020-08-29,1043,415,19773,345,44,862,1458
Imperial,2020-08-29,31,0,259,8,0,18,31
Ventura,2020-08-29,69,23,1300,32,5,45,92
Fresno,2020-08-29,196,29,1587,48,5,17,225
Placer,2020-08-29,38,23,739,12,4,28,61
Sacramento,2020-08-29,200,45,2472,60,6,100,245
Tehama,2020-08-29,1,0,59,0,0,2,1
Mono,2020-08-29,0,0,17,0,0,2,0
Tehama,2020-08-30,1,0,59,0,0,1,1
Los Angeles,2020-08-30,1057,386,19714,345,53,934,1443
Tulare,2020-08-30,49,3,664,12,0,17,52
Orange,2020-08-30,317,61,5701,98,9,244,378
Santa Barbara,2020-08-30,36,4,666,17,0,51,40
Mono,2020-08-30,0,0,17,0,0,2,0
Nevada,2020-08-30,2,2,108,0,2,2,4
Yolo,2020-08-30,5,0,96,3,0,7,5
Placer,2020-08-30,39,20,742,12,2,29,59
Glenn,2020-08-30,0,0,47,0,0,0,0
Madera,2020-08-30,28,9,274,11,0,4,37
El Dorado,2020-08-30,1,0,189,1,0,10,1
Mendocino,2020-08-30,2,0,150,0,0,6,2
Fresno,2020-08-30,190,34,1572,44,3,19,224
Mariposa,2020-08-30,0,0,19,0,0,0,0
San Luis Obispo,2020-08-30,10,3,451,4,0,20,13
Santa Clara,2020-08-30,139,25,3007,47,1,95,164
Alameda,2020-08-30,183,37,2414,53,3,89,220
Contra Costa,2020-08-30,91,14,1456,29,3,57,105
Kings,2020-08-30,32,0,193,3,0,9,32
Yuba,2020-08-30,13,0,265,2,0,13,13
Marin,2020-08-30,12,3,321,2,0,11,15
Humboldt,2020-08-30,1,1,268,1,1,2,2
San Benito,2020-08-30,2,0,25,2,0,1,2
Sonoma,2020-08-30,33,3,511,8,0,12,36
Ventura,2020-08-30,72,30,1287,28,6,45,102
San Joaquin,2020-08-30,102,14,1005,30,1,43,116
Sacramento,2020-08-30,196,31,2463,55,2,109,227
Inyo,2020-08-30,0,0,29,0,0,4,0
Siskiyou,2020-08-30,0,0,56,0,0,4,0
Amador,2020-08-30,1,0,51,0,0,2,1
Calaveras,2020-08-30,2,2,33,2,0,4,4
Stanislaus,2020-08-30,140,31,1305,37,2,24,171
Napa,2020-08-30,3,1,359,0,0,25,4
Colusa,2020-08-30,10,1,48,0,0,0,11
Monterey,2020-08-30,35,0,729,15,0,25,35
San Diego,2020-08-30,234,71,6638,81,15,300,305
Del Norte,2020-08-30,0,0,52,0,0,5,0
Butte,2020-08-30,18,0,451,4,0,6,18
San Bernardino,2020-08-30,283,54,3808,99,7,149,337
Trinity,2020-08-30,0,0,25,0,0,0,0
Lassen,2020-08-30,0,0,25,0,0,0,0
San Francisco,2020-08-30,70,10,1788,28,3,77,80
Kern,2020-08-30,115,4,1320,34,0,47,119
Merced,2020-08-30,25,1,253,10,0,3,26
Solano,2020-08-30,33,7,532,8,0,10,40
Tuolumne,2020-08-30,2,0,84,0,0,4,2
Santa Cruz,2020-08-30,8,6,276,2,0,8,14
Imperial,2020-08-30,28,0,259,8,0,16,28
Lake,2020-08-30,0,0,65,0,0,4,0
San Mateo,2020-08-30,45,12,688,14,5,28,57
Plumas,2020-08-30,0,0,35,0,0,0,0
Shasta,2020-08-30,3,0,561,1,0,11,3
Modoc,2020-08-30,0,0,41,0,0,0,0
Sutter,2020-08-30,0,0,0,0,0,0,0
Riverside,2020-08-30,210,71,3322,73,5,96,281
Yolo,2020-08-31,6,0,96,3,0,6,6
Madera,2020-08-31,29,12,274,11,2,5,41
Tuolumne,2020-08-31,1,0,84,0,0,3,1
Modoc,2020-08-31,0,0,41,0,0,0,0
Santa Barbara,2020-08-31,41,6,666,18,1,52,47
Mariposa,2020-08-31,0,0,19,0,0,0,0
Orange,2020-08-31,307,61,5714,93,10,254,368
Contra Costa,2020-08-31,81,28,1450,25,5,57,109
Glenn,2020-08-31,0,0,47,0,0,0,0
Monterey,2020-08-31,30,0,729,15,0,25,30
Humboldt,2020-08-31,1,0,265,1,0,4,1
Colusa,2020-08-31,10,1,48,0,0,0,11
Yuba,2020-08-31,12,0,265,2,0,11,12
Stanislaus,2020-08-31,143,46,1305,38,8,26,189
Mendocino,2020-08-31,2,0,150,0,0,6,2
Placer,2020-08-31,39,22,733,12,5,29,61
Del Norte,2020-08-31,0,0,52,0,0,3,0
Siskiyou,2020-08-31,0,0,56,0,0,4,0
Nevada,2020-08-31,2,4,109,0,2,4,6
San Bernardino,2020-08-31,292,63,3843,98,7,168,355
San Mateo,2020-08-31,41,14,686,13,4,35,55
San Francisco,2020-08-31,74,12,1809,26,3,79,86
Alameda,2020-08-31,173,46,2372,46,10,96,219
Santa Cruz,2020-08-31,9,4,276,2,0,9,13
Marin,2020-08-31,14,1,323,3,1,11,15
San Joaquin,2020-08-31,102,14,1005,33,1,40,116
Riverside,2020-08-31,216,54,3288,68,10,102,270
Merced,2020-08-31,27,1,253,11,0,4,28
Inyo,2020-08-31,0,0,29,0,0,4,0
San Benito,2020-08-31,2,0,25,2,0,1,2
Kern,2020-08-31,122,6,1309,42,0,46,128
San Luis Obispo,2020-08-31,10,4,451,4,0,21,14
Solano,2020-08-31,32,6,537,8,0,6,38
San Diego,2020-08-31,233,73,6632,84,11,307,306
Fresno,2020-08-31,184,25,1568,48,1,21,209
Los Angeles,2020-08-31,1048,415,19746,321,62,954,1463
Santa Clara,2020-08-31,134,26,3072,45,1,109,160
Sonoma,2020-08-31,31,10,507,9,2,12,41
Plumas,2020-08-31,0,0,35,0,0,0,0
Lassen,2020-08-31,0,0,25,0,0,0,0
Trinity,2020-08-31,0,0,25,0,0,0,0
Butte,2020-08-31,17,1,451,4,0,19,18
Kings,2020-08-31,39,1,193,9,1,2,40
Sutter,2020-08-31,0,0,0,0,0,0,0
Mono,2020-08-31,0,0,17,0,0,2,0
Tehama,2020-08-31,1,0,59,0,0,6,1
Napa,2020-08-31,1,0,351,0,0,21,1
Sacramento,2020-08-31,196,47,2464,52,7,121,243
Imperial,2020-08-31,27,0,259,8,0,15,27
Ventura,2020-08-31,65,15,1276,27,4,45,80
Shasta,2020-08-31,2,0,561,1,0,7,2
Tulare,2020-08-31,50,1,686,10,0,16,51
Calaveras,2020-08-31,2,1,33,2,0,4,3
Lake,2020-08-31,0,0,65,0,0,6,0
El Dorado,2020-08-31,0,0,189,0,0,13,0
Amador,2020-08-31,1,0,51,0,0,3,1
Tehama,2020-09-01,2,0,59,1,0,4,2
Lassen,2020-09-01,0,0,25,0,0,0,0
Humboldt,2020-09-01,1,2,263,1,0,4,3
Napa,2020-09-01,2,1,351,0,0,22,3
Stanislaus,2020-09-01,135,43,1307,38,6,23,178
Merced,2020-09-01,26,1,253,12,0,3,27
San Joaquin,2020-09-01,102,13,1004,31,3,42,115
Marin,2020-09-01,12,2,323,2,0,6,14
Mendocino,2020-09-01,4,0,150,2,0,4,4
Madera,2020-09-01,27,10,274,10,0,3,37
Orange,2020-09-01,295,64,5754,89,13,218,359
Yolo,2020-09-01,7,0,96,4,0,4,7
San Francisco,2020-09-01,77,16,1873,24,3,68,93
San Mateo,2020-09-01,37,15,685,12,3,32,52
Monterey,2020-09-01,28,1,729,16,1,21,29
Tuolumne,2020-09-01,2,0,84,0,0,4,2
Amador,2020-09-01,2,0,51,0,0,4,2
Nevada,2020-09-01,1,1,118,0,1,4,2
Modoc,2020-09-01,0,0,41,0,0,0,0
Solano,2020-09-01,31,7,539,6,0,7,38
San Luis Obispo,2020-09-01,9,4,451,4,1,22,13
Placer,2020-09-01,37,26,742,11,0,25,63
Kings,2020-09-01,38,0,193,9,0,2,38
Siskiyou,2020-09-01,0,0,56,0,0,8,0
Trinity,2020-09-01,0,0,25,0,0,0,0
Glenn,2020-09-01,0,0,47,0,0,0,0
Butte,2020-09-01,17,0,451,3,0,19,17
Alameda,2020-09-01,162,48,2395,49,8,87,210
Kern,2020-09-01,117,10,1321,39,0,43,127
Santa Cruz,2020-09-01,10,6,276,3,0,8,16
Plumas,2020-09-01,0,0,35,0,0,0,0
Santa Barbara,2020-09-01,38,5,666,18,0,40,43
Riverside,2020-09-01,207,57,3363,69,8,93,264
Los Angeles,2020-09-01,1062,426,19849,320,52,933,1488
Yuba,2020-09-01,13,0,265,2,0,10,13
Colusa,2020-09-01,6,1,48,0,0,0,7
Del Norte,2020-09-01,0,0,51,0,0,2,0
San Diego,2020-09-01,231,76,6640,85,11,305,307
El Dorado,2020-09-01,0,2,189,0,1,14,2
Contra Costa,2020-09-01,76,22,1463,24,5,53,98
Tulare,2020-09-01,50,2,664,10,0,15,52
San Benito,2020-09-01,4,0,25,2,0,1,4
Sutter,2020-09-01,0,0,0,0,0,0,0
Inyo,2020-09-01,0,1,29,0,0,4,1
Mono,2020-09-01,0,0,17,0,0,2,0
Shasta,2020-09-01,3,0,561,1,0,8,3
Santa Clara,2020-09-01,132,27,3113,49,2,108,159
Mariposa,2020-09-01,0,0,19,0,0,0,0
Sacramento,2020-09-01,187,47,2481,54,6,106,234
Ventura,2020-09-01,68,31,1301,27,5,47,99
Lake,2020-09-01,0,1,65,0,1,4,1
Calaveras,2020-09-01,2,2,33,2,2,4,4
Fresno,2020-09-01,172,34,1573,48,2,18,206
Imperial,2020-09-01,29,0,259,8,0,12,29
San Bernardino,2020-09-01,283,66,3860,100,7,137,349
Sonoma,2020-09-01,29,8,498,12,1,9,37
Tehama,2020-09-02,2,0,59,1,0,4,2
Ventura,2020-09-02,61,30,1305,23,7,41,91
Butte,2020-09-02,17,1,451,3,0,12,18
Contra Costa,2020-09-02,77,17,1459,26,5,62,94
Tulare,2020-09-02,53,1,664,10,0,8,54
Santa Clara,2020-09-02,130,28,3124,51,3,98,158
Santa Barbara,2020-09-02,39,5,666,16,0,45,44
Mendocino,2020-09-02,4,0,150,1,0,4,4
Fresno,2020-09-02,161,27,1539,45,1,17,188
Los Angeles,2020-09-02,992,386,19805,296,49,919,1378
Mariposa,2020-09-02,0,0,19,0,0,0,0
San Joaquin,2020-09-02,103,22,1003,32,4,48,125
Placer,2020-09-02,38,20,740,12,2,28,58
Monterey,2020-09-02,29,1,729,15,0,23,30
Madera,2020-09-02,25,9,274,10,0,5,34
Yuba,2020-09-02,17,0,265,2,0,11,17
Siskiyou,2020-09-02,0,0,56,0,0,8,0
San Bernardino,2020-09-02,264,59,3851,92,9,134,323
Imperial,2020-09-02,29,0,259,8,0,12,29
San Diego,2020-09-02,220,70,6652,80,14,280,290
San Luis Obispo,2020-09-02,9,5,451,3,1,20,14
El Dorado,2020-09-02,0,1,189,0,1,10,1
Kern,2020-09-02,120,6,1322,39,0,43,126
Glenn,2020-09-02,0,0,47,0,0,0,0
Calaveras,2020-09-02,4,2,33,2,1,4,6
Shasta,2020-09-02,4,0,561,1,0,10,4
Sutter,2020-09-02,0,0,0,0,0,0,0
San Mateo,2020-09-02,36,11,690,12,3,25,47
San Francisco,2020-09-02,70,12,1854,21,4,61,82
Mono,2020-09-02,0,0,17,0,0,1,0
Amador,2020-09-02,3,0,51,0,0,4,3
Kings,2020-09-02,31,0,193,2,0,9,31
Plumas,2020-09-02,0,0,35,0,0,0,0
Lassen,2020-09-02,0,0,25,0,0,0,0
Tuolumne,2020-09-02,2,1,84,0,0,5,3
Alameda,2020-09-02,150,41,2404,44,6,95,191
Merced,2020-09-02,27,1,253,12,0,6,28
Solano,2020-09-02,32,6,533,8,0,8,38
Humboldt,2020-09-02,1,2,271,1,0,1,3
Del Norte,2020-09-02,0,0,51,0,0,1,0
Marin,2020-09-02,14,1,331,3,0,7,15
Santa Cruz,2020-09-02,11,4,276,3,1,10,15
Trinity,2020-09-02,0,0,25,0,0,0,0
Napa,2020-09-02,1,0,351,1,0,23,1
Sonoma,2020-09-02,31,6,513,11,2,8,37
Riverside,2020-09-02,189,67,3359,60,13,97,256
Colusa,2020-09-02,1,0,48,0,0,0,1
Lake,2020-09-02,0,0,65,0,0,4,0
Nevada,2020-09-02,1,1,129,0,0,5,2
San Benito,2020-09-02,2,0,25,2,0,1,2
Modoc,2020-09-02,0,0,41,0,0,0,0
Orange,2020-09-02,272,60,5612,79,10,202,332
Stanislaus,2020-09-02,131,34,1296,36,7,22,165
Yolo,2020-09-02,8,0,96,2,0,7,8
Sacramento,2020-09-02,193,29,2467,54,8,96,222
Inyo,2020-09-02,0,1,29,0,0,4,1
Humboldt,2020-09-03,1,0,271,1,0,0,1
Solano,2020-09-03,32,13,547,9,1,8,45
Mono,2020-09-03,0,0,17,0,0,2,0
Glenn,2020-09-03,0,0,47,0,0,0,0
Sonoma,2020-09-03,33,2,534,13,0,9,35
Mariposa,2020-09-03,0,0,19,0,0,0,0
Santa Clara,2020-09-03,125,27,3124,49,2,90,152
San Bernardino,2020-09-03,252,43,3878,89,4,138,295
Imperial,2020-09-03,27,0,259,7,0,13,27
Riverside,2020-09-03,185,37,3349,63,10,102,222
Calaveras,2020-09-03,5,0,33,3,0,5,5
Marin,2020-09-03,16,3,326,2,0,9,19
Yolo,2020-09-03,8,0,97,1,0,7,8
Stanislaus,2020-09-03,124,34,1295,35,4,19,158
Yuba,2020-09-03,13,0,265,2,0,13,13
San Joaquin,2020-09-03,93,19,1002,30,0,48,112
Inyo,2020-09-03,0,0,29,0,0,4,0
Ventura,2020-09-03,57,19,1314,24,4,42,76
Tehama,2020-09-03,2,0,59,1,0,4,2
El Dorado,2020-09-03,0,2,189,0,2,9,2
Sutter,2020-09-03,0,0,0,0,0,0,0
Santa Cruz,2020-09-03,9,7,277,3,1,9,16
Contra Costa,2020-09-03,71,13,1461,24,3,56,84
Napa,2020-09-03,3,2,351,2,0,19,5
Lassen,2020-09-03,0,0,25,0,0,0,0
Alameda,2020-09-03,147,54,2401,43,4,95,201
Colusa,2020-09-03,1,0,48,0,0,0,1
Del Norte,2020-09-03,0,0,51,0,0,2,0
Orange,2020-09-03,264,44,5614,77,9,221,308
Santa Barbara,2020-09-03,40,7,666,16,2,49,47
Sacramento,2020-09-03,190,32,2434,52,6,84,222
Madera,2020-09-03,25,12,274,9,0,5,37
Amador,2020-09-03,2,0,51,0,0,5,2
Nevada,2020-09-03,1,0,129,0,0,5,1
Trinity,2020-09-03,0,0,25,0,0,0,0
Butte,2020-09-03,20,1,451,3,0,14,21
San Luis Obispo,2020-09-03,9,1,451,2,1,20,10
Monterey,2020-09-03,27,1,729,15,0,21,28
Modoc,2020-09-03,0,0,41,0,0,0,0
Tulare,2020-09-03,46,5,664,7,0,17,51
Lake,2020-09-03,0,0,65,0,0,3,0
San Benito,2020-09-03,2,0,25,2,0,1,2
Tuolumne,2020-09-03,2,0,84,0,0,3,2
Siskiyou,2020-09-03,0,0,56,0,0,8,0
San Francisco,2020-09-03,63,11,1848,21,4,58,74
Kings,2020-09-03,32,0,193,3,0,9,32
Los Angeles,2020-09-03,984,362,19780,310,51,913,1346
Merced,2020-09-03,27,3,253,11,0,7,30
Fresno,2020-09-03,156,25,1552,44,1,15,181
Placer,2020-09-03,41,24,744,13,3,28,65
Plumas,2020-09-03,0,0,35,0,0,0,0
San Diego,2020-09-03,218,71,6634,71,14,280,289
Mendocino,2020-09-03,4,0,150,1,0,1,4
San Mateo,2020-09-03,33,8,695,11,2,25,41
Kern,2020-09-03,119,6,1322,37,0,44,125
Shasta,2020-09-03,4,0,561,1,0,10,4
San Bernardino,2020-09-04,239,44,3864,87,7,167,283
Nevada,2020-09-04,1,2,119,0,1,2,3
Colusa,2020-09-04,1,1,48,0,0,0,2
Mendocino,2020-09-04,4,0,150,1,0,1,4
Sonoma,2020-09-04,37,6,519,13,0,7,43
Plumas,2020-09-04,0,0,35,0,0,0,0
Mariposa,2020-09-04,0,0,19,0,0,0,0
Placer,2020-09-04,41,16,743,11,1,27,57
El Dorado,2020-09-04,0,1,189,0,1,7,1
Kings,2020-09-04,35,0,193,3,0,6,35
Santa Cruz,2020-09-04,8,2,276,3,0,7,10
Amador,2020-09-04,2,0,51,0,0,3,2
San Mateo,2020-09-04,37,5,686,12,2,27,42
San Francisco,2020-09-04,58,7,1860,23,0,56,65
Los Angeles,2020-09-04,966,355,19804,305,52,907,1321
Imperial,2020-09-04,25,0,259,7,0,12,25
Yolo,2020-09-04,8,0,97,7,0,2,8
Del Norte,2020-09-04,0,0,51,0,0,2,0
Riverside,2020-09-04,177,39,3380,64,9,98,216
Merced,2020-09-04,23,0,253,9,0,10,23
Tehama,2020-09-04,2,0,59,1,0,4,2
Tulare,2020-09-04,44,4,664,7,0,16,48
Shasta,2020-09-04,3,3,561,1,0,5,6
Sacramento,2020-09-04,177,33,2480,52,5,90,210
Sutter,2020-09-04,0,0,0,0,0,0,0
Alameda,2020-09-04,142,35,2391,44,3,100,177
Napa,2020-09-04,3,1,351,2,0,21,4
Santa Clara,2020-09-04,122,11,3083,42,0,96,133
Solano,2020-09-04,32,8,564,9,1,9,40
Humboldt,2020-09-04,1,1,269,1,1,2,2
Marin,2020-09-04,12,3,323,4,0,8,15
Kern,2020-09-04,98,1,1332,32,0,50,99
San Benito,2020-09-04,3,0,25,2,0,1,3
Mono,2020-09-04,0,0,17,0,0,2,0
Butte,2020-09-04,15,0,451,3,0,15,15
Stanislaus,2020-09-04,126,33,1296,37,2,12,159
Tuolumne,2020-09-04,1,0,84,0,0,2,1
Monterey,2020-09-04,26,3,729,17,0,20,29
Contra Costa,2020-09-04,73,14,1519,27,5,68,87
San Diego,2020-09-04,219,59,6616,80,17,282,278
Madera,2020-09-04,25,8,274,9,0,3,33
Trinity,2020-09-04,0,0,25,0,0,0,0
Fresno,2020-09-04,153,23,1498,44,3,12,176
Orange,2020-09-04,274,54,5576,83,6,220,328
San Joaquin,2020-09-04,86,15,1005,29,0,41,101
Lake,2020-09-04,0,1,65,0,0,4,1
Calaveras,2020-09-04,4,1,33,3,0,5,5
Siskiyou,2020-09-04,0,0,56,0,0,7,0
San Luis Obispo,2020-09-04,7,3,451,3,1,20,10
Lassen,2020-09-04,0,0,25,0,0,0,0
Inyo,2020-09-04,0,1,29,0,0,4,1
Ventura,2020-09-04,50,30,1269,22,6,52,80
Modoc,2020-09-04,0,0,41,0,0,0,0
Yuba,2020-09-04,16,0,265,3,0,14,16
Glenn,2020-09-04,0,0,47,0,0,0,0
Santa Barbara,2020-09-04,37,6,666,14,3,53,43
Tehama,2020-09-05,2,0,59,1,0,2,2
Butte,2020-09-05,15,1,451,4,0,17,16
Inyo,2020-09-05,0,0,29,0,0,4,0
Tuolumne,2020-09-05,1,0,84,1,0,3,1
Los Angeles,2020-09-05,943,361,19813,305,43,926,1304
Monterey,2020-09-05,27,2,729,10,0,18,29
San Francisco,2020-09-05,51,6,1808,22,0,64,57
Imperial,2020-09-05,26,1,259,7,0,9,27
Tulare,2020-09-05,52,4,664,7,0,18,56
Nevada,2020-09-05,0,0,29,0,0,1,0
Glenn,2020-09-05,0,0,47,0,0,0,0
Lassen,2020-09-05,0,0,25,0,0,0,0
Alameda,2020-09-05,145,42,2406,37,4,105,187
Del Norte,2020-09-05,0,1,51,0,0,4,1
San Mateo,2020-09-05,35,8,680,10,3,25,43
Colusa,2020-09-05,1,0,48,0,0,0,1
Fresno,2020-09-05,153,20,1515,44,1,22,173
Lake,2020-09-05,1,0,65,0,0,4,1
Shasta,2020-09-05,3,1,561,1,0,4,4
San Diego,2020-09-05,193,67,6611,82,12,276,260
Orange,2020-09-05,253,54,5615,77,6,231,307
Yolo,2020-09-05,10,0,97,7,0,3,10
San Joaquin,2020-09-05,88,16,1005,31,0,52,104
Placer,2020-09-05,42,21,744,11,2,27,63
San Bernardino,2020-09-05,243,39,3822,86,4,156,282
Sonoma,2020-09-05,34,7,480,10,0,6,41
Stanislaus,2020-09-05,131,31,1298,38,4,18,162
San Benito,2020-09-05,1,0,25,1,0,2,1
Amador,2020-09-05,1,0,51,0,0,3,1
Santa Clara,2020-09-05,124,17,2985,42,0,93,141
Kern,2020-09-05,83,4,1309,27,0,53,87
Humboldt,2020-09-05,1,1,269,1,1,3,2
Sacramento,2020-09-05,168,36,2424,50,3,92,204
Madera,2020-09-05,23,13,274,9,0,2,36
Siskiyou,2020-09-05,0,0,56,0,0,7,0
Santa Barbara,2020-09-05,41,7,666,14,2,59,48
Ventura,2020-09-05,50,27,1254,25,9,54,77
Merced,2020-09-05,26,3,254,10,2,7,29
Trinity,2020-09-05,0,0,25,0,0,0,0
El Dorado,2020-09-05,0,0,189,0,0,12,0
Solano,2020-09-05,37,8,584,10,1,9,45
Kings,2020-09-05,32,1,193,3,0,8,33
Santa Cruz,2020-09-05,8,3,276,3,0,6,11
San Luis Obispo,2020-09-05,6,1,451,3,0,18,7
Mendocino,2020-09-05,4,0,150,1,0,1,4
Marin,2020-09-05,13,7,330,5,0,9,20
Plumas,2020-09-05,0,0,35,0,0,0,0
Mono,2020-09-05,0,0,17,0,0,2,0
Yuba,2020-09-05,19,0,265,3,0,13,19
Napa,2020-09-05,3,2,351,3,2,18,5
Contra Costa,2020-09-05,73,26,1528,26,3,50,99
Calaveras,2020-09-05,3,3,33,2,1,4,6
Modoc,2020-09-05,0,0,41,0,0,0,0
Sutter,2020-09-05,0,0,0,0,0,0,0
Mariposa,2020-09-05,0,0,19,0,0,0,0
Riverside,2020-09-05,171,49,3319,62,7,91,220
Yuba,2020-09-06,19,0,265,3,0,11,19
Trinity,2020-09-06,0,0,25,0,0,0,0
Shasta,2020-09-06,2,1,561,1,0,4,3
Glenn,2020-09-06,0,0,47,0,0,0,0
Sonoma,2020-09-06,37,14,501,10,2,5,51
Lake,2020-09-06,0,1,65,0,1,3,1
Marin,2020-09-06,13,8,323,5,1,8,21
San Francisco,2020-09-06,57,17,1772,24,2,69,74
Imperial,2020-09-06,30,1,259,10,0,6,31
Inyo,2020-09-06,0,0,29,0,0,4,0
Colusa,2020-09-06,0,1,48,0,0,0,1
Sacramento,2020-09-06,161,42,2391,70,1,92,203
Stanislaus,2020-09-06,134,31,1296,37,5,18,165
Humboldt,2020-09-06,1,1,269,1,1,3,2
Del Norte,2020-09-06,0,1,51,0,0,6,1
Siskiyou,2020-09-06,0,0,56,0,0,7,0
Sutter,2020-09-06,0,0,0,0,0,0,0
San Bernardino,2020-09-06,228,39,3785,89,4,151,267
Mono,2020-09-06,0,0,17,0,0,2,0
Calaveras,2020-09-06,2,2,33,1,1,5,4
Mariposa,2020-09-06,0,0,19,0,0,0,0
Tehama,2020-09-06,2,0,59,2,0,4,2
Modoc,2020-09-06,0,0,41,0,0,0,0
Lassen,2020-09-06,0,0,25,0,0,0,0
Merced,2020-09-06,27,6,253,9,1,5,33
Amador,2020-09-06,2,0,51,0,0,4,2
Santa Barbara,2020-09-06,44,7,666,17,2,63,51
Fresno,2020-09-06,152,18,1520,45,0,17,170
Yolo,2020-09-06,9,1,97,6,1,4,10
Solano,2020-09-06,32,8,562,9,1,9,40
San Mateo,2020-09-06,30,16,677,11,6,23,46
Nevada,2020-09-06,2,0,93,1,0,2,2
San Diego,2020-09-06,195,71,6617,80,16,307,266
Monterey,2020-09-06,28,1,729,8,0,18,29
Los Angeles,2020-09-06,942,372,19715,312,40,929,1314
San Luis Obispo,2020-09-06,7,3,451,4,0,22,10
Madera,2020-09-06,25,11,274,8,0,4,36
El Dorado,2020-09-06,0,0,189,0,0,10,0
Placer,2020-09-06,41,26,739,11,3,22,67
Plumas,2020-09-06,0,0,35,0,0,0,0
Butte,2020-09-06,20,1,451,6,0,11,21
Tulare,2020-09-06,55,4,664,8,0,15,59
Kings,2020-09-06,35,1,193,3,0,9,36
San Benito,2020-09-06,1,0,25,1,0,1,1
Napa,2020-09-06,4,5,351,1,0,17,9
Riverside,2020-09-06,171,59,3307,59,10,94,230
Mendocino,2020-09-06,5,0,150,2,0,1,5
Ventura,2020-09-06,52,33,1249,28,11,51,85
Contra Costa,2020-09-06,68,24,1522,26,2,53,92
Alameda,2020-09-06,146,43,2405,40,2,114,189
Kern,2020-09-06,80,12,1277,25,0,56,92
Tuolumne,2020-09-06,0,0,84,0,0,2,0
Santa Cruz,2020-09-06,9,5,276,3,1,8,14
Santa Clara,2020-09-06,116,18,2936,41,1,95,134
Orange,2020-09-06,238,64,5534,75,9,242,302
San Joaquin,2020-09-06,86,9,1004,28,0,50,95
Placer,2020-09-07,37,28,721,10,1,29,65
Stanislaus,2020-09-07,142,38,1302,38,5,12,180
Mariposa,2020-09-07,0,0,19,0,0,0,0
Alameda,2020-09-07,148,57,2371,38,5,113,205
Siskiyou,2020-09-07,0,0,56,0,0,7,0
Solano,2020-09-07,27,9,533,8,1,10,36
Imperial,2020-09-07,29,1,259,10,0,6,30
Ventura,2020-09-07,58,21,1220,27,11,50,79
Shasta,2020-09-07,2,1,561,1,0,5,3
Colusa,2020-09-07,0,0,48,0,0,0,0
Inyo,2020-09-07,0,0,29,0,0,4,0
Sutter,2020-09-07,0,0,0,0,0,0,0
San Diego,2020-09-07,211,72,6621,79,14,309,283
Kings,2020-09-07,32,2,193,3,0,9,34
Sacramento,2020-09-07,141,41,2412,51,5,104,182
San Bernardino,2020-09-07,224,42,3811,85,5,162,266
Santa Cruz,2020-09-07,10,5,276,3,1,8,15
San Mateo,2020-09-07,39,15,673,10,2,21,54
Yuba,2020-09-07,18,0,265,3,0,12,18
Tehama,2020-09-07,1,0,59,1,0,5,1
Glenn,2020-09-07,0,0,47,0,0,0,0
Lake,2020-09-07,0,0,65,0,0,3,0
Sonoma,2020-09-07,38,9,506,10,2,5,47
Nevada,2020-09-07,2,0,127,1,0,7,2
San Francisco,2020-09-07,63,15,1742,26,1,63,78
Merced,2020-09-07,22,6,253,9,2,5,28
San Luis Obispo,2020-09-07,10,2,451,4,1,21,12
Amador,2020-09-07,2,0,51,0,0,4,2
Calaveras,2020-09-07,1,1,33,1,0,6,2
San Benito,2020-09-07,1,0,25,1,0,1,1
Monterey,2020-09-07,28,0,729,8,0,20,28
Los Angeles,2020-09-07,936,414,19650,308,48,954,1350
Fresno,2020-09-07,153,16,1511,41,2,24,169
El Dorado,2020-09-07,0,0,189,0,0,12,0
Marin,2020-09-07,14,3,323,5,0,9,17
Yolo,2020-09-07,8,0,96,6,0,1,8
Tuolumne,2020-09-07,0,0,84,0,0,1,0
Humboldt,2020-09-07,1,1,269,1,1,3,2
Orange,2020-09-07,242,47,5578,70,11,222,289
Mendocino,2020-09-07,4,0,150,2,0,2,4
Tulare,2020-09-07,57,2,664,10,0,17,59
Del Norte,2020-09-07,0,0,51,0,0,6,0
San Joaquin,2020-09-07,87,12,1002,29,1,47,99
Trinity,2020-09-07,0,0,25,0,0,0,0
Plumas,2020-09-07,0,0,35,0,0,0,0
Riverside,2020-09-07,175,68,3334,60,13,91,243
Mono,2020-09-07,0,0,17,0,0,2,0
Modoc,2020-09-07,0,0,41,0,0,0,0
Lassen,2020-09-07,0,0,25,0,0,0,0
Santa Barbara,2020-09-07,39,4,666,13,1,64,43
Santa Clara,2020-09-07,118,15,2926,41,0,96,133
Napa,2020-09-07,5,2,351,1,0,19,7
Butte,2020-09-07,23,0,451,6,0,7,23
Madera,2020-09-07,25,6,274,9,0,2,31
Kern,2020-09-07,84,13,1281,26,2,51,97
Contra Costa,2020-09-07,64,18,1499,25,2,46,82
Contra Costa,2020-09-08,62,29,1505,25,4,41,91
Marin,2020-09-08,14,3,329,5,0,6,17
San Luis Obispo,2020-09-08,10,5,451,4,0,22,15
Ventura,2020-09-08,55,25,1216,24,4,49,80
Inyo,2020-09-08,0,0,29,0,0,4,0
Santa Cruz,2020-09-08,14,2,277,3,0,8,16
Calaveras,2020-09-08,1,5,33,1,0,2,6
El Dorado,2020-09-08,0,0,189,0,0,10,0
Sacramento,2020-09-08,157,46,2416,58,6,95,203
Tulare,2020-09-08,60,6,686,10,0,18,66
Siskiyou,2020-09-08,0,0,56,0,0,7,0
Fresno,2020-09-08,145,23,1520,33,3,29,168
Madera,2020-09-08,22,11,274,8,0,2,33
Alameda,2020-09-08,154,50,2388,40,7,107,204
Yuba,2020-09-08,17,0,265,3,0,10,17
Mono,2020-09-08,0,0,17,0,0,2,0
Sutter,2020-09-08,0,0,0,0,0,0,0
Kings,2020-09-08,36,2,193,3,0,9,38
Los Angeles,2020-09-08,940,415,19839,307,53,995,1355
Glenn,2020-09-08,0,0,47,0,0,0,0
San Francisco,2020-09-08,64,18,1781,25,4,73,82
Del Norte,2020-09-08,0,0,51,0,0,3,0
Santa Barbara,2020-09-08,37,2,666,11,0,67,39
Napa,2020-09-08,4,0,351,2,0,21,4
Lake,2020-09-08,1,1,65,0,0,5,2
Colusa,2020-09-08,0,2,48,0,0,0,2
Lassen,2020-09-08,0,0,25,0,0,0,0
Kern,2020-09-08,89,9,1286,26,1,51,98
Santa Clara,2020-09-08,121,16,3028,42,1,86,137
Shasta,2020-09-08,2,1,561,1,0,6,3
San Bernardino,2020-09-08,214,61,3814,84,5,172,275
Stanislaus,2020-09-08,144,50,1307,41,5,12,194
San Diego,2020-09-08,219,59,6638,81,15,332,278
Mendocino,2020-09-08,4,1,150,2,1,4,5
Modoc,2020-09-08,0,0,41,0,0,0,0
Nevada,2020-09-08,2,0,124,1,0,4,2
Amador,2020-09-08,1,0,51,0,0,6,1
San Joaquin,2020-09-08,89,18,1007,30,5,40,107
Butte,2020-09-08,24,1,451,5,1,8,25
Humboldt,2020-09-08,3,1,269,1,1,3,4
Merced,2020-09-08,20,2,253,9,1,5,22
Tuolumne,2020-09-08,0,1,84,0,1,0,1
Yolo,2020-09-08,8,0,96,5,0,2,8
Imperial,2020-09-08,22,0,259,9,0,3,22
Riverside,2020-09-08,185,76,3370,62,19,100,261
Trinity,2020-09-08,0,0,25,0,0,0,0
Tehama,2020-09-08,1,0,59,1,0,4,1
Plumas,2020-09-08,0,0,35,0,0,0,0
Solano,2020-09-08,33,10,543,8,1,10,43
Placer,2020-09-08,37,25,721,12,4,31,62
Mariposa,2020-09-08,0,0,19,0,0,0,0
Orange,2020-09-08,234,60,5578,62,14,223,294
San Mateo,2020-09-08,43,27,699,8,4,22,70
Sonoma,2020-09-08,36,6,505,11,1,4,42
Monterey,2020-09-08,30,2,729,9,0,26,32
San Benito,2020-09-08,0,0,25,0,0,2,0
Kern,2020-09-09,94,8,1305,25,2,48,102
Alameda,2020-09-09,149,40,2391,38,8,105,189
Ventura,2020-09-09,55,32,1227,25,7,36,87
Amador,2020-09-09,2,0,51,0,0,4,2
Napa,2020-09-09,5,1,351,2,0,19,6
Yolo,2020-09-09,7,2,96,5,2,4,9
Tehama,2020-09-09,1,0,59,1,0,4,1
San Joaquin,2020-09-09,83,10,1004,31,1,48,93
San Francisco,2020-09-09,66,18,1825,25,4,58,84
Tulare,2020-09-09,58,7,686,7,0,19,65
San Benito,2020-09-09,0,0,25,0,0,2,0
San Mateo,2020-09-09,47,29,720,9,5,19,76
Inyo,2020-09-09,0,0,29,0,0,3,0
Kings,2020-09-09,36,1,193,3,0,8,37
Modoc,2020-09-09,0,0,41,0,0,0,0
Sutter,2020-09-09,0,0,0,0,0,0,0
Tuolumne,2020-09-09,1,0,84,0,0,3,1
Santa Cruz,2020-09-09,12,3,277,2,1,7,15
Santa Clara,2020-09-09,127,14,3068,40,1,97,141
Monterey,2020-09-09,27,1,729,9,0,24,28
Santa Barbara,2020-09-09,38,1,666,12,0,56,39
Orange,2020-09-09,239,70,5654,64,12,226,309
Los Angeles,2020-09-09,889,365,19917,290,51,957,1254
Humboldt,2020-09-09,4,0,272,2,0,1,4
El Dorado,2020-09-09,0,0,189,0,0,10,0
Shasta,2020-09-09,3,0,561,1,0,5,3
Nevada,2020-09-09,2,0,124,1,0,6,2
Madera,2020-09-09,20,8,274,7,0,2,28
Sacramento,2020-09-09,155,35,2417,55,7,81,190
Colusa,2020-09-09,0,4,48,0,0,0,4
Yuba,2020-09-09,20,0,265,3,0,6,20
Lake,2020-09-09,1,0,65,0,0,2,1
Stanislaus,2020-09-09,136,23,1298,43,3,15,159
Riverside,2020-09-09,189,49,3385,57,10,83,238
Imperial,2020-09-09,24,0,259,10,0,4,24
Mono,2020-09-09,0,0,17,0,0,2,0
San Bernardino,2020-09-09,210,60,3836,81,6,161,270
Lassen,2020-09-09,0,0,25,0,0,0,0
Sonoma,2020-09-09,31,3,563,9,0,5,34
Del Norte,2020-09-09,0,0,51,0,0,1,0
Plumas,2020-09-09,0,0,35,0,0,0,0
Placer,2020-09-09,36,14,734,10,1,27,50
San Luis Obispo,2020-09-09,8,1,451,3,0,19,9
Mariposa,2020-09-09,0,0,19,0,0,0,0
Butte,2020-09-09,21,0,451,5,0,4,21
Glenn,2020-09-09,0,0,47,0,0,0,0
Calaveras,2020-09-09,2,3,33,2,1,4,5
Contra Costa,2020-09-09,62,19,1490,26,2,35,81
Siskiyou,2020-09-09,0,0,56,0,0,7,0
Fresno,2020-09-09,133,24,1526,30,4,29,157
Mendocino,2020-09-09,1,0,150,1,0,5,1
Solano,2020-09-09,29,10,558,7,1,9,39
Merced,2020-09-09,18,1,253,9,0,7,19
Marin,2020-09-09,13,6,324,4,2,5,19
Trinity,2020-09-09,0,0,25,0,0,0,0
San Diego,2020-09-09,234,75,6648,86,13,302,309
Yolo,2020-09-10,7,1,96,4,1,3,8
Amador,2020-09-10,2,0,51,0,0,4,2
Santa Barbara,2020-09-10,36,3,666,9,1,54,39
Lake,2020-09-10,0,2,65,0,0,2,2
Trinity,2020-09-10,0,0,25,0,0,0,0
Humboldt,2020-09-10,4,1,272,2,0,1,5
Contra Costa,2020-09-10,66,17,1508,25,4,41,83
San Francisco,2020-09-10,67,22,1839,24,8,58,89
Sutter,2020-09-10,0,0,0,0,0,0,0
Kings,2020-09-10,31,1,193,3,0,8,32
Mono,2020-09-10,0,0,17,0,0,2,0
Mariposa,2020-09-10,0,0,19,0,0,0,0
Del Norte,2020-09-10,0,0,51,0,0,3,0
San Benito,2020-09-10,0,0,25,0,0,2,0
San Luis Obispo,2020-09-10,7,3,451,3,1,18,10
Santa Clara,2020-09-10,114,18,3067,39,3,89,132
Colusa,2020-09-10,0,2,48,0,0,0,2
Kern,2020-09-10,82,3,1303,20,1,55,85
Lassen,2020-09-10,0,0,25,0,0,0,0
Napa,2020-09-10,4,1,351,2,0,17,5
Modoc,2020-09-10,0,0,41,0,0,0,0
Marin,2020-09-10,10,6,325,3,0,9,16
Placer,2020-09-10,34,25,738,10,4,26,59
San Mateo,2020-09-10,34,17,706,11,5,33,51
Ventura,2020-09-10,55,35,1236,20,7,43,90
San Joaquin,2020-09-10,75,9,1005,32,2,33,84
Mendocino,2020-09-10,2,0,150,1,0,6,2
Sacramento,2020-09-10,151,32,2451,53,8,82,183
El Dorado,2020-09-10,1,0,189,1,0,7,1
Santa Cruz,2020-09-10,14,1,277,2,0,11,15
Los Angeles,2020-09-10,877,342,19990,301,49,924,1219
Nevada,2020-09-10,3,0,119,1,0,1,3
Madera,2020-09-10,19,5,274,7,0,2,24
Sonoma,2020-09-10,31,3,529,11,0,7,34
San Bernardino,2020-09-10,205,54,3848,74,4,156,259
Orange,2020-09-10,223,54,5614,65,10,236,277
Fresno,2020-09-10,122,21,1524,29,4,33,143
Tulare,2020-09-10,53,6,686,6,0,20,59
Imperial,2020-09-10,22,0,259,9,0,7,22
Monterey,2020-09-10,28,0,729,9,0,29,28
Yuba,2020-09-10,19,0,265,4,0,9,19
Solano,2020-09-10,27,8,566,6,3,8,35
Glenn,2020-09-10,0,0,47,0,0,0,0
Stanislaus,2020-09-10,125,30,1305,41,3,15,155
Tehama,2020-09-10,1,0,59,1,0,4,1
Alameda,2020-09-10,142,41,2432,39,6,88,183
Inyo,2020-09-10,0,0,29,0,0,3,0
Shasta,2020-09-10,3,0,561,1,0,5,3
Butte,2020-09-10,17,0,451,4,0,8,17
Tuolumne,2020-09-10,1,0,84,0,0,1,1
San Diego,2020-09-10,232,53,6636,87,11,287,285
Siskiyou,2020-09-10,1,0,56,0,0,8,1
Calaveras,2020-09-10,2,5,33,2,2,3,7
Merced,2020-09-10,13,9,253,9,0,5,22
Riverside,2020-09-10,180,51,3400,53,12,93,231
Plumas,2020-09-10,0,0,35,0,0,0,0
Yolo,2020-09-11,5,0,96,5,0,2,5
Inyo,2020-09-11,0,0,29,0,0,3,0
San Bernardino,2020-09-11,201,49,3846,67,10,149,250
Calaveras,2020-09-11,2,1,33,2,0,4,3
Colusa,2020-09-11,0,3,48,0,0,0,3
Amador,2020-09-11,2,0,51,0,0,3,2
Stanislaus,2020-09-11,119,44,1310,44,2,18,163
Kern,2020-09-11,66,17,1317,20,1,50,83
Fresno,2020-09-11,112,15,1536,29,1,37,127
Contra Costa,2020-09-11,73,20,1534,25,3,40,93
Santa Cruz,2020-09-11,16,0,276,2,0,7,16
Del Norte,2020-09-11,0,0,51,0,0,2,0
Monterey,2020-09-11,28,1,729,9,0,33,29
Alameda,2020-09-11,131,47,2444,33,10,100,178
San Diego,2020-09-11,227,60,6637,88,12,281,287
Los Angeles,2020-09-11,813,345,20020,275,59,942,1158
Merced,2020-09-11,15,1,253,8,0,2,16
San Francisco,2020-09-11,74,18,1831,22,4,67,92
Humboldt,2020-09-11,2,1,275,2,0,4,3
Butte,2020-09-11,11,0,451,3,0,8,11
Trinity,2020-09-11,0,0,25,0,0,0,0
Placer,2020-09-11,34,18,740,10,1,32,52
Modoc,2020-09-11,0,0,41,0,0,0,0
San Benito,2020-09-11,0,0,25,0,0,3,0
Glenn,2020-09-11,0,0,47,0,0,0,0
Shasta,2020-09-11,3,0,561,1,0,5,3
Mariposa,2020-09-11,0,0,19,0,0,0,0
Riverside,2020-09-11,171,61,3417,45,14,85,232
Sacramento,2020-09-11,135,26,2448,50,7,79,161
Marin,2020-09-11,9,2,325,2,1,10,11
Tulare,2020-09-11,47,3,686,7,0,22,50
Plumas,2020-09-11,0,0,35,0,0,0,0
Santa Clara,2020-09-11,112,20,3067,41,1,82,132
San Mateo,2020-09-11,38,10,701,11,5,36,48
Madera,2020-09-11,18,7,274,6,0,3,25
Solano,2020-09-11,25,8,578,6,2,6,33
Siskiyou,2020-09-11,1,0,56,0,0,6,1
Nevada,2020-09-11,2,1,111,1,0,1,3
Tehama,2020-09-11,2,0,59,1,0,2,2
Sutter,2020-09-11,0,0,0,0,0,0,0
Imperial,2020-09-11,25,0,259,9,0,12,25
Mendocino,2020-09-11,3,0,150,1,0,6,3
Mono,2020-09-11,0,0,17,0,0,1,0
San Luis Obispo,2020-09-11,7,3,451,3,1,18,10
Santa Barbara,2020-09-11,33,4,666,8,1,57,37
El Dorado,2020-09-11,1,1,189,1,1,6,2
Yuba,2020-09-11,20,1,265,4,0,9,21
Napa,2020-09-11,5,0,351,2,0,15,5
Tuolumne,2020-09-11,1,0,84,0,0,2,1
Kings,2020-09-11,31,0,193,3,0,9,31
Lassen,2020-09-11,0,0,25,0,0,0,0
Sonoma,2020-09-11,32,3,536,9,1,9,35
San Joaquin,2020-09-11,68,15,1004,29,1,41,83
Ventura,2020-09-11,55,25,1248,21,5,44,80
Orange,2020-09-11,215,47,5666,65,6,245,262
Lake,2020-09-11,0,1,65,0,1,4,1
Shasta,2020-09-12,2,1,561,1,0,5,3
Plumas,2020-09-12,0,0,35,0,0,0,0
Mendocino,2020-09-12,4,0,150,1,0,6,4
Napa,2020-09-12,5,1,351,2,0,16,6
San Benito,2020-09-12,1,0,25,0,0,4,1
El Dorado,2020-09-12,2,0,189,1,0,6,2
Nevada,2020-09-12,3,0,111,0,0,4,3
Merced,2020-09-12,15,1,253,9,0,1,16
Madera,2020-09-12,17,11,274,6,0,4,28
San Francisco,2020-09-12,72,15,1820,20,6,68,87
Inyo,2020-09-12,0,0,29,0,0,3,0
Mono,2020-09-12,0,0,17,0,0,2,0
Tuolumne,2020-09-12,2,0,84,1,0,1,2
Santa Clara,2020-09-12,107,19,2888,39,2,97,126
Ventura,2020-09-12,50,13,1201,24,4,50,63
Glenn,2020-09-12,0,0,47,0,0,0,0
Marin,2020-09-12,10,1,318,2,0,9,11
Tulare,2020-09-12,46,3,664,7,1,24,49
Modoc,2020-09-12,0,0,41,0,0,0,0
Tehama,2020-09-12,2,0,59,1,0,3,2
Del Norte,2020-09-12,0,0,51,0,0,4,0
Monterey,2020-09-12,27,1,729,9,0,31,28
Kern,2020-09-12,70,11,1311,15,1,51,81
Solano,2020-09-12,27,7,594,7,0,9,34
Santa Cruz,2020-09-12,16,0,276,2,0,7,16
Sonoma,2020-09-12,36,1,511,8,0,12,37
Siskiyou,2020-09-12,1,0,56,0,0,7,1
Los Angeles,2020-09-12,775,375,19884,261,47,971,1150
Sacramento,2020-09-12,128,47,2427,49,9,82,175
Mariposa,2020-09-12,0,0,19,0,0,0,0
Lassen,2020-09-12,0,0,25,0,0,0,0
Sutter,2020-09-12,0,0,0,0,0,0,0
San Diego,2020-09-12,218,59,6634,80,7,283,277
Riverside,2020-09-12,157,43,3362,46,10,92,200
Stanislaus,2020-09-12,114,34,1310,39,3,20,148
San Luis Obispo,2020-09-12,8,2,451,3,0,21,10
Orange,2020-09-12,196,42,5767,58,5,235,238
Contra Costa,2020-09-12,69,19,1541,24,3,40,88
San Mateo,2020-09-12,39,17,698,11,7,34,56
San Joaquin,2020-09-12,70,6,1005,28,1,51,76
Placer,2020-09-12,38,22,745,10,1,29,60
Santa Barbara,2020-09-12,30,1,666,8,0,59,31
Butte,2020-09-12,12,0,451,1,0,8,12
Trinity,2020-09-12,0,0,25,0,0,0,0
Colusa,2020-09-12,0,3,48,0,0,0,3
Yuba,2020-09-12,20,2,265,4,0,9,22
Kings,2020-09-12,23,0,193,3,0,10,23
Amador,2020-09-12,0,1,51,0,1,3,1
Calaveras,2020-09-12,2,3,33,2,0,4,5
Imperial,2020-09-12,27,0,259,9,0,6,27
Fresno,2020-09-12,111,26,1507,34,5,31,137
Humboldt,2020-09-12,2,1,277,2,0,1,3
Yolo,2020-09-12,4,0,96,4,0,3,4
Alameda,2020-09-12,121,47,2419,35,9,102,168
San Bernardino,2020-09-12,190,36,3800,66,2,170,226
Lake,2020-09-12,0,1,65,0,0,3,1
Mono,2020-09-13,0,0,17,0,0,0,0
Mendocino,2020-09-13,3,0,150,1,0,6,3
Santa Clara,2020-09-13,111,18,2956,41,2,97,129
Riverside,2020-09-13,151,49,3363,48,10,95,200
San Francisco,2020-09-13,76,18,1816,21,5,79,94
Butte,2020-09-13,15,0,451,3,0,5,15
Amador,2020-09-13,0,0,51,0,0,4,0
Sutter,2020-09-13,0,0,0,0,0,0,0
Kings,2020-09-13,27,0,193,3,0,9,27
Lassen,2020-09-13,0,0,25,0,0,0,0
Fresno,2020-09-13,101,21,1501,31,4,29,122
Yuba,2020-09-13,18,1,265,5,0,15,19
Marin,2020-09-13,11,5,322,3,0,10,16
Colusa,2020-09-13,0,3,48,0,0,0,3
Siskiyou,2020-09-13,1,0,56,0,0,6,1
Imperial,2020-09-13,21,1,259,7,0,5,22
Kern,2020-09-13,69,4,1309,18,1,51,73
Humboldt,2020-09-13,1,1,277,1,0,1,2
Tehama,2020-09-13,2,0,59,1,0,1,2
Ventura,2020-09-13,42,17,1194,20,3,55,59
San Benito,2020-09-13,2,0,25,1,0,3,2
Orange,2020-09-13,193,45,5716,56,6,238,238
San Luis Obispo,2020-09-13,8,0,451,4,0,26,8
Napa,2020-09-13,7,1,351,4,0,19,8
Mariposa,2020-09-13,0,0,19,0,0,0,0
Madera,2020-09-13,19,6,274,5,1,5,25
Plumas,2020-09-13,0,0,35,0,0,0,0
San Joaquin,2020-09-13,66,21,1000,28,3,51,87
Contra Costa,2020-09-13,70,21,1539,28,2,51,91
Tuolumne,2020-09-13,1,0,84,0,0,2,1
Lake,2020-09-13,0,1,65,0,0,3,1
Stanislaus,2020-09-13,114,32,1309,34,3,22,146
Sonoma,2020-09-13,36,3,466,9,0,10,39
Merced,2020-09-13,12,2,253,7,1,1,14
Inyo,2020-09-13,0,0,29,0,0,4,0
San Bernardino,2020-09-13,183,34,3795,65,4,139,217
San Diego,2020-09-13,225,61,6624,79,11,327,286
Monterey,2020-09-13,28,0,729,8,0,36,28
Santa Barbara,2020-09-13,32,1,666,8,0,60,33
Shasta,2020-09-13,2,1,561,0,0,7,3
Calaveras,2020-09-13,2,0,33,2,0,4,2
Placer,2020-09-13,33,16,742,9,2,33,49
Modoc,2020-09-13,0,0,41,0,0,0,0
Yolo,2020-09-13,4,0,96,3,0,5,4
Glenn,2020-09-13,0,0,47,0,0,0,0
Alameda,2020-09-13,115,47,2418,33,9,118,162
Sacramento,2020-09-13,129,38,2466,47,7,91,167
Solano,2020-09-13,31,7,587,8,0,8,38
Santa Cruz,2020-09-13,17,0,276,2,0,9,17
Trinity,2020-09-13,0,0,25,0,0,0,0
El Dorado,2020-09-13,2,0,189,2,0,8,2
Nevada,2020-09-13,4,0,98,0,0,4,4
San Mateo,2020-09-13,43,12,695,11,5,39,55
Los Angeles,2020-09-13,772,330,19838,258,40,1010,1102
Tulare,2020-09-13,42,5,664,7,0,25,47
Del Norte,2020-09-13,0,2,53,0,0,5,2
Mendocino,2020-09-14,5,0,150,1,0,5,5
Sacramento,2020-09-14,116,39,2456,46,7,102,155
Glenn,2020-09-14,0,0,47,0,0,0,0
Napa,2020-09-14,7,2,351,4,0,18,9
Kings,2020-09-14,26,0,193,3,0,9,26
Alameda,2020-09-14,118,37,2385,33,8,117,155
Orange,2020-09-14,201,51,5480,67,10,268,252
Ventura,2020-09-14,47,17,1215,19,5,49,64
Solano,2020-09-14,36,5,563,8,0,10,41
Mono,2020-09-14,0,0,17,0,0,2,0
Amador,2020-09-14,0,0,51,0,0,6,0
Humboldt,2020-09-14,1,3,275,1,0,4,4
Tuolumne,2020-09-14,1,0,84,0,0,2,1
Calaveras,2020-09-14,2,0,33,2,0,3,2
Tehama,2020-09-14,2,0,59,1,0,4,2
San Mateo,2020-09-14,38,12,676,10,5,34,50
Del Norte,2020-09-14,0,1,53,0,0,4,1
Yuba,2020-09-14,18,1,265,5,0,14,19
Inyo,2020-09-14,1,0,29,0,0,4,1
Lake,2020-09-14,0,1,65,0,0,4,1
Imperial,2020-09-14,20,1,259,6,0,6,21
Nevada,2020-09-14,4,1,100,0,0,6,5
San Luis Obispo,2020-09-14,9,0,451,4,0,23,9
Sonoma,2020-09-14,34,4,517,8,0,8,38
San Diego,2020-09-14,225,48,6604,76,16,322,273
Plumas,2020-09-14,0,0,35,0,0,0,0
Colusa,2020-09-14,0,3,48,0,0,0,3
San Benito,2020-09-14,1,0,25,0,0,3,1
Monterey,2020-09-14,28,0,729,9,0,40,28
Contra Costa,2020-09-14,67,25,1533,26,2,54,92
Santa Barbara,2020-09-14,30,2,666,8,1,62,32
Los Angeles,2020-09-14,804,343,19858,244,56,1023,1147
Mariposa,2020-09-14,0,0,19,0,0,0,0
Fresno,2020-09-14,118,28,1502,33,2,30,146
Siskiyou,2020-09-14,0,0,56,0,0,8,0
Modoc,2020-09-14,0,0,41,0,0,0,0
Santa Cruz,2020-09-14,18,0,276,2,0,9,18
Riverside,2020-09-14,155,49,3342,49,12,95,204
San Francisco,2020-09-14,78,12,1817,21,5,86,90
Santa Clara,2020-09-14,108,15,3052,38,2,110,123
Stanislaus,2020-09-14,113,30,1316,34,4,22,143
Placer,2020-09-14,31,20,738,9,2,31,51
Yolo,2020-09-14,4,0,96,3,0,4,4
El Dorado,2020-09-14,1,0,189,1,0,12,1
Sutter,2020-09-14,0,0,0,0,0,0,0
Shasta,2020-09-14,2,0,561,0,0,5,2
Lassen,2020-09-14,0,0,25,0,0,0,0
Tulare,2020-09-14,39,7,678,6,0,22,46
Kern,2020-09-14,76,5,1297,20,0,55,81
San Joaquin,2020-09-14,61,21,997,25,2,48,82
Merced,2020-09-14,11,1,253,5,0,3,12
San Bernardino,2020-09-14,186,53,3828,63,2,148,239
Butte,2020-09-14,14,0,451,3,0,6,14
Trinity,2020-09-14,0,0,25,0,0,0,0
Madera,2020-09-14,21,4,274,6,0,5,25
Marin,2020-09-14,10,7,326,3,1,9,17
Kern,2020-09-15,71,6,1330,17,0,54,77
Orange,2020-09-15,202,56,5636,67,17,229,258
Inyo,2020-09-15,0,0,29,0,0,3,0
Napa,2020-09-15,6,0,351,3,0,19,6
Alameda,2020-09-15,110,44,2395,34,8,118,154
Placer,2020-09-15,30,13,743,9,2,30,43
Amador,2020-09-15,0,0,51,0,0,6,0
El Dorado,2020-09-15,0,0,189,0,0,11,0
Modoc,2020-09-15,0,0,41,0,0,0,0
Lassen,2020-09-15,0,0,25,0,0,0,0
Tuolumne,2020-09-15,1,0,84,0,0,2,1
Nevada,2020-09-15,3,1,111,0,0,4,4
Contra Costa,2020-09-15,60,17,1510,23,1,53,77
Butte,2020-09-15,10,0,451,3,0,8,10
Madera,2020-09-15,21,9,274,4,2,6,30
Mariposa,2020-09-15,0,0,19,0,0,0,0
San Francisco,2020-09-15,68,13,1880,22,3,80,81
Imperial,2020-09-15,21,1,259,6,0,7,22
Colusa,2020-09-15,3,0,48,0,0,0,3
Yuba,2020-09-15,19,0,265,5,0,16,19
Trinity,2020-09-15,0,0,25,0,0,0,0
Marin,2020-09-15,9,2,318,1,0,10,11
Ventura,2020-09-15,52,15,1225,20,3,51,67
Lake,2020-09-15,0,0,65,0,0,2,0
Merced,2020-09-15,11,5,253,6,1,4,16
Santa Cruz,2020-09-15,19,0,276,2,0,7,19
Monterey,2020-09-15,26,3,729,8,0,36,29
Siskiyou,2020-09-15,0,1,56,0,0,9,1
San Bernardino,2020-09-15,180,57,3845,55,6,144,237
Yolo,2020-09-15,3,0,96,1,0,5,3
Humboldt,2020-09-15,1,2,275,1,0,2,3
Stanislaus,2020-09-15,109,29,1313,35,3,20,138
Plumas,2020-09-15,0,0,35,0,0,0,0
Calaveras,2020-09-15,1,1,33,1,1,6,2
Los Angeles,2020-09-15,780,348,20011,238,56,968,1128
San Luis Obispo,2020-09-15,10,3,451,4,0,22,13
Tulare,2020-09-15,40,13,678,5,1,19,53
Santa Clara,2020-09-15,103,15,3058,41,3,101,118
Mendocino,2020-09-15,5,0,150,1,0,6,5
San Mateo,2020-09-15,40,12,684,11,7,21,52
San Diego,2020-09-15,220,55,6621,78,14,303,275
Riverside,2020-09-15,155,62,3402,47,16,102,217
Sonoma,2020-09-15,33,2,556,8,0,7,35
Del Norte,2020-09-15,0,0,51,0,0,2,0
Mono,2020-09-15,0,0,17,0,0,2,0
Tehama,2020-09-15,1,0,59,0,0,4,1
Sutter,2020-09-15,0,0,0,0,0,0,0
Shasta,2020-09-15,2,0,561,0,0,3,2
Santa Barbara,2020-09-15,28,3,666,7,2,63,31
Fresno,2020-09-15,117,20,1524,32,3,25,137
San Benito,2020-09-15,1,0,25,0,0,2,1
Sacramento,2020-09-15,127,34,2502,44,8,88,161
San Joaquin,2020-09-15,62,18,1003,25,0,49,80
Kings,2020-09-15,26,0,193,3,0,9,26
Glenn,2020-09-15,0,0,47,0,0,0,0
Solano,2020-09-15,35,4,572,8,0,7,39
Lassen,2020-09-16,0,0,25,0,0,0,0
Nevada,2020-09-16,3,0,125,0,0,6,3
Sonoma,2020-09-16,32,2,527,8,0,6,34
Del Norte,2020-09-16,0,0,51,0,0,0,0
Sutter,2020-09-16,0,0,0,0,0,0,0
El Dorado,2020-09-16,0,0,189,0,0,10,0
Tehama,2020-09-16,1,0,59,1,0,4,1
San Joaquin,2020-09-16,58,14,1010,22,4,37,72
San Benito,2020-09-16,1,0,25,0,0,3,1
Santa Barbara,2020-09-16,23,2,666,4,1,55,25
Santa Cruz,2020-09-16,18,0,276,2,0,9,18
Butte,2020-09-16,10,1,451,3,0,8,11
Yuba,2020-09-16,20,1,265,6,1,10,21
San Mateo,2020-09-16,39,14,702,14,7,16,53
Merced,2020-09-16,14,1,253,5,0,5,15
Alameda,2020-09-16,101,46,2401,33,4,121,147
Kern,2020-09-16,70,3,1325,17,0,54,73
Monterey,2020-09-16,31,0,729,9,0,34,31
Mariposa,2020-09-16,0,0,19,0,0,0,0
Orange,2020-09-16,198,53,5632,64,13,250,251
San Bernardino,2020-09-16,186,59,3844,58,9,145,245
Ventura,2020-09-16,48,13,1234,16,4,49,61
San Luis Obispo,2020-09-16,11,1,451,5,0,21,12
Sacramento,2020-09-16,108,35,2363,43,8,87,143
Lake,2020-09-16,0,0,65,0,0,1,0
Amador,2020-09-16,0,0,51,0,0,3,0
Imperial,2020-09-16,22,1,259,7,0,6,23
Siskiyou,2020-09-16,1,0,56,0,0,9,1
Trinity,2020-09-16,0,0,25,0,0,0,0
Stanislaus,2020-09-16,99,32,1305,33,3,27,131
Santa Clara,2020-09-16,103,15,3086,42,1,85,118
Fresno,2020-09-16,100,26,1534,31,0,25,126
Inyo,2020-09-16,0,0,29,0,0,4,0
Madera,2020-09-16,18,11,274,2,0,9,29
Calaveras,2020-09-16,1,0,33,1,0,6,1
Colusa,2020-09-16,2,1,48,0,0,0,3
Contra Costa,2020-09-16,53,28,1502,22,4,45,81
Los Angeles,2020-09-16,739,379,20004,232,40,958,1118
Modoc,2020-09-16,0,0,41,0,0,0,0
Mono,2020-09-16,0,0,17,0,0,2,0
Kings,2020-09-16,20,0,193,3,0,8,20
Riverside,2020-09-16,158,60,3408,48,15,92,218
Solano,2020-09-16,32,6,580,8,0,11,38
Tuolumne,2020-09-16,1,0,84,0,0,2,1
Mendocino,2020-09-16,6,1,150,1,0,4,7
Plumas,2020-09-16,0,0,35,0,0,0,0
Humboldt,2020-09-16,1,2,267,0,1,5,3
Marin,2020-09-16,11,5,317,2,0,8,16
Tulare,2020-09-16,43,10,678,6,1,20,53
San Diego,2020-09-16,224,60,6620,79,12,306,284
Glenn,2020-09-16,0,0,47,0,0,0,0
Yolo,2020-09-16,3,0,96,2,0,3,3
Napa,2020-09-16,4,2,351,2,0,24,6
Placer,2020-09-16,29,15,746,9,1,26,44
San Francisco,2020-09-16,64,14,1881,20,8,68,78
Shasta,2020-09-16,2,0,561,0,0,9,2
Napa,2020-09-17,4,3,351,2,0,24,7
Nevada,2020-09-17,2,0,119,0,0,5,2
Colusa,2020-09-17,2,2,48,0,0,0,4
Solano,2020-09-17,29,17,586,6,3,9,46
Plumas,2020-09-17,0,0,35,0,0,0,0
Amador,2020-09-17,0,0,51,0,0,5,0
Del Norte,2020-09-17,0,0,51,0,0,0,0
Santa Cruz,2020-09-17,18,0,276,2,0,10,18
Santa Clara,2020-09-17,114,16,3087,37,1,89,130
Marin,2020-09-17,10,9,320,2,1,9,19
Sonoma,2020-09-17,30,1,577,8,0,10,31
Shasta,2020-09-17,2,0,561,0,0,7,2
Glenn,2020-09-17,0,0,47,0,0,0,0
Tuolumne,2020-09-17,1,0,84,0,0,2,1
Mariposa,2020-09-17,0,0,19,0,0,0,0
Imperial,2020-09-17,20,0,259,8,0,5,20
Lake,2020-09-17,0,2,65,0,0,2,2
Modoc,2020-09-17,0,0,41,0,0,0,0
Kern,2020-09-17,74,2,1304,21,0,57,76
Merced,2020-09-17,11,0,253,5,0,9,11
Stanislaus,2020-09-17,98,21,1313,30,3,19,119
Calaveras,2020-09-17,0,0,33,0,0,6,0
Mendocino,2020-09-17,6,1,150,1,0,4,7
Butte,2020-09-17,9,0,451,3,0,13,9
Santa Barbara,2020-09-17,27,3,666,5,0,56,30
Riverside,2020-09-17,143,67,3379,44,12,82,210
Ventura,2020-09-17,46,20,1243,18,6,47,66
Yuba,2020-09-17,23,1,265,6,1,10,24
Fresno,2020-09-17,98,33,1548,30,1,23,131
Los Angeles,2020-09-17,732,340,20066,228,36,941,1072
Tulare,2020-09-17,38,9,678,6,0,21,47
San Diego,2020-09-17,217,59,6630,77,14,286,276
Tehama,2020-09-17,1,0,59,0,0,5,1
San Joaquin,2020-09-17,60,13,1003,25,2,35,73
Orange,2020-09-17,201,59,5596,64,11,237,260
Sacramento,2020-09-17,109,32,2485,34,10,101,141
San Benito,2020-09-17,2,0,25,0,0,2,2
San Mateo,2020-09-17,39,10,704,13,1,31,49
Alameda,2020-09-17,98,37,2411,31,5,117,135
Monterey,2020-09-17,30,0,702,8,0,33,30
San Francisco,2020-09-17,67,19,1806,23,7,61,86
Trinity,2020-09-17,0,0,25,0,0,0,0
Kings,2020-09-17,23,0,193,4,0,8,23
Yolo,2020-09-17,5,0,96,2,0,2,5
El Dorado,2020-09-17,0,0,189,0,0,10,0
San Bernardino,2020-09-17,172,51,3832,55,8,146,223
Inyo,2020-09-17,0,0,29,0,0,4,0
Mono,2020-09-17,0,0,17,0,0,2,0
Placer,2020-09-17,26,28,746,9,0,32,54
Madera,2020-09-17,19,10,274,2,1,12,29
Humboldt,2020-09-17,1,3,267,0,1,4,4
Sutter,2020-09-17,0,0,0,0,0,0,0
San Luis Obispo,2020-09-17,13,1,451,6,0,25,14
Contra Costa,2020-09-17,55,25,1510,21,5,57,80
Lassen,2020-09-17,0,0,25,0,0,0,0
Siskiyou,2020-09-17,1,0,56,0,0,9,1
Alameda,2020-09-18,99,39,2415,36,5,113,138
Del Norte,2020-09-18,0,0,51,0,0,1,0
Sutter,2020-09-18,0,0,0,0,0,0,0
Nevada,2020-09-18,3,0,132,0,0,3,3
Merced,2020-09-18,9,2,254,5,1,9,11
Madera,2020-09-18,13,12,274,3,2,5,25
Santa Clara,2020-09-18,114,19,3097,39,2,97,133
Shasta,2020-09-18,4,0,561,0,0,8,4
Riverside,2020-09-18,148,51,3404,46,8,102,199
Monterey,2020-09-18,34,1,702,8,1,38,35
Sonoma,2020-09-18,23,4,513,6,0,10,27
Tulare,2020-09-18,38,6,678,6,0,24,44
Tehama,2020-09-18,1,0,59,0,0,4,1
San Bernardino,2020-09-18,169,47,3832,50,10,156,216
Orange,2020-09-18,202,50,5704,65,9,239,252
Mariposa,2020-09-18,0,0,19,0,0,0,0
San Diego,2020-09-18,208,41,6631,71,11,284,249
Tuolumne,2020-09-18,1,0,84,0,0,2,1
Inyo,2020-09-18,0,0,29,0,0,4,0
Kings,2020-09-18,24,0,193,5,0,9,24
Sacramento,2020-09-18,110,41,2465,41,9,92,151
Lassen,2020-09-18,0,0,25,0,0,0,0
Glenn,2020-09-18,0,0,47,0,0,0,0
Santa Cruz,2020-09-18,17,0,276,2,0,10,17
Imperial,2020-09-18,19,0,259,8,0,7,19
Modoc,2020-09-18,0,0,41,0,0,0,0
San Francisco,2020-09-18,64,12,1872,20,4,62,76
San Mateo,2020-09-18,39,9,715,15,1,29,48
Lake,2020-09-18,0,1,66,0,1,3,1
Ventura,2020-09-18,48,13,1256,21,3,51,61
Placer,2020-09-18,26,28,747,8,4,30,54
Calaveras,2020-09-18,0,1,33,0,0,7,1
Kern,2020-09-18,66,4,1320,18,0,57,70
Stanislaus,2020-09-18,95,25,1316,30,1,29,120
San Luis Obispo,2020-09-18,11,1,451,4,0,24,12
Plumas,2020-09-18,0,0,35,0,0,0,0
El Dorado,2020-09-18,0,0,189,0,0,8,0
Los Angeles,2020-09-18,765,363,20006,227,46,941,1128
San Joaquin,2020-09-18,55,9,1002,24,1,37,64
Trinity,2020-09-18,0,0,25,0,0,0,0
Siskiyou,2020-09-18,1,0,56,0,0,9,1
Santa Barbara,2020-09-18,26,2,666,3,1,60,28
Marin,2020-09-18,7,4,317,2,0,9,11
Humboldt,2020-09-18,2,2,272,0,1,1,4
Solano,2020-09-18,27,10,593,7,0,7,37
Yolo,2020-09-18,4,0,96,2,0,4,4
Yuba,2020-09-18,21,1,265,6,0,8,22
Fresno,2020-09-18,96,18,1538,31,1,21,114
Mono,2020-09-18,0,0,17,0,0,2,0
Colusa,2020-09-18,2,1,48,0,0,0,3
Mendocino,2020-09-18,5,0,150,2,0,5,5
San Benito,2020-09-18,3,0,25,0,0,1,3
Napa,2020-09-18,5,0,359,3,0,22,5
Amador,2020-09-18,0,0,51,0,0,4,0
Contra Costa,2020-09-18,45,29,1499,20,8,56,74
Butte,2020-09-18,14,1,451,5,1,10,15
Kern,2020-09-19,72,4,1308,21,0,69,76
Amador,2020-09-19,0,0,51,0,0,4,0
Orange,2020-09-19,185,52,5674,65,7,246,237
Marin,2020-09-19,7,5,317,2,0,9,12
Shasta,2020-09-19,3,0,561,0,0,11,3
Tuolumne,2020-09-19,1,0,84,0,0,2,1
Sacramento,2020-09-19,114,34,2471,43,6,95,148
Glenn,2020-09-19,0,0,47,0,0,0,0
Sutter,2020-09-19,0,0,0,0,0,0,0
Riverside,2020-09-19,138,54,3359,47,7,105,192
Napa,2020-09-19,4,0,359,2,0,26,4
Plumas,2020-09-19,0,0,35,0,0,0,0
Santa Clara,2020-09-19,111,20,3097,38,1,102,131
San Francisco,2020-09-19,58,9,1874,18,2,61,67
Solano,2020-09-19,26,11,593,6,0,7,37
Del Norte,2020-09-19,0,0,51,0,0,2,0
Nevada,2020-09-19,3,0,82,0,0,2,3
San Benito,2020-09-19,3,0,25,1,0,1,3
San Mateo,2020-09-19,39,6,707,13,0,32,45
Butte,2020-09-19,16,1,451,4,0,17,17
San Luis Obispo,2020-09-19,10,2,451,4,0,19,12
Ventura,2020-09-19,48,11,1251,18,4,54,59
Inyo,2020-09-19,0,0,29,0,0,4,0
San Bernardino,2020-09-19,167,54,3800,45,11,169,221
Trinity,2020-09-19,0,0,25,0,0,0,0
San Joaquin,2020-09-19,57,10,1002,24,0,39,67
Sonoma,2020-09-19,22,6,526,6,0,6,28
Humboldt,2020-09-19,2,2,272,0,1,1,4
Yolo,2020-09-19,5,0,96,2,0,4,5
Alameda,2020-09-19,95,48,2416,37,5,112,143
Kings,2020-09-19,20,0,193,4,0,11,20
Siskiyou,2020-09-19,0,1,56,0,0,9,1
Monterey,2020-09-19,32,2,702,7,2,30,34
Santa Barbara,2020-09-19,23,3,666,4,0,64,26
El Dorado,2020-09-19,0,0,189,0,0,6,0
Yuba,2020-09-19,21,1,265,6,0,6,22
Stanislaus,2020-09-19,94,18,1316,33,1,29,112
Fresno,2020-09-19,92,23,1541,28,4,30,115
Los Angeles,2020-09-19,749,328,19792,207,48,967,1077
San Diego,2020-09-19,203,50,6634,72,10,314,253
Imperial,2020-09-19,18,0,259,8,0,7,18
Lassen,2020-09-19,0,0,25,0,0,0,0
Mono,2020-09-19,0,0,17,0,0,2,0
Colusa,2020-09-19,2,3,48,0,0,0,5
Merced,2020-09-19,9,0,253,6,0,9,9
Contra Costa,2020-09-19,51,25,1499,18,5,49,76
Tulare,2020-09-19,36,8,664,4,0,26,44
Tehama,2020-09-19,2,0,59,0,0,4,2
Placer,2020-09-19,24,30,747,8,4,31,54
Mariposa,2020-09-19,0,0,19,0,0,0,0
Calaveras,2020-09-19,0,0,33,0,0,7,0
Madera,2020-09-19,14,11,274,3,0,8,25
Santa Cruz,2020-09-19,17,0,276,2,0,9,17
Modoc,2020-09-19,0,0,41,0,0,0,0
Mendocino,2020-09-19,5,0,150,1,0,8,5
Lake,2020-09-19,0,2,65,0,0,4,2
Santa Barbara,2020-09-20,23,3,666,5,1,64,26
Solano,2020-09-20,26,10,593,5,0,9,36
Mono,2020-09-20,0,0,17,0,0,2,0
Kern,2020-09-20,67,4,1281,19,0,64,71
Fresno,2020-09-20,92,13,1528,30,2,29,105
Shasta,2020-09-20,3,0,561,0,0,16,3
Sacramento,2020-09-20,120,30,2427,42,8,123,150
Del Norte,2020-09-20,0,1,51,0,1,3,1
Sonoma,2020-09-20,21,6,531,5,0,8,27
Imperial,2020-09-20,20,0,259,8,0,7,20
Placer,2020-09-20,22,28,747,8,3,34,50
El Dorado,2020-09-20,0,0,189,0,0,6,0
Mariposa,2020-09-20,0,0,19,0,0,0,0
Colusa,2020-09-20,3,3,48,0,0,0,6
Kings,2020-09-20,19,0,193,3,0,14,19
Alameda,2020-09-20,98,46,2415,38,8,108,144
Inyo,2020-09-20,0,0,29,0,0,4,0
Humboldt,2020-09-20,2,2,272,0,1,1,4
Plumas,2020-09-20,0,0,35,0,0,0,0
Siskiyou,2020-09-20,0,1,56,0,0,9,1
Trinity,2020-09-20,0,0,25,0,0,0,0
San Diego,2020-09-20,211,56,6626,73,12,300,267
Modoc,2020-09-20,0,0,41,0,0,0,0
Marin,2020-09-20,8,4,317,2,0,10,12
Santa Cruz,2020-09-20,17,0,276,2,0,9,17
Calaveras,2020-09-20,0,0,33,0,0,6,0
San Joaquin,2020-09-20,58,6,1002,24,0,37,64
Merced,2020-09-20,9,0,253,6,0,8,9
Nevada,2020-09-20,3,1,97,0,0,3,4
Amador,2020-09-20,1,0,51,0,0,2,1
Tehama,2020-09-20,3,0,59,0,0,2,3
San Luis Obispo,2020-09-20,7,0,451,3,0,21,7
Los Angeles,2020-09-20,745,368,19800,207,63,989,1113
Orange,2020-09-20,178,59,5614,64,13,235,237
Ventura,2020-09-20,44,13,1248,19,3,59,57
Contra Costa,2020-09-20,50,26,1498,17,5,55,76
Lassen,2020-09-20,0,0,25,0,0,0,0
Santa Clara,2020-09-20,113,22,3096,36,4,120,135
San Mateo,2020-09-20,34,8,707,12,0,33,42
Madera,2020-09-20,15,12,274,4,0,6,27
Glenn,2020-09-20,0,0,47,0,0,0,0
Riverside,2020-09-20,131,55,3315,47,6,112,186
Mendocino,2020-09-20,4,0,150,1,0,7,4
San Benito,2020-09-20,4,0,25,1,0,1,4
Monterey,2020-09-20,33,2,702,7,2,31,35
San Bernardino,2020-09-20,156,62,3803,49,13,175,218
Stanislaus,2020-09-20,92,21,1321,33,1,28,113
Butte,2020-09-20,13,0,451,4,0,20,13
San Francisco,2020-09-20,65,8,1859,21,2,62,73
Tuolumne,2020-09-20,0,0,84,0,0,4,0
Yuba,2020-09-20,19,1,265,5,0,8,20
Sutter,2020-09-20,0,0,0,0,0,0,0
Tulare,2020-09-20,37,10,664,8,0,21,47
Yolo,2020-09-20,6,0,96,3,0,5,6
Lake,2020-09-20,0,2,65,0,1,3,2
Napa,2020-09-20,1,3,359,0,0,26,4
Inyo,2020-09-21,0,0,29,0,0,4,0
Lassen,2020-09-21,0,0,25,0,0,0,0
Nevada,2020-09-21,3,1,133,0,0,4,4
Monterey,2020-09-21,33,2,702,8,2,39,35
Orange,2020-09-21,170,64,5510,55,13,250,234
Kern,2020-09-21,69,2,1293,22,0,56,71
San Francisco,2020-09-21,68,2,1837,18,0,75,70
Glenn,2020-09-21,0,0,47,0,0,0,0
Napa,2020-09-21,2,4,359,1,0,23,6
Colusa,2020-09-21,3,3,48,0,0,0,6
Contra Costa,2020-09-21,52,22,1492,18,3,54,74
San Luis Obispo,2020-09-21,5,0,451,2,0,27,5
Humboldt,2020-09-21,4,3,276,0,1,4,7
Stanislaus,2020-09-21,93,24,1297,29,0,27,117
Placer,2020-09-21,30,20,734,10,1,30,50
Madera,2020-09-21,13,14,274,5,0,7,27
Alameda,2020-09-21,96,34,2337,36,5,115,130
Santa Clara,2020-09-21,111,18,3051,34,0,109,129
Santa Barbara,2020-09-21,26,8,666,4,0,60,34
Amador,2020-09-21,1,0,51,0,0,3,1
San Mateo,2020-09-21,35,12,701,11,3,35,47
Butte,2020-09-21,12,1,451,3,1,13,13
Tehama,2020-09-21,3,0,59,0,0,2,3
Kings,2020-09-21,21,0,193,2,0,9,21
Yolo,2020-09-21,5,0,96,3,0,5,5
Modoc,2020-09-21,0,0,41,0,0,0,0
San Benito,2020-09-21,3,0,25,1,0,1,3
Riverside,2020-09-21,146,52,3363,42,10,108,198
Santa Cruz,2020-09-21,15,0,276,2,0,10,15
Sonoma,2020-09-21,15,4,522,3,0,11,19
Lake,2020-09-21,0,1,66,0,0,5,1
San Diego,2020-09-21,209,54,6623,68,12,320,263
San Bernardino,2020-09-21,164,71,3849,46,12,172,235
Plumas,2020-09-21,0,0,35,0,0,0,0
Imperial,2020-09-21,23,0,259,9,0,7,23
Shasta,2020-09-21,2,0,561,0,0,10,2
Yuba,2020-09-21,19,1,265,5,0,11,20
Mono,2020-09-21,0,0,17,0,0,2,0
Calaveras,2020-09-21,0,0,33,0,0,6,0
Del Norte,2020-09-21,0,0,51,0,0,1,0
Sacramento,2020-09-21,132,29,2456,48,7,95,161
Marin,2020-09-21,8,5,324,2,0,11,13
Siskiyou,2020-09-21,0,1,56,0,0,8,1
Tuolumne,2020-09-21,0,0,84,0,0,3,0
Mendocino,2020-09-21,5,0,150,2,0,8,5
San Joaquin,2020-09-21,60,18,1004,22,3,39,78
Mariposa,2020-09-21,0,0,19,0,0,0,0
El Dorado,2020-09-21,0,0,189,0,0,8,0
Merced,2020-09-21,11,0,253,6,0,11,11
Sutter,2020-09-21,0,0,0,0,0,0,0
Fresno,2020-09-21,89,17,1552,28,2,18,106
Trinity,2020-09-21,0,0,25,0,0,0,0
Los Angeles,2020-09-21,779,365,19865,222,46,988,1144
Ventura,2020-09-21,39,11,1240,21,2,63,50
Solano,2020-09-21,21,13,568,4,1,11,34
Tulare,2020-09-21,37,12,677,7,0,24,49
Mariposa,2020-09-22,0,0,19,0,0,0,0
Shasta,2020-09-22,4,1,561,2,0,9,5
Stanislaus,2020-09-22,92,26,1301,29,2,22,118
San Diego,2020-09-22,210,50,6635,68,10,304,260
Ventura,2020-09-22,45,14,1259,18,4,63,59
Sutter,2020-09-22,0,0,0,0,0,0,0
Alameda,2020-09-22,91,36,2370,35,5,117,127
Sonoma,2020-09-22,18,2,529,3,1,8,20
Nevada,2020-09-22,3,2,124,0,0,7,5
Placer,2020-09-22,27,24,750,11,2,32,51
Lake,2020-09-22,0,1,66,0,0,4,1
Inyo,2020-09-22,0,1,29,0,0,3,1
Fresno,2020-09-22,82,23,1556,28,1,21,105
Plumas,2020-09-22,0,0,35,0,0,0,0
San Francisco,2020-09-22,72,8,1857,19,3,68,80
Yolo,2020-09-22,6,0,96,2,0,6,6
Mendocino,2020-09-22,6,0,150,2,0,4,6
Modoc,2020-09-22,0,0,41,0,0,0,0
San Bernardino,2020-09-22,162,72,3861,46,12,186,234
Sacramento,2020-09-22,138,33,2515,45,6,92,171
Orange,2020-09-22,175,64,5658,51,10,243,239
Kern,2020-09-22,69,1,1321,21,0,59,70
Contra Costa,2020-09-22,49,25,1518,14,2,54,74
San Luis Obispo,2020-09-22,4,0,451,1,0,30,4
Colusa,2020-09-22,3,2,48,0,0,0,5
Glenn,2020-09-22,0,0,47,0,0,0,0
Mono,2020-09-22,0,0,17,0,0,2,0
Lassen,2020-09-22,0,0,25,0,0,0,0
Trinity,2020-09-22,0,0,25,0,0,0,0
Tuolumne,2020-09-22,0,0,84,0,0,3,0
Solano,2020-09-22,22,20,567,3,2,-5,42
Humboldt,2020-09-22,4,3,276,1,1,2,7
Madera,2020-09-22,15,15,274,5,1,5,30
San Joaquin,2020-09-22,56,18,1001,21,3,39,74
San Benito,2020-09-22,2,0,25,1,0,1,2
El Dorado,2020-09-22,0,0,189,0,0,12,0
Siskiyou,2020-09-22,0,1,56,0,0,10,1
Santa Barbara,2020-09-22,21,6,666,6,0,61,27
Napa,2020-09-22,3,1,359,2,0,21,4
Tulare,2020-09-22,41,9,677,7,0,23,50
Merced,2020-09-22,9,0,253,4,0,9,9
Kings,2020-09-22,22,0,193,2,0,13,22
Amador,2020-09-22,1,0,51,0,0,1,1
Riverside,2020-09-22,150,64,3372,42,11,101,214
Los Angeles,2020-09-22,753,392,20023,212,42,970,1145
Butte,2020-09-22,13,0,451,5,0,11,13
Santa Cruz,2020-09-22,17,0,276,3,0,6,17
San Mateo,2020-09-22,36,8,703,11,1,37,44
Santa Clara,2020-09-22,114,8,3030,38,0,91,122
Calaveras,2020-09-22,0,0,33,0,0,3,0
Monterey,2020-09-22,34,2,702,11,2,37,36
Del Norte,2020-09-22,0,1,51,0,1,2,1
Marin,2020-09-22,7,5,333,2,0,7,12
Imperial,2020-09-22,26,0,259,7,0,6,26
Tehama,2020-09-22,1,0,59,1,0,3,1
Yuba,2020-09-22,14,2,265,4,0,10,16
Modoc,2020-09-23,0,0,41,0,0,0,0
Tehama,2020-09-23,2,0,59,1,0,2,2
Mariposa,2020-09-23,0,0,19,0,0,0,0
Yuba,2020-09-23,12,0,265,3,0,12,12
Trinity,2020-09-23,0,0,25,0,0,0,0
San Benito,2020-09-23,1,0,25,1,0,3,1
Solano,2020-09-23,24,24,565,3,2,8,48
Inyo,2020-09-23,0,0,29,0,0,3,0
Humboldt,2020-09-23,5,4,267,1,1,0,9
Sonoma,2020-09-23,18,8,511,4,0,5,26
Plumas,2020-09-23,0,0,35,0,0,0,0
Lassen,2020-09-23,0,0,25,0,0,0,0
Napa,2020-09-23,3,0,359,3,0,19,3
Marin,2020-09-23,7,3,325,2,1,13,10
Shasta,2020-09-23,5,1,561,3,0,6,6
Glenn,2020-09-23,0,0,47,0,0,0,0
Kern,2020-09-23,75,2,1341,21,0,55,77
Los Angeles,2020-09-23,760,378,20078,216,62,989,1138
Siskiyou,2020-09-23,1,0,56,0,0,8,1
Amador,2020-09-23,1,0,52,0,0,4,1
Santa Clara,2020-09-23,109,11,3028,41,1,92,120
Tulare,2020-09-23,39,13,677,6,0,22,52
Nevada,2020-09-23,2,0,137,0,0,7,2
Merced,2020-09-23,8,0,253,4,0,10,8
Colusa,2020-09-23,1,0,48,0,0,0,1
Butte,2020-09-23,12,0,451,6,0,5,12
San Francisco,2020-09-23,65,9,1891,18,5,64,74
San Mateo,2020-09-23,37,10,711,13,1,35,47
San Luis Obispo,2020-09-23,3,0,451,1,0,28,3
Yolo,2020-09-23,6,0,96,2,0,7,6
Mendocino,2020-09-23,8,0,150,2,0,5,8
Madera,2020-09-23,13,17,274,5,0,3,30
Kings,2020-09-23,15,0,193,2,0,13,15
Calaveras,2020-09-23,0,0,33,0,0,3,0
Stanislaus,2020-09-23,91,24,1316,28,2,23,115
Alameda,2020-09-23,92,43,2386,32,5,120,135
Santa Cruz,2020-09-23,17,0,276,2,0,7,17
Riverside,2020-09-23,141,56,3401,40,10,114,197
Mono,2020-09-23,0,0,17,0,0,2,0
San Diego,2020-09-23,200,53,6635,67,13,291,253
El Dorado,2020-09-23,0,0,189,0,0,5,0
San Bernardino,2020-09-23,160,52,3848,49,7,180,212
Imperial,2020-09-23,27,0,259,7,0,4,27
Ventura,2020-09-23,44,20,1260,19,6,54,64
Sutter,2020-09-23,0,0,0,0,0,0,0
Orange,2020-09-23,168,57,5625,42,10,217,225
Fresno,2020-09-23,84,24,1556,26,3,24,108
San Joaquin,2020-09-23,54,16,1000,19,2,41,70
Santa Barbara,2020-09-23,20,4,666,5,0,45,24
Del Norte,2020-09-23,0,0,51,0,0,2,0
Contra Costa,2020-09-23,45,21,1523,13,2,40,66
Placer,2020-09-23,29,28,752,13,1,28,57
Monterey,2020-09-23,27,0,702,11,0,31,27
Lake,2020-09-23,0,1,66,0,0,4,1
Tuolumne,2020-09-23,0,0,84,0,0,0,0
Sacramento,2020-09-23,147,27,2493,43,6,87,174
Nevada,2020-09-24,2,1,131,0,1,2,3
Kings,2020-09-24,18,0,193,2,0,12,18
Fresno,2020-09-24,80,23,1561,24,1,24,103
Lassen,2020-09-24,0,0,25,0,0,0,0
Los Angeles,2020-09-24,715,319,20052,207,66,949,1034
Tuolumne,2020-09-24,0,0,84,0,0,1,0
Orange,2020-09-24,157,69,5606,50,12,239,226
Mariposa,2020-09-24,0,0,19,0,0,0,0
El Dorado,2020-09-24,1,0,189,1,0,6,1
San Benito,2020-09-24,2,0,25,1,0,0,2
Amador,2020-09-24,1,0,51,0,0,3,1
Yuba,2020-09-24,12,0,265,2,0,12,12
Sacramento,2020-09-24,139,31,2498,34,7,79,170
Mono,2020-09-24,0,0,17,0,0,2,0
Glenn,2020-09-24,0,0,47,0,0,0,0
Yolo,2020-09-24,3,0,96,2,0,4,3
Tehama,2020-09-24,4,0,59,1,0,0,4
Sonoma,2020-09-24,16,5,541,6,0,5,21
Lake,2020-09-24,0,0,66,0,0,4,0
Del Norte,2020-09-24,0,0,52,0,0,2,0
Stanislaus,2020-09-24,82,32,1324,26,5,21,114
Shasta,2020-09-24,5,0,561,2,0,7,5
San Joaquin,2020-09-24,49,7,1003,20,2,44,56
San Diego,2020-09-24,196,45,6629,65,8,300,241
Trinity,2020-09-24,0,0,25,0,0,0,0
Monterey,2020-09-24,28,0,702,10,0,31,28
Butte,2020-09-24,11,0,451,6,0,5,11
Humboldt,2020-09-24,4,1,272,1,0,1,5
Marin,2020-09-24,5,3,324,4,1,12,8
Merced,2020-09-24,11,0,253,5,0,14,11
Alameda,2020-09-24,87,36,2383,31,8,122,123
Solano,2020-09-24,24,24,513,3,0,6,48
Contra Costa,2020-09-24,39,20,1505,14,3,40,59
Santa Clara,2020-09-24,111,10,3021,35,0,96,121
San Mateo,2020-09-24,35,12,689,14,2,32,47
Imperial,2020-09-24,28,0,259,8,0,4,28
San Bernardino,2020-09-24,152,42,3841,50,8,153,194
San Luis Obispo,2020-09-24,3,1,451,1,0,29,4
Riverside,2020-09-24,142,62,3429,39,8,110,204
San Francisco,2020-09-24,60,9,1898,16,5,49,69
Colusa,2020-09-24,1,0,48,0,0,0,1
Sutter,2020-09-24,0,0,0,0,0,0,0
Placer,2020-09-24,30,30,755,12,2,29,60
Madera,2020-09-24,11,12,221,4,1,7,23
Ventura,2020-09-24,44,23,1266,16,6,56,67
Siskiyou,2020-09-24,1,0,56,0,0,7,1
Kern,2020-09-24,72,2,1339,21,0,59,74
Modoc,2020-09-24,0,0,41,0,0,0,0
Mendocino,2020-09-24,8,0,150,2,0,4,8
Calaveras,2020-09-24,0,0,33,0,0,5,0
Tulare,2020-09-24,41,8,677,7,0,16,49
Santa Cruz,2020-09-24,18,0,276,3,0,9,18
Napa,2020-09-24,3,2,359,3,0,20,5
Plumas,2020-09-24,0,0,35,0,0,0,0
Inyo,2020-09-24,0,0,29,0,0,4,0
Santa Barbara,2020-09-24,23,4,666,5,0,50,27
Santa Cruz,2020-09-25,20,0,376,5,0,13,20
Butte,2020-09-25,12,0,451,7,0,6,12
San Luis Obispo,2020-09-25,3,0,451,1,0,31,3
Imperial,2020-09-25,25,0,259,9,0,9,25
Orange,2020-09-25,156,51,5578,47,7,232,207
Tuolumne,2020-09-25,0,0,84,0,0,4,0
Stanislaus,2020-09-25,76,28,1313,24,3,20,104
Yuba,2020-09-25,13,0,265,2,0,10,13
Santa Clara,2020-09-25,108,12,2999,38,1,100,120
San Bernardino,2020-09-25,148,50,3858,47,6,150,198
Colusa,2020-09-25,1,0,48,0,0,0,1
Merced,2020-09-25,10,0,253,4,0,15,10
Napa,2020-09-25,3,2,359,3,0,18,5
Plumas,2020-09-25,0,0,35,0,0,0,0
Monterey,2020-09-25,28,0,702,11,0,28,28
San Mateo,2020-09-25,32,13,700,11,2,30,45
Kern,2020-09-25,70,2,1334,20,0,57,72
Madera,2020-09-25,13,19,263,4,0,19,32
Tehama,2020-09-25,5,0,59,1,0,2,5
Sacramento,2020-09-25,134,28,2479,31,3,74,162
Sonoma,2020-09-25,18,8,592,6,3,5,26
Inyo,2020-09-25,0,0,29,0,0,4,0
Del Norte,2020-09-25,0,0,52,0,0,1,0
Yolo,2020-09-25,3,0,96,2,0,5,3
Mendocino,2020-09-25,9,0,150,2,0,5,9
Mono,2020-09-25,0,0,17,0,0,2,0
Siskiyou,2020-09-25,1,0,56,0,0,8,1
Amador,2020-09-25,0,0,51,0,0,2,0
Marin,2020-09-25,5,2,319,4,0,12,7
Lake,2020-09-25,0,2,65,0,1,2,2
El Dorado,2020-09-25,1,0,189,1,0,8,1
Los Angeles,2020-09-25,692,336,20053,200,63,930,1028
Sutter,2020-09-25,0,0,0,0,0,0,0
Alameda,2020-09-25,86,27,2377,30,2,125,113
Nevada,2020-09-25,2,1,130,0,1,5,3
Riverside,2020-09-25,129,67,3395,36,9,106,196
Calaveras,2020-09-25,0,0,33,0,0,5,0
Modoc,2020-09-25,0,0,41,0,0,0,0
Fresno,2020-09-25,78,23,1566,20,1,20,101
San Benito,2020-09-25,2,0,25,1,0,0,2
San Diego,2020-09-25,196,39,6728,71,4,307,235
Shasta,2020-09-25,6,0,561,2,0,11,6
Glenn,2020-09-25,0,0,47,0,0,0,0
Trinity,2020-09-25,0,0,25,0,0,0,0
Mariposa,2020-09-25,0,0,19,0,0,0,0
Santa Barbara,2020-09-25,24,4,666,6,0,49,28
Ventura,2020-09-25,44,22,1268,16,6,53,66
Humboldt,2020-09-25,5,0,272,1,0,2,5
San Francisco,2020-09-25,61,11,1870,20,5,56,72
Kings,2020-09-25,13,0,193,1,0,14,13
San Joaquin,2020-09-25,44,8,1007,19,1,52,52
Lassen,2020-09-25,0,0,25,0,0,0,0
Placer,2020-09-25,25,20,752,11,2,34,45
Tulare,2020-09-25,36,9,677,7,0,14,45
Solano,2020-09-25,18,15,549,4,1,8,33
Contra Costa,2020-09-25,30,19,1502,13,3,54,49
Contra Costa,2020-09-26,30,11,1492,13,1,54,41
Yolo,2020-09-26,3,0,96,2,0,7,3
Humboldt,2020-09-26,3,0,277,2,0,2,3
El Dorado,2020-09-26,1,0,189,1,0,4,1
Sacramento,2020-09-26,131,25,2485,32,7,85,156
Del Norte,2020-09-26,0,0,51,0,0,2,0
Mendocino,2020-09-26,9,0,150,3,0,5,9
Ventura,2020-09-26,46,18,1254,18,5,62,64
Amador,2020-09-26,0,0,51,0,0,2,0
Kings,2020-09-26,10,0,193,1,0,14,10
Tulare,2020-09-26,32,10,664,6,0,13,42
Yuba,2020-09-26,13,0,265,2,0,15,13
Santa Barbara,2020-09-26,21,5,666,4,1,56,26
Alameda,2020-09-26,75,36,2363,24,6,118,111
Plumas,2020-09-26,0,0,35,0,0,0,0
Stanislaus,2020-09-26,69,19,1282,23,2,27,88
Santa Cruz,2020-09-26,19,0,376,5,0,12,19
Shasta,2020-09-26,8,1,561,1,0,10,9
San Luis Obispo,2020-09-26,3,1,451,1,0,28,4
Mono,2020-09-26,0,0,17,0,0,2,0
Sutter,2020-09-26,0,0,0,0,0,0,0
Modoc,2020-09-26,0,0,41,0,0,0,0
Tehama,2020-09-26,4,0,59,1,0,3,4
San Bernardino,2020-09-26,152,44,3825,47,4,159,196
San Francisco,2020-09-26,56,8,1859,18,3,63,64
Marin,2020-09-26,5,8,328,3,1,6,13
Inyo,2020-09-26,0,0,29,0,0,4,0
San Joaquin,2020-09-26,38,11,1013,19,1,52,49
Colusa,2020-09-26,1,0,48,0,0,0,1
Butte,2020-09-26,13,0,451,7,0,4,13
San Benito,2020-09-26,2,0,25,1,0,2,2
Madera,2020-09-26,13,3,263,4,0,21,16
Trinity,2020-09-26,0,0,25,0,0,0,0
Tuolumne,2020-09-26,1,0,84,0,0,0,1
San Mateo,2020-09-26,29,12,700,10,2,32,41
Siskiyou,2020-09-26,1,0,56,0,0,6,1
Sonoma,2020-09-26,18,7,579,8,1,5,25
Santa Clara,2020-09-26,93,11,2902,35,1,106,104
Riverside,2020-09-26,135,46,3353,37,13,104,181
Kern,2020-09-26,66,4,1330,20,0,64,70
San Diego,2020-09-26,197,42,6766,74,5,307,239
Placer,2020-09-26,25,25,756,11,2,37,50
Calaveras,2020-09-26,0,0,33,0,0,5,0
Lake,2020-09-26,0,1,65,0,0,5,1
Nevada,2020-09-26,1,0,122,0,0,5,1
Orange,2020-09-26,164,36,5585,45,2,251,200
Imperial,2020-09-26,25,0,259,10,0,5,25
Los Angeles,2020-09-26,687,371,19966,206,71,977,1058
Solano,2020-09-26,18,19,545,3,3,8,37
Mariposa,2020-09-26,0,0,19,0,0,0,0
Merced,2020-09-26,9,0,253,4,0,13,9
Glenn,2020-09-26,0,0,47,0,0,0,0
Monterey,2020-09-26,29,0,702,10,0,28,29
Fresno,2020-09-26,73,24,1533,19,3,16,97
Napa,2020-09-26,3,0,356,3,0,18,3
Lassen,2020-09-26,0,0,25,0,0,0,0
Humboldt,2020-09-27,3,0,277,1,0,2,3
Placer,2020-09-27,22,28,747,10,5,31,50
Tulare,2020-09-27,33,8,664,7,0,18,41
Plumas,2020-09-27,0,0,35,0,0,0,0
Lassen,2020-09-27,0,0,25,0,0,0,0
San Joaquin,2020-09-27,32,20,1007,16,2,53,52
Glenn,2020-09-27,0,0,47,0,0,0,0
Napa,2020-09-27,3,0,359,3,0,17,3
El Dorado,2020-09-27,1,0,189,1,0,4,1
Santa Clara,2020-09-27,94,13,2882,33,3,106,107
Inyo,2020-09-27,0,1,29,0,0,3,1
Yolo,2020-09-27,3,0,96,3,0,3,3
Monterey,2020-09-27,29,0,702,9,0,30,29
Imperial,2020-09-27,20,0,259,8,0,6,20
Santa Barbara,2020-09-27,21,1,666,5,0,55,22
Butte,2020-09-27,13,0,451,8,0,4,13
Kings,2020-09-27,14,0,193,1,0,15,14
Trinity,2020-09-27,0,0,25,0,0,0,0
Calaveras,2020-09-27,0,0,33,0,0,6,0
Contra Costa,2020-09-27,31,13,1484,13,1,54,44
Madera,2020-09-27,12,9,263,3,0,21,21
Los Angeles,2020-09-27,714,356,19933,205,61,998,1070
San Diego,2020-09-27,184,48,6761,69,9,319,232
Alameda,2020-09-27,76,37,2364,25,5,124,113
Kern,2020-09-27,67,3,1303,16,0,61,70
Ventura,2020-09-27,48,11,1255,18,0,54,59
Mariposa,2020-09-27,0,0,19,0,0,0,0
Fresno,2020-09-27,74,22,1555,20,2,14,96
San Bernardino,2020-09-27,160,50,3812,47,5,171,210
Lake,2020-09-27,1,0,65,0,0,3,1
San Luis Obispo,2020-09-27,2,1,451,1,0,29,3
Solano,2020-09-27,17,22,533,1,1,5,39
Mono,2020-09-27,0,0,17,0,0,2,0
Santa Cruz,2020-09-27,24,0,376,4,0,12,24
Colusa,2020-09-27,1,0,48,0,0,0,1
Tuolumne,2020-09-27,1,0,84,0,0,0,1
San Benito,2020-09-27,2,0,25,1,0,2,2
Sutter,2020-09-27,0,0,0,0,0,0,0
San Francisco,2020-09-27,54,6,1813,18,0,81,60
Marin,2020-09-27,7,7,326,3,0,14,14
Amador,2020-09-27,0,0,51,0,0,3,0
Sacramento,2020-09-27,119,35,2486,38,6,88,154
Siskiyou,2020-09-27,1,0,56,0,0,6,1
Tehama,2020-09-27,4,0,59,1,0,1,4
Modoc,2020-09-27,0,0,41,0,0,0,0
Yuba,2020-09-27,14,0,265,1,0,14,14
Merced,2020-09-27,9,1,253,4,0,11,10
Del Norte,2020-09-27,0,0,52,0,0,0,0
Shasta,2020-09-27,1,6,561,0,1,11,7
Sonoma,2020-09-27,20,4,552,7,1,7,24
San Mateo,2020-09-27,29,9,675,9,0,31,38
Orange,2020-09-27,161,63,5518,46,4,257,224
Nevada,2020-09-27,2,0,132,0,0,3,2
Stanislaus,2020-09-27,59,20,1315,20,1,33,79
Mendocino,2020-09-27,7,0,150,3,0,5,7
Riverside,2020-09-27,128,49,3340,36,10,111,177
Plumas,2020-09-28,0,0,35,0,0,0,0
Yuba,2020-09-28,13,0,265,1,0,13,13
San Mateo,2020-09-28,29,11,680,8,2,32,40
Colusa,2020-09-28,1,0,48,0,0,0,1
San Luis Obispo,2020-09-28,3,0,451,1,0,29,3
Tuolumne,2020-09-28,1,0,84,0,0,6,1
Kern,2020-09-28,71,3,1304,14,0,68,74
Shasta,2020-09-28,6,1,561,1,0,13,7
Sutter,2020-09-28,0,0,0,0,0,0,0
Sonoma,2020-09-28,20,8,581,7,1,4,28
Sacramento,2020-09-28,125,35,2489,33,9,95,160
Monterey,2020-09-28,30,0,702,8,0,29,30
San Francisco,2020-09-28,60,5,1828,17,1,88,65
San Bernardino,2020-09-28,165,58,3831,48,8,173,223
Solano,2020-09-28,19,19,546,2,1,7,38
Lassen,2020-09-28,0,0,25,0,0,0,0
Kings,2020-09-28,16,0,193,1,0,14,16
Siskiyou,2020-09-28,0,1,56,0,0,7,1
Mono,2020-09-28,0,0,17,0,0,2,0
Santa Barbara,2020-09-28,26,1,666,6,0,56,27
Del Norte,2020-09-28,0,1,52,0,1,1,1
Trinity,2020-09-28,0,0,25,0,0,0,0
Amador,2020-09-28,0,0,51,0,0,3,0
Inyo,2020-09-28,0,1,29,0,0,4,1
Napa,2020-09-28,4,2,359,4,0,26,6
Merced,2020-09-28,10,10,271,4,0,10,20
Mariposa,2020-09-28,0,0,19,0,0,0,0
Los Angeles,2020-09-28,734,291,19925,207,55,1043,1025
Placer,2020-09-28,24,28,742,9,2,30,52
Imperial,2020-09-28,22,0,259,8,0,4,22
Modoc,2020-09-28,0,0,41,0,0,0,0
Marin,2020-09-28,8,6,320,3,0,12,14
Mendocino,2020-09-28,6,0,150,3,0,5,6
San Benito,2020-09-28,2,0,25,1,0,1,2
Santa Clara,2020-09-28,93,18,2972,29,1,118,111
Glenn,2020-09-28,0,0,47,0,0,0,0
El Dorado,2020-09-28,1,0,189,1,0,5,1
Santa Cruz,2020-09-28,25,0,376,5,0,16,25
Ventura,2020-09-28,46,7,1244,14,1,62,53
Calaveras,2020-09-28,0,0,33,0,0,6,0
Riverside,2020-09-28,125,57,3322,33,7,110,182
Contra Costa,2020-09-28,30,15,1477,12,0,52,45
Fresno,2020-09-28,76,14,1579,20,2,13,90
San Joaquin,2020-09-28,35,18,1009,14,4,45,53
Lake,2020-09-28,1,1,65,0,1,2,2
Orange,2020-09-28,162,78,5626,46,10,239,240
Butte,2020-09-28,13,0,451,6,0,8,13
Humboldt,2020-09-28,2,3,275,1,1,2,5
San Diego,2020-09-28,199,58,6770,68,19,338,257
Tehama,2020-09-28,5,0,59,1,0,1,5
Yolo,2020-09-28,3,0,96,2,0,5,3
Stanislaus,2020-09-28,54,24,1310,21,1,29,78
Madera,2020-09-28,12,14,263,2,1,18,26
Alameda,2020-09-28,79,35,2368,25,7,125,114
Nevada,2020-09-28,2,0,134,0,0,4,2
Tulare,2020-09-28,34,8,677,7,0,23,42
Butte,2020-09-29,13,0,451,6,0,3,13
Santa Clara,2020-09-29,90,15,2970,29,4,104,105
Orange,2020-09-29,172,52,5747,48,9,231,224
Mono,2020-09-29,0,0,17,0,0,2,0
Sacramento,2020-09-29,122,38,2492,32,5,97,160
Solano,2020-09-29,18,21,562,2,4,8,39
Mariposa,2020-09-29,0,0,19,0,0,0,0
Modoc,2020-09-29,0,0,41,0,0,0,0
Madera,2020-09-29,9,13,263,2,1,17,22
Amador,2020-09-29,1,0,51,1,0,2,1
Napa,2020-09-29,6,1,351,3,0,25,7
Siskiyou,2020-09-29,0,1,56,0,0,7,1
Contra Costa,2020-09-29,32,17,1509,13,3,49,49
Inyo,2020-09-29,0,0,29,0,0,4,0
Glenn,2020-09-29,0,0,47,0,0,0,0
Imperial,2020-09-29,23,0,259,8,0,6,23
Ventura,2020-09-29,48,14,1270,17,3,53,62
Marin,2020-09-29,7,8,326,3,1,11,15
Mendocino,2020-09-29,5,0,150,2,0,2,5
Stanislaus,2020-09-29,50,30,1312,21,6,18,80
Yolo,2020-09-29,4,0,96,3,0,3,4
Nevada,2020-09-29,3,0,134,1,0,4,3
Humboldt,2020-09-29,2,3,277,1,0,3,5
Shasta,2020-09-29,5,1,561,1,0,13,6
Riverside,2020-09-29,130,52,3312,36,7,110,182
Santa Cruz,2020-09-29,23,0,376,4,0,14,23
San Luis Obispo,2020-09-29,3,0,451,1,0,25,3
Kings,2020-09-29,20,1,193,2,1,13,21
Tuolumne,2020-09-29,1,0,84,0,0,2,1
San Mateo,2020-09-29,26,17,696,7,5,12,43
El Dorado,2020-09-29,1,0,189,1,0,8,1
Lake,2020-09-29,1,1,65,0,1,3,2
San Francisco,2020-09-29,61,5,1866,16,1,73,66
San Diego,2020-09-29,182,56,6775,65,9,309,238
Del Norte,2020-09-29,0,0,53,0,0,0,0
Yuba,2020-09-29,13,1,265,1,0,9,14
Los Angeles,2020-09-29,746,340,19969,205,49,1013,1086
Monterey,2020-09-29,30,0,702,8,0,25,30
Santa Barbara,2020-09-29,23,0,666,6,0,50,23
Sutter,2020-09-29,0,0,0,0,0,0,0
Kern,2020-09-29,73,5,1304,16,0,65,78
San Benito,2020-09-29,1,0,25,1,0,1,1
Sonoma,2020-09-29,17,4,557,7,1,6,21
Placer,2020-09-29,22,22,744,7,0,38,44
Fresno,2020-09-29,80,14,1574,23,4,14,94
Merced,2020-09-29,9,11,271,5,0,9,20
Lassen,2020-09-29,0,0,25,0,0,0,0
Trinity,2020-09-29,0,0,25,0,0,0,0
Alameda,2020-09-29,78,47,2390,26,5,126,125
San Joaquin,2020-09-29,33,20,1007,14,5,47,53
San Bernardino,2020-09-29,170,55,3845,45,9,160,225
Colusa,2020-09-29,1,0,48,0,0,0,1
Tulare,2020-09-29,34,9,677,7,0,21,43
Plumas,2020-09-29,0,0,35,0,0,0,0
Calaveras,2020-09-29,0,0,33,0,0,6,0
Tehama,2020-09-29,5,0,59,1,0,1,5
Imperial,2020-09-30,26,0,259,8,0,7,26
Santa Clara,2020-09-30,93,17,2998,28,3,103,110
Napa,2020-09-30,6,0,351,3,0,31,6
Madera,2020-09-30,10,9,263,2,0,23,19
Ventura,2020-09-30,46,10,1273,17,3,53,56
Plumas,2020-09-30,0,0,35,0,0,0,0
El Dorado,2020-09-30,0,0,189,0,0,6,0
Merced,2020-09-30,11,0,271,5,0,6,11
Yuba,2020-09-30,13,0,265,1,0,10,13
Del Norte,2020-09-30,0,0,52,0,0,0,0
Orange,2020-09-30,173,55,5746,45,13,218,228
Sutter,2020-09-30,0,0,0,0,0,0,0
Inyo,2020-09-30,0,1,29,0,0,4,1
Fresno,2020-09-30,80,26,1562,22,1,21,106
Shasta,2020-09-30,8,1,561,1,0,4,9
San Bernardino,2020-09-30,165,58,3863,45,12,164,223
Marin,2020-09-30,7,4,325,4,0,9,11
Humboldt,2020-09-30,2,0,272,1,0,6,2
Butte,2020-09-30,9,0,451,3,0,4,9
Mendocino,2020-09-30,6,1,150,2,0,3,7
Glenn,2020-09-30,0,0,47,0,0,0,0
Alameda,2020-09-30,84,32,2415,27,2,121,116
Tehama,2020-09-30,6,0,59,1,0,1,6
Lake,2020-09-30,1,2,65,0,0,1,3
Contra Costa,2020-09-30,31,15,1515,10,3,49,46
Amador,2020-09-30,1,0,51,1,0,2,1
San Luis Obispo,2020-09-30,1,0,451,0,0,25,1
Placer,2020-09-30,17,18,744,5,3,29,35
Trinity,2020-09-30,0,0,25,0,0,0,0
Lassen,2020-09-30,0,0,25,0,0,0,0
Mariposa,2020-09-30,0,0,19,0,0,0,0
Tulare,2020-09-30,39,9,677,8,1,20,48
Sonoma,2020-09-30,15,5,509,6,0,7,20
Solano,2020-09-30,14,18,570,2,1,10,32
Colusa,2020-09-30,5,0,48,0,0,0,5
Calaveras,2020-09-30,0,0,33,0,0,8,0
Los Angeles,2020-09-30,730,371,20001,197,55,996,1101
San Benito,2020-09-30,1,0,25,1,0,2,1
Sacramento,2020-09-30,119,27,2502,31,6,83,146
Mono,2020-09-30,0,0,17,0,0,2,0
Nevada,2020-09-30,3,0,126,2,0,5,3
Riverside,2020-09-30,119,45,3370,40,10,122,164
Santa Cruz,2020-09-30,20,0,376,6,0,10,20
Siskiyou,2020-09-30,0,0,56,0,0,8,0
Kings,2020-09-30,15,0,193,2,0,12,15
San Francisco,2020-09-30,64,10,1881,15,2,75,74
San Mateo,2020-09-30,26,16,703,8,2,19,42
Stanislaus,2020-09-30,58,21,1308,21,4,21,79
San Diego,2020-09-30,187,43,6771,70,8,309,230
Yolo,2020-09-30,6,0,96,4,0,3,6
Santa Barbara,2020-09-30,18,1,666,5,1,44,19
Modoc,2020-09-30,0,0,41,0,0,0,0
San Joaquin,2020-09-30,35,16,1008,14,2,40,51
Monterey,2020-09-30,27,0,702,8,0,25,27
Kern,2020-09-30,70,5,1336,14,0,56,75
Tuolumne,2020-09-30,2,0,84,0,0,2,2
Lassen,2020-10-01,0,0,25,0,0,0,0
Contra Costa,2020-10-01,31,17,1505,10,2,44,48
Madera,2020-10-01,9,14,263,2,0,19,23
Tuolumne,2020-10-01,0,0,84,0,0,2,0
Fresno,2020-10-01,94,19,1517,19,2,18,113
Yuba,2020-10-01,10,1,265,1,0,9,11
Santa Clara,2020-10-01,84,17,3013,28,1,88,101
Santa Cruz,2020-10-01,20,0,376,6,0,14,20
Colusa,2020-10-01,0,0,48,0,0,0,0
Orange,2020-10-01,175,34,5721,48,1,237,209
Tulare,2020-10-01,39,7,677,8,1,21,46
San Benito,2020-10-01,1,0,25,1,0,2,1
San Luis Obispo,2020-10-01,2,1,451,0,0,23,3
Riverside,2020-10-01,130,59,3381,39,11,131,189
Shasta,2020-10-01,7,1,561,0,0,8,8
Marin,2020-10-01,6,5,340,3,1,10,11
Merced,2020-10-01,9,0,271,3,0,4,9
Modoc,2020-10-01,0,0,41,0,0,0,0
Lake,2020-10-01,1,0,65,0,0,1,1
San Joaquin,2020-10-01,35,18,1013,14,3,42,53
Kern,2020-10-01,58,4,1343,15,0,73,62
El Dorado,2020-10-01,1,1,189,0,0,10,2
Sutter,2020-10-01,0,0,0,0,0,0,0
Nevada,2020-10-01,3,1,124,1,0,2,4
Butte,2020-10-01,6,0,451,2,0,7,6
Mariposa,2020-10-01,0,0,19,0,0,0,0
Calaveras,2020-10-01,0,0,33,0,0,7,0
San Diego,2020-10-01,186,54,6775,73,12,302,240
Sacramento,2020-10-01,108,26,2491,29,7,86,134
San Bernardino,2020-10-01,173,47,3861,43,6,163,220
Los Angeles,2020-10-01,698,371,20041,202,53,989,1069
Glenn,2020-10-01,0,0,47,0,0,0,0
Amador,2020-10-01,1,0,51,0,0,2,1
Imperial,2020-10-01,23,0,259,6,0,10,23
Humboldt,2020-10-01,2,0,270,1,0,2,2
Mono,2020-10-01,1,0,17,0,0,2,1
Del Norte,2020-10-01,0,1,51,0,0,1,1
Yolo,2020-10-01,4,0,96,2,0,7,4
Alameda,2020-10-01,94,36,2433,28,5,101,130
Stanislaus,2020-10-01,55,24,1309,19,3,21,79
Solano,2020-10-01,18,13,572,3,2,7,31
Mendocino,2020-10-01,8,1,150,3,0,4,9
Sonoma,2020-10-01,17,1,530,5,0,5,18
Siskiyou,2020-10-01,0,0,56,0,0,10,0
Tehama,2020-10-01,7,0,59,1,0,2,7
Inyo,2020-10-01,0,1,29,0,0,4,1
Plumas,2020-10-01,0,0,35,0,0,0,0
Napa,2020-10-01,8,1,200,5,0,14,9
Kings,2020-10-01,16,0,193,2,0,15,16
San Mateo,2020-10-01,29,13,711,10,1,26,42
Ventura,2020-10-01,43,9,1271,14,2,49,52
San Francisco,2020-10-01,59,9,1864,14,2,76,68
Monterey,2020-10-01,29,0,702,7,0,27,29
Trinity,2020-10-01,0,0,25,0,0,0,0
Santa Barbara,2020-10-01,20,1,666,6,1,46,21
Placer,2020-10-01,19,20,743,6,1,33,39
Contra Costa,2020-10-02,31,7,1479,10,1,46,38
Stanislaus,2020-10-02,55,19,1310,19,0,17,74
San Luis Obispo,2020-10-02,2,0,451,0,0,26,2
Orange,2020-10-02,160,53,5771,47,9,229,213
San Bernardino,2020-10-02,164,48,3839,41,5,165,212
Napa,2020-10-02,8,1,200,3,0,15,9
Plumas,2020-10-02,0,0,35,0,0,0,0
Lassen,2020-10-02,0,0,25,0,0,0,0
Yolo,2020-10-02,4,0,96,1,0,6,4
Siskiyou,2020-10-02,0,0,56,0,0,6,0
Santa Barbara,2020-10-02,19,1,666,5,1,40,20
San Benito,2020-10-02,1,0,25,1,0,2,1
Colusa,2020-10-02,4,1,48,0,0,0,5
Fresno,2020-10-02,97,18,1527,22,3,22,115
Nevada,2020-10-02,3,0,137,1,0,4,3
Amador,2020-10-02,1,0,51,0,0,3,1
Solano,2020-10-02,22,13,568,3,1,7,35
Placer,2020-10-02,18,24,746,5,1,33,42
Yuba,2020-10-02,7,0,265,2,0,11,7
Monterey,2020-10-02,30,0,702,7,0,24,30
Glenn,2020-10-02,0,0,47,0,0,0,0
El Dorado,2020-10-02,1,0,189,0,0,13,1
Tuolumne,2020-10-02,0,0,84,0,0,2,0
Inyo,2020-10-02,0,1,29,0,0,3,1
Mendocino,2020-10-02,8,0,150,3,0,4,8
Lake,2020-10-02,1,0,65,0,0,6,1
San Joaquin,2020-10-02,39,19,1004,13,2,35,58
Humboldt,2020-10-02,2,0,270,1,0,3,2
Tulare,2020-10-02,35,7,677,6,1,29,42
San Diego,2020-10-02,203,56,6784,77,10,278,259
Riverside,2020-10-02,135,66,3361,39,13,122,201
Ventura,2020-10-02,39,13,1260,15,3,50,52
Del Norte,2020-10-02,0,0,51,0,0,0,0
Sonoma,2020-10-02,21,6,530,5,1,6,27
Mariposa,2020-10-02,0,0,19,0,0,0,0
Imperial,2020-10-02,26,0,259,7,0,9,26
Los Angeles,2020-10-02,673,324,20018,188,48,1001,997
Shasta,2020-10-02,7,1,561,0,0,5,8
Santa Clara,2020-10-02,82,19,3022,34,1,88,101
Tehama,2020-10-02,5,0,59,1,0,1,5
Sutter,2020-10-02,0,0,0,0,0,0,0
Madera,2020-10-02,7,6,263,1,0,25,13
Butte,2020-10-02,7,0,451,3,0,9,7
Kings,2020-10-02,13,0,193,1,0,13,13
Mono,2020-10-02,0,0,17,0,0,2,0
Marin,2020-10-02,7,5,336,2,1,12,12
Alameda,2020-10-02,76,34,2380,27,4,103,110
San Mateo,2020-10-02,29,13,708,10,1,31,42
Trinity,2020-10-02,0,0,25,0,0,0,0
Sacramento,2020-10-02,96,23,2496,32,3,97,119
Santa Cruz,2020-10-02,22,0,376,6,0,14,22
Merced,2020-10-02,9,1,271,3,0,10,10
Modoc,2020-10-02,0,0,41,0,0,0,0
Kern,2020-10-02,63,3,1338,16,0,69,66
Calaveras,2020-10-02,0,0,33,0,0,5,0
San Francisco,2020-10-02,55,10,1846,16,5,71,65
Shasta,2020-10-03,6,1,561,1,0,3,7
Butte,2020-10-03,12,0,451,4,0,12,12
Santa Barbara,2020-10-03,23,1,666,5,0,44,24
Glenn,2020-10-03,0,0,47,0,0,0,0
Solano,2020-10-03,21,13,568,2,1,6,34
Plumas,2020-10-03,0,0,35,0,0,0,0
San Mateo,2020-10-03,29,11,705,10,2,34,40
Stanislaus,2020-10-03,55,17,1315,18,0,32,72
San Joaquin,2020-10-03,38,16,1004,12,3,41,54
Nevada,2020-10-03,3,0,120,1,0,4,3
Napa,2020-10-03,6,0,200,2,0,13,6
Sutter,2020-10-03,0,0,0,0,0,0,0
Mendocino,2020-10-03,6,0,150,2,0,5,6
Colusa,2020-10-03,2,4,48,0,0,0,6
Imperial,2020-10-03,26,1,259,7,1,6,27
Sonoma,2020-10-03,26,7,518,7,1,6,33
Madera,2020-10-03,7,6,263,1,0,23,13
Orange,2020-10-03,155,52,5860,47,9,241,207
San Francisco,2020-10-03,50,7,1840,17,1,88,57
Kern,2020-10-03,63,4,1316,17,1,69,67
Fresno,2020-10-03,102,16,1523,24,0,18,118
Tuolumne,2020-10-03,0,0,84,0,0,0,0
Yolo,2020-10-03,2,0,96,1,0,6,2
Amador,2020-10-03,0,0,51,0,0,6,0
San Benito,2020-10-03,1,0,25,1,0,0,1
Siskiyou,2020-10-03,0,0,56,0,0,8,0
Sacramento,2020-10-03,87,29,2494,28,4,91,116
Santa Cruz,2020-10-03,21,0,376,6,0,15,21
Trinity,2020-10-03,0,0,25,0,0,0,0
Mariposa,2020-10-03,0,0,19,0,0,0,0
Monterey,2020-10-03,29,0,702,5,0,24,29
Lake,2020-10-03,0,3,65,0,1,6,3
El Dorado,2020-10-03,1,0,189,0,0,10,1
Del Norte,2020-10-03,0,0,51,0,0,1,0
Lassen,2020-10-03,0,0,25,0,0,0,0
Kings,2020-10-03,15,0,193,1,0,14,15
Tulare,2020-10-03,36,9,664,9,2,30,45
Santa Clara,2020-10-03,82,23,2921,30,2,109,105
San Luis Obispo,2020-10-03,2,0,451,0,0,30,2
Modoc,2020-10-03,0,0,41,0,0,0,0
Placer,2020-10-03,18,24,746,4,0,33,42
Yuba,2020-10-03,6,0,265,2,0,9,6
Merced,2020-10-03,6,0,271,3,0,12,6
San Bernardino,2020-10-03,170,54,3808,43,7,164,224
Inyo,2020-10-03,0,0,29,0,0,4,0
Marin,2020-10-03,8,6,336,3,1,14,14
Humboldt,2020-10-03,2,0,250,1,0,7,2
Contra Costa,2020-10-03,31,10,1478,9,1,45,41
San Diego,2020-10-03,207,60,6770,68,13,296,267
Alameda,2020-10-03,78,41,2396,27,6,101,119
Ventura,2020-10-03,38,11,1253,15,3,51,49
Tehama,2020-10-03,4,0,59,0,0,1,4
Mono,2020-10-03,0,0,17,0,0,2,0
Los Angeles,2020-10-03,674,353,19912,188,51,988,1027
Riverside,2020-10-03,135,67,3320,43,13,112,202
Calaveras,2020-10-03,0,0,33,0,0,4,0
Modoc,2020-10-04,0,0,41,0,0,0,0
Tuolumne,2020-10-04,1,1,84,1,0,0,2
Kern,2020-10-04,61,1,1317,19,0,70,62
Humboldt,2020-10-04,2,1,264,1,0,11,3
Orange,2020-10-04,168,42,5897,53,7,234,210
Napa,2020-10-04,6,1,200,2,0,12,7
Madera,2020-10-04,8,7,263,1,0,22,15
Butte,2020-10-04,8,0,451,4,0,18,8
Alameda,2020-10-04,71,29,2379,23,6,115,100
Monterey,2020-10-04,27,2,702,6,1,22,29
Solano,2020-10-04,21,17,553,2,2,7,38
San Benito,2020-10-04,1,0,25,1,0,2,1
San Joaquin,2020-10-04,35,11,1001,12,3,46,46
San Diego,2020-10-04,203,53,6805,70,12,307,256
San Luis Obispo,2020-10-04,4,0,451,0,0,30,4
Contra Costa,2020-10-04,34,19,1490,7,2,51,53
Siskiyou,2020-10-04,0,0,56,0,0,7,0
Glenn,2020-10-04,0,0,47,0,0,0,0
Fresno,2020-10-04,103,13,1515,23,2,17,116
Del Norte,2020-10-04,0,0,51,0,0,1,0
Santa Cruz,2020-10-04,16,0,376,5,0,13,16
Merced,2020-10-04,7,0,271,3,0,10,7
San Mateo,2020-10-04,28,12,676,9,1,32,40
Kings,2020-10-04,14,0,193,1,0,16,14
Imperial,2020-10-04,24,0,259,10,0,6,24
Sonoma,2020-10-04,28,7,505,7,0,6,35
San Francisco,2020-10-04,52,9,1787,16,1,92,61
Santa Clara,2020-10-04,87,20,2919,30,4,103,107
Trinity,2020-10-04,0,0,25,0,0,0,0
Tulare,2020-10-04,35,9,664,7,1,31,44
Tehama,2020-10-04,4,0,59,1,0,3,4
Shasta,2020-10-04,4,1,561,0,0,8,5
Lake,2020-10-04,0,0,65,0,0,4,0
Nevada,2020-10-04,4,0,121,2,0,4,4
Placer,2020-10-04,22,34,747,4,2,29,56
El Dorado,2020-10-04,2,0,189,0,0,12,2
Ventura,2020-10-04,31,11,1247,14,3,53,42
Inyo,2020-10-04,0,0,29,0,0,4,0
Lassen,2020-10-04,0,0,25,0,0,0,0
Riverside,2020-10-04,133,68,3361,40,13,112,201
Mariposa,2020-10-04,0,0,19,0,0,0,0
Santa Barbara,2020-10-04,22,0,666,6,0,56,22
Yolo,2020-10-04,1,0,96,0,0,6,1
San Bernardino,2020-10-04,175,59,3825,49,8,180,234
Calaveras,2020-10-04,0,0,33,0,0,5,0
Sutter,2020-10-04,0,0,0,0,0,0,0
Marin,2020-10-04,4,10,333,1,0,13,14
Plumas,2020-10-04,0,0,35,0,0,0,0
Mendocino,2020-10-04,7,1,150,1,1,6,8
Colusa,2020-10-04,2,4,48,0,0,0,6
Amador,2020-10-04,0,0,51,0,0,3,0
Yuba,2020-10-04,4,0,265,2,0,10,4
Los Angeles,2020-10-04,685,373,19854,201,51,1072,1058
Stanislaus,2020-10-04,54,11,1316,20,1,39,65
Sacramento,2020-10-04,93,29,2474,27,3,104,122
Mono,2020-10-04,0,0,17,0,0,2,0
El Dorado,2020-10-05,1,0,189,1,0,11,1
Plumas,2020-10-05,0,0,35,0,0,0,0
Santa Clara,2020-10-05,83,23,3014,28,4,114,106
Mendocino,2020-10-05,5,0,150,3,0,4,5
Trinity,2020-10-05,0,0,25,0,0,0,0
Yuba,2020-10-05,4,0,265,2,0,10,4
Kings,2020-10-05,15,0,193,1,0,16,15
Sacramento,2020-10-05,96,29,2466,29,5,109,125
Fresno,2020-10-05,107,18,1514,19,4,12,125
Marin,2020-10-05,5,4,325,1,0,16,9
Lake,2020-10-05,0,3,65,0,2,1,3
Tuolumne,2020-10-05,0,0,84,0,0,0,0
Amador,2020-10-05,0,0,51,0,0,3,0
Lassen,2020-10-05,0,0,25,0,0,0,0
Kern,2020-10-05,66,0,1335,16,0,67,66
Sutter,2020-10-05,0,0,0,0,0,0,0
Butte,2020-10-05,8,0,451,4,0,15,8
Shasta,2020-10-05,10,1,561,0,0,9,11
San Joaquin,2020-10-05,30,13,1002,11,3,45,43
Solano,2020-10-05,20,10,545,4,1,9,30
Riverside,2020-10-05,142,67,3390,42,16,115,209
Calaveras,2020-10-05,0,0,33,0,0,5,0
Mariposa,2020-10-05,0,0,19,0,0,0,0
San Luis Obispo,2020-10-05,3,0,451,0,0,28,3
Merced,2020-10-05,5,1,271,2,0,14,6
Santa Cruz,2020-10-05,14,0,376,4,0,14,14
San Mateo,2020-10-05,26,12,682,8,2,29,38
San Francisco,2020-10-05,50,9,1812,16,0,86,59
Alameda,2020-10-05,73,37,2381,23,6,110,110
Santa Barbara,2020-10-05,19,0,666,6,0,62,19
Placer,2020-10-05,20,25,729,4,1,30,45
San Diego,2020-10-05,217,56,6773,66,10,313,273
Del Norte,2020-10-05,0,0,52,0,0,3,0
Humboldt,2020-10-05,2,3,264,1,0,11,5
Orange,2020-10-05,176,52,5698,63,10,210,228
Glenn,2020-10-05,0,0,47,0,0,0,0
San Benito,2020-10-05,0,0,25,0,0,3,0
Mono,2020-10-05,0,0,17,0,0,2,0
Modoc,2020-10-05,0,0,41,0,0,0,0
Stanislaus,2020-10-05,53,21,1313,21,2,37,74
Ventura,2020-10-05,33,12,1227,14,4,56,45
San Bernardino,2020-10-05,186,53,3844,50,6,169,239
Los Angeles,2020-10-05,696,339,19975,195,47,1040,1035
Sonoma,2020-10-05,28,7,522,11,0,4,35
Imperial,2020-10-05,27,0,259,10,0,2,27
Contra Costa,2020-10-05,37,20,1500,7,3,59,57
Siskiyou,2020-10-05,0,0,56,0,0,8,0
Tulare,2020-10-05,34,8,677,9,1,25,42
Inyo,2020-10-05,1,0,29,0,0,4,1
Tehama,2020-10-05,5,0,59,0,0,0,5
Colusa,2020-10-05,4,0,48,0,0,0,4
Monterey,2020-10-05,24,1,702,5,1,26,25
Yolo,2020-10-05,1,0,96,0,0,7,1
Madera,2020-10-05,8,6,263,1,0,25,14
Napa,2020-10-05,6,1,200,2,0,14,7
Nevada,2020-10-05,4,0,133,2,0,3,4
Inyo,2020-10-06,2,1,29,1,0,3,3
Siskiyou,2020-10-06,0,0,56,0,0,10,0
Del Norte,2020-10-06,0,0,51,0,0,2,0
Calaveras,2020-10-06,0,0,33,0,0,4,0
Plumas,2020-10-06,0,0,35,0,0,0,0
Placer,2020-10-06,20,31,747,4,2,32,51
Los Angeles,2020-10-06,709,351,20081,197,58,943,1060
Santa Cruz,2020-10-06,15,0,376,4,0,10,15
Monterey,2020-10-06,25,1,702,6,1,22,26
Colusa,2020-10-06,0,4,48,0,0,0,4
San Bernardino,2020-10-06,200,39,3848,52,5,157,239
Mendocino,2020-10-06,5,0,150,3,0,4,5
Humboldt,2020-10-06,2,3,252,1,0,8,5
Mariposa,2020-10-06,0,0,19,0,0,0,0
Tuolumne,2020-10-06,0,0,84,0,0,2,0
Yolo,2020-10-06,1,0,96,0,0,6,1
Shasta,2020-10-06,7,0,561,0,0,6,7
Orange,2020-10-06,183,52,5822,64,7,214,235
Mono,2020-10-06,0,0,17,0,0,2,0
Lake,2020-10-06,0,3,65,0,2,2,3
Madera,2020-10-06,4,8,263,1,1,24,12
Sonoma,2020-10-06,34,6,570,11,0,7,40
Solano,2020-10-06,20,15,548,4,0,8,35
Lassen,2020-10-06,0,0,25,0,0,0,0
Sacramento,2020-10-06,89,30,2386,29,2,91,119
Riverside,2020-10-06,135,83,3419,38,16,122,218
San Diego,2020-10-06,214,66,6780,63,7,311,280
Amador,2020-10-06,0,0,51,0,0,5,0
Tulare,2020-10-06,28,8,677,9,0,17,36
San Benito,2020-10-06,0,0,25,0,0,2,0
Modoc,2020-10-06,0,0,41,0,0,0,0
San Joaquin,2020-10-06,26,17,1005,11,1,46,43
Contra Costa,2020-10-06,32,25,1526,6,4,56,57
Imperial,2020-10-06,30,0,259,11,0,2,30
Alameda,2020-10-06,75,40,2416,24,5,113,115
San Luis Obispo,2020-10-06,2,0,451,0,0,25,2
Santa Barbara,2020-10-06,19,0,666,7,0,54,19
Stanislaus,2020-10-06,45,15,1314,17,1,36,60
Kern,2020-10-06,65,3,1346,10,0,67,68
Santa Clara,2020-10-06,77,23,3010,30,4,102,100
Merced,2020-10-06,4,0,271,1,0,9,4
Nevada,2020-10-06,3,0,114,1,0,5,3
Sutter,2020-10-06,0,0,0,0,0,0,0
Marin,2020-10-06,6,6,330,0,0,17,12
El Dorado,2020-10-06,0,0,189,0,0,8,0
Kings,2020-10-06,16,0,193,2,0,15,16
Glenn,2020-10-06,0,0,47,0,0,0,0
Trinity,2020-10-06,0,0,25,0,0,0,0
Fresno,2020-10-06,100,22,1518,18,3,32,122
San Francisco,2020-10-06,47,7,1865,14,1,74,54
Butte,2020-10-06,8,0,451,5,0,5,8
Ventura,2020-10-06,34,9,1233,16,4,60,43
Tehama,2020-10-06,5,0,59,1,0,0,5
Yuba,2020-10-06,6,1,265,2,0,14,7
Napa,2020-10-06,6,2,351,2,0,27,8
San Mateo,2020-10-06,24,10,697,8,0,30,34
Contra Costa,2020-10-07,32,27,1527,6,6,53,59
San Luis Obispo,2020-10-07,3,4,451,1,0,26,7
Amador,2020-10-07,0,0,51,0,0,4,0
Santa Cruz,2020-10-07,15,0,376,5,0,12,15
Santa Clara,2020-10-07,77,25,3035,24,0,105,102
San Benito,2020-10-07,0,0,25,0,0,2,0
San Joaquin,2020-10-07,30,15,1004,10,2,51,45
Napa,2020-10-07,5,4,351,2,0,24,9
Nevada,2020-10-07,2,1,129,1,1,5,3
Shasta,2020-10-07,4,1,561,0,0,3,5
San Bernardino,2020-10-07,205,44,3860,45,5,149,249
Humboldt,2020-10-07,3,1,264,1,0,8,4
Butte,2020-10-07,7,0,451,4,0,9,7
Colusa,2020-10-07,0,2,48,0,0,0,2
Lake,2020-10-07,0,1,65,0,0,3,1
Calaveras,2020-10-07,0,1,33,0,0,5,1
Solano,2020-10-07,19,21,570,5,4,7,40
Plumas,2020-10-07,0,0,35,0,0,0,0
Kings,2020-10-07,19,0,193,3,0,13,19
Sutter,2020-10-07,0,0,0,0,0,0,0
Trinity,2020-10-07,0,0,25,0,0,0,0
Mono,2020-10-07,0,0,17,0,0,2,0
Mendocino,2020-10-07,3,0,150,3,0,4,3
Mariposa,2020-10-07,0,0,19,0,0,0,0
San Francisco,2020-10-07,44,11,1900,16,1,70,55
Tuolumne,2020-10-07,0,0,84,0,0,2,0
Glenn,2020-10-07,0,0,47,0,0,0,0
Fresno,2020-10-07,104,23,1545,12,2,32,127
Orange,2020-10-07,172,38,5770,62,3,219,210
Modoc,2020-10-07,0,2,41,0,0,0,2
Merced,2020-10-07,4,1,271,1,0,8,5
San Mateo,2020-10-07,22,10,698,9,0,19,32
Kern,2020-10-07,62,3,1336,12,0,59,65
Imperial,2020-10-07,26,0,259,9,0,1,26
Yolo,2020-10-07,3,0,96,0,0,5,3
Inyo,2020-10-07,1,1,29,0,0,4,2
Tulare,2020-10-07,37,6,677,8,0,23,43
Riverside,2020-10-07,135,74,3421,40,13,128,209
Sonoma,2020-10-07,31,8,579,7,0,10,39
San Diego,2020-10-07,217,44,6784,63,9,308,261
Marin,2020-10-07,6,4,318,0,0,14,10
Monterey,2020-10-07,25,0,702,8,0,18,25
Del Norte,2020-10-07,0,0,51,0,0,2,0
Siskiyou,2020-10-07,0,0,56,0,0,10,0
Ventura,2020-10-07,35,11,1227,20,1,56,46
El Dorado,2020-10-07,1,0,189,0,0,5,1
Los Angeles,2020-10-07,724,353,20087,185,43,958,1077
Lassen,2020-10-07,0,0,25,0,0,0,0
Santa Barbara,2020-10-07,20,0,666,7,0,48,20
Madera,2020-10-07,7,4,263,1,0,23,11
Placer,2020-10-07,16,33,754,4,4,26,49
Tehama,2020-10-07,6,0,59,2,0,0,6
Stanislaus,2020-10-07,46,14,1314,19,1,30,60
Yuba,2020-10-07,7,0,265,2,0,15,7
Alameda,2020-10-07,66,34,2417,25,3,116,100
Sacramento,2020-10-07,87,37,2499,30,4,78,124
Mendocino,2020-10-08,4,0,150,3,0,6,4
San Francisco,2020-10-08,39,5,1885,17,1,72,44
Sonoma,2020-10-08,30,8,560,5,1,7,38
Tehama,2020-10-08,3,0,59,0,0,0,3
San Joaquin,2020-10-08,31,11,1006,8,1,46,42
Imperial,2020-10-08,26,0,259,9,0,2,26
Fresno,2020-10-08,102,26,1544,18,1,23,128
Kern,2020-10-08,59,4,1338,11,0,56,63
Contra Costa,2020-10-08,29,12,1532,5,4,45,41
Sutter,2020-10-08,0,0,0,0,0,0,0
Sacramento,2020-10-08,85,45,2534,29,6,81,130
Siskiyou,2020-10-08,0,0,56,0,0,10,0
Mariposa,2020-10-08,0,0,19,0,0,0,0
Plumas,2020-10-08,0,0,35,0,0,0,0
Ventura,2020-10-08,33,13,1252,20,0,48,46
Alameda,2020-10-08,61,44,2416,21,4,106,105
El Dorado,2020-10-08,1,0,189,1,0,10,1
Calaveras,2020-10-08,0,0,33,0,0,8,0
Colusa,2020-10-08,0,1,48,0,0,0,1
Tuolumne,2020-10-08,0,0,84,0,0,1,0
Riverside,2020-10-08,145,70,3434,39,14,112,215
Humboldt,2020-10-08,3,6,248,0,1,6,9
Yolo,2020-10-08,5,0,96,0,0,6,5
Shasta,2020-10-08,4,0,561,0,0,5,4
Solano,2020-10-08,21,23,583,5,1,9,44
Lake,2020-10-08,0,1,65,0,0,4,1
San Bernardino,2020-10-08,207,51,3869,35,10,158,258
Modoc,2020-10-08,0,0,41,0,0,0,0
Los Angeles,2020-10-08,701,358,20130,184,38,920,1059
Placer,2020-10-08,18,24,749,4,1,26,42
Marin,2020-10-08,7,2,324,0,0,12,9
San Luis Obispo,2020-10-08,3,0,451,1,0,25,3
Glenn,2020-10-08,0,0,47,0,0,0,0
Napa,2020-10-08,2,0,351,2,0,25,2
Santa Cruz,2020-10-08,13,0,376,4,0,14,13
Del Norte,2020-10-08,0,0,51,0,0,2,0
San Benito,2020-10-08,0,0,25,0,0,3,0
Kings,2020-10-08,16,0,193,4,0,12,16
Yuba,2020-10-08,9,1,265,3,0,12,10
Nevada,2020-10-08,1,1,123,0,1,6,2
Mono,2020-10-08,0,0,17,0,0,2,0
San Diego,2020-10-08,215,47,6784,64,10,348,262
Tulare,2020-10-08,36,6,677,6,0,25,42
Trinity,2020-10-08,0,0,25,0,0,0,0
Lassen,2020-10-08,0,0,25,0,0,0,0
Inyo,2020-10-08,2,0,29,1,0,3,2
Amador,2020-10-08,0,0,51,0,0,6,0
Monterey,2020-10-08,25,0,702,6,0,20,25
Merced,2020-10-08,7,6,271,2,0,4,13
Santa Barbara,2020-10-08,24,0,666,8,0,50,24
Santa Clara,2020-10-08,79,19,3041,24,3,97,98
Orange,2020-10-08,176,44,5743,64,7,212,220
Stanislaus,2020-10-08,50,27,1320,20,1,23,77
Butte,2020-10-08,7,0,451,3,0,7,7
San Mateo,2020-10-08,23,10,712,8,0,21,33
Madera,2020-10-08,8,11,263,1,2,22,19
Mono,2020-10-09,0,0,17,0,0,2,0
Los Angeles,2020-10-09,715,329,20053,187,40,941,1044
San Bernardino,2020-10-09,209,49,3839,33,8,163,258
Mariposa,2020-10-09,0,0,19,0,0,0,0
Lassen,2020-10-09,0,0,25,0,0,0,0
Placer,2020-10-09,18,22,745,2,2,29,40
Fresno,2020-10-09,93,23,1554,14,3,18,116
Sutter,2020-10-09,0,0,0,0,0,0,0
Merced,2020-10-09,7,3,272,2,0,6,10
Amador,2020-10-09,0,0,51,0,0,4,0
Sacramento,2020-10-09,75,37,2482,27,5,75,112
Solano,2020-10-09,23,18,586,5,0,11,41
Monterey,2020-10-09,27,3,702,6,0,21,30
Glenn,2020-10-09,0,0,47,0,0,0,0
Santa Clara,2020-10-09,69,23,3031,20,2,108,92
Alameda,2020-10-09,59,41,2417,21,4,111,100
Santa Cruz,2020-10-09,13,0,376,4,0,14,13
San Luis Obispo,2020-10-09,3,1,451,1,0,29,4
Santa Barbara,2020-10-09,23,1,666,6,0,50,24
Kern,2020-10-09,57,2,1345,11,0,55,59
San Joaquin,2020-10-09,25,7,1007,6,5,51,32
Madera,2020-10-09,9,8,263,1,1,24,17
Yuba,2020-10-09,7,0,265,1,0,12,7
San Francisco,2020-10-09,33,8,1907,14,2,72,41
Humboldt,2020-10-09,3,2,265,0,0,5,5
Riverside,2020-10-09,146,57,3413,40,10,101,203
Ventura,2020-10-09,34,17,1255,19,7,49,51
Colusa,2020-10-09,0,0,48,0,0,0,0
El Dorado,2020-10-09,1,0,189,1,0,5,1
Trinity,2020-10-09,0,0,25,0,0,0,0
Inyo,2020-10-09,1,0,29,1,0,3,1
Plumas,2020-10-09,0,0,35,0,0,0,0
San Diego,2020-10-09,197,47,6783,59,10,295,244
Siskiyou,2020-10-09,0,0,56,0,0,9,0
Kings,2020-10-09,17,0,193,3,0,13,17
Imperial,2020-10-09,28,0,259,11,0,3,28
Marin,2020-10-09,10,2,334,0,0,16,12
Butte,2020-10-09,6,0,451,3,0,11,6
Mendocino,2020-10-09,4,0,150,4,0,3,4
Shasta,2020-10-09,3,0,561,0,0,8,3
Modoc,2020-10-09,0,0,41,0,0,0,0
Sonoma,2020-10-09,30,6,579,5,2,11,36
San Benito,2020-10-09,0,0,25,0,0,3,0
Tulare,2020-10-09,31,6,677,7,0,31,37
Yolo,2020-10-09,3,0,96,0,0,11,3
Orange,2020-10-09,169,52,5786,61,10,223,221
San Mateo,2020-10-09,29,10,707,9,3,22,39
Del Norte,2020-10-09,0,0,51,0,0,1,0
Napa,2020-10-09,2,1,351,2,0,21,3
Nevada,2020-10-09,1,0,123,0,0,5,1
Stanislaus,2020-10-09,51,31,1313,19,2,24,82
Calaveras,2020-10-09,0,0,33,0,0,8,0
Contra Costa,2020-10-09,30,14,1516,7,4,49,44
Tehama,2020-10-09,3,0,59,0,0,0,3
Tuolumne,2020-10-09,0,0,84,0,0,3,0
Lake,2020-10-09,0,0,65,0,0,5,0
Trinity,2020-10-10,0,0,25,0,0,0,0
Riverside,2020-10-10,135,56,3392,38,9,113,191
Stanislaus,2020-10-10,52,27,1322,21,2,27,79
Nevada,2020-10-10,2,0,116,0,0,5,2
Tehama,2020-10-10,3,0,59,0,0,0,3
Napa,2020-10-10,2,2,351,0,0,24,4
Calaveras,2020-10-10,0,0,33,0,0,8,0
Humboldt,2020-10-10,3,0,255,0,0,9,3
Madera,2020-10-10,11,8,263,1,0,13,19
Contra Costa,2020-10-10,30,18,1465,7,2,52,48
San Francisco,2020-10-10,33,4,1882,12,1,68,37
Shasta,2020-10-10,5,2,561,0,0,5,7
Orange,2020-10-10,164,49,5768,57,5,237,213
San Diego,2020-10-10,195,52,6797,51,8,318,247
Imperial,2020-10-10,31,0,259,11,0,-1,31
Kern,2020-10-10,46,2,1085,13,0,55,48
Colusa,2020-10-10,0,0,48,0,0,0,0
Mendocino,2020-10-10,3,0,150,3,0,7,3
San Bernardino,2020-10-10,192,52,3788,35,9,171,244
Santa Clara,2020-10-10,71,24,2926,20,2,110,95
Solano,2020-10-10,21,16,585,4,0,8,37
Merced,2020-10-10,6,3,272,2,0,9,9
Monterey,2020-10-10,26,2,702,8,0,18,28
Santa Cruz,2020-10-10,17,0,376,4,0,17,17
Placer,2020-10-10,17,40,736,4,5,29,57
Marin,2020-10-10,8,7,332,0,0,11,15
Lake,2020-10-10,0,1,65,0,1,4,1
Los Angeles,2020-10-10,693,360,19986,202,57,950,1053
Sacramento,2020-10-10,78,56,2517,27,7,79,134
San Luis Obispo,2020-10-10,2,0,451,1,0,27,2
Fresno,2020-10-10,85,19,1539,13,2,27,104
Mariposa,2020-10-10,0,0,19,0,0,0,0
San Benito,2020-10-10,0,0,25,0,0,1,0
El Dorado,2020-10-10,1,0,189,1,0,8,1
Amador,2020-10-10,0,0,51,0,0,3,0
Modoc,2020-10-10,0,0,41,0,0,0,0
Del Norte,2020-10-10,0,0,51,0,0,2,0
Tulare,2020-10-10,32,8,664,5,1,32,40
Tuolumne,2020-10-10,1,0,84,0,0,4,1
Inyo,2020-10-10,1,0,29,0,0,4,1
Mono,2020-10-10,0,0,17,0,0,2,0
Sutter,2020-10-10,0,0,0,0,0,0,0
Siskiyou,2020-10-10,0,0,56,0,0,8,0
Santa Barbara,2020-10-10,24,0,666,6,0,52,24
Kings,2020-10-10,18,0,193,2,0,16,18
Lassen,2020-10-10,0,0,25,0,0,0,0
Alameda,2020-10-10,64,46,2422,24,5,121,110
Sonoma,2020-10-10,32,6,552,6,1,9,38
Glenn,2020-10-10,0,0,47,0,0,0,0
Butte,2020-10-10,6,0,451,3,0,9,6
Plumas,2020-10-10,0,0,35,0,0,0,0
Ventura,2020-10-10,37,11,1239,18,3,55,48
San Joaquin,2020-10-10,22,14,1006,5,0,57,36
San Mateo,2020-10-10,29,9,710,7,3,27,38
Yolo,2020-10-10,2,0,96,0,0,10,2
Yuba,2020-10-10,9,0,265,1,0,11,9
Sacramento,2020-10-11,77,54,2454,25,9,97,131
Del Norte,2020-10-11,0,0,51,0,0,1,0
Siskiyou,2020-10-11,0,0,56,0,0,9,0
San Diego,2020-10-11,173,51,6778,51,16,325,224
Santa Barbara,2020-10-11,19,0,666,5,0,64,19
Ventura,2020-10-11,31,12,1235,18,1,59,43
San Bernardino,2020-10-11,183,53,3799,42,15,164,236
San Francisco,2020-10-11,27,3,1801,11,1,83,30
Santa Clara,2020-10-11,78,30,2910,23,4,117,108
San Luis Obispo,2020-10-11,1,0,346,1,0,22,1
Modoc,2020-10-11,0,0,41,0,0,0,0
Nevada,2020-10-11,2,1,89,0,0,7,3
Merced,2020-10-11,6,2,271,2,1,10,8
Mendocino,2020-10-11,3,0,150,3,0,6,3
Lake,2020-10-11,1,0,65,0,0,4,1
Lassen,2020-10-11,0,0,25,0,0,0,0
Calaveras,2020-10-11,0,0,33,0,0,6,0
Solano,2020-10-11,26,17,564,4,0,8,43
Imperial,2020-10-11,34,2,259,11,0,1,36
Madera,2020-10-11,10,9,263,1,0,26,19
San Mateo,2020-10-11,29,8,677,6,2,40,37
Plumas,2020-10-11,0,0,35,0,0,0,0
Placer,2020-10-11,19,35,729,3,3,32,54
Kern,2020-10-11,51,2,1326,13,0,59,53
El Dorado,2020-10-11,2,0,189,2,0,6,2
Fresno,2020-10-11,98,14,1511,13,1,29,112
Mariposa,2020-10-11,0,0,19,0,0,0,0
Napa,2020-10-11,2,4,200,2,0,9,6
Los Angeles,2020-10-11,692,353,19844,190,50,999,1045
Sutter,2020-10-11,0,0,0,0,0,0,0
Tulare,2020-10-11,28,7,664,4,0,33,35
Yuba,2020-10-11,10,0,265,2,0,12,10
Glenn,2020-10-11,0,0,47,0,0,0,0
Marin,2020-10-11,6,3,336,0,0,12,9
Orange,2020-10-11,167,43,5738,56,7,212,210
Santa Cruz,2020-10-11,20,0,389,5,0,16,20
San Benito,2020-10-11,0,0,25,0,0,3,0
Sonoma,2020-10-11,26,6,527,6,0,8,32
Riverside,2020-10-11,131,62,3383,36,9,110,193
Tehama,2020-10-11,2,0,59,0,0,3,2
Shasta,2020-10-11,4,1,561,0,0,5,5
San Joaquin,2020-10-11,22,6,1004,6,1,51,28
Contra Costa,2020-10-11,38,23,1452,7,3,40,61
Monterey,2020-10-11,27,2,702,9,0,20,29
Yolo,2020-10-11,5,0,96,2,0,5,5
Inyo,2020-10-11,1,0,29,0,0,3,1
Mono,2020-10-11,0,0,17,0,0,2,0
Kings,2020-10-11,19,0,193,2,0,15,19
Amador,2020-10-11,1,0,51,0,0,2,1
Colusa,2020-10-11,0,0,48,0,0,0,0
Stanislaus,2020-10-11,54,25,1321,19,1,35,79
Alameda,2020-10-11,61,44,2354,20,7,126,105
Butte,2020-10-11,6,0,451,4,0,13,6
Trinity,2020-10-11,0,0,25,0,0,0,0
Tuolumne,2020-10-11,1,0,84,0,0,4,1
Humboldt,2020-10-11,3,2,269,0,1,6,5
Inyo,2020-10-12,1,0,29,0,0,2,1
San Diego,2020-10-12,178,52,6778,57,14,321,230
Colusa,2020-10-12,0,0,48,0,0,0,0
Ventura,2020-10-12,32,9,1234,18,2,60,41
El Dorado,2020-10-12,1,0,189,1,0,10,1
Mono,2020-10-12,0,0,17,0,0,2,0
San Luis Obispo,2020-10-12,1,0,451,0,0,25,1
Tehama,2020-10-12,2,0,59,1,0,2,2
Sutter,2020-10-12,0,0,14,0,0,0,0
Mariposa,2020-10-12,0,0,19,0,0,0,0
San Benito,2020-10-12,0,0,25,0,0,3,0
Siskiyou,2020-10-12,0,0,56,0,0,9,0
Butte,2020-10-12,6,0,451,4,0,10,6
Merced,2020-10-12,10,0,271,3,0,9,10
Lassen,2020-10-12,0,0,25,0,0,0,0
Tuolumne,2020-10-12,1,0,84,0,0,2,1
Humboldt,2020-10-12,4,1,264,1,1,3,5
Tulare,2020-10-12,26,4,664,4,0,35,30
Monterey,2020-10-12,28,0,702,9,0,20,28
San Joaquin,2020-10-12,25,11,1008,6,1,47,36
San Bernardino,2020-10-12,186,50,3811,42,8,168,236
Nevada,2020-10-12,1,0,127,0,0,7,1
San Mateo,2020-10-12,29,11,683,5,3,33,40
Madera,2020-10-12,8,11,263,1,0,20,19
Stanislaus,2020-10-12,54,9,1312,18,1,40,63
Sonoma,2020-10-12,23,6,539,6,1,7,29
Alameda,2020-10-12,61,45,2332,19,9,124,106
Yolo,2020-10-12,4,0,96,2,0,3,4
Riverside,2020-10-12,146,55,3350,42,9,101,201
Marin,2020-10-12,5,3,328,0,0,14,8
Modoc,2020-10-12,0,1,41,0,0,0,1
Contra Costa,2020-10-12,26,19,1473,7,1,53,45
Santa Cruz,2020-10-12,20,0,389,5,0,16,20
Los Angeles,2020-10-12,720,356,19946,197,48,1025,1076
Napa,2020-10-12,1,1,351,0,0,26,2
San Francisco,2020-10-12,28,2,1821,11,2,90,30
Solano,2020-10-12,29,16,552,6,0,6,45
Mendocino,2020-10-12,3,0,150,3,0,6,3
Plumas,2020-10-12,0,0,35,0,0,0,0
Sacramento,2020-10-12,77,47,2417,19,8,101,124
Lake,2020-10-12,2,0,65,1,0,4,2
Imperial,2020-10-12,31,0,259,12,0,0,31
Del Norte,2020-10-12,0,0,51,0,0,2,0
Kings,2020-10-12,19,0,193,2,0,14,19
Placer,2020-10-12,16,34,714,3,3,27,50
Kern,2020-10-12,53,3,1333,13,0,63,56
Yuba,2020-10-12,11,1,265,1,0,16,12
Shasta,2020-10-12,7,1,561,0,0,4,8
Santa Barbara,2020-10-12,21,5,666,7,2,61,26
Santa Clara,2020-10-12,80,20,2883,25,2,124,100
Calaveras,2020-10-12,0,0,33,0,0,6,0
Orange,2020-10-12,160,49,5670,57,7,252,209
Trinity,2020-10-12,0,0,25,0,0,0,0
Fresno,2020-10-12,89,12,1525,18,0,36,101
Amador,2020-10-12,1,0,51,0,0,3,1
Glenn,2020-10-12,0,0,47,0,0,0,0
Ventura,2020-10-13,35,10,1242,18,2,54,45
Solano,2020-10-13,31,15,564,7,2,6,46
Lake,2020-10-13,2,1,65,1,0,3,3
San Bernardino,2020-10-13,179,49,3852,40,5,161,228
Siskiyou,2020-10-13,0,0,56,0,0,6,0
San Diego,2020-10-13,187,56,6784,61,14,306,243
Tuolumne,2020-10-13,1,0,84,0,0,1,1
Humboldt,2020-10-13,4,1,259,1,0,3,5
Mendocino,2020-10-13,1,0,150,1,0,5,1
Modoc,2020-10-13,0,2,41,0,0,0,2
Fresno,2020-10-13,91,14,1542,17,3,32,105
Inyo,2020-10-13,1,0,29,0,0,3,1
Mariposa,2020-10-13,0,0,19,0,0,0,0
San Luis Obispo,2020-10-13,2,1,451,0,0,26,3
Kern,2020-10-13,59,2,1323,17,0,60,61
Merced,2020-10-13,10,2,271,3,0,10,12
Sonoma,2020-10-13,23,4,581,6,0,8,27
Marin,2020-10-13,6,8,332,0,1,13,14
Santa Barbara,2020-10-13,18,2,666,7,2,56,20
Calaveras,2020-10-13,0,0,33,0,0,8,0
Kings,2020-10-13,14,2,193,2,0,12,16
Mono,2020-10-13,0,0,17,0,0,2,0
Contra Costa,2020-10-13,21,18,1492,7,1,52,39
Del Norte,2020-10-13,0,0,51,0,0,1,0
Santa Cruz,2020-10-13,17,0,389,5,0,16,17
Napa,2020-10-13,1,3,351,0,0,24,4
El Dorado,2020-10-13,1,2,189,1,0,6,3
Riverside,2020-10-13,149,59,3409,45,14,110,208
Glenn,2020-10-13,0,0,47,0,0,0,0
Stanislaus,2020-10-13,51,16,1302,17,0,29,67
Los Angeles,2020-10-13,723,382,20029,196,49,983,1105
Butte,2020-10-13,6,0,451,2,0,6,6
Sutter,2020-10-13,0,0,14,0,0,0,0
Santa Clara,2020-10-13,80,22,2904,23,4,115,102
San Joaquin,2020-10-13,28,13,1016,5,1,44,41
San Francisco,2020-10-13,27,4,1874,8,1,73,31
Orange,2020-10-13,165,48,5790,60,12,230,213
Shasta,2020-10-13,1,5,561,0,0,5,6
Monterey,2020-10-13,28,1,702,9,1,33,29
Plumas,2020-10-13,0,0,35,0,0,0,0
Nevada,2020-10-13,2,0,119,0,0,7,2
San Benito,2020-10-13,0,0,25,0,0,3,0
Colusa,2020-10-13,0,0,48,0,0,0,0
Placer,2020-10-13,18,34,738,4,2,25,52
Tulare,2020-10-13,28,9,677,5,0,26,37
Sacramento,2020-10-13,74,46,2484,14,10,100,120
Alameda,2020-10-13,63,32,2363,19,5,126,95
Lassen,2020-10-13,0,0,25,0,0,0,0
Trinity,2020-10-13,0,0,25,0,0,0,0
Imperial,2020-10-13,30,0,259,13,0,3,30
Madera,2020-10-13,7,13,263,0,0,20,20
Amador,2020-10-13,0,1,51,0,0,2,1
Tehama,2020-10-13,3,0,59,1,0,2,3
San Mateo,2020-10-13,28,9,694,4,2,27,37
Yolo,2020-10-13,3,0,96,2,0,2,3
Yuba,2020-10-13,11,0,265,1,0,15,11
Marin,2020-10-14,8,9,333,0,1,13,17
Sacramento,2020-10-14,75,36,2469,15,9,95,111
San Mateo,2020-10-14,24,6,704,6,0,31,30
Lassen,2020-10-14,0,0,25,0,0,0,0
Riverside,2020-10-14,149,69,3414,42,8,108,218
Tehama,2020-10-14,4,0,59,0,0,2,4
San Bernardino,2020-10-14,181,52,3871,41,2,169,233
Plumas,2020-10-14,0,0,35,0,0,0,0
Placer,2020-10-14,13,14,736,2,1,28,27
Kings,2020-10-14,12,2,193,0,0,14,14
Los Angeles,2020-10-14,735,372,20079,188,51,984,1107
Monterey,2020-10-14,27,1,702,8,0,37,28
Siskiyou,2020-10-14,0,0,56,0,0,8,0
Contra Costa,2020-10-14,17,12,1498,5,2,48,29
Santa Barbara,2020-10-14,19,3,666,6,1,57,22
Kern,2020-10-14,67,0,1332,18,0,54,67
Mendocino,2020-10-14,0,0,150,0,0,4,0
Del Norte,2020-10-14,0,0,51,0,0,3,0
Imperial,2020-10-14,34,0,259,14,0,2,34
Sutter,2020-10-14,0,0,14,0,0,0,0
Yuba,2020-10-14,8,0,265,0,0,14,8
Nevada,2020-10-14,2,0,139,0,0,5,2
Lake,2020-10-14,1,0,65,1,0,2,1
Ventura,2020-10-14,29,13,1241,13,3,58,42
Tulare,2020-10-14,29,9,677,5,1,19,38
Yolo,2020-10-14,1,0,96,1,0,2,1
San Francisco,2020-10-14,26,6,1907,7,1,71,32
Solano,2020-10-14,28,16,574,6,0,13,44
Modoc,2020-10-14,0,0,41,0,0,0,0
Madera,2020-10-14,7,6,263,0,0,24,13
Mariposa,2020-10-14,0,0,19,0,0,0,0
San Joaquin,2020-10-14,29,7,1015,4,0,51,36
Colusa,2020-10-14,0,0,48,0,0,0,0
Alameda,2020-10-14,59,40,2371,15,5,125,99
San Diego,2020-10-14,181,43,6781,61,6,295,224
Merced,2020-10-14,10,0,271,2,0,12,10
Santa Clara,2020-10-14,87,20,2924,25,3,106,107
Humboldt,2020-10-14,4,2,270,1,0,3,6
Santa Cruz,2020-10-14,17,1,389,5,0,16,18
Inyo,2020-10-14,1,0,29,0,0,3,1
El Dorado,2020-10-14,0,1,189,0,1,6,1
Napa,2020-10-14,2,3,351,1,0,23,5
Fresno,2020-10-14,94,22,1533,18,3,36,116
Trinity,2020-10-14,0,0,25,0,0,0,0
Sonoma,2020-10-14,25,4,557,6,0,9,29
San Luis Obispo,2020-10-14,4,2,451,0,0,23,6
Stanislaus,2020-10-14,55,19,1302,15,2,32,74
Mono,2020-10-14,0,0,17,0,0,2,0
Tuolumne,2020-10-14,1,0,84,0,0,2,1
Shasta,2020-10-14,7,1,561,1,0,5,8
Butte,2020-10-14,3,0,451,2,0,7,3
Glenn,2020-10-14,0,0,47,0,0,0,0
Orange,2020-10-14,164,48,5749,66,6,231,212
Calaveras,2020-10-14,0,0,33,0,0,8,0
San Benito,2020-10-14,0,0,25,0,0,4,0
Amador,2020-10-14,0,0,51,0,0,2,0
Tulare,2020-10-15,27,8,677,4,1,22,35
Sutter,2020-10-15,0,0,14,0,0,0,0
Shasta,2020-10-15,8,1,561,2,0,2,9
Orange,2020-10-15,170,33,5725,66,3,252,203
Calaveras,2020-10-15,0,0,33,0,0,8,0
Sacramento,2020-10-15,79,34,2466,18,8,82,113
Tuolumne,2020-10-15,1,0,84,0,0,3,1
Modoc,2020-10-15,0,0,41,0,0,0,0
San Luis Obispo,2020-10-15,5,0,451,0,0,25,5
San Francisco,2020-10-15,21,8,1907,7,2,65,29
Merced,2020-10-15,11,2,271,1,0,10,13
Napa,2020-10-15,2,3,351,0,1,23,5
Contra Costa,2020-10-15,20,14,1498,6,3,45,34
Siskiyou,2020-10-15,0,1,56,0,0,8,1
Riverside,2020-10-15,148,57,3437,44,9,113,205
Monterey,2020-10-15,24,1,702,8,0,37,25
Kern,2020-10-15,59,1,1332,17,0,53,60
Amador,2020-10-15,0,0,51,0,0,4,0
Butte,2020-10-15,2,0,451,1,0,9,2
Sonoma,2020-10-15,26,4,561,7,1,7,30
Mono,2020-10-15,0,0,17,0,0,2,0
Santa Barbara,2020-10-15,16,2,666,5,1,53,18
Imperial,2020-10-15,32,2,259,14,0,3,34
Glenn,2020-10-15,0,0,47,0,0,0,0
Inyo,2020-10-15,2,0,29,0,0,4,2
Solano,2020-10-15,24,16,574,6,0,6,40
San Benito,2020-10-15,0,0,25,0,0,3,0
San Joaquin,2020-10-15,28,10,1015,3,2,52,38
Lassen,2020-10-15,0,0,25,0,0,0,0
Tehama,2020-10-15,3,0,59,1,0,3,3
Mendocino,2020-10-15,0,0,150,0,0,7,0
Placer,2020-10-15,12,12,737,2,0,33,24
Yolo,2020-10-15,5,0,96,3,0,3,5
San Bernardino,2020-10-15,186,53,3836,45,5,159,239
Fresno,2020-10-15,95,15,1526,17,0,33,110
Del Norte,2020-10-15,0,0,51,0,0,4,0
Santa Clara,2020-10-15,84,19,2920,27,6,110,103
Lake,2020-10-15,1,4,66,1,1,2,5
Trinity,2020-10-15,0,0,25,0,0,0,0
San Mateo,2020-10-15,25,8,704,7,0,29,33
Humboldt,2020-10-15,4,1,267,1,1,4,5
Los Angeles,2020-10-15,746,340,20041,180,40,951,1086
Plumas,2020-10-15,0,0,35,0,0,0,0
Alameda,2020-10-15,57,42,2366,16,1,133,99
Colusa,2020-10-15,0,0,48,0,0,0,0
Mariposa,2020-10-15,0,0,19,0,0,0,0
El Dorado,2020-10-15,0,0,189,0,0,8,0
Nevada,2020-10-15,1,0,142,0,0,1,1
Kings,2020-10-15,13,1,193,2,0,14,14
Marin,2020-10-15,8,8,362,1,1,16,16
Madera,2020-10-15,8,9,263,0,0,18,17
Ventura,2020-10-15,29,11,1245,18,1,50,40
Yuba,2020-10-15,8,0,265,1,0,10,8
Santa Cruz,2020-10-15,15,0,389,5,0,14,15
Stanislaus,2020-10-15,56,19,1302,17,0,31,75
San Diego,2020-10-15,184,51,6790,62,11,293,235
San Mateo,2020-10-16,27,12,722,9,0,23,39
Riverside,2020-10-16,136,67,3412,41,15,109,203
Modoc,2020-10-16,0,0,41,0,0,0,0
Solano,2020-10-16,21,17,547,6,1,5,38
Humboldt,2020-10-16,4,4,264,1,3,2,8
El Dorado,2020-10-16,0,0,189,0,0,8,0
Mariposa,2020-10-16,0,0,19,0,0,0,0
Inyo,2020-10-16,2,1,29,0,0,4,3
Colusa,2020-10-16,0,0,48,0,0,0,0
Stanislaus,2020-10-16,55,12,1309,15,3,31,67
Shasta,2020-10-16,6,0,561,1,0,2,6
Glenn,2020-10-16,0,0,47,0,0,0,0
Siskiyou,2020-10-16,0,0,56,0,0,8,0
Tuolumne,2020-10-16,0,0,84,0,0,2,0
Santa Cruz,2020-10-16,14,0,389,6,0,13,14
San Francisco,2020-10-16,20,4,2294,6,0,52,24
San Benito,2020-10-16,0,0,25,0,0,3,0
Santa Barbara,2020-10-16,13,3,666,4,1,60,16
Nevada,2020-10-16,0,0,138,0,0,0,0
Imperial,2020-10-16,33,2,259,13,0,5,35
Monterey,2020-10-16,25,0,702,8,0,38,25
Tehama,2020-10-16,4,0,59,2,0,4,4
Orange,2020-10-16,159,40,5806,56,8,249,199
Yuba,2020-10-16,9,1,265,0,0,15,10
Napa,2020-10-16,2,1,351,0,0,24,3
Placer,2020-10-16,11,22,736,4,4,29,33
Del Norte,2020-10-16,0,0,51,0,0,3,0
Trinity,2020-10-16,0,0,25,0,0,0,0
San Diego,2020-10-16,189,46,6781,65,9,318,235
Butte,2020-10-16,2,0,451,2,0,12,2
Merced,2020-10-16,9,1,272,1,1,12,10
Alameda,2020-10-16,52,43,2356,17,2,130,95
Sutter,2020-10-16,0,0,14,0,0,0,0
Amador,2020-10-16,0,0,51,0,0,2,0
Santa Clara,2020-10-16,89,16,2928,29,1,111,105
San Bernardino,2020-10-16,189,44,3836,46,4,161,233
Sonoma,2020-10-16,25,6,563,6,1,5,31
Plumas,2020-10-16,0,0,35,0,0,0,0
Calaveras,2020-10-16,0,0,33,0,0,6,0
Fresno,2020-10-16,92,17,1555,24,0,43,109
Lake,2020-10-16,1,0,65,1,0,3,1
Ventura,2020-10-16,29,4,1238,18,1,54,33
Lassen,2020-10-16,0,0,25,0,0,0,0
Madera,2020-10-16,8,8,263,0,0,25,16
San Luis Obispo,2020-10-16,3,1,451,0,0,23,4
Kern,2020-10-16,58,1,1338,20,0,53,59
Sacramento,2020-10-16,84,33,2471,22,5,82,117
San Joaquin,2020-10-16,30,10,1013,5,3,44,40
Contra Costa,2020-10-16,21,13,1480,5,3,35,34
Los Angeles,2020-10-16,752,324,19999,200,34,941,1076
Yolo,2020-10-16,6,0,96,4,0,5,6
Tulare,2020-10-16,31,5,677,4,0,31,36
Marin,2020-10-16,9,3,368,2,0,15,12
Mono,2020-10-16,0,0,17,0,0,2,0
Kings,2020-10-16,14,0,193,1,0,16,14
Mendocino,2020-10-16,0,0,150,0,0,5,0
Tuolumne,2020-10-17,0,0,84,0,0,4,0
Del Norte,2020-10-17,0,0,51,0,0,2,0
Trinity,2020-10-17,0,0,25,0,0,0,0
Madera,2020-10-17,7,7,263,0,1,25,14
San Francisco,2020-10-17,23,3,1854,8,1,65,26
Solano,2020-10-17,22,19,548,6,1,8,41
Sonoma,2020-10-17,23,4,560,4,0,4,27
Sutter,2020-10-17,0,0,14,0,0,0,0
San Joaquin,2020-10-17,25,8,1009,4,3,43,33
Siskiyou,2020-10-17,0,0,56,0,0,8,0
Mariposa,2020-10-17,0,0,19,0,0,0,0
Kings,2020-10-17,15,0,193,1,0,15,15
Nevada,2020-10-17,0,0,111,0,0,0,0
Tehama,2020-10-17,5,0,59,2,0,0,5
Ventura,2020-10-17,30,10,1234,13,3,63,40
Plumas,2020-10-17,0,0,35,0,0,0,0
Contra Costa,2020-10-17,26,17,1499,3,2,49,43
Mendocino,2020-10-17,0,0,150,0,0,6,0
Yolo,2020-10-17,6,0,96,4,0,3,6
Merced,2020-10-17,7,0,272,2,0,12,7
Butte,2020-10-17,2,0,451,2,0,12,2
Marin,2020-10-17,9,4,365,2,0,14,13
Tulare,2020-10-17,32,0,677,4,0,29,32
Riverside,2020-10-17,153,65,3350,44,11,112,218
El Dorado,2020-10-17,0,0,189,0,0,10,0
Modoc,2020-10-17,0,0,41,0,0,0,0
Stanislaus,2020-10-17,60,8,1307,17,2,22,68
San Mateo,2020-10-17,21,7,686,6,3,30,28
Placer,2020-10-17,24,21,738,5,2,33,45
Lake,2020-10-17,1,0,65,1,0,2,1
Amador,2020-10-17,0,0,51,0,0,1,0
Santa Cruz,2020-10-17,12,0,389,6,0,11,12
Lassen,2020-10-17,0,0,25,0,0,0,0
Yuba,2020-10-17,9,1,265,0,0,14,10
Napa,2020-10-17,2,0,351,0,0,24,2
San Benito,2020-10-17,0,0,25,0,0,3,0
Colusa,2020-10-17,0,0,48,0,0,0,0
Glenn,2020-10-17,0,0,47,0,0,0,0
Alameda,2020-10-17,54,36,2340,19,5,133,90
Monterey,2020-10-17,25,0,702,6,0,38,25
Humboldt,2020-10-17,3,2,266,1,2,3,5
Los Angeles,2020-10-17,722,297,19935,197,31,929,1019
Calaveras,2020-10-17,0,0,33,0,0,6,0
San Luis Obispo,2020-10-17,2,0,451,0,0,25,2
Santa Barbara,2020-10-17,12,2,666,3,1,61,14
Imperial,2020-10-17,34,2,259,14,0,3,36
Santa Clara,2020-10-17,84,17,2932,23,0,117,101
Inyo,2020-10-17,1,0,29,0,0,2,1
Kern,2020-10-17,59,5,1281,18,0,60,64
Sacramento,2020-10-17,78,33,2460,21,5,90,111
Orange,2020-10-17,162,42,5706,59,12,250,204
Shasta,2020-10-17,0,5,561,0,1,4,5
Fresno,2020-10-17,86,23,1548,24,1,38,109
San Diego,2020-10-17,185,51,6779,66,7,333,236
San Bernardino,2020-10-17,265,45,3819,39,9,166,310
Mono,2020-10-17,0,0,17,0,0,1,0
San Joaquin,2020-10-18,23,5,997,5,1,49,28
San Benito,2020-10-18,0,0,25,0,0,3,0
San Francisco,2020-10-18,25,3,1794,8,2,80,28
Humboldt,2020-10-18,3,1,269,1,0,4,4
Sonoma,2020-10-18,22,9,507,5,1,8,31
Santa Cruz,2020-10-18,11,0,389,6,0,13,11
Orange,2020-10-18,168,42,5672,63,6,251,210
San Mateo,2020-10-18,20,7,670,5,2,35,27
Kings,2020-10-18,19,0,193,1,0,15,19
Nevada,2020-10-18,1,0,117,0,0,2,1
Del Norte,2020-10-18,1,0,51,0,0,2,1
Mariposa,2020-10-18,0,0,19,0,0,0,0
Riverside,2020-10-18,153,55,3319,43,9,118,208
Modoc,2020-10-18,0,0,41,0,0,0,0
Tehama,2020-10-18,6,1,59,2,0,2,7
Los Angeles,2020-10-18,730,312,19873,216,30,960,1042
Shasta,2020-10-18,7,1,561,1,0,7,8
Trinity,2020-10-18,0,0,25,0,0,0,0
Tuolumne,2020-10-18,0,1,84,0,0,0,1
Glenn,2020-10-18,0,0,47,0,0,0,0
Calaveras,2020-10-18,0,0,33,0,0,8,0
Kern,2020-10-18,55,3,1323,17,0,60,58
Santa Clara,2020-10-18,90,19,2908,26,1,123,109
Yuba,2020-10-18,9,0,265,0,0,11,9
Mendocino,2020-10-18,1,0,150,1,0,5,1
Yolo,2020-10-18,6,0,96,4,0,4,6
Lake,2020-10-18,2,0,65,1,0,3,2
Tulare,2020-10-18,30,5,677,3,0,30,35
Ventura,2020-10-18,30,10,1228,15,1,58,40
Monterey,2020-10-18,20,0,702,7,0,40,20
Siskiyou,2020-10-18,0,0,56,0,0,7,0
San Bernardino,2020-10-18,181,47,3822,41,9,172,228
Butte,2020-10-18,2,0,451,2,0,13,2
San Luis Obispo,2020-10-18,1,0,451,0,0,27,1
Inyo,2020-10-18,1,0,29,1,0,3,1
Marin,2020-10-18,6,4,357,1,0,16,10
Plumas,2020-10-18,0,0,35,0,0,0,0
Imperial,2020-10-18,33,1,259,15,0,3,34
Madera,2020-10-18,8,5,263,1,0,17,13
Santa Barbara,2020-10-18,16,1,666,5,1,55,17
Sutter,2020-10-18,0,0,14,0,0,0,0
Sacramento,2020-10-18,81,43,2491,23,12,100,124
Stanislaus,2020-10-18,61,12,1298,15,2,20,73
Contra Costa,2020-10-18,32,12,1480,4,0,52,44
Mono,2020-10-18,0,0,17,0,0,1,0
Merced,2020-10-18,6,1,272,2,0,11,7
El Dorado,2020-10-18,0,0,189,0,0,11,0
Lassen,2020-10-18,0,0,25,0,0,0,0
Colusa,2020-10-18,0,2,48,0,0,0,2
Amador,2020-10-18,0,0,51,0,0,2,0
Placer,2020-10-18,20,18,738,4,4,25,38
Fresno,2020-10-18,96,20,1537,28,2,29,116
Solano,2020-10-18,20,20,560,5,0,9,40
San Diego,2020-10-18,189,54,6765,63,10,331,243
Alameda,2020-10-18,54,42,2329,20,5,128,96
Napa,2020-10-18,2,5,351,0,0,24,7
Modoc,2020-10-19,0,0,41,0,0,0,0
San Mateo,2020-10-19,23,9,669,7,2,40,32
San Luis Obispo,2020-10-19,2,0,460,0,0,31,2
Tuolumne,2020-10-19,1,0,84,0,0,6,1
San Joaquin,2020-10-19,23,5,976,4,0,53,28
Monterey,2020-10-19,22,1,702,7,0,44,23
Santa Barbara,2020-10-19,18,0,666,4,0,58,18
Orange,2020-10-19,168,44,5647,63,5,256,212
Imperial,2020-10-19,41,0,259,15,0,3,41
Amador,2020-10-19,0,0,51,0,0,3,0
Contra Costa,2020-10-19,25,14,1493,5,1,52,39
Mendocino,2020-10-19,1,0,150,1,0,5,1
Yuba,2020-10-19,10,0,265,1,0,11,10
Calaveras,2020-10-19,0,0,33,0,0,6,0
Fresno,2020-10-19,100,17,1538,23,3,34,117
Trinity,2020-10-19,0,0,25,0,0,0,0
Yolo,2020-10-19,6,0,96,3,0,4,6
Ventura,2020-10-19,30,4,1233,15,1,60,34
Tehama,2020-10-19,6,1,59,2,0,2,7
Butte,2020-10-19,2,0,451,2,0,11,2
San Diego,2020-10-19,191,48,6771,72,13,354,239
Tulare,2020-10-19,28,7,677,1,0,38,35
El Dorado,2020-10-19,0,0,189,0,0,10,0
Stanislaus,2020-10-19,59,17,1299,14,3,25,76
Los Angeles,2020-10-19,758,364,19985,216,46,1006,1122
Nevada,2020-10-19,1,1,138,0,1,6,2
Del Norte,2020-10-19,1,0,51,0,0,1,1
Lake,2020-10-19,2,1,65,1,1,2,3
San Francisco,2020-10-19,25,5,1758,8,2,78,30
Napa,2020-10-19,3,5,351,0,0,24,8
Sonoma,2020-10-19,20,5,514,4,0,7,25
Shasta,2020-10-19,8,1,561,1,0,7,9
San Benito,2020-10-19,0,0,25,0,0,3,0
Inyo,2020-10-19,1,0,29,0,0,4,1
Santa Cruz,2020-10-19,9,0,389,5,0,14,9
Santa Clara,2020-10-19,91,20,2914,26,1,123,111
Kings,2020-10-19,20,0,193,1,0,17,20
Marin,2020-10-19,5,7,357,1,0,16,12
Humboldt,2020-10-19,3,3,269,1,2,3,6
Mariposa,2020-10-19,0,0,19,0,0,0,0
Placer,2020-10-19,19,21,738,3,1,34,40
Alameda,2020-10-19,53,48,2319,20,5,128,101
Riverside,2020-10-19,157,60,3363,42,14,129,217
Sutter,2020-10-19,0,0,14,0,0,0,0
Colusa,2020-10-19,0,2,48,0,0,0,2
Lassen,2020-10-19,0,0,25,0,0,0,0
Kern,2020-10-19,56,3,1312,18,0,52,59
Siskiyou,2020-10-19,0,0,56,0,0,7,0
Sacramento,2020-10-19,80,29,2438,23,13,114,109
Plumas,2020-10-19,0,0,35,0,0,0,0
Mono,2020-10-19,0,0,17,0,0,2,0
Glenn,2020-10-19,0,0,47,0,0,0,0
Madera,2020-10-19,8,8,263,1,1,22,16
Solano,2020-10-19,22,18,546,4,2,6,40
San Bernardino,2020-10-19,187,44,3853,40,7,162,231
Merced,2020-10-19,6,1,271,3,0,6,7
San Luis Obispo,2020-10-20,3,0,460,0,0,29,3
Monterey,2020-10-20,21,0,729,10,0,34,21
Shasta,2020-10-20,8,0,561,1,0,3,8
Contra Costa,2020-10-20,23,18,1493,7,4,54,41
Alameda,2020-10-20,58,37,2354,18,5,127,95
Santa Barbara,2020-10-20,18,0,688,4,0,58,18
Butte,2020-10-20,6,0,451,3,0,7,6
Trinity,2020-10-20,0,0,25,0,0,0,0
Colusa,2020-10-20,0,0,48,0,0,0,0
Kern,2020-10-20,55,2,1349,17,0,49,57
Madera,2020-10-20,6,8,263,1,0,16,14
San Benito,2020-10-20,0,0,25,0,0,3,0
Ventura,2020-10-20,28,10,1247,15,4,30,38
El Dorado,2020-10-20,0,0,189,0,0,6,0
Sacramento,2020-10-20,82,25,2468,22,6,87,107
San Joaquin,2020-10-20,22,8,1007,4,0,49,30
Los Angeles,2020-10-20,777,322,20131,222,39,747,1099
Mendocino,2020-10-20,0,0,150,0,0,5,0
Napa,2020-10-20,0,2,351,0,0,27,2
Yolo,2020-10-20,7,0,96,3,0,4,7
Tuolumne,2020-10-20,1,0,84,0,0,0,1
Solano,2020-10-20,26,18,545,4,1,12,44
Del Norte,2020-10-20,1,0,52,0,0,2,1
Marin,2020-10-20,5,4,360,2,0,16,9
San Francisco,2020-10-20,21,4,1865,6,1,71,25
Calaveras,2020-10-20,0,0,33,0,0,5,0
Placer,2020-10-20,17,21,764,3,4,24,38
Inyo,2020-10-20,0,0,29,0,0,3,0
Yuba,2020-10-20,7,0,265,0,0,11,7
Stanislaus,2020-10-20,52,26,1321,14,1,21,78
Tehama,2020-10-20,5,1,59,2,0,2,6
Modoc,2020-10-20,0,0,41,0,0,0,0
Plumas,2020-10-20,0,0,35,0,0,0,0
San Mateo,2020-10-20,20,7,661,7,2,33,27
Tulare,2020-10-20,26,10,677,2,0,27,36
Mariposa,2020-10-20,0,0,19,0,0,0,0
Humboldt,2020-10-20,3,4,256,1,0,7,7
Fresno,2020-10-20,114,20,1652,24,1,27,134
Kings,2020-10-20,22,0,193,2,0,16,22
San Bernardino,2020-10-20,198,31,4042,41,7,125,229
Nevada,2020-10-20,1,0,120,0,0,5,1
San Diego,2020-10-20,199,34,6894,69,8,319,233
Santa Cruz,2020-10-20,8,0,389,4,0,6,8
Orange,2020-10-20,174,52,5761,66,5,216,226
Imperial,2020-10-20,40,0,259,15,0,1,40
Sonoma,2020-10-20,19,1,532,4,0,6,20
Lake,2020-10-20,2,0,65,2,0,1,2
Amador,2020-10-20,0,0,51,0,0,4,0
Merced,2020-10-20,7,0,271,3,0,5,7
Santa Clara,2020-10-20,99,18,2989,25,1,48,117
Glenn,2020-10-20,0,0,47,0,0,0,0
Lassen,2020-10-20,0,0,25,0,0,0,0
Sutter,2020-10-20,0,0,14,0,0,0,0
Mono,2020-10-20,0,0,17,0,0,2,0
Riverside,2020-10-20,167,46,3467,37,14,15,213
Siskiyou,2020-10-20,0,0,56,0,0,8,0
Colusa,2020-10-21,0,0,48,0,0,0,0
Placer,2020-10-21,16,11,775,3,2,25,27
Monterey,2020-10-21,20,1,717,9,0,30,21
Ventura,2020-10-21,29,14,1251,18,4,50,43
Sacramento,2020-10-21,81,30,2453,19,5,81,111
Imperial,2020-10-21,45,0,259,17,0,0,45
Santa Barbara,2020-10-21,17,1,688,3,0,64,18
Yolo,2020-10-21,6,0,96,3,0,3,6
San Joaquin,2020-10-21,26,10,1003,6,0,54,36
El Dorado,2020-10-21,0,0,189,0,0,2,0
Kings,2020-10-21,21,0,193,2,0,16,21
Fresno,2020-10-21,110,19,1676,19,0,36,129
Plumas,2020-10-21,0,0,35,0,0,0,0
Madera,2020-10-21,4,13,263,2,1,20,17
Orange,2020-10-21,168,50,5771,56,9,173,218
Mono,2020-10-21,0,0,17,0,0,2,0
Tuolumne,2020-10-21,1,0,84,0,0,2,1
Glenn,2020-10-21,0,0,47,0,0,0,0
Kern,2020-10-21,53,3,1364,19,0,58,56
Santa Cruz,2020-10-21,10,0,389,4,0,5,10
Solano,2020-10-21,23,10,566,4,3,9,33
Amador,2020-10-21,0,0,51,0,0,5,0
Humboldt,2020-10-21,3,1,275,1,1,4,4
San Benito,2020-10-21,0,0,25,0,0,3,0
Los Angeles,2020-10-21,769,290,20077,221,34,774,1059
Stanislaus,2020-10-21,54,20,1371,12,3,22,74
Riverside,2020-10-21,176,51,3491,41,16,78,227
San Luis Obispo,2020-10-21,6,1,460,0,0,30,7
Merced,2020-10-21,6,0,271,2,0,10,6
Sutter,2020-10-21,0,0,14,0,0,0,0
Calaveras,2020-10-21,0,0,33,0,0,6,0
Lassen,2020-10-21,0,0,25,0,0,0,0
San Mateo,2020-10-21,22,3,683,8,1,35,25
Mariposa,2020-10-21,0,0,19,0,0,0,0
Shasta,2020-10-21,7,0,561,1,0,1,7
Alameda,2020-10-21,61,37,2564,16,3,121,98
Mendocino,2020-10-21,1,0,150,1,0,5,1
Tulare,2020-10-21,27,6,677,2,0,18,33
San Diego,2020-10-21,187,44,6898,67,8,305,231
Yuba,2020-10-21,8,0,265,0,0,10,8
Modoc,2020-10-21,0,0,41,0,0,0,0
Siskiyou,2020-10-21,0,0,56,0,0,8,0
Trinity,2020-10-21,0,0,25,0,0,0,0
San Bernardino,2020-10-21,208,37,4052,48,5,108,245
San Francisco,2020-10-21,23,10,1894,7,5,59,33
Del Norte,2020-10-21,1,0,51,0,0,1,1
Inyo,2020-10-21,0,0,29,0,0,4,0
Contra Costa,2020-10-21,22,13,1509,6,2,50,35
Napa,2020-10-21,1,3,351,0,0,26,4
Sonoma,2020-10-21,23,0,538,5,0,8,23
Santa Clara,2020-10-21,94,17,3037,23,4,56,111
Lake,2020-10-21,2,0,65,2,0,1,2
Marin,2020-10-21,5,5,360,2,0,12,10
Nevada,2020-10-21,1,0,139,0,0,3,1
Tehama,2020-10-21,7,0,59,2,0,2,7
Butte,2020-10-21,7,0,451,1,0,4,7
Santa Clara,2020-10-22,89,20,3021,23,3,80,109
Humboldt,2020-10-22,4,0,268,1,0,3,4
Ventura,2020-10-22,31,14,1257,19,2,53,45
Monterey,2020-10-22,22,0,720,8,0,19,22
Solano,2020-10-22,21,12,376,3,2,7,33
Mendocino,2020-10-22,0,0,150,0,0,7,0
San Diego,2020-10-22,188,47,6899,58,13,280,235
Sonoma,2020-10-22,23,3,544,5,1,10,26
Sutter,2020-10-22,0,0,14,0,0,0,0
Del Norte,2020-10-22,1,1,51,0,0,3,2
Mariposa,2020-10-22,0,0,19,0,0,0,0
Riverside,2020-10-22,161,57,3476,39,15,77,218
Tulare,2020-10-22,28,1,677,4,0,19,29
Trinity,2020-10-22,0,0,25,0,0,0,0
Siskiyou,2020-10-22,0,0,56,0,0,8,0
Amador,2020-10-22,1,0,51,0,0,6,1
Glenn,2020-10-22,0,0,47,0,0,0,0
Shasta,2020-10-22,9,1,561,2,0,4,10
Kings,2020-10-22,22,1,193,2,1,14,23
Mono,2020-10-22,0,0,17,0,0,2,0
Colusa,2020-10-22,0,1,48,0,0,0,1
Imperial,2020-10-22,43,0,259,17,0,1,43
Nevada,2020-10-22,2,3,120,1,0,4,5
Fresno,2020-10-22,100,13,1665,21,0,37,113
Tehama,2020-10-22,6,0,59,2,0,1,6
Lassen,2020-10-22,0,0,25,0,0,0,0
Kern,2020-10-22,55,5,1348,20,0,59,60
El Dorado,2020-10-22,0,0,189,0,0,4,0
Los Angeles,2020-10-22,770,262,20091,227,32,794,1032
Merced,2020-10-22,7,2,271,3,0,11,9
Madera,2020-10-22,5,8,263,2,1,19,13
San Luis Obispo,2020-10-22,5,0,460,1,0,28,5
San Francisco,2020-10-22,23,3,1876,7,3,59,26
Calaveras,2020-10-22,0,0,33,0,0,5,0
Sacramento,2020-10-22,90,27,2483,16,7,71,117
Yolo,2020-10-22,6,0,97,3,0,4,6
Tuolumne,2020-10-22,2,0,84,0,0,2,2
Napa,2020-10-22,2,0,351,0,0,24,2
Santa Barbara,2020-10-22,13,0,688,2,0,53,13
San Joaquin,2020-10-22,30,7,1004,7,1,41,37
Butte,2020-10-22,7,0,451,1,0,11,7
Santa Cruz,2020-10-22,10,0,389,5,0,7,10
Placer,2020-10-22,12,14,769,3,3,25,26
Stanislaus,2020-10-22,53,20,1301,15,1,12,73
Orange,2020-10-22,162,41,5874,58,5,179,203
San Benito,2020-10-22,0,0,25,0,0,3,0
Lake,2020-10-22,2,0,65,2,0,2,2
Yuba,2020-10-22,8,0,265,0,0,11,8
Alameda,2020-10-22,61,43,2575,15,3,125,104
Marin,2020-10-22,6,6,360,3,1,15,12
Modoc,2020-10-22,0,0,41,0,0,0,0
San Mateo,2020-10-22,19,7,691,5,2,32,26
San Bernardino,2020-10-22,215,48,4055,43,6,131,263
Plumas,2020-10-22,0,0,35,0,0,0,0
Contra Costa,2020-10-22,24,6,1467,7,2,46,30
Inyo,2020-10-22,0,0,29,0,0,4,0
Glenn,2020-10-23,0,0,47,0,0,0,0
Lassen,2020-10-23,0,0,25,0,0,0,0
Sacramento,2020-10-23,92,26,2464,15,7,74,118
San Joaquin,2020-10-23,30,4,1001,6,0,36,34
San Luis Obispo,2020-10-23,8,0,460,1,0,26,8
Inyo,2020-10-23,0,0,29,0,0,3,0
Fresno,2020-10-23,100,15,1664,23,2,17,115
Santa Barbara,2020-10-23,11,0,688,2,0,51,11
Tulare,2020-10-23,29,1,677,5,0,27,30
Kern,2020-10-23,56,3,1333,19,0,59,59
Imperial,2020-10-23,42,1,259,16,0,2,43
Santa Clara,2020-10-23,88,21,3012,16,2,70,109
Amador,2020-10-23,1,0,51,0,0,5,1
Orange,2020-10-23,159,42,5892,55,9,168,201
Yuba,2020-10-23,9,1,265,0,0,14,10
San Benito,2020-10-23,0,0,25,0,0,3,0
Trinity,2020-10-23,0,0,25,0,0,0,0
Shasta,2020-10-23,10,2,561,1,0,6,12
Butte,2020-10-23,7,0,451,1,0,8,7
San Francisco,2020-10-23,24,4,1893,7,3,53,28
Ventura,2020-10-23,31,13,1254,14,4,51,44
Kings,2020-10-23,19,1,193,3,1,12,20
Sutter,2020-10-23,0,0,14,0,0,0,0
Tuolumne,2020-10-23,2,0,84,1,0,1,2
Yolo,2020-10-23,10,0,97,3,0,4,10
Mendocino,2020-10-23,0,0,150,0,0,7,0
Solano,2020-10-23,20,11,564,2,2,9,31
Mono,2020-10-23,0,0,17,0,0,2,0
Riverside,2020-10-23,151,58,3407,37,13,63,209
Marin,2020-10-23,4,6,357,2,1,21,10
El Dorado,2020-10-23,0,0,189,0,0,7,0
Modoc,2020-10-23,0,0,41,0,0,0,0
Los Angeles,2020-10-23,785,254,20067,229,27,754,1039
Humboldt,2020-10-23,4,1,275,1,1,4,5
Napa,2020-10-23,1,0,351,0,0,23,1
Sonoma,2020-10-23,20,0,533,5,0,7,20
Nevada,2020-10-23,2,1,126,0,0,8,3
San Bernardino,2020-10-23,212,51,4069,40,9,137,263
Colusa,2020-10-23,0,1,48,0,0,0,1
Siskiyou,2020-10-23,1,0,56,0,0,8,1
Stanislaus,2020-10-23,53,21,1318,14,3,16,74
Plumas,2020-10-23,0,0,35,0,0,0,0
Mariposa,2020-10-23,0,0,19,0,0,0,0
Merced,2020-10-23,7,2,271,2,1,11,9
Del Norte,2020-10-23,1,0,51,0,0,3,1
Santa Cruz,2020-10-23,11,0,389,4,0,7,11
Calaveras,2020-10-23,0,0,33,0,0,6,0
Placer,2020-10-23,15,10,795,4,1,31,25
Madera,2020-10-23,6,5,263,2,0,19,11
Monterey,2020-10-23,21,0,717,8,0,20,21
San Mateo,2020-10-23,22,10,714,5,1,22,32
Lake,2020-10-23,2,1,65,2,1,3,3
Alameda,2020-10-23,55,46,2404,11,7,121,101
Contra Costa,2020-10-23,24,9,1475,9,1,28,33
Tehama,2020-10-23,6,0,59,2,0,2,6
San Diego,2020-10-23,185,50,7026,69,12,277,235
Napa,2020-10-24,1,0,351,0,0,23,1
El Dorado,2020-10-24,0,0,189,0,0,8,0
Alameda,2020-10-24,54,27,2404,14,5,125,81
Tulare,2020-10-24,27,1,677,5,0,27,28
Monterey,2020-10-24,22,1,717,8,0,19,23
Santa Barbara,2020-10-24,9,0,688,2,0,53,9
Ventura,2020-10-24,27,14,1256,13,7,60,41
Mariposa,2020-10-24,0,0,19,0,0,0,0
Contra Costa,2020-10-24,23,13,1437,8,3,36,36
Marin,2020-10-24,3,9,357,0,2,17,12
San Benito,2020-10-24,0,0,25,0,0,3,0
Mono,2020-10-24,0,0,17,0,0,2,0
Riverside,2020-10-24,151,53,3357,34,9,64,204
Plumas,2020-10-24,0,0,35,0,0,0,0
Glenn,2020-10-24,0,0,47,0,0,0,0
Kings,2020-10-24,20,0,193,3,0,14,20
Trinity,2020-10-24,0,0,25,0,0,0,0
Solano,2020-10-24,21,7,562,2,2,11,28
Fresno,2020-10-24,96,21,1646,22,2,21,117
Colusa,2020-10-24,0,0,48,0,0,0,0
Placer,2020-10-24,13,12,798,3,1,34,25
Tuolumne,2020-10-24,2,0,84,0,0,2,2
Yolo,2020-10-24,9,0,97,4,0,5,9
San Francisco,2020-10-24,23,5,1887,6,1,61,28
Sutter,2020-10-24,0,0,14,0,0,0,0
Stanislaus,2020-10-24,46,15,1323,12,2,15,61
Sonoma,2020-10-24,24,4,530,4,1,7,28
Del Norte,2020-10-24,1,0,51,0,0,2,1
Orange,2020-10-24,150,33,5818,55,5,189,183
Lake,2020-10-24,2,3,65,2,1,3,5
San Joaquin,2020-10-24,33,4,1007,5,0,47,37
Los Angeles,2020-10-24,767,294,19924,221,43,785,1061
San Diego,2020-10-24,166,42,6988,67,3,289,208
Humboldt,2020-10-24,4,2,270,1,0,6,6
Kern,2020-10-24,53,3,1322,20,0,60,56
Calaveras,2020-10-24,0,0,33,0,0,6,0
Madera,2020-10-24,7,12,263,2,2,20,19
San Luis Obispo,2020-10-24,7,4,460,1,0,26,11
Imperial,2020-10-24,43,0,259,15,0,6,43
Modoc,2020-10-24,1,0,41,0,0,0,1
Tehama,2020-10-24,6,0,59,2,0,2,6
San Bernardino,2020-10-24,203,60,4033,38,6,130,263
Inyo,2020-10-24,0,0,29,0,0,4,0
Nevada,2020-10-24,2,2,126,0,0,6,4
Santa Cruz,2020-10-24,10,0,389,3,0,8,10
Siskiyou,2020-10-24,0,0,56,0,0,8,0
San Mateo,2020-10-24,21,12,693,4,1,29,33
Mendocino,2020-10-24,1,0,150,1,0,5,1
Santa Clara,2020-10-24,84,29,2990,17,2,72,113
Butte,2020-10-24,5,0,451,1,0,12,5
Lassen,2020-10-24,0,0,25,0,0,0,0
Shasta,2020-10-24,10,1,561,3,0,5,11
Yuba,2020-10-24,6,1,265,0,0,12,7
Amador,2020-10-24,3,0,51,0,0,4,3
Merced,2020-10-24,7,2,271,2,0,9,9
Sacramento,2020-10-24,91,29,2370,15,9,68,120
Siskiyou,2020-10-25,0,0,56,0,0,11,0
Tulare,2020-10-25,30,3,677,4,0,27,33
Yuba,2020-10-25,5,0,265,0,0,18,5
Riverside,2020-10-25,164,60,3368,37,11,79,224
Orange,2020-10-25,162,46,5740,59,5,168,208
Imperial,2020-10-25,41,0,259,16,0,2,41
Plumas,2020-10-25,0,0,35,0,0,0,0
Fresno,2020-10-25,88,11,1644,24,1,22,99
San Benito,2020-10-25,0,0,25,0,0,3,0
Butte,2020-10-25,6,0,453,1,0,12,6
Merced,2020-10-25,6,2,271,2,0,8,8
Glenn,2020-10-25,0,0,47,0,0,0,0
Mono,2020-10-25,0,1,17,0,0,2,1
Inyo,2020-10-25,0,0,29,0,0,4,0
Kings,2020-10-25,21,0,193,2,0,14,21
San Mateo,2020-10-25,21,9,691,5,1,31,30
Amador,2020-10-25,3,0,51,0,0,6,3
Tuolumne,2020-10-25,1,0,84,0,0,0,1
San Bernardino,2020-10-25,219,42,4016,45,7,128,261
Marin,2020-10-25,6,3,353,0,0,21,9
Contra Costa,2020-10-25,24,12,1451,8,3,35,36
Madera,2020-10-25,11,10,263,3,1,18,21
Calaveras,2020-10-25,0,0,33,0,0,6,0
San Joaquin,2020-10-25,29,3,1003,7,0,50,32
Shasta,2020-10-25,10,2,561,3,0,5,12
Tehama,2020-10-25,6,0,59,2,0,1,6
Colusa,2020-10-25,0,0,48,0,0,0,0
Nevada,2020-10-25,2,1,119,0,0,8,3
Sutter,2020-10-25,0,0,14,0,0,0,0
Santa Clara,2020-10-25,85,29,2959,16,3,93,114
San Luis Obispo,2020-10-25,7,1,460,1,0,26,8
Lake,2020-10-25,2,4,65,2,0,1,6
Mariposa,2020-10-25,0,0,19,0,0,0,0
Santa Cruz,2020-10-25,10,0,389,3,0,8,10
Santa Barbara,2020-10-25,11,1,688,3,0,54,12
Los Angeles,2020-10-25,747,291,19948,204,34,807,1038
Alameda,2020-10-25,56,38,2420,16,4,119,94
Sonoma,2020-10-25,26,2,533,4,1,9,28
Placer,2020-10-25,13,16,783,3,2,25,29
Kern,2020-10-25,48,1,1305,19,0,59,49
El Dorado,2020-10-25,1,1,189,1,1,8,2
San Diego,2020-10-25,162,45,6979,63,11,320,207
Trinity,2020-10-25,0,0,25,0,0,0,0
Ventura,2020-10-25,21,12,1256,10,5,55,33
Humboldt,2020-10-25,4,2,271,1,1,6,6
Del Norte,2020-10-25,1,0,51,0,0,0,1
Modoc,2020-10-25,0,1,41,0,0,0,1
Solano,2020-10-25,23,11,545,2,1,12,34
Yolo,2020-10-25,7,0,97,3,0,5,7
Stanislaus,2020-10-25,53,21,1311,13,1,22,74
Monterey,2020-10-25,30,3,717,7,1,26,33
Mendocino,2020-10-25,2,0,150,0,0,4,2
Lassen,2020-10-25,0,0,25,0,0,0,0
Sacramento,2020-10-25,88,24,2338,14,8,70,112
San Francisco,2020-10-25,28,2,1824,7,0,69,30
Napa,2020-10-25,1,0,200,0,0,9,1
Tulare,2020-10-26,32,6,679,6,0,20,38
Colusa,2020-10-26,0,0,48,0,0,0,0
San Francisco,2020-10-26,29,3,1820,5,0,74,32
Plumas,2020-10-26,0,0,35,0,0,0,0
Inyo,2020-10-26,0,0,29,0,0,4,0
Ventura,2020-10-26,26,11,1200,11,6,60,37
Santa Barbara,2020-10-26,11,1,688,3,0,62,12
San Benito,2020-10-26,0,0,25,0,0,3,0
Del Norte,2020-10-26,1,0,52,0,0,2,1
Tehama,2020-10-26,6,0,59,2,0,0,6
Kings,2020-10-26,22,0,193,2,0,15,22
San Bernardino,2020-10-26,217,42,4030,48,8,125,259
Glenn,2020-10-26,0,0,47,0,0,0,0
Monterey,2020-10-26,29,0,717,8,0,25,29
Orange,2020-10-26,157,46,5738,56,8,191,203
Madera,2020-10-26,11,4,263,3,0,20,15
Marin,2020-10-26,5,1,351,0,0,19,6
Placer,2020-10-26,15,16,777,3,2,33,31
San Mateo,2020-10-26,20,6,697,4,0,33,26
Calaveras,2020-10-26,0,0,33,0,0,6,0
Stanislaus,2020-10-26,54,14,1308,13,1,26,68
San Diego,2020-10-26,176,49,6994,69,14,318,225
Lake,2020-10-26,2,0,65,2,0,2,2
Modoc,2020-10-26,0,0,41,0,0,0,0
Tuolumne,2020-10-26,1,0,84,0,0,0,1
Mono,2020-10-26,0,1,17,0,0,2,1
Mariposa,2020-10-26,0,0,19,0,0,0,0
Sacramento,2020-10-26,84,22,2421,13,9,91,106
Lassen,2020-10-26,0,0,25,0,0,0,0
Alameda,2020-10-26,58,31,2380,17,2,114,89
Sonoma,2020-10-26,30,4,556,5,2,9,34
Amador,2020-10-26,4,0,51,0,0,6,4
Fresno,2020-10-26,95,12,1651,25,1,24,107
Contra Costa,2020-10-26,26,12,1428,10,1,57,38
Butte,2020-10-26,8,0,453,1,0,12,8
Trinity,2020-10-26,0,0,25,0,0,0,0
Nevada,2020-10-26,1,3,144,0,1,5,4
Santa Clara,2020-10-26,86,36,2944,20,4,82,122
Riverside,2020-10-26,166,51,3386,58,9,77,217
Imperial,2020-10-26,43,0,259,17,0,2,43
Sutter,2020-10-26,0,0,14,0,0,0,0
Siskiyou,2020-10-26,3,0,56,1,0,10,3
Shasta,2020-10-26,11,0,561,3,0,2,11
Kern,2020-10-26,47,0,1313,18,0,63,47
Humboldt,2020-10-26,2,2,275,0,0,3,4
Los Angeles,2020-10-26,755,276,19943,214,43,814,1031
San Luis Obispo,2020-10-26,6,2,460,1,1,22,8
El Dorado,2020-10-26,1,1,189,1,1,8,2
Napa,2020-10-26,6,0,351,0,0,27,6
Yuba,2020-10-26,5,0,265,0,0,15,5
Solano,2020-10-26,29,11,534,4,1,8,40
Merced,2020-10-26,8,0,271,2,0,10,8
Yolo,2020-10-26,7,0,96,3,0,13,7
Santa Cruz,2020-10-26,10,0,389,3,0,7,10
San Joaquin,2020-10-26,28,3,1004,8,1,51,31
Mendocino,2020-10-26,1,0,150,0,0,4,1
Orange,2020-10-27,177,36,5842,60,5,176,213
Butte,2020-10-27,10,0,453,3,0,9,10
Modoc,2020-10-27,0,0,41,0,0,0,0
Inyo,2020-10-27,0,0,29,0,0,4,0
Riverside,2020-10-27,148,48,3437,32,11,69,196
Glenn,2020-10-27,0,0,47,0,0,0,0
San Mateo,2020-10-27,18,3,700,5,0,35,21
Mariposa,2020-10-27,0,0,19,0,0,0,0
San Francisco,2020-10-27,31,1,1822,6,0,64,32
Tehama,2020-10-27,6,1,59,2,0,2,7
Yuba,2020-10-27,7,0,265,0,0,14,7
San Bernardino,2020-10-27,233,35,3997,52,12,109,268
Fresno,2020-10-27,96,16,1659,28,0,23,112
Contra Costa,2020-10-27,33,10,1467,11,0,47,43
Imperial,2020-10-27,44,0,259,14,0,1,44
Madera,2020-10-27,12,10,263,2,1,28,22
Alameda,2020-10-27,58,34,2412,17,6,116,92
Solano,2020-10-27,27,11,550,7,0,8,38
San Benito,2020-10-27,0,0,50,0,0,3,0
Santa Clara,2020-10-27,79,26,3017,19,1,64,105
Trinity,2020-10-27,0,0,25,0,0,0,0
Tulare,2020-10-27,33,6,677,6,1,19,39
Lake,2020-10-27,2,0,65,2,0,2,2
Amador,2020-10-27,2,0,51,0,0,6,2
Mendocino,2020-10-27,0,0,150,0,0,4,0
Tuolumne,2020-10-27,1,0,84,0,0,1,1
Napa,2020-10-27,7,0,351,2,0,22,7
Merced,2020-10-27,5,1,271,2,0,8,6
Kern,2020-10-27,46,1,1339,19,0,67,47
Plumas,2020-10-27,0,0,35,0,0,0,0
Lassen,2020-10-27,0,1,25,0,0,0,1
San Diego,2020-10-27,182,59,6997,67,13,286,241
Yolo,2020-10-27,8,0,96,3,0,5,8
Shasta,2020-10-27,9,1,561,2,0,3,10
Siskiyou,2020-10-27,2,0,56,1,0,7,2
Sutter,2020-10-27,0,0,14,0,0,0,0
Colusa,2020-10-27,0,0,48,0,0,0,0
Humboldt,2020-10-27,2,1,264,0,0,6,3
Sacramento,2020-10-27,76,20,2340,12,8,77,96
San Joaquin,2020-10-27,26,4,983,7,0,41,30
Calaveras,2020-10-27,0,0,33,0,0,4,0
Stanislaus,2020-10-27,59,21,1326,15,3,12,80
San Luis Obispo,2020-10-27,7,0,460,1,0,29,7
Del Norte,2020-10-27,1,0,52,0,0,1,1
El Dorado,2020-10-27,1,1,189,1,1,7,2
Sonoma,2020-10-27,27,8,548,5,1,11,35
Marin,2020-10-27,5,3,450,0,0,17,8
Placer,2020-10-27,18,14,784,3,3,29,32
Nevada,2020-10-27,1,1,131,0,0,4,2
Ventura,2020-10-27,28,14,1213,11,3,56,42
Santa Cruz,2020-10-27,9,0,389,2,0,6,9
Santa Barbara,2020-10-27,11,0,688,3,0,61,11
Mono,2020-10-27,0,1,17,0,0,2,1
Kings,2020-10-27,19,0,193,3,0,14,19
Monterey,2020-10-27,26,1,717,9,0,19,27
Los Angeles,2020-10-27,750,267,20060,229,38,762,1017
Amador,2020-10-28,2,0,51,0,0,3,2
Glenn,2020-10-28,0,0,47,0,0,0,0
Plumas,2020-10-28,0,0,35,0,0,0,0
Humboldt,2020-10-28,2,1,271,0,0,7,3
Marin,2020-10-28,7,4,355,1,0,12,11
San Bernardino,2020-10-28,231,43,4004,53,9,103,274
Solano,2020-10-28,22,9,565,4,0,9,31
Monterey,2020-10-28,29,1,717,7,0,26,30
Santa Clara,2020-10-28,82,24,3034,18,1,64,106
Madera,2020-10-28,12,9,263,3,0,28,21
Fresno,2020-10-28,94,12,1670,29,1,23,106
Colusa,2020-10-28,0,0,48,0,0,0,0
Kings,2020-10-28,13,0,193,2,0,15,13
San Benito,2020-10-28,0,0,50,0,0,2,0
San Joaquin,2020-10-28,29,5,1003,8,0,39,34
Merced,2020-10-28,7,0,271,2,0,6,7
Napa,2020-10-28,4,0,351,1,0,23,4
San Mateo,2020-10-28,15,9,692,3,1,34,24
Trinity,2020-10-28,0,0,25,0,0,0,0
Lassen,2020-10-28,0,0,25,0,0,0,0
Calaveras,2020-10-28,0,0,33,0,0,3,0
Santa Barbara,2020-10-28,9,1,688,1,0,63,10
Lake,2020-10-28,2,0,65,2,0,1,2
Butte,2020-10-28,10,0,453,3,0,5,10
Shasta,2020-10-28,8,0,561,1,0,5,8
Kern,2020-10-28,43,5,1343,20,0,60,48
Tulare,2020-10-28,36,6,677,6,1,19,42
Imperial,2020-10-28,49,0,259,17,0,0,49
Sacramento,2020-10-28,83,26,2467,14,8,69,109
Riverside,2020-10-28,149,63,3424,35,12,64,212
Stanislaus,2020-10-28,58,17,1336,16,0,19,75
Tehama,2020-10-28,6,0,59,2,0,0,6
Sutter,2020-10-28,0,0,14,0,0,0,0
Modoc,2020-10-28,0,0,41,0,0,0,0
Contra Costa,2020-10-28,31,12,1476,5,4,52,43
Sonoma,2020-10-28,28,3,549,5,2,10,31
Nevada,2020-10-28,2,0,112,1,0,4,2
Los Angeles,2020-10-28,743,290,20061,222,41,738,1033
Siskiyou,2020-10-28,3,0,56,1,0,8,3
San Diego,2020-10-28,187,48,6993,66,8,269,235
Yuba,2020-10-28,8,0,265,0,0,14,8
Placer,2020-10-28,22,23,798,4,1,29,45
Mono,2020-10-28,0,0,17,0,0,2,0
Del Norte,2020-10-28,1,0,52,0,0,2,1
Santa Cruz,2020-10-28,8,0,389,2,0,7,8
San Luis Obispo,2020-10-28,6,0,460,2,0,29,6
Tuolumne,2020-10-28,5,0,84,2,0,2,5
El Dorado,2020-10-28,1,1,189,1,1,5,2
Ventura,2020-10-28,27,15,1234,10,5,62,42
Yolo,2020-10-28,9,0,96,4,0,3,9
San Francisco,2020-10-28,35,1,1852,7,0,73,36
Mendocino,2020-10-28,0,0,150,0,0,4,0
Alameda,2020-10-28,58,41,2415,17,6,117,99
Orange,2020-10-28,181,56,5847,59,10,183,237
Inyo,2020-10-28,1,0,29,1,0,3,1
Mariposa,2020-10-28,0,0,19,0,0,0,0
Nevada,2020-10-29,2,1,131,1,1,3,3
Placer,2020-10-29,24,17,797,6,2,26,41
Marin,2020-10-29,6,12,360,1,0,11,18
Monterey,2020-10-29,26,0,717,10,0,23,26
San Luis Obispo,2020-10-29,6,0,460,2,0,29,6
Trinity,2020-10-29,0,0,25,0,0,0,0
Fresno,2020-10-29,87,12,1653,25,0,23,99
Tehama,2020-10-29,6,0,59,2,0,1,6
Amador,2020-10-29,2,0,51,0,0,2,2
Ventura,2020-10-29,25,14,1247,9,4,60,39
Santa Clara,2020-10-29,79,19,3014,19,2,74,98
Sutter,2020-10-29,0,0,14,0,0,0,0
Madera,2020-10-29,11,9,263,3,1,25,20
Butte,2020-10-29,9,0,453,2,0,13,9
Napa,2020-10-29,6,0,351,0,0,24,6
Lassen,2020-10-29,0,0,25,0,0,0,0
Stanislaus,2020-10-29,68,27,1337,17,1,10,95
Lake,2020-10-29,3,2,65,1,1,1,5
Alameda,2020-10-29,57,34,2417,14,5,126,91
Riverside,2020-10-29,150,64,3370,33,7,83,214
Calaveras,2020-10-29,0,0,33,0,0,4,0
Humboldt,2020-10-29,3,0,270,0,0,8,3
San Francisco,2020-10-29,37,2,1874,8,1,71,39
Sonoma,2020-10-29,28,5,542,8,2,8,33
San Mateo,2020-10-29,22,7,669,4,0,35,29
Mono,2020-10-29,0,0,17,0,0,2,0
Santa Cruz,2020-10-29,8,0,389,2,0,10,8
Mendocino,2020-10-29,0,0,150,0,0,4,0
Yolo,2020-10-29,10,0,96,5,0,3,10
Modoc,2020-10-29,0,0,41,0,0,0,0
Glenn,2020-10-29,0,0,47,0,0,0,0
Siskiyou,2020-10-29,4,0,56,1,0,7,4
Shasta,2020-10-29,11,2,561,2,0,7,13
Yuba,2020-10-29,8,0,265,0,0,14,8
El Dorado,2020-10-29,1,0,189,1,0,6,1
Merced,2020-10-29,7,3,271,2,2,3,10
San Benito,2020-10-29,0,0,50,0,0,3,0
Kings,2020-10-29,15,1,193,2,0,13,16
Inyo,2020-10-29,1,0,30,0,0,4,1
Del Norte,2020-10-29,1,0,52,0,0,1,1
Orange,2020-10-29,182,51,5875,61,5,191,233
Kern,2020-10-29,44,2,1338,20,0,58,46
Santa Barbara,2020-10-29,9,1,688,2,0,51,10
Sacramento,2020-10-29,85,21,2472,14,6,79,106
Tuolumne,2020-10-29,6,0,84,0,0,2,6
Plumas,2020-10-29,0,0,35,0,0,0,0
Mariposa,2020-10-29,0,0,19,0,0,0,0
Imperial,2020-10-29,45,1,259,16,1,0,46
San Bernardino,2020-10-29,233,40,3980,58,12,100,273
Los Angeles,2020-10-29,783,281,20056,221,44,722,1064
Contra Costa,2020-10-29,32,10,1475,5,1,49,42
Solano,2020-10-29,24,10,563,4,0,10,34
Colusa,2020-10-29,0,0,48,0,0,0,0
Tulare,2020-10-29,42,9,681,6,1,18,51
San Joaquin,2020-10-29,25,13,1014,6,1,37,38
San Diego,2020-10-29,197,48,6992,73,6,275,245
Mariposa,2020-10-30,0,0,19,0,0,0,0
Solano,2020-10-30,29,10,572,4,0,9,39
Trinity,2020-10-30,0,0,25,0,0,0,0
Santa Barbara,2020-10-30,9,1,688,3,0,58,10
Santa Cruz,2020-10-30,12,0,389,2,0,8,12
Ventura,2020-10-30,27,11,1253,13,3,47,38
Napa,2020-10-30,4,1,200,0,0,9,5
Tulare,2020-10-30,44,7,681,5,0,19,51
Mono,2020-10-30,0,0,17,0,0,2,0
Sacramento,2020-10-30,81,25,2467,19,4,69,106
San Bernardino,2020-10-30,248,51,3970,54,10,97,299
San Francisco,2020-10-30,35,5,1861,6,1,77,40
Marin,2020-10-30,5,5,361,1,1,15,10
San Benito,2020-10-30,0,0,50,0,0,2,0
Inyo,2020-10-30,0,0,29,0,0,4,0
El Dorado,2020-10-30,2,0,189,1,0,8,2
Yolo,2020-10-30,8,0,96,5,0,4,8
Lake,2020-10-30,3,1,65,2,0,1,4
Contra Costa,2020-10-30,34,9,1482,5,1,43,43
Sonoma,2020-10-30,22,4,542,7,0,8,26
Calaveras,2020-10-30,0,0,33,0,0,6,0
Lassen,2020-10-30,0,0,25,0,0,0,0
Sutter,2020-10-30,0,0,14,0,0,0,0
Siskiyou,2020-10-30,2,0,56,0,0,8,2
San Joaquin,2020-10-30,28,8,1015,6,2,38,36
Stanislaus,2020-10-30,70,14,1333,17,0,15,84
San Diego,2020-10-30,212,40,6965,81,6,248,252
Kern,2020-10-30,53,5,1340,23,1,55,58
Alameda,2020-10-30,68,42,2426,17,5,116,110
Plumas,2020-10-30,0,0,35,0,0,0,0
Madera,2020-10-30,10,7,263,3,0,20,17
Mendocino,2020-10-30,0,0,150,0,0,3,0
Humboldt,2020-10-30,3,0,272,0,0,5,3
Glenn,2020-10-30,0,0,47,0,0,0,0
Tuolumne,2020-10-30,3,0,84,0,0,3,3
Del Norte,2020-10-30,1,0,51,0,0,0,1
Los Angeles,2020-10-30,799,295,20077,222,36,730,1094
Modoc,2020-10-30,0,1,41,0,0,0,1
Butte,2020-10-30,7,0,453,2,0,14,7
Imperial,2020-10-30,44,0,259,13,0,3,44
Colusa,2020-10-30,0,0,48,0,0,0,0
Kings,2020-10-30,17,1,193,3,0,14,18
Fresno,2020-10-30,94,11,1633,26,1,25,105
Riverside,2020-10-30,157,57,3360,38,10,56,214
Tehama,2020-10-30,5,0,59,1,0,0,5
Merced,2020-10-30,9,0,271,2,0,7,9
Nevada,2020-10-30,2,0,134,0,0,7,2
Shasta,2020-10-30,8,3,561,2,0,4,11
San Mateo,2020-10-30,24,6,688,2,0,35,30
Yuba,2020-10-30,8,1,265,0,0,8,9
San Luis Obispo,2020-10-30,7,2,460,2,0,30,9
Placer,2020-10-30,27,15,793,4,3,28,42
Amador,2020-10-30,0,0,51,0,0,2,0
Monterey,2020-10-30,25,0,717,10,0,20,25
Santa Clara,2020-10-30,91,13,3033,22,1,73,104
Orange,2020-10-30,188,36,5849,58,5,174,224
Modoc,2020-10-31,0,2,41,0,0,0,2
Inyo,2020-10-31,0,0,29,0,0,4,0
Butte,2020-10-31,7,1,453,2,1,12,8
Santa Clara,2020-10-31,83,9,3028,24,2,71,92
Plumas,2020-10-31,0,0,35,0,0,0,0
Contra Costa,2020-10-31,35,11,1478,7,1,51,46
San Luis Obispo,2020-10-31,7,2,460,3,0,29,9
Shasta,2020-10-31,9,0,561,3,0,4,9
San Benito,2020-10-31,0,0,50,0,0,2,0
Placer,2020-10-31,30,16,792,6,3,23,46
Amador,2020-10-31,0,0,51,0,0,3,0
Monterey,2020-10-31,25,0,717,9,0,24,25
Kings,2020-10-31,12,3,193,3,2,14,15
Sutter,2020-10-31,0,0,14,0,0,0,0
Riverside,2020-10-31,156,56,3312,34,10,76,212
Fresno,2020-10-31,96,14,1643,25,1,29,110
Colusa,2020-10-31,0,2,48,0,0,0,2
Mendocino,2020-10-31,1,0,150,1,0,4,1
Yolo,2020-10-31,8,0,96,5,0,5,8
Mono,2020-10-31,0,0,17,0,0,2,0
Trinity,2020-10-31,0,0,25,0,0,0,0
Tehama,2020-10-31,5,0,59,0,0,4,5
Calaveras,2020-10-31,0,0,33,0,0,7,0
Humboldt,2020-10-31,2,0,259,0,0,4,2
Kern,2020-10-31,51,6,1287,23,0,59,57
San Francisco,2020-10-31,34,4,1803,6,0,85,38
Sonoma,2020-10-31,20,6,533,5,0,7,26
Nevada,2020-10-31,1,1,121,0,0,5,2
Madera,2020-10-31,8,10,350,3,1,14,18
San Mateo,2020-10-31,19,12,710,3,2,35,31
Lassen,2020-10-31,0,0,25,0,0,0,0
Los Angeles,2020-10-31,777,302,20022,223,27,777,1079
Merced,2020-10-31,5,0,271,1,0,13,5
Mariposa,2020-10-31,0,0,19,0,0,0,0
Santa Cruz,2020-10-31,11,0,389,2,0,6,11
Lake,2020-10-31,3,1,65,2,0,3,4
Yuba,2020-10-31,5,1,265,0,1,11,6
Sacramento,2020-10-31,77,25,2340,17,3,84,102
Marin,2020-10-31,6,9,359,1,0,17,15
San Diego,2020-10-31,244,36,6958,95,5,258,280
Napa,2020-10-31,3,3,351,0,0,27,6
San Bernardino,2020-10-31,241,47,3936,58,9,102,288
Alameda,2020-10-31,62,49,2412,19,4,124,111
Stanislaus,2020-10-31,66,18,1331,19,2,18,84
Tulare,2020-10-31,40,5,685,4,0,19,45
Siskiyou,2020-10-31,1,0,56,0,0,8,1
San Joaquin,2020-10-31,24,6,1012,8,2,33,30
Del Norte,2020-10-31,0,0,52,0,0,3,0
Glenn,2020-10-31,0,0,47,0,0,0,0
El Dorado,2020-10-31,2,0,189,1,0,6,2
Solano,2020-10-31,30,11,563,4,0,11,41
Santa Barbara,2020-10-31,10,1,688,3,1,62,11
Imperial,2020-10-31,50,0,259,13,0,2,50
Tuolumne,2020-10-31,3,0,84,0,0,5,3
Ventura,2020-10-31,24,14,1240,11,7,49,38
Orange,2020-10-31,181,36,5833,55,9,191,217
Calaveras,2020-11-01,0,0,33,0,0,7,0
Tehama,2020-11-01,5,0,59,0,0,1,5
San Joaquin,2020-11-01,30,7,1006,8,3,40,37
Solano,2020-11-01,25,13,554,4,3,11,38
Merced,2020-11-01,6,0,271,1,0,16,6
Nevada,2020-11-01,1,1,137,0,1,5,2
Ventura,2020-11-01,29,14,1229,14,8,45,43
El Dorado,2020-11-01,4,0,189,0,0,8,4
Shasta,2020-11-01,8,0,561,3,0,3,8
Kern,2020-11-01,46,4,1269,24,0,53,50
Yuba,2020-11-01,3,0,265,0,0,11,3
Lake,2020-11-01,3,1,65,2,0,2,4
Tulare,2020-11-01,37,10,681,3,0,24,47
Butte,2020-11-01,9,1,453,1,1,16,10
San Luis Obispo,2020-11-01,7,1,460,3,0,30,8
San Diego,2020-11-01,239,61,6946,86,10,278,300
San Bernardino,2020-11-01,242,61,3910,58,14,104,303
Los Angeles,2020-11-01,798,258,19895,223,39,781,1056
Santa Barbara,2020-11-01,10,1,688,2,0,58,11
Sacramento,2020-11-01,85,30,2432,21,4,86,115
Santa Cruz,2020-11-01,12,0,389,2,0,8,12
Yolo,2020-11-01,5,0,96,4,0,2,5
Santa Clara,2020-11-01,85,15,2977,21,1,77,100
Mono,2020-11-01,0,0,17,0,0,1,0
Tuolumne,2020-11-01,3,0,84,0,0,4,3
Imperial,2020-11-01,49,0,259,14,0,0,49
Modoc,2020-11-01,0,0,41,0,0,0,0
Lassen,2020-11-01,0,0,25,0,0,0,0
Colusa,2020-11-01,0,2,48,0,0,0,2
Monterey,2020-11-01,25,2,717,9,0,28,27
Plumas,2020-11-01,0,0,35,0,0,0,0
Napa,2020-11-01,3,0,351,1,0,27,3
Contra Costa,2020-11-01,35,17,1479,9,1,49,52
Siskiyou,2020-11-01,1,0,56,0,0,8,1
San Benito,2020-11-01,0,0,50,0,0,2,0
Amador,2020-11-01,0,0,51,0,0,4,0
Inyo,2020-11-01,0,0,29,0,0,4,0
Del Norte,2020-11-01,0,0,51,0,0,6,0
Sonoma,2020-11-01,20,4,504,4,0,7,24
Stanislaus,2020-11-01,71,22,1326,17,2,17,93
Marin,2020-11-01,5,12,355,1,1,16,17
Trinity,2020-11-01,0,0,25,0,0,0,0
Fresno,2020-11-01,102,7,1663,26,0,32,109
Orange,2020-11-01,183,18,5797,60,3,196,201
Riverside,2020-11-01,179,52,3350,43,10,65,231
Madera,2020-11-01,8,10,350,3,1,20,18
Alameda,2020-11-01,63,46,2394,18,6,125,109
Sutter,2020-11-01,0,0,14,0,0,0,0
San Mateo,2020-11-01,17,10,676,4,3,37,27
Placer,2020-11-01,31,17,787,6,2,28,48
San Francisco,2020-11-01,37,3,1786,9,0,93,40
Mendocino,2020-11-01,1,0,150,1,0,5,1
Kings,2020-11-01,12,3,193,3,2,16,15
Mariposa,2020-11-01,0,0,19,0,0,0,0
Glenn,2020-11-01,0,0,47,0,0,0,0
Humboldt,2020-11-01,3,1,246,0,0,0,4
Placer,2020-11-02,30,16,789,5,1,29,46
Monterey,2020-11-02,28,0,717,11,0,28,28
Fresno,2020-11-02,106,14,1674,26,3,31,120
Trinity,2020-11-02,0,0,25,0,0,0,0
Lassen,2020-11-02,0,0,25,0,0,0,0
Mendocino,2020-11-02,1,0,150,1,0,5,1
Imperial,2020-11-02,48,0,259,14,0,1,48
Napa,2020-11-02,3,1,351,1,0,27,4
Yuba,2020-11-02,4,0,265,1,0,9,4
Kern,2020-11-02,46,2,1307,22,1,56,48
Contra Costa,2020-11-02,40,18,1472,10,2,41,58
Lake,2020-11-02,2,1,65,1,0,1,3
Santa Clara,2020-11-02,91,21,2973,25,2,82,112
Sonoma,2020-11-02,23,2,533,4,0,8,25
San Mateo,2020-11-02,17,13,682,3,1,41,30
Merced,2020-11-02,8,0,271,2,0,14,8
Madera,2020-11-02,8,8,350,3,0,21,16
Amador,2020-11-02,0,0,51,0,0,6,0
Tulare,2020-11-02,39,9,681,3,0,30,48
Tehama,2020-11-02,3,0,59,0,0,2,3
Butte,2020-11-02,9,1,453,4,1,10,10
Ventura,2020-11-02,29,9,1225,13,4,48,38
Glenn,2020-11-02,0,0,47,0,0,0,0
Santa Barbara,2020-11-02,13,1,688,2,0,64,14
Del Norte,2020-11-02,0,0,51,0,0,5,0
Yolo,2020-11-02,7,0,96,3,0,4,7
San Bernardino,2020-11-02,243,54,3951,62,7,121,297
Modoc,2020-11-02,0,0,41,0,0,0,0
Riverside,2020-11-02,194,56,3363,53,7,60,250
Orange,2020-11-02,177,37,5744,60,9,197,214
San Diego,2020-11-02,239,52,6957,87,12,289,291
Tuolumne,2020-11-02,3,0,84,0,0,3,3
San Luis Obispo,2020-11-02,7,0,460,2,0,26,7
Calaveras,2020-11-02,0,0,33,0,0,6,0
Marin,2020-11-02,5,9,358,1,2,16,14
Inyo,2020-11-02,0,0,29,0,0,4,0
Plumas,2020-11-02,0,0,35,0,0,0,0
Kings,2020-11-02,11,4,193,3,2,13,15
San Francisco,2020-11-02,36,2,1792,11,1,84,38
Sutter,2020-11-02,0,0,14,0,0,0,0
Colusa,2020-11-02,0,2,48,0,0,0,2
Humboldt,2020-11-02,2,0,259,0,0,2,2
Siskiyou,2020-11-02,2,0,56,1,0,7,2
Solano,2020-11-02,27,11,552,3,1,7,38
Mono,2020-11-02,0,0,17,0,0,2,0
San Benito,2020-11-02,2,0,50,1,0,0,2
Sacramento,2020-11-02,86,23,2392,22,6,100,109
Nevada,2020-11-02,2,0,142,0,0,5,2
Stanislaus,2020-11-02,74,24,1326,15,3,23,98
El Dorado,2020-11-02,2,0,189,1,0,8,2
Santa Cruz,2020-11-02,12,0,389,2,0,7,12
Alameda,2020-11-02,69,41,2407,17,6,126,110
Shasta,2020-11-02,9,0,561,4,0,2,9
Los Angeles,2020-11-02,817,229,19933,238,24,807,1046
Mariposa,2020-11-02,0,0,19,0,0,0,0
San Joaquin,2020-11-02,28,8,1007,6,2,42,36
Humboldt,2020-11-03,2,0,262,0,0,3,2
El Dorado,2020-11-03,3,0,189,2,0,10,3
Fresno,2020-11-03,96,14,1677,29,3,20,110
Stanislaus,2020-11-03,56,17,1347,15,4,21,73
Modoc,2020-11-03,0,0,41,0,0,0,0
San Benito,2020-11-03,3,0,50,1,0,1,3
Shasta,2020-11-03,9,0,561,3,0,8,9
Monterey,2020-11-03,32,0,717,12,0,32,32
Santa Clara,2020-11-03,102,17,2999,27,2,77,119
San Mateo,2020-11-03,17,11,712,1,2,35,28
Orange,2020-11-03,182,42,5881,78,8,168,224
San Joaquin,2020-11-03,31,5,1007,7,2,38,36
Marin,2020-11-03,5,7,358,2,0,14,12
San Francisco,2020-11-03,35,5,1889,11,1,65,40
Plumas,2020-11-03,0,0,35,0,0,0,0
Santa Barbara,2020-11-03,12,3,688,2,2,57,15
Contra Costa,2020-11-03,41,10,1490,11,4,45,51
Amador,2020-11-03,0,0,51,0,0,4,0
Mariposa,2020-11-03,0,0,19,0,0,0,0
Mendocino,2020-11-03,2,0,150,2,0,3,2
Ventura,2020-11-03,31,10,1238,15,1,40,41
Del Norte,2020-11-03,0,1,51,0,1,4,1
Placer,2020-11-03,36,17,809,5,3,24,53
Inyo,2020-11-03,1,0,29,0,0,4,1
Lake,2020-11-03,2,0,65,1,0,1,2
San Luis Obispo,2020-11-03,6,2,460,2,0,22,8
San Bernardino,2020-11-03,263,52,3952,66,9,96,315
Alameda,2020-11-03,65,51,2484,16,4,114,116
Sonoma,2020-11-03,22,6,586,5,2,10,28
Tulare,2020-11-03,41,10,681,3,0,21,51
Sacramento,2020-11-03,92,19,2520,19,6,91,111
Sutter,2020-11-03,0,0,14,0,0,0,0
Siskiyou,2020-11-03,2,0,56,1,0,8,2
Madera,2020-11-03,8,13,339,2,1,17,21
Calaveras,2020-11-03,0,0,33,0,0,8,0
Yolo,2020-11-03,9,0,96,3,0,5,9
Mono,2020-11-03,0,0,17,0,0,2,0
Merced,2020-11-03,9,0,272,2,0,12,9
Glenn,2020-11-03,0,0,47,0,0,0,0
Imperial,2020-11-03,49,0,259,14,0,1,49
San Diego,2020-11-03,243,52,6978,88,18,286,295
Santa Cruz,2020-11-03,13,0,389,3,0,7,13
Solano,2020-11-03,21,9,562,4,0,7,30
Tuolumne,2020-11-03,2,0,84,0,0,3,2
Napa,2020-11-03,3,0,200,3,0,11,3
Los Angeles,2020-11-03,825,303,20014,238,37,728,1128
Colusa,2020-11-03,0,2,48,0,0,0,2
Butte,2020-11-03,12,1,453,3,1,7,13
Nevada,2020-11-03,2,0,127,0,0,3,2
Trinity,2020-11-03,0,0,25,0,0,0,0
Riverside,2020-11-03,210,57,3405,56,8,63,267
Tehama,2020-11-03,3,0,59,0,0,1,3
Kern,2020-11-03,53,2,1340,22,1,52,55
Yuba,2020-11-03,3,0,265,1,0,1,3
Kings,2020-11-03,15,3,193,4,2,12,18
Lassen,2020-11-03,0,0,25,0,0,0,0
Marin,2020-11-04,5,3,352,1,0,15,8
San Luis Obispo,2020-11-04,8,0,460,2,0,23,8
San Mateo,2020-11-04,22,6,711,3,0,42,28
Sacramento,2020-11-04,94,29,2535,21,4,84,123
Sutter,2020-11-04,0,0,14,0,0,0,0
Los Angeles,2020-11-04,821,322,20000,238,46,693,1143
San Diego,2020-11-04,278,51,6951,93,12,262,329
Humboldt,2020-11-04,2,0,273,0,0,3,2
Imperial,2020-11-04,50,0,259,15,0,1,50
Colusa,2020-11-04,0,1,48,0,0,0,1
Amador,2020-11-04,1,0,51,0,0,4,1
Plumas,2020-11-04,0,0,35,0,0,0,0
Shasta,2020-11-04,14,0,561,3,0,5,14
San Francisco,2020-11-04,34,4,1891,12,1,57,38
Mariposa,2020-11-04,0,0,19,0,0,0,0
Del Norte,2020-11-04,0,0,51,0,0,2,0
Santa Cruz,2020-11-04,11,0,389,20,0,6,11
Sonoma,2020-11-04,25,4,556,5,1,7,29
Santa Barbara,2020-11-04,12,3,688,3,1,59,15
Mendocino,2020-11-04,3,0,152,2,0,2,3
Merced,2020-11-04,8,0,272,4,0,11,8
Santa Clara,2020-11-04,100,18,3036,26,0,81,118
Fresno,2020-11-04,99,20,1656,26,2,20,119
Orange,2020-11-04,178,49,5879,76,7,189,227
San Benito,2020-11-04,3,0,25,1,0,2,3
Calaveras,2020-11-04,0,0,33,0,0,8,0
Tehama,2020-11-04,2,0,59,0,0,0,2
Lassen,2020-11-04,0,0,25,0,0,0,0
El Dorado,2020-11-04,2,0,189,2,0,8,2
Kings,2020-11-04,15,3,193,2,1,14,18
Tuolumne,2020-11-04,3,1,84,0,1,3,4
San Bernardino,2020-11-04,281,58,3978,77,9,95,339
Placer,2020-11-04,35,11,809,4,0,26,46
Napa,2020-11-04,4,0,351,3,0,24,4
Ventura,2020-11-04,26,9,1232,12,1,34,35
San Joaquin,2020-11-04,32,5,1007,8,2,30,37
Riverside,2020-11-04,201,60,3446,57,7,67,261
Glenn,2020-11-04,0,0,47,0,0,0,0
Tulare,2020-11-04,36,9,683,4,0,16,45
Siskiyou,2020-11-04,2,0,56,1,0,8,2
Solano,2020-11-04,19,9,539,7,0,15,28
Contra Costa,2020-11-04,39,4,1479,11,2,40,43
Madera,2020-11-04,9,9,329,1,0,8,18
Trinity,2020-11-04,0,0,25,0,0,0,0
Mono,2020-11-04,0,0,17,0,0,2,0
Yuba,2020-11-04,2,0,265,1,0,3,2
Butte,2020-11-04,11,0,453,4,0,12,11
Kern,2020-11-04,51,2,1328,21,0,51,53
Yolo,2020-11-04,8,0,96,3,0,5,8
Stanislaus,2020-11-04,61,15,1297,15,5,20,76
Monterey,2020-11-04,36,0,717,12,0,24,36
Inyo,2020-11-04,1,0,29,0,0,4,1
Modoc,2020-11-04,0,0,41,0,0,0,0
Lake,2020-11-04,2,0,65,1,0,1,2
Nevada,2020-11-04,3,0,120,0,0,4,3
Alameda,2020-11-04,63,45,2505,17,6,122,108
San Joaquin,2020-11-05,38,1,1031,7,1,35,39
Napa,2020-11-05,4,0,351,2,0,26,4
Calaveras,2020-11-05,0,0,33,0,0,8,0
Butte,2020-11-05,12,0,453,1,0,16,12
Santa Barbara,2020-11-05,15,0,688,3,0,58,15
Tuolumne,2020-11-05,2,1,181,0,1,4,3
Sonoma,2020-11-05,22,3,535,7,0,6,25
Modoc,2020-11-05,1,0,41,0,0,0,1
Tulare,2020-11-05,38,11,677,6,1,16,49
Del Norte,2020-11-05,0,0,51,0,0,1,0
Glenn,2020-11-05,0,0,47,0,0,0,0
Stanislaus,2020-11-05,58,15,1296,15,0,18,73
Lake,2020-11-05,1,0,77,1,0,2,1
Merced,2020-11-05,9,0,271,4,0,11,9
San Luis Obispo,2020-11-05,8,0,460,2,0,25,8
Fresno,2020-11-05,103,20,1687,27,3,21,123
Tehama,2020-11-05,2,0,59,0,0,0,2
Riverside,2020-11-05,208,58,3419,54,14,70,266
Kern,2020-11-05,54,3,1265,20,0,47,57
Shasta,2020-11-05,15,0,561,3,0,5,15
San Francisco,2020-11-05,33,3,1911,10,1,61,36
Orange,2020-11-05,177,46,5855,72,12,199,223
Monterey,2020-11-05,38,0,717,11,0,24,38
Mono,2020-11-05,0,0,17,0,0,2,0
Amador,2020-11-05,1,0,51,0,0,3,1
San Benito,2020-11-05,3,0,25,1,0,2,3
Solano,2020-11-05,20,13,540,7,0,17,33
Los Angeles,2020-11-05,840,292,20185,254,31,688,1132
El Dorado,2020-11-05,3,0,189,3,0,7,3
San Diego,2020-11-05,286,55,6949,94,15,258,341
Humboldt,2020-11-05,2,0,281,0,0,6,2
Alameda,2020-11-05,66,43,2509,16,5,126,109
Siskiyou,2020-11-05,1,0,56,1,0,7,1
Imperial,2020-11-05,45,0,259,16,0,0,45
Sutter,2020-11-05,0,0,14,0,0,0,0
Marin,2020-11-05,4,6,352,1,0,15,10
San Bernardino,2020-11-05,283,49,4000,77,9,94,332
Mendocino,2020-11-05,2,0,177,2,0,5,2
Yuba,2020-11-05,2,0,265,1,0,5,2
Inyo,2020-11-05,1,0,29,0,0,4,1
Kings,2020-11-05,14,0,193,2,0,15,14
Lassen,2020-11-05,1,0,25,0,0,0,1
Colusa,2020-11-05,0,0,48,0,0,0,0
Madera,2020-11-05,7,6,283,1,0,10,13
Yolo,2020-11-05,7,0,96,3,0,6,7
Santa Cruz,2020-11-05,11,0,389,16,0,8,11
Plumas,2020-11-05,0,0,35,0,0,0,0
Mariposa,2020-11-05,0,0,19,0,0,0,0
Placer,2020-11-05,40,19,808,6,1,23,59
Contra Costa,2020-11-05,40,5,1498,9,0,48,45
Santa Clara,2020-11-05,100,21,3014,25,2,68,121
Ventura,2020-11-05,30,5,1240,15,2,37,35
Trinity,2020-11-05,0,0,25,0,0,0,0
San Mateo,2020-11-05,23,12,710,6,0,32,35
Sacramento,2020-11-05,90,18,2505,20,3,77,108
Nevada,2020-11-05,5,1,133,1,0,4,6
Placer,2020-11-06,34,12,809,5,0,21,46
Fresno,2020-11-06,103,16,1683,26,0,23,119
Tehama,2020-11-06,1,0,59,0,0,3,1
Sonoma,2020-11-06,26,1,553,8,0,8,27
El Dorado,2020-11-06,2,0,189,2,0,8,2
San Diego,2020-11-06,284,54,6949,95,15,255,338
Calaveras,2020-11-06,0,0,33,0,0,7,0
Siskiyou,2020-11-06,2,0,56,1,0,8,2
Alameda,2020-11-06,66,41,2508,17,3,116,107
Lassen,2020-11-06,1,0,25,0,0,0,1
Solano,2020-11-06,25,13,548,7,0,19,38
Shasta,2020-11-06,15,1,561,2,0,11,16
Del Norte,2020-11-06,0,0,51,0,0,3,0
Colusa,2020-11-06,0,1,48,0,0,0,1
Modoc,2020-11-06,2,0,41,0,0,0,2
Plumas,2020-11-06,0,0,35,0,0,0,0
Contra Costa,2020-11-06,39,13,1484,10,1,43,52
San Francisco,2020-11-06,38,4,1937,11,1,54,42
Santa Cruz,2020-11-06,9,0,389,3,0,7,9
Kern,2020-11-06,59,3,1266,20,0,51,62
Humboldt,2020-11-06,2,3,281,0,0,7,5
Monterey,2020-11-06,36,0,717,12,0,19,36
Nevada,2020-11-06,4,1,124,0,1,5,5
Mendocino,2020-11-06,3,0,177,2,0,7,3
Yolo,2020-11-06,5,0,96,3,0,6,5
Amador,2020-11-06,4,0,51,0,0,4,4
Glenn,2020-11-06,0,0,47,0,0,0,0
Tulare,2020-11-06,41,3,679,6,0,15,44
Santa Barbara,2020-11-06,12,1,688,3,0,58,13
Merced,2020-11-06,12,0,271,6,0,10,12
Inyo,2020-11-06,0,0,29,0,0,4,0
Yuba,2020-11-06,1,1,265,1,0,5,2
Marin,2020-11-06,6,4,354,1,0,18,10
San Luis Obispo,2020-11-06,7,0,460,2,0,24,7
Lake,2020-11-06,1,0,77,1,0,2,1
Riverside,2020-11-06,202,46,3392,57,12,62,248
San Bernardino,2020-11-06,281,43,4024,76,7,107,324
Sacramento,2020-11-06,104,26,2522,22,4,68,130
Butte,2020-11-06,8,0,453,1,0,14,8
Trinity,2020-11-06,0,0,25,0,0,0,0
Napa,2020-11-06,4,1,351,2,0,25,5
Tuolumne,2020-11-06,2,1,181,0,1,2,3
Santa Clara,2020-11-06,103,14,3016,26,1,72,117
Orange,2020-11-06,199,33,5909,72,3,192,232
San Mateo,2020-11-06,20,11,717,6,0,32,31
Imperial,2020-11-06,45,0,250,15,0,2,45
Mono,2020-11-06,0,0,17,0,0,2,0
Ventura,2020-11-06,33,8,1245,7,3,33,41
San Benito,2020-11-06,3,0,25,1,0,2,3
Sutter,2020-11-06,0,0,14,0,0,0,0
Madera,2020-11-06,7,11,310,1,0,8,18
Stanislaus,2020-11-06,58,9,1297,14,1,16,67
Kings,2020-11-06,17,0,193,2,0,14,17
Mariposa,2020-11-06,0,0,19,0,0,0,0
San Joaquin,2020-11-06,44,5,1025,10,2,26,49
Los Angeles,2020-11-06,851,255,20230,251,39,661,1106
Orange,2020-11-07,201,23,5952,72,5,200,224
Fresno,2020-11-07,110,21,1673,22,3,17,131
San Joaquin,2020-11-07,53,4,1028,13,0,27,57
San Francisco,2020-11-07,36,5,1903,8,2,56,41
Placer,2020-11-07,38,16,808,5,1,29,54
Mono,2020-11-07,0,0,17,0,0,2,0
Yuba,2020-11-07,1,1,265,1,0,6,2
Mendocino,2020-11-07,3,0,177,3,0,4,3
Sonoma,2020-11-07,27,2,542,8,0,5,29
Tulare,2020-11-07,37,3,679,6,0,21,40
El Dorado,2020-11-07,2,0,189,2,0,8,2
Mariposa,2020-11-07,1,0,19,0,0,0,1
Glenn,2020-11-07,0,0,47,0,0,0,0
San Luis Obispo,2020-11-07,6,1,460,3,0,28,7
Tehama,2020-11-07,4,0,59,0,0,1,4
Amador,2020-11-07,3,0,51,0,0,3,3
Kern,2020-11-07,61,1,1276,19,0,58,62
Ventura,2020-11-07,39,5,1233,19,1,34,44
Los Angeles,2020-11-07,855,278,20173,251,34,695,1133
Trinity,2020-11-07,0,0,25,0,0,0,0
Modoc,2020-11-07,2,0,41,0,0,0,2
Siskiyou,2020-11-07,3,0,56,2,0,6,3
Humboldt,2020-11-07,2,0,267,0,0,6,2
Yolo,2020-11-07,4,0,96,3,0,6,4
Lake,2020-11-07,1,0,77,1,0,3,1
Santa Barbara,2020-11-07,9,0,688,2,0,46,9
Butte,2020-11-07,10,1,453,2,1,15,11
Stanislaus,2020-11-07,61,6,1297,12,1,20,67
Sutter,2020-11-07,0,0,14,0,0,0,0
Imperial,2020-11-07,47,0,250,14,0,0,47
Del Norte,2020-11-07,0,0,51,0,0,3,0
San Benito,2020-11-07,3,0,25,1,0,2,3
Inyo,2020-11-07,0,0,29,0,0,4,0
San Mateo,2020-11-07,20,5,701,5,1,37,25
Contra Costa,2020-11-07,38,12,1482,8,0,52,50
Madera,2020-11-07,6,13,310,1,0,8,19
Tuolumne,2020-11-07,3,1,181,0,0,2,4
Merced,2020-11-07,10,0,271,5,0,11,10
San Diego,2020-11-07,297,57,6955,92,14,252,354
Santa Clara,2020-11-07,105,19,3020,26,1,69,124
Colusa,2020-11-07,0,1,48,0,0,0,1
Sacramento,2020-11-07,120,24,2579,27,4,71,144
Shasta,2020-11-07,17,1,561,2,0,6,18
Alameda,2020-11-07,69,37,2479,18,5,106,106
Solano,2020-11-07,28,12,559,8,1,19,40
Plumas,2020-11-07,0,0,35,0,0,0,0
Santa Cruz,2020-11-07,7,2,389,3,0,6,9
Nevada,2020-11-07,4,1,124,0,1,3,5
Marin,2020-11-07,6,7,359,2,1,17,13
Kings,2020-11-07,16,0,193,2,0,13,16
Calaveras,2020-11-07,0,0,33,0,0,4,0
Monterey,2020-11-07,33,0,717,10,0,22,33
San Bernardino,2020-11-07,274,38,3983,69,9,119,312
Riverside,2020-11-07,223,55,3387,62,14,65,278
Napa,2020-11-07,6,0,200,2,0,13,6
Lassen,2020-11-07,1,0,25,0,0,0,1
Solano,2020-11-08,28,11,491,8,2,21,39
Humboldt,2020-11-08,2,1,270,0,0,4,3
Siskiyou,2020-11-08,2,0,56,0,0,7,2
Mendocino,2020-11-08,4,0,177,2,0,6,4
Sonoma,2020-11-08,29,3,547,9,0,5,32
Kings,2020-11-08,14,0,193,2,0,15,14
San Benito,2020-11-08,3,0,25,1,0,2,3
Yuba,2020-11-08,4,0,265,2,0,8,4
Napa,2020-11-08,7,1,200,2,0,11,8
Lassen,2020-11-08,1,0,25,0,0,0,1
Plumas,2020-11-08,0,0,35,0,0,0,0
Shasta,2020-11-08,19,1,561,3,0,6,20
Del Norte,2020-11-08,1,0,51,0,0,1,1
Trinity,2020-11-08,0,0,25,0,0,0,0
Mariposa,2020-11-08,1,0,19,0,0,0,1
Glenn,2020-11-08,0,0,47,0,0,0,0
Merced,2020-11-08,11,0,271,5,0,12,11
San Francisco,2020-11-08,40,2,1855,10,1,65,42
Monterey,2020-11-08,32,0,717,9,0,24,32
Stanislaus,2020-11-08,64,12,1275,16,1,21,76
Fresno,2020-11-08,109,21,1668,26,1,-4,130
Lake,2020-11-08,1,0,77,1,0,1,1
Amador,2020-11-08,3,2,51,0,1,4,5
Butte,2020-11-08,10,0,453,1,0,11,10
Inyo,2020-11-08,0,0,29,0,0,3,0
Colusa,2020-11-08,0,0,48,0,0,0,0
Orange,2020-11-08,205,28,5875,76,7,193,233
Marin,2020-11-08,5,6,354,2,0,17,11
Tehama,2020-11-08,4,0,59,0,0,1,4
Santa Cruz,2020-11-08,9,0,389,3,0,6,9
Alameda,2020-11-08,69,48,2439,21,7,120,117
Madera,2020-11-08,5,7,310,1,1,8,12
Placer,2020-11-08,42,14,806,7,2,23,56
Imperial,2020-11-08,50,0,250,15,0,0,50
Sutter,2020-11-08,0,0,14,0,0,0,0
Calaveras,2020-11-08,0,0,33,0,0,4,0
Tuolumne,2020-11-08,1,3,181,0,1,3,4
Riverside,2020-11-08,228,58,3341,64,13,67,286
Santa Barbara,2020-11-08,10,0,688,3,0,50,10
San Luis Obispo,2020-11-08,6,2,460,3,1,26,8
San Bernardino,2020-11-08,289,37,3994,73,7,94,326
Modoc,2020-11-08,2,0,41,0,0,0,2
Kern,2020-11-08,61,1,1269,19,0,50,62
Mono,2020-11-08,0,0,17,0,0,2,0
San Joaquin,2020-11-08,55,1,1023,14,0,25,56
Sacramento,2020-11-08,136,22,2561,27,5,74,158
Contra Costa,2020-11-08,46,17,1493,13,0,53,63
Santa Clara,2020-11-08,111,27,2989,28,2,81,138
Yolo,2020-11-08,4,0,96,3,0,4,4
Los Angeles,2020-11-08,888,264,20059,250,33,769,1152
Ventura,2020-11-08,40,8,1225,18,3,40,48
San Mateo,2020-11-08,20,7,695,4,0,38,27
San Diego,2020-11-08,287,55,6948,91,13,265,342
Tulare,2020-11-08,38,8,679,5,1,23,46
El Dorado,2020-11-08,2,0,189,2,0,5,2
Nevada,2020-11-08,3,0,124,0,0,7,3
Modoc,2020-11-09,2,0,41,0,0,0,2
Orange,2020-11-09,224,52,5797,79,14,200,276
Merced,2020-11-09,9,0,271,5,0,5,9
Santa Clara,2020-11-09,110,24,2979,25,2,80,134
Mariposa,2020-11-09,1,0,19,0,0,0,1
Amador,2020-11-09,2,2,51,0,0,4,4
Butte,2020-11-09,12,0,453,0,0,13,12
Yuba,2020-11-09,3,0,265,2,0,11,3
Yolo,2020-11-09,4,0,96,1,0,2,4
Riverside,2020-11-09,244,43,3392,70,11,95,287
Kings,2020-11-09,18,0,193,4,0,16,18
Sonoma,2020-11-09,22,2,544,5,0,4,24
San Mateo,2020-11-09,19,7,699,3,0,39,26
El Dorado,2020-11-09,4,1,189,4,1,5,5
San Benito,2020-11-09,1,0,0,1,0,3,1
San Joaquin,2020-11-09,55,4,1022,13,0,26,59
Inyo,2020-11-09,0,0,29,0,0,4,0
Contra Costa,2020-11-09,45,12,1485,14,2,44,57
Imperial,2020-11-09,49,0,251,16,0,2,49
Santa Cruz,2020-11-09,8,0,389,3,0,7,8
Mono,2020-11-09,0,0,17,0,0,2,0
Shasta,2020-11-09,24,2,561,3,0,3,26
Madera,2020-11-09,7,4,329,1,0,7,11
Kern,2020-11-09,65,2,1267,17,0,57,67
Fresno,2020-11-09,112,24,1682,30,2,26,136
Alameda,2020-11-09,63,45,2429,18,7,113,108
Napa,2020-11-09,8,0,351,3,0,23,8
Santa Barbara,2020-11-09,11,0,688,2,0,57,11
San Diego,2020-11-09,299,53,6950,95,12,283,352
Nevada,2020-11-09,5,0,116,1,0,1,5
Del Norte,2020-11-09,0,0,51,0,0,0,0
Glenn,2020-11-09,0,0,47,0,0,0,0
Sacramento,2020-11-09,148,31,2567,28,5,80,179
Marin,2020-11-09,7,2,355,3,1,11,9
Colusa,2020-11-09,0,0,48,0,0,0,0
San Bernardino,2020-11-09,284,47,4001,79,5,93,331
Sutter,2020-11-09,0,0,14,0,0,0,0
Monterey,2020-11-09,33,0,717,10,0,24,33
Los Angeles,2020-11-09,903,306,20064,249,48,778,1209
Trinity,2020-11-09,0,0,25,0,0,0,0
San Francisco,2020-11-09,36,3,1856,11,1,68,39
Siskiyou,2020-11-09,4,0,56,0,0,8,4
Tulare,2020-11-09,38,8,679,5,1,26,46
Lassen,2020-11-09,1,0,25,0,0,0,1
Ventura,2020-11-09,41,9,1217,18,6,38,50
Placer,2020-11-09,44,9,806,6,3,28,53
Tehama,2020-11-09,3,0,59,0,0,2,3
Calaveras,2020-11-09,0,0,33,0,0,3,0
Mendocino,2020-11-09,4,0,177,4,0,6,4
Plumas,2020-11-09,0,0,35,0,0,0,0
Stanislaus,2020-11-09,62,9,1269,15,2,19,71
Solano,2020-11-09,33,12,550,10,2,18,45
Humboldt,2020-11-09,2,3,258,0,0,6,5
Tuolumne,2020-11-09,5,0,181,1,0,3,5
Lake,2020-11-09,1,0,77,1,0,2,1
San Luis Obispo,2020-11-09,8,0,460,4,0,25,8
Lake,2020-11-10,2,0,78,2,0,1,2
Ventura,2020-11-10,35,11,1238,11,1,40,46
Trinity,2020-11-10,0,0,25,0,0,0,0
Kings,2020-11-10,18,0,193,4,0,16,18
Santa Barbara,2020-11-10,14,0,688,2,0,54,14
Placer,2020-11-10,49,10,803,6,3,28,59
Modoc,2020-11-10,2,0,41,0,0,0,2
San Mateo,2020-11-10,22,11,725,2,1,33,33
Sutter,2020-11-10,0,0,14,0,0,0,0
Sacramento,2020-11-10,158,25,2574,35,4,69,183
Madera,2020-11-10,8,9,329,2,0,7,17
San Benito,2020-11-10,1,0,25,1,0,2,1
Shasta,2020-11-10,31,0,561,4,0,3,31
El Dorado,2020-11-10,4,0,189,4,0,4,4
Fresno,2020-11-10,121,24,1707,28,2,13,145
Nevada,2020-11-10,5,0,133,1,0,1,5
Tuolumne,2020-11-10,4,0,181,1,0,2,4
Colusa,2020-11-10,1,0,48,0,0,0,1
Calaveras,2020-11-10,0,0,33,0,0,4,0
Merced,2020-11-10,14,0,272,6,0,5,14
Tehama,2020-11-10,5,0,59,0,0,3,5
San Francisco,2020-11-10,35,4,1876,8,1,69,39
Los Angeles,2020-11-10,953,317,20118,266,49,683,1270
Marin,2020-11-10,12,7,360,3,0,11,19
Orange,2020-11-10,244,40,5964,83,6,193,284
Siskiyou,2020-11-10,4,0,56,1,0,6,4
Solano,2020-11-10,30,12,563,11,2,15,42
Santa Clara,2020-11-10,109,26,3044,28,6,52,135
Lassen,2020-11-10,0,0,25,0,0,0,0
Riverside,2020-11-10,263,44,3450,70,9,102,307
Mono,2020-11-10,0,0,17,0,0,2,0
San Diego,2020-11-10,294,61,6945,97,10,258,355
Contra Costa,2020-11-10,45,14,1504,15,4,46,59
Mariposa,2020-11-10,1,0,19,0,0,0,1
Monterey,2020-11-10,38,0,717,9,0,23,38
Mendocino,2020-11-10,4,0,177,4,0,6,4
Santa Cruz,2020-11-10,9,0,389,3,0,8,9
Tulare,2020-11-10,42,8,679,4,1,24,50
Plumas,2020-11-10,0,0,35,0,0,0,0
Glenn,2020-11-10,0,0,47,0,0,0,0
Yolo,2020-11-10,3,0,96,2,0,4,3
Imperial,2020-11-10,51,0,266,16,0,2,51
Kern,2020-11-10,56,1,1266,15,0,64,57
Del Norte,2020-11-10,0,0,51,0,0,1,0
San Bernardino,2020-11-10,286,63,4013,79,5,105,349
Sonoma,2020-11-10,21,10,562,5,1,5,31
Humboldt,2020-11-10,2,1,262,0,0,6,3
Amador,2020-11-10,3,0,51,0,0,3,3
Stanislaus,2020-11-10,64,9,1288,18,2,9,73
Inyo,2020-11-10,0,0,29,0,0,4,0
Yuba,2020-11-10,3,0,265,2,0,10,3
San Luis Obispo,2020-11-10,6,0,460,3,0,28,6
Alameda,2020-11-10,70,51,2471,20,10,107,121
Butte,2020-11-10,13,0,453,1,0,5,13
San Joaquin,2020-11-10,62,5,1030,15,0,24,67
Napa,2020-11-10,7,0,351,2,0,14,7
Mendocino,2020-11-11,7,0,177,5,0,4,7
Marin,2020-11-11,13,3,369,2,0,10,16
Los Angeles,2020-11-11,942,323,20217,266,49,648,1265
Sutter,2020-11-11,0,0,14,0,0,0,0
Merced,2020-11-11,17,0,272,9,0,7,17
Alameda,2020-11-11,75,36,2453,19,6,96,111
Amador,2020-11-11,3,0,51,0,0,3,3
Ventura,2020-11-11,37,6,1236,12,0,43,43
San Benito,2020-11-11,1,0,25,1,0,3,1
Sacramento,2020-11-11,153,20,2470,34,3,104,173
Kings,2020-11-11,19,0,193,3,0,15,19
Tuolumne,2020-11-11,6,0,181,1,0,2,6
Stanislaus,2020-11-11,66,12,1295,16,3,15,78
Modoc,2020-11-11,1,0,41,0,0,0,1
San Diego,2020-11-11,303,41,6946,94,6,252,344
Santa Clara,2020-11-11,106,15,3069,29,0,54,121
San Luis Obispo,2020-11-11,7,0,460,3,0,28,7
Colusa,2020-11-11,2,0,48,0,0,0,2
Calaveras,2020-11-11,0,0,33,0,0,4,0
Yuba,2020-11-11,6,0,265,2,0,6,6
Fresno,2020-11-11,123,16,1700,33,1,11,139
Napa,2020-11-11,9,0,351,2,0,26,9
Lake,2020-11-11,2,0,78,2,0,1,2
Kern,2020-11-11,59,9,1276,16,0,51,68
Riverside,2020-11-11,271,52,3439,67,8,65,323
Tulare,2020-11-11,43,6,679,4,0,18,49
Lassen,2020-11-11,0,0,25,0,0,0,0
San Francisco,2020-11-11,36,7,1904,9,0,59,43
Solano,2020-11-11,30,14,563,10,2,15,44
Mono,2020-11-11,0,0,17,0,0,2,0
San Mateo,2020-11-11,21,10,738,2,1,37,31
Placer,2020-11-11,50,10,797,8,5,21,60
Siskiyou,2020-11-11,4,0,56,1,0,6,4
Inyo,2020-11-11,0,0,29,0,0,4,0
Plumas,2020-11-11,0,0,35,0,0,0,0
Shasta,2020-11-11,28,1,561,6,1,2,29
Santa Cruz,2020-11-11,12,0,389,4,0,7,12
Yolo,2020-11-11,5,0,96,3,0,3,5
Santa Barbara,2020-11-11,12,0,688,2,0,57,12
Mariposa,2020-11-11,1,0,19,0,0,0,1
Glenn,2020-11-11,0,0,47,0,0,0,0
Orange,2020-11-11,251,43,5921,89,6,192,294
Humboldt,2020-11-11,2,2,276,0,1,2,4
Del Norte,2020-11-11,0,0,51,0,0,2,0
El Dorado,2020-11-11,5,1,189,5,1,8,6
Sonoma,2020-11-11,21,2,585,5,0,6,23
San Bernardino,2020-11-11,302,50,4067,84,2,107,352
Monterey,2020-11-11,44,0,717,9,0,20,44
San Joaquin,2020-11-11,69,4,1034,16,0,25,73
Nevada,2020-11-11,4,0,142,1,0,3,4
Imperial,2020-11-11,53,0,266,17,0,2,53
Contra Costa,2020-11-11,50,8,1564,19,2,40,58
Madera,2020-11-11,8,11,329,2,0,16,19
Butte,2020-11-11,16,0,453,1,0,8,16
Trinity,2020-11-11,0,0,25,0,0,0,0
Tehama,2020-11-11,5,0,59,0,0,2,5
San Joaquin,2020-11-12,62,2,1039,17,1,30,64
Los Angeles,2020-11-12,966,314,20215,269,52,661,1280
Santa Clara,2020-11-12,115,20,3045,29,1,72,135
San Diego,2020-11-12,302,35,6943,98,7,244,337
Lassen,2020-11-12,2,0,25,0,0,0,2
Plumas,2020-11-12,0,0,35,0,0,0,0
Ventura,2020-11-12,36,9,1235,12,1,41,45
Solano,2020-11-12,36,14,566,13,3,10,50
Sonoma,2020-11-12,18,9,581,5,0,4,27
Orange,2020-11-12,244,45,5916,95,6,193,289
Kern,2020-11-12,63,8,1287,13,0,54,71
San Luis Obispo,2020-11-12,7,0,460,2,0,27,7
Siskiyou,2020-11-12,3,0,25,3,0,0,3
Butte,2020-11-12,16,0,453,0,0,7,16
Marin,2020-11-12,11,6,365,2,0,7,17
Imperial,2020-11-12,60,0,266,20,0,0,60
Glenn,2020-11-12,0,0,47,0,0,0,0
Santa Cruz,2020-11-12,16,1,389,4,0,7,17
El Dorado,2020-11-12,4,0,189,4,0,7,4
Mariposa,2020-11-12,0,0,19,0,0,0,0
Sutter,2020-11-12,0,0,14,0,0,0,0
San Benito,2020-11-12,1,0,26,1,0,1,1
Madera,2020-11-12,11,14,329,2,0,16,25
Sacramento,2020-11-12,177,23,2561,41,2,64,200
Shasta,2020-11-12,28,1,561,8,0,3,29
Mono,2020-11-12,0,0,17,0,0,2,0
Lake,2020-11-12,2,0,77,2,0,1,2
Kings,2020-11-12,20,0,193,3,0,13,20
Amador,2020-11-12,4,0,51,0,0,5,4
Fresno,2020-11-12,120,19,1672,28,1,15,139
Santa Barbara,2020-11-12,13,2,688,4,0,58,15
San Mateo,2020-11-12,23,9,737,3,1,38,32
Humboldt,2020-11-12,3,4,279,1,1,2,7
Yuba,2020-11-12,7,0,265,2,0,5,7
Inyo,2020-11-12,0,0,29,0,0,3,0
Calaveras,2020-11-12,0,0,33,0,0,4,0
Riverside,2020-11-12,286,57,3476,65,6,64,343
Monterey,2020-11-12,43,2,717,8,0,18,45
Alameda,2020-11-12,70,39,2434,20,5,102,109
Modoc,2020-11-12,1,0,41,0,0,0,1
Yolo,2020-11-12,9,0,97,3,0,7,9
Napa,2020-11-12,9,0,351,2,0,27,9
Del Norte,2020-11-12,0,0,51,0,0,2,0
Colusa,2020-11-12,3,1,48,0,0,0,4
Trinity,2020-11-12,0,0,25,0,0,0,0
Nevada,2020-11-12,4,0,126,1,0,2,4
Tulare,2020-11-12,40,7,679,3,0,18,47
Placer,2020-11-12,46,10,797,6,1,24,56
Stanislaus,2020-11-12,74,15,1297,16,4,21,89
Contra Costa,2020-11-12,50,7,1551,19,0,32,57
Tehama,2020-11-12,7,0,59,2,0,3,7
Mendocino,2020-11-12,7,0,177,3,0,6,7
Tuolumne,2020-11-12,7,0,181,0,0,4,7
San Bernardino,2020-11-12,318,58,4102,86,7,93,376
San Francisco,2020-11-12,38,8,1851,10,1,62,46
Merced,2020-11-12,17,0,271,6,0,7,17
Calaveras,2020-11-13,1,0,33,1,0,4,1
Mono,2020-11-13,0,0,17,0,0,2,0
Glenn,2020-11-13,0,0,47,0,0,0,0
Lassen,2020-11-13,0,0,25,0,0,0,0
Merced,2020-11-13,17,0,271,6,0,7,17
Placer,2020-11-13,44,9,801,5,1,22,53
Napa,2020-11-13,8,0,351,1,0,28,8
Tulare,2020-11-13,44,7,679,3,0,21,51
El Dorado,2020-11-13,4,0,189,4,0,6,4
Del Norte,2020-11-13,0,0,52,0,0,0,0
San Francisco,2020-11-13,36,7,1908,9,0,65,43
Ventura,2020-11-13,36,11,1248,15,2,28,47
Monterey,2020-11-13,44,2,717,8,0,23,46
Marin,2020-11-13,10,5,363,2,1,12,15
Mariposa,2020-11-13,0,0,19,0,0,0,0
Trinity,2020-11-13,0,0,25,0,0,0,0
Butte,2020-11-13,19,1,453,1,1,10,20
Santa Barbara,2020-11-13,13,3,688,5,0,53,16
Amador,2020-11-13,4,1,51,0,0,6,5
San Bernardino,2020-11-13,334,54,4089,83,8,95,388
Yuba,2020-11-13,7,0,265,2,0,4,7
Inyo,2020-11-13,1,0,29,1,0,3,1
Humboldt,2020-11-13,3,4,281,1,2,3,7
Kings,2020-11-13,26,0,193,3,0,13,26
Tuolumne,2020-11-13,9,0,84,0,0,2,9
Nevada,2020-11-13,4,0,126,1,0,2,4
Fresno,2020-11-13,131,16,1657,32,2,22,147
San Benito,2020-11-13,2,0,25,1,0,0,2
Contra Costa,2020-11-13,46,10,1543,17,2,37,56
Sacramento,2020-11-13,172,18,2546,42,3,64,190
San Joaquin,2020-11-13,68,6,1035,17,1,32,74
Orange,2020-11-13,235,37,5924,90,3,188,272
Kern,2020-11-13,63,3,1287,15,0,53,66
Los Angeles,2020-11-13,1014,282,20222,276,24,658,1296
San Mateo,2020-11-13,19,6,734,4,0,34,25
Riverside,2020-11-13,314,50,3461,73,4,56,364
San Diego,2020-11-13,298,51,6941,99,4,255,349
Plumas,2020-11-13,0,0,35,0,0,0,0
Solano,2020-11-13,41,12,577,12,0,10,53
Sonoma,2020-11-13,20,5,576,5,1,4,25
Colusa,2020-11-13,3,1,48,0,0,0,4
Sutter,2020-11-13,0,0,14,0,0,0,0
Shasta,2020-11-13,27,1,561,8,0,3,28
Mendocino,2020-11-13,5,0,177,1,0,7,5
Imperial,2020-11-13,63,0,266,18,0,3,63
Modoc,2020-11-13,0,0,41,0,0,0,0
Stanislaus,2020-11-13,84,16,1291,21,3,21,100
Tehama,2020-11-13,7,0,59,2,0,3,7
Santa Clara,2020-11-13,131,12,3063,36,1,66,143
Alameda,2020-11-13,74,38,2458,20,6,98,112
San Luis Obispo,2020-11-13,7,2,460,1,0,27,9
Lake,2020-11-13,2,1,77,2,0,1,3
Santa Cruz,2020-11-13,17,1,389,4,0,4,18
Yolo,2020-11-13,10,0,96,3,0,6,10
Madera,2020-11-13,10,9,329,2,0,18,19
Siskiyou,2020-11-13,4,0,25,3,0,0,4
Lake,2020-11-14,2,1,77,2,0,1,3
Lassen,2020-11-14,0,0,25,0,0,0,0
San Joaquin,2020-11-14,72,9,1030,17,0,29,81
Mariposa,2020-11-14,0,0,19,0,0,0,0
El Dorado,2020-11-14,4,0,189,4,0,6,4
San Mateo,2020-11-14,23,6,734,5,0,38,29
Santa Cruz,2020-11-14,19,0,389,3,0,3,19
Yolo,2020-11-14,14,0,96,5,0,4,14
Santa Barbara,2020-11-14,15,4,688,5,0,60,19
Stanislaus,2020-11-14,93,13,1284,19,2,24,106
Modoc,2020-11-14,0,0,41,0,0,0,0
Shasta,2020-11-14,22,22,561,6,1,8,44
Monterey,2020-11-14,51,1,717,9,0,22,52
Sacramento,2020-11-14,170,23,2566,46,4,67,193
Humboldt,2020-11-14,3,3,281,1,2,4,6
Fresno,2020-11-14,146,21,1673,33,1,17,167
Kings,2020-11-14,28,0,193,3,0,12,28
Nevada,2020-11-14,4,1,126,2,0,4,5
Imperial,2020-11-14,62,0,266,17,0,3,62
Solano,2020-11-14,38,8,554,11,0,7,46
Placer,2020-11-14,50,12,794,5,0,24,62
Tuolumne,2020-11-14,12,0,84,1,0,2,12
Butte,2020-11-14,21,0,453,1,0,13,21
Colusa,2020-11-14,4,2,48,0,0,0,6
Del Norte,2020-11-14,0,0,52,0,0,1,0
Madera,2020-11-14,10,6,329,2,0,19,16
Kern,2020-11-14,70,3,1269,14,0,47,73
Napa,2020-11-14,8,0,351,1,0,26,8
San Bernardino,2020-11-14,362,57,4084,83,10,92,419
Mono,2020-11-14,0,0,17,0,0,2,0
Alameda,2020-11-14,69,36,2483,19,6,100,105
Los Angeles,2020-11-14,1049,346,20221,298,38,690,1395
Plumas,2020-11-14,0,0,35,0,0,0,0
Merced,2020-11-14,13,0,271,4,0,11,13
Mendocino,2020-11-14,4,0,177,0,0,5,4
San Luis Obispo,2020-11-14,8,2,460,1,2,25,10
Sonoma,2020-11-14,19,3,534,6,0,3,22
Tulare,2020-11-14,54,6,675,6,0,21,60
Amador,2020-11-14,2,1,51,0,0,6,3
Inyo,2020-11-14,0,0,29,0,0,3,0
Ventura,2020-11-14,38,6,1241,20,0,35,44
Siskiyou,2020-11-14,7,0,56,3,0,8,7
Orange,2020-11-14,242,44,5900,90,4,173,286
Riverside,2020-11-14,310,58,3370,78,11,57,368
Contra Costa,2020-11-14,45,12,1526,16,1,38,57
San Benito,2020-11-14,1,0,25,1,0,2,1
Santa Clara,2020-11-14,135,12,3032,38,2,72,147
Marin,2020-11-14,9,4,358,3,0,17,13
Trinity,2020-11-14,0,0,25,0,0,0,0
Yuba,2020-11-14,9,1,265,2,1,6,10
Sutter,2020-11-14,0,0,14,0,0,0,0
Glenn,2020-11-14,0,0,47,0,0,0,0
San Diego,2020-11-14,317,46,6931,107,7,262,363
San Francisco,2020-11-14,38,2,1890,10,1,68,40
Tehama,2020-11-14,9,0,59,2,0,1,9
Calaveras,2020-11-14,2,0,33,2,0,4,2
Napa,2020-11-15,7,0,351,2,0,25,7
Humboldt,2020-11-15,3,1,275,1,0,4,4
Placer,2020-11-15,53,13,794,6,1,20,66
San Joaquin,2020-11-15,76,7,1005,19,1,28,83
Tehama,2020-11-15,8,0,59,3,0,4,8
Nevada,2020-11-15,4,1,118,2,0,3,5
Sutter,2020-11-15,0,0,14,0,0,0,0
San Luis Obispo,2020-11-15,10,0,460,1,0,34,10
Plumas,2020-11-15,0,0,35,0,0,0,0
San Diego,2020-11-15,317,53,6918,106,10,273,370
Tulare,2020-11-15,54,5,675,6,0,26,59
Del Norte,2020-11-15,0,0,51,0,0,0,0
Lake,2020-11-15,2,0,77,2,0,2,2
Tuolumne,2020-11-15,6,0,84,0,0,2,6
Ventura,2020-11-15,40,5,1238,22,0,37,45
Sonoma,2020-11-15,18,2,551,6,2,4,20
Santa Cruz,2020-11-15,14,0,389,3,0,2,14
Stanislaus,2020-11-15,94,14,1284,18,2,26,108
San Benito,2020-11-15,2,0,25,1,0,1,2
San Mateo,2020-11-15,18,6,735,5,0,39,24
Siskiyou,2020-11-15,7,0,56,3,0,7,7
Solano,2020-11-15,41,8,554,12,0,6,49
Yolo,2020-11-15,15,0,96,6,0,4,15
Orange,2020-11-15,257,45,5853,85,3,192,302
San Bernardino,2020-11-15,378,64,4083,88,12,109,442
El Dorado,2020-11-15,3,0,189,3,0,6,3
Glenn,2020-11-15,0,0,47,0,0,0,0
Inyo,2020-11-15,0,0,29,0,0,3,0
Santa Clara,2020-11-15,150,8,3016,42,0,70,158
Colusa,2020-11-15,3,2,48,0,0,0,5
Alameda,2020-11-15,71,39,2483,22,5,107,110
Shasta,2020-11-15,26,0,561,3,0,8,26
Trinity,2020-11-15,0,0,25,0,0,0,0
Marin,2020-11-15,9,4,358,3,0,17,13
Los Angeles,2020-11-15,1126,277,20107,308,43,654,1403
San Francisco,2020-11-15,39,3,1841,9,1,70,42
Calaveras,2020-11-15,2,0,33,2,0,5,2
Monterey,2020-11-15,51,1,717,10,0,22,52
Sacramento,2020-11-15,172,20,2561,48,4,82,192
Modoc,2020-11-15,0,1,41,0,0,0,1
Madera,2020-11-15,11,13,329,3,0,15,24
Mariposa,2020-11-15,1,0,19,0,0,0,1
Riverside,2020-11-15,320,68,3372,74,12,46,388
Contra Costa,2020-11-15,48,19,1526,16,2,40,67
Yuba,2020-11-15,11,0,265,3,0,9,11
Butte,2020-11-15,21,0,453,2,0,13,21
Lassen,2020-11-15,2,0,25,0,0,0,2
Fresno,2020-11-15,155,12,1662,35,2,10,167
Kings,2020-11-15,28,1,193,4,0,13,29
Imperial,2020-11-15,62,0,266,20,0,0,62
Mendocino,2020-11-15,5,1,177,1,0,4,6
Kern,2020-11-15,80,9,1266,17,0,51,89
Mono,2020-11-15,0,0,17,0,0,1,0
Merced,2020-11-15,13,0,271,5,0,11,13
Amador,2020-11-15,2,0,51,0,0,5,2
Santa Barbara,2020-11-15,17,5,688,4,0,55,22
Butte,2020-11-16,23,0,453,1,0,16,23
Yolo,2020-11-16,14,0,96,8,0,2,14
Lake,2020-11-16,1,0,77,1,0,2,1
Stanislaus,2020-11-16,102,20,1272,17,1,17,122
Mono,2020-11-16,0,0,17,0,0,2,0
Yuba,2020-11-16,15,0,265,3,0,7,15
Santa Barbara,2020-11-16,19,5,688,3,0,62,24
San Joaquin,2020-11-16,78,8,1005,18,1,30,86
Orange,2020-11-16,270,73,5829,79,13,204,343
Calaveras,2020-11-16,2,0,33,2,0,5,2
El Dorado,2020-11-16,5,0,189,5,0,5,5
San Luis Obispo,2020-11-16,7,0,460,1,0,32,7
Fresno,2020-11-16,151,21,1660,35,3,21,172
Lassen,2020-11-16,1,0,25,0,0,0,1
Monterey,2020-11-16,43,1,717,8,0,25,44
San Benito,2020-11-16,2,0,25,1,0,0,2
Trinity,2020-11-16,0,0,25,0,0,0,0
Madera,2020-11-16,11,5,329,3,1,14,16
Siskiyou,2020-11-16,6,0,56,2,0,9,6
Riverside,2020-11-16,338,59,3452,81,10,51,397
Santa Clara,2020-11-16,153,9,2997,43,1,76,162
Solano,2020-11-16,41,8,558,12,1,7,49
Alameda,2020-11-16,89,28,2438,24,3,110,117
Mendocino,2020-11-16,6,1,177,2,0,3,7
San Diego,2020-11-16,345,57,6920,112,10,287,402
San Bernardino,2020-11-16,411,69,4078,102,9,111,480
Humboldt,2020-11-16,2,5,274,1,2,3,7
Merced,2020-11-16,20,0,271,7,0,9,20
Placer,2020-11-16,68,18,793,9,3,22,86
Tuolumne,2020-11-16,6,0,84,0,0,3,6
Ventura,2020-11-16,49,5,1227,23,2,33,54
Del Norte,2020-11-16,0,0,51,0,0,3,0
Amador,2020-11-16,3,0,51,0,0,6,3
San Mateo,2020-11-16,22,5,708,6,0,40,27
Los Angeles,2020-11-16,1188,286,20078,323,47,700,1474
Inyo,2020-11-16,0,0,29,0,0,3,0
Contra Costa,2020-11-16,63,21,1506,25,2,36,84
Kern,2020-11-16,86,11,1276,19,0,46,97
Tulare,2020-11-16,60,6,683,6,0,29,66
Glenn,2020-11-16,0,0,47,0,0,0,0
San Francisco,2020-11-16,38,6,1835,8,2,86,44
Kings,2020-11-16,33,1,193,4,0,12,34
Modoc,2020-11-16,0,0,41,0,0,0,0
Marin,2020-11-16,12,2,360,3,0,14,14
Shasta,2020-11-16,26,0,561,4,0,4,26
Nevada,2020-11-16,4,0,133,2,0,0,4
Colusa,2020-11-16,4,1,48,0,0,0,5
Napa,2020-11-16,7,0,351,2,0,25,7
Plumas,2020-11-16,0,0,35,0,0,0,0
Santa Cruz,2020-11-16,14,0,389,4,0,4,14
Mariposa,2020-11-16,1,0,19,0,0,0,1
Sutter,2020-11-16,0,0,14,0,0,0,0
Tehama,2020-11-16,7,0,59,2,0,2,7
Imperial,2020-11-16,64,2,265,19,0,1,66
Sonoma,2020-11-16,17,5,548,8,1,4,22
Sacramento,2020-11-16,191,29,2518,48,8,83,220
Yuba,2020-11-17,20,0,265,4,0,5,20
Sacramento,2020-11-17,208,20,2585,47,6,61,228
Orange,2020-11-17,291,71,5937,90,10,171,362
Lassen,2020-11-17,0,0,25,0,0,0,0
Tehama,2020-11-17,7,0,59,3,0,2,7
Nevada,2020-11-17,7,1,129,2,0,2,8
Calaveras,2020-11-17,1,0,33,1,0,5,1
San Bernardino,2020-11-17,417,67,4095,107,12,96,484
Solano,2020-11-17,48,11,579,14,2,5,59
Ventura,2020-11-17,50,8,1234,22,4,29,58
Marin,2020-11-17,13,2,361,3,0,16,15
Humboldt,2020-11-17,3,3,272,1,1,1,6
Merced,2020-11-17,19,0,271,9,0,6,19
Fresno,2020-11-17,162,22,1676,33,3,15,184
Placer,2020-11-17,74,21,795,8,3,22,95
Butte,2020-11-17,23,0,453,2,0,12,23
Modoc,2020-11-17,0,1,41,0,0,0,1
San Benito,2020-11-17,2,0,25,1,0,0,2
Amador,2020-11-17,2,0,51,0,0,5,2
Shasta,2020-11-17,26,0,561,4,0,7,26
El Dorado,2020-11-17,5,2,189,5,2,5,7
Lake,2020-11-17,1,0,77,1,0,3,1
San Joaquin,2020-11-17,78,4,1006,18,2,26,82
Riverside,2020-11-17,350,59,3469,86,12,46,409
Stanislaus,2020-11-17,101,23,1288,14,2,19,124
Siskiyou,2020-11-17,5,0,56,2,0,9,5
Santa Barbara,2020-11-17,20,0,688,3,0,60,20
Colusa,2020-11-17,4,0,48,0,0,0,4
Del Norte,2020-11-17,0,0,52,0,0,2,0
Alameda,2020-11-17,95,24,2474,22,4,99,119
Sutter,2020-11-17,0,0,14,0,0,0,0
Imperial,2020-11-17,62,1,265,19,0,1,63
Sonoma,2020-11-17,21,2,572,9,0,5,23
San Francisco,2020-11-17,37,11,1898,11,3,63,48
Trinity,2020-11-17,0,0,25,0,0,0,0
Tulare,2020-11-17,55,3,679,9,0,23,58
Kern,2020-11-17,87,9,1305,19,0,45,96
Santa Clara,2020-11-17,163,16,3044,42,1,65,179
San Diego,2020-11-17,367,51,6939,118,11,254,418
Los Angeles,2020-11-17,1238,304,20249,349,31,607,1542
Tuolumne,2020-11-17,7,0,84,2,0,1,7
San Mateo,2020-11-17,26,9,711,7,1,33,35
Mono,2020-11-17,1,0,17,0,0,2,1
Monterey,2020-11-17,48,0,717,10,0,17,48
Yolo,2020-11-17,14,0,96,7,0,2,14
Madera,2020-11-17,10,13,329,3,0,13,23
Mendocino,2020-11-17,3,0,177,3,0,2,3
San Luis Obispo,2020-11-17,10,2,460,1,0,27,12
Inyo,2020-11-17,0,0,29,0,0,4,0
Mariposa,2020-11-17,0,0,19,0,0,0,0
Napa,2020-11-17,5,0,351,1,0,24,5
Kings,2020-11-17,39,0,193,5,0,11,39
Glenn,2020-11-17,0,0,47,0,0,0,0
Contra Costa,2020-11-17,67,8,1536,25,0,42,75
Santa Cruz,2020-11-17,17,1,389,6,0,3,18
Plumas,2020-11-17,0,0,35,0,0,0,0
San Diego,2020-11-18,369,65,6942,117,9,247,434
Santa Clara,2020-11-18,167,17,3059,48,0,53,184
Del Norte,2020-11-18,0,0,51,0,0,4,0
Tehama,2020-11-18,10,0,59,3,0,0,10
Glenn,2020-11-18,0,0,47,0,0,0,0
Riverside,2020-11-18,362,65,3484,85,6,40,427
Alameda,2020-11-18,103,30,2501,21,4,94,133
Monterey,2020-11-18,48,0,717,9,0,17,48
San Bernardino,2020-11-18,439,57,4093,119,8,89,496
Santa Cruz,2020-11-18,20,1,389,6,0,1,21
San Luis Obispo,2020-11-18,12,0,460,2,0,22,12
Trinity,2020-11-18,0,0,25,0,0,0,0
Napa,2020-11-18,5,0,351,1,0,26,5
Nevada,2020-11-18,8,0,134,2,0,2,8
Imperial,2020-11-18,67,3,265,19,0,2,70
San Joaquin,2020-11-18,83,5,1033,20,1,33,88
Sonoma,2020-11-18,23,4,603,7,0,6,27
Lassen,2020-11-18,1,0,25,0,0,0,1
Plumas,2020-11-18,0,1,35,0,0,0,1
Ventura,2020-11-18,50,7,1257,24,3,30,57
Colusa,2020-11-18,4,0,48,0,0,0,4
El Dorado,2020-11-18,8,1,189,4,0,7,9
Placer,2020-11-18,81,27,804,11,1,25,108
Stanislaus,2020-11-18,111,15,1295,15,1,22,126
Modoc,2020-11-18,0,0,41,0,0,0,0
Tulare,2020-11-18,57,6,679,7,1,23,63
Marin,2020-11-18,7,2,368,3,0,14,9
Tuolumne,2020-11-18,8,0,84,2,0,1,8
San Mateo,2020-11-18,27,6,712,8,0,29,33
Sacramento,2020-11-18,227,22,2595,54,5,65,249
Mariposa,2020-11-18,0,0,19,0,0,0,0
Los Angeles,2020-11-18,1298,330,20283,344,40,585,1628
Calaveras,2020-11-18,1,0,33,1,0,4,1
Merced,2020-11-18,22,0,271,7,0,11,22
Mono,2020-11-18,1,0,17,0,0,2,1
Madera,2020-11-18,12,9,329,3,0,17,21
San Benito,2020-11-18,2,0,25,1,0,1,2
Contra Costa,2020-11-18,67,16,1535,24,3,31,83
Fresno,2020-11-18,170,19,1699,28,1,19,189
Sutter,2020-11-18,0,0,14,0,0,0,0
San Francisco,2020-11-18,39,8,1933,10,2,52,47
Lake,2020-11-18,2,0,77,2,0,1,2
Butte,2020-11-18,22,0,453,2,0,12,22
Humboldt,2020-11-18,3,3,271,0,1,2,6
Yolo,2020-11-18,12,0,96,7,0,2,12
Solano,2020-11-18,53,12,588,10,2,15,65
Orange,2020-11-18,304,55,5953,83,9,182,359
Mendocino,2020-11-18,5,0,177,5,0,6,5
Santa Barbara,2020-11-18,20,2,688,3,0,59,22
Kern,2020-11-18,95,7,1315,21,0,41,102
Yuba,2020-11-18,22,0,265,4,0,6,22
Shasta,2020-11-18,29,0,561,6,0,2,29
Kings,2020-11-18,40,0,193,5,0,11,40
Inyo,2020-11-18,0,0,29,0,0,4,0
Amador,2020-11-18,1,1,51,0,1,2,2
Siskiyou,2020-11-18,6,0,56,2,0,7,6
San Bernardino,2020-11-19,458,54,4100,126,5,91,512
San Luis Obispo,2020-11-19,9,1,460,1,0,23,10
Lake,2020-11-19,2,0,77,2,0,2,2
Monterey,2020-11-19,48,0,717,9,0,21,48
Siskiyou,2020-11-19,4,0,56,2,0,9,4
Ventura,2020-11-19,54,1,1234,26,2,29,55
Santa Cruz,2020-11-19,22,1,389,8,0,1,23
Santa Barbara,2020-11-19,17,3,688,4,0,68,20
Del Norte,2020-11-19,0,0,52,0,0,3,0
Tulare,2020-11-19,51,8,679,7,1,18,59
Placer,2020-11-19,86,23,808,12,1,25,109
Kings,2020-11-19,45,0,193,6,0,11,45
Santa Clara,2020-11-19,178,18,3064,50,0,51,196
Nevada,2020-11-19,12,1,119,4,0,2,13
Amador,2020-11-19,2,0,51,0,0,5,2
San Benito,2020-11-19,1,0,25,1,0,1,1
San Mateo,2020-11-19,25,7,729,7,1,28,32
Mariposa,2020-11-19,0,0,19,0,0,0,0
Trinity,2020-11-19,0,0,25,0,0,0,0
Kern,2020-11-19,101,8,1310,22,0,46,109
Orange,2020-11-19,333,41,5908,102,4,175,374
Contra Costa,2020-11-19,68,12,1523,26,1,38,80
Sonoma,2020-11-19,26,5,591,8,1,6,31
Shasta,2020-11-19,38,1,561,7,0,1,39
Butte,2020-11-19,24,1,453,3,0,14,25
San Diego,2020-11-19,393,54,6939,118,12,238,447
Los Angeles,2020-11-19,1391,304,20341,368,36,584,1695
Colusa,2020-11-19,4,0,48,0,0,0,4
Lassen,2020-11-19,1,0,25,0,0,0,1
Napa,2020-11-19,7,0,351,1,0,28,7
Modoc,2020-11-19,0,0,41,0,0,0,0
Merced,2020-11-19,30,1,272,9,0,9,31
Mendocino,2020-11-19,5,0,177,5,0,4,5
Humboldt,2020-11-19,3,3,267,0,0,5,6
Stanislaus,2020-11-19,112,7,1292,17,1,16,119
Yuba,2020-11-19,22,0,265,5,0,6,22
Tehama,2020-11-19,11,0,59,4,0,0,11
El Dorado,2020-11-19,8,0,189,4,0,10,8
Solano,2020-11-19,54,10,609,10,1,18,64
Yolo,2020-11-19,13,0,96,7,0,0,13
Plumas,2020-11-19,0,0,35,0,0,0,0
San Francisco,2020-11-19,42,4,1942,11,4,53,46
Tuolumne,2020-11-19,8,0,84,2,0,1,8
Riverside,2020-11-19,375,65,3478,99,7,38,440
Glenn,2020-11-19,0,0,47,0,0,0,0
Madera,2020-11-19,12,9,329,4,0,12,21
San Joaquin,2020-11-19,84,6,1036,22,2,22,90
Alameda,2020-11-19,104,30,2506,23,5,88,134
Sacramento,2020-11-19,231,28,2596,50,4,64,259
Mono,2020-11-19,0,0,17,0,0,2,0
Marin,2020-11-19,7,2,364,3,0,20,9
Imperial,2020-11-19,61,5,265,20,0,0,66
Inyo,2020-11-19,1,0,29,1,0,2,1
Calaveras,2020-11-19,1,0,33,1,0,5,1
Fresno,2020-11-19,171,29,1718,23,4,25,200
Sutter,2020-11-19,0,0,14,0,0,0,0
Inyo,2020-11-20,1,0,29,1,0,2,1
Placer,2020-11-20,88,21,806,9,3,21,109
Kern,2020-11-20,109,2,1301,20,0,42,111
Tulare,2020-11-20,58,8,679,7,0,21,66
San Diego,2020-11-20,411,51,6792,121,5,243,462
Kings,2020-11-20,47,0,193,6,0,11,47
Madera,2020-11-20,14,11,329,5,0,5,25
Yolo,2020-11-20,14,0,96,7,0,1,14
Trinity,2020-11-20,0,0,25,0,0,0,0
Mono,2020-11-20,0,0,17,0,0,1,0
San Joaquin,2020-11-20,97,8,1034,24,3,30,105
Santa Cruz,2020-11-20,24,2,387,8,1,1,26
Sonoma,2020-11-20,24,7,575,6,3,5,31
Mariposa,2020-11-20,0,0,19,0,0,0,0
Sacramento,2020-11-20,239,27,2572,47,6,77,266
Colusa,2020-11-20,5,2,48,0,0,0,7
Glenn,2020-11-20,0,0,47,0,0,0,0
Imperial,2020-11-20,59,5,265,18,0,0,64
Modoc,2020-11-20,0,0,41,0,0,0,0
Yuba,2020-11-20,24,0,265,6,0,2,24
Santa Barbara,2020-11-20,21,3,688,6,1,45,24
Los Angeles,2020-11-20,1401,317,20307,363,45,614,1718
Lassen,2020-11-20,1,0,25,0,0,0,1
Marin,2020-11-20,6,2,354,3,1,20,8
Lake,2020-11-20,2,0,77,2,0,1,2
Riverside,2020-11-20,385,55,3439,98,6,51,440
Fresno,2020-11-20,190,27,1698,30,2,20,217
Contra Costa,2020-11-20,71,11,1548,22,0,37,82
Ventura,2020-11-20,65,7,1237,29,3,13,72
San Benito,2020-11-20,1,0,25,1,0,0,1
Humboldt,2020-11-20,3,1,277,0,0,0,4
San Luis Obispo,2020-11-20,10,2,460,2,0,25,12
Solano,2020-11-20,57,8,585,11,0,13,65
Merced,2020-11-20,29,0,272,9,0,5,29
Calaveras,2020-11-20,0,0,33,0,0,3,0
Santa Clara,2020-11-20,184,13,3054,50,1,56,197
Plumas,2020-11-20,0,0,35,0,0,0,0
Mendocino,2020-11-20,5,0,177,5,0,5,5
El Dorado,2020-11-20,8,0,189,4,0,6,8
Stanislaus,2020-11-20,127,16,1294,18,1,14,143
Alameda,2020-11-20,97,31,2507,25,5,89,128
Siskiyou,2020-11-20,5,0,56,2,0,9,5
Del Norte,2020-11-20,0,0,51,0,0,2,0
Napa,2020-11-20,6,0,351,1,0,28,6
San Francisco,2020-11-20,49,4,1921,10,3,57,53
Tuolumne,2020-11-20,8,0,84,1,0,2,8
Sutter,2020-11-20,0,0,14,0,0,0,0
Orange,2020-11-20,365,47,5955,88,8,190,412
Nevada,2020-11-20,9,0,116,4,0,2,9
San Bernardino,2020-11-20,509,52,4112,129,7,68,561
Amador,2020-11-20,3,0,51,0,0,4,3
Butte,2020-11-20,29,1,453,2,0,16,30
Tehama,2020-11-20,11,0,59,5,0,1,11
Monterey,2020-11-20,52,0,717,9,0,25,52
San Mateo,2020-11-20,26,12,741,7,1,34,38
Shasta,2020-11-20,40,3,561,6,0,4,43
Orange,2020-11-21,380,39,5822,91,7,168,419
Alameda,2020-11-21,108,24,2513,25,4,92,132
San Bernardino,2020-11-21,495,64,4067,128,10,93,559
Los Angeles,2020-11-21,1482,346,20246,391,48,647,1828
San Diego,2020-11-21,439,46,6780,126,6,238,485
Tehama,2020-11-21,12,0,59,4,0,1,12
Imperial,2020-11-21,57,0,265,18,0,-1,57
Monterey,2020-11-21,54,0,717,12,0,21,54
Nevada,2020-11-21,9,0,115,3,0,2,9
Modoc,2020-11-21,0,0,41,0,0,0,0
Mariposa,2020-11-21,0,0,19,0,0,0,0
Merced,2020-11-21,28,1,271,3,0,7,29
Mono,2020-11-21,1,0,17,0,0,2,1
Santa Barbara,2020-11-21,21,3,688,5,0,44,24
Yuba,2020-11-21,21,0,265,5,0,5,21
Riverside,2020-11-21,409,54,3387,96,7,47,463
Kings,2020-11-21,45,1,193,8,0,8,46
Solano,2020-11-21,60,7,581,11,0,11,67
Santa Clara,2020-11-21,190,19,3047,55,1,48,209
Yolo,2020-11-21,14,2,96,9,0,0,16
Glenn,2020-11-21,0,0,47,0,0,0,0
Del Norte,2020-11-21,0,0,51,0,0,2,0
Siskiyou,2020-11-21,4,0,56,2,0,9,4
Contra Costa,2020-11-21,70,11,1553,24,2,37,81
Placer,2020-11-21,97,24,811,11,2,24,121
Santa Cruz,2020-11-21,25,0,388,8,0,2,25
Lassen,2020-11-21,2,0,25,0,0,0,2
Amador,2020-11-21,2,0,51,1,0,3,2
Trinity,2020-11-21,0,0,25,0,0,0,0
Napa,2020-11-21,6,0,506,2,0,25,6
Marin,2020-11-21,6,2,347,3,1,20,8
San Benito,2020-11-21,1,0,25,1,0,1,1
Mendocino,2020-11-21,3,0,177,3,0,5,3
San Francisco,2020-11-21,52,5,1896,13,2,65,57
Kern,2020-11-21,117,3,1312,19,0,43,120
San Luis Obispo,2020-11-21,11,1,460,2,0,26,12
Sutter,2020-11-21,0,0,14,0,0,0,0
Fresno,2020-11-21,203,21,1690,29,3,18,224
Inyo,2020-11-21,1,0,29,1,0,3,1
San Joaquin,2020-11-21,107,8,1036,31,3,23,115
Sacramento,2020-11-21,255,22,2563,52,4,83,277
Madera,2020-11-21,18,6,329,5,0,6,24
Lake,2020-11-21,1,0,77,1,0,2,1
Colusa,2020-11-21,5,3,48,0,0,0,8
El Dorado,2020-11-21,10,0,189,5,0,5,10
Humboldt,2020-11-21,4,1,265,0,0,3,5
Tuolumne,2020-11-21,9,0,84,2,0,0,9
Tulare,2020-11-21,58,9,679,8,0,18,67
Ventura,2020-11-21,62,6,1230,22,7,22,68
Stanislaus,2020-11-21,129,6,1298,22,1,19,135
Butte,2020-11-21,23,0,453,2,0,14,23
Plumas,2020-11-21,0,0,35,0,0,0,0
Calaveras,2020-11-21,0,0,33,0,0,3,0
Shasta,2020-11-21,39,4,561,6,0,3,43
Sonoma,2020-11-21,24,0,576,6,0,6,24
San Mateo,2020-11-21,30,10,728,11,0,31,40
Trinity,2020-11-22,0,0,25,0,0,0,0
Yolo,2020-11-22,15,0,96,8,0,5,15
Ventura,2020-11-22,63,10,1216,27,4,23,73
San Luis Obispo,2020-11-22,16,1,460,3,1,26,17
San Mateo,2020-11-22,32,10,719,7,0,35,42
Butte,2020-11-22,25,0,453,2,0,14,25
Merced,2020-11-22,19,0,271,2,0,6,19
Glenn,2020-11-22,0,0,47,0,0,0,0
Sacramento,2020-11-22,255,22,2549,52,6,82,277
Santa Barbara,2020-11-22,23,2,688,4,0,49,25
Madera,2020-11-22,20,10,329,6,1,4,30
Colusa,2020-11-22,5,3,48,0,0,0,8
Fresno,2020-11-22,232,15,1706,34,0,19,247
San Francisco,2020-11-22,47,2,1852,14,2,67,49
Sutter,2020-11-22,0,0,14,0,0,0,0
Placer,2020-11-22,93,24,802,9,1,24,117
Santa Cruz,2020-11-22,24,0,387,8,0,2,24
Lake,2020-11-22,1,0,77,1,0,2,1
San Benito,2020-11-22,2,0,25,1,0,1,2
Shasta,2020-11-22,51,0,561,6,0,3,51
San Bernardino,2020-11-22,527,53,4053,137,9,88,580
Orange,2020-11-22,428,58,5817,105,7,156,486
Sonoma,2020-11-22,25,6,563,6,1,6,31
Plumas,2020-11-22,0,0,35,0,0,0,0
Nevada,2020-11-22,10,0,123,3,0,5,10
Inyo,2020-11-22,1,0,29,1,0,3,1
Monterey,2020-11-22,58,1,717,13,1,20,59
Napa,2020-11-22,5,0,506,2,0,28,5
Humboldt,2020-11-22,4,2,271,0,1,2,6
Siskiyou,2020-11-22,8,0,56,2,0,8,8
San Joaquin,2020-11-22,110,6,1040,33,2,25,116
Amador,2020-11-22,2,0,51,1,0,2,2
Contra Costa,2020-11-22,79,11,1547,24,1,45,90
Alameda,2020-11-22,115,35,2486,23,3,114,150
Riverside,2020-11-22,409,65,3351,96,11,44,474
Los Angeles,2020-11-22,1575,344,20163,404,59,654,1919
Imperial,2020-11-22,51,0,265,16,0,2,51
Kern,2020-11-22,120,6,1291,21,0,46,126
Mendocino,2020-11-22,2,0,177,2,0,5,2
Santa Clara,2020-11-22,197,21,3021,54,3,71,218
Solano,2020-11-22,58,11,587,14,0,16,69
Tulare,2020-11-22,50,7,679,8,0,22,57
San Diego,2020-11-22,446,47,6801,131,8,237,493
Tehama,2020-11-22,11,0,59,4,0,0,11
Calaveras,2020-11-22,2,0,33,2,0,5,2
Stanislaus,2020-11-22,138,20,1297,25,1,18,158
Lassen,2020-11-22,1,0,25,0,0,0,1
Mariposa,2020-11-22,0,0,19,0,0,0,0
Kings,2020-11-22,47,0,193,7,0,11,47
Mono,2020-11-22,1,0,17,0,0,2,1
Yuba,2020-11-22,26,0,265,5,0,5,26
Marin,2020-11-22,8,3,352,3,0,22,11
Del Norte,2020-11-22,0,0,52,0,0,3,0
Tuolumne,2020-11-22,12,0,84,2,0,1,12
Modoc,2020-11-22,0,0,41,0,0,0,0
El Dorado,2020-11-22,10,0,189,5,0,7,10
San Diego,2020-11-23,470,56,6797,140,12,245,526
Orange,2020-11-23,463,80,5814,116,10,183,543
Siskiyou,2020-11-23,8,0,56,1,0,9,8
Nevada,2020-11-23,8,2,142,4,0,3,10
San Bernardino,2020-11-23,583,75,4082,140,11,80,658
Tuolumne,2020-11-23,14,0,84,2,0,2,14
Lassen,2020-11-23,4,0,25,0,0,0,4
Stanislaus,2020-11-23,156,9,1298,25,0,17,165
Imperial,2020-11-23,51,1,265,15,0,4,52
Sacramento,2020-11-23,253,31,2542,49,7,90,284
Monterey,2020-11-23,64,2,717,13,2,23,66
Merced,2020-11-23,21,0,271,2,0,13,21
Mendocino,2020-11-23,12,0,177,5,0,5,12
San Benito,2020-11-23,3,0,25,1,0,1,3
Alameda,2020-11-23,123,26,2479,26,2,104,149
Kings,2020-11-23,43,2,193,7,0,11,45
Del Norte,2020-11-23,1,0,52,0,0,2,1
Yuba,2020-11-23,31,0,265,6,0,5,31
Glenn,2020-11-23,0,0,47,0,0,0,0
Humboldt,2020-11-23,4,5,271,0,1,2,9
Ventura,2020-11-23,64,6,1226,30,2,26,70
Mono,2020-11-23,1,0,17,0,0,2,1
San Joaquin,2020-11-23,114,8,1036,32,3,30,122
Riverside,2020-11-23,420,78,3347,107,10,52,498
Tehama,2020-11-23,8,0,59,4,0,0,8
Plumas,2020-11-23,0,0,35,0,0,0,0
Santa Cruz,2020-11-23,27,0,385,8,0,1,27
Modoc,2020-11-23,0,0,41,0,0,0,0
Inyo,2020-11-23,1,0,29,1,0,3,1
Fresno,2020-11-23,255,13,1715,40,0,20,268
Santa Barbara,2020-11-23,24,3,688,4,1,52,27
Los Angeles,2020-11-23,1682,296,20138,422,47,689,1978
Shasta,2020-11-23,48,0,561,7,0,5,48
Napa,2020-11-23,6,0,351,1,0,29,6
San Mateo,2020-11-23,40,4,712,7,0,35,44
San Luis Obispo,2020-11-23,13,3,460,3,0,28,16
Sutter,2020-11-23,0,0,14,0,0,0,0
Lake,2020-11-23,1,0,77,1,0,2,1
Butte,2020-11-23,32,0,453,4,0,14,32
Sonoma,2020-11-23,29,0,558,5,0,8,29
Tulare,2020-11-23,56,12,679,8,1,24,68
Contra Costa,2020-11-23,94,14,1564,25,1,50,108
Yolo,2020-11-23,20,0,96,7,0,8,20
Calaveras,2020-11-23,2,0,33,2,0,4,2
Solano,2020-11-23,61,7,575,14,1,12,68
Kern,2020-11-23,132,1,1282,24,0,43,133
San Francisco,2020-11-23,52,1,1834,15,0,66,53
Santa Clara,2020-11-23,201,24,3006,48,4,68,225
Amador,2020-11-23,3,0,51,1,0,3,3
Mariposa,2020-11-23,0,0,19,0,0,0,0
Marin,2020-11-23,8,4,355,4,0,19,12
El Dorado,2020-11-23,11,0,189,5,0,4,11
Trinity,2020-11-23,0,0,25,0,0,0,0
Placer,2020-11-23,101,18,792,11,1,26,119
Colusa,2020-11-23,5,2,48,0,0,0,7
Madera,2020-11-23,21,14,329,5,1,4,35
Fresno,2020-11-24,259,29,1729,37,5,14,288
Santa Cruz,2020-11-24,33,0,382,9,0,1,33
Mariposa,2020-11-24,0,0,19,0,0,0,0
Santa Clara,2020-11-24,217,20,3041,51,3,48,237
El Dorado,2020-11-24,11,1,189,6,0,7,12
San Benito,2020-11-24,3,0,25,1,0,1,3
Kings,2020-11-24,42,1,193,7,0,10,43
Mendocino,2020-11-24,12,0,177,3,0,4,12
Del Norte,2020-11-24,0,0,51,0,0,1,0
Siskiyou,2020-11-24,10,0,56,2,0,8,10
Imperial,2020-11-24,59,1,265,14,0,4,60
San Luis Obispo,2020-11-24,10,3,460,2,0,23,13
Marin,2020-11-24,7,3,359,4,0,17,10
Stanislaus,2020-11-24,162,7,1291,25,0,18,169
Modoc,2020-11-24,1,0,41,0,0,0,1
Solano,2020-11-24,63,11,588,15,2,12,74
Riverside,2020-11-24,455,72,3441,116,14,61,527
Sutter,2020-11-24,0,0,14,0,0,0,0
Kern,2020-11-24,126,3,1293,25,0,39,129
Alameda,2020-11-24,138,38,2505,32,5,98,176
Sonoma,2020-11-24,30,6,607,5,0,4,36
Tuolumne,2020-11-24,9,1,84,2,0,0,10
Santa Barbara,2020-11-24,26,4,688,4,2,44,30
Sacramento,2020-11-24,265,30,2551,49,5,87,295
Lassen,2020-11-24,3,0,25,0,0,0,3
Tehama,2020-11-24,10,0,59,4,0,0,10
Inyo,2020-11-24,2,0,29,0,0,4,2
Napa,2020-11-24,8,1,351,3,0,27,9
Yolo,2020-11-24,16,0,96,6,0,11,16
Shasta,2020-11-24,51,0,561,8,0,4,51
Tulare,2020-11-24,72,15,679,8,1,24,87
Placer,2020-11-24,110,15,795,9,2,23,125
Humboldt,2020-11-24,3,5,267,0,1,1,8
San Mateo,2020-11-24,45,6,720,7,2,31,51
Lake,2020-11-24,2,0,77,2,0,2,2
Colusa,2020-11-24,3,0,48,0,0,0,3
Orange,2020-11-24,479,47,6034,115,5,201,526
Merced,2020-11-24,21,0,271,4,0,11,21
San Francisco,2020-11-24,62,1,1873,19,0,55,63
San Bernardino,2020-11-24,606,67,4093,145,13,65,673
Monterey,2020-11-24,64,2,717,13,2,17,66
Plumas,2020-11-24,0,0,35,0,0,0,0
San Joaquin,2020-11-24,109,13,1040,31,4,24,122
San Diego,2020-11-24,510,44,6807,145,6,219,554
Contra Costa,2020-11-24,86,6,1541,22,0,50,92
Ventura,2020-11-24,77,8,1235,26,2,21,85
Butte,2020-11-24,33,0,453,4,0,11,33
Glenn,2020-11-24,0,0,47,0,0,0,0
Amador,2020-11-24,4,0,51,0,0,3,4
Trinity,2020-11-24,0,0,25,0,0,0,0
Mono,2020-11-24,0,0,17,0,0,2,0
Los Angeles,2020-11-24,1809,388,20182,437,44,636,2197
Calaveras,2020-11-24,1,0,33,1,0,5,1
Nevada,2020-11-24,12,1,133,3,0,4,13
Yuba,2020-11-24,30,0,265,6,0,3,30
Madera,2020-11-24,22,12,329,6,0,3,34
Alameda,2020-11-25,143,50,2536,37,6,97,193
Stanislaus,2020-11-25,171,15,1297,28,0,17,186
Riverside,2020-11-25,490,65,3449,112,13,57,555
Butte,2020-11-25,28,0,453,4,0,15,28
Modoc,2020-11-25,0,0,41,0,0,0,0
Trinity,2020-11-25,0,0,25,0,0,0,0
Los Angeles,2020-11-25,1893,301,20201,461,36,611,2194
San Bernardino,2020-11-25,628,66,4088,155,10,72,694
Shasta,2020-11-25,54,0,561,9,0,2,54
Sonoma,2020-11-25,28,3,582,4,0,7,31
San Benito,2020-11-25,3,0,25,2,0,1,3
Lassen,2020-11-25,4,0,25,0,0,0,4
Mendocino,2020-11-25,10,0,177,4,0,4,10
Merced,2020-11-25,17,0,271,6,0,9,17
Solano,2020-11-25,65,13,581,16,2,16,78
Kings,2020-11-25,44,1,193,7,0,11,45
Kern,2020-11-25,136,3,1293,29,0,46,139
Sutter,2020-11-25,0,0,14,0,0,0,0
Tehama,2020-11-25,9,0,59,4,0,0,9
Contra Costa,2020-11-25,92,8,1541,21,0,49,100
Sacramento,2020-11-25,279,20,2510,49,5,88,299
Tulare,2020-11-25,73,9,679,7,0,24,82
Orange,2020-11-25,499,38,5909,130,3,164,537
Santa Clara,2020-11-25,229,24,3043,58,4,47,253
Imperial,2020-11-25,59,1,265,14,0,4,60
El Dorado,2020-11-25,9,2,190,5,0,4,11
Del Norte,2020-11-25,0,0,51,0,0,4,0
Lake,2020-11-25,2,0,77,0,0,3,2
Placer,2020-11-25,106,18,798,6,4,25,124
Calaveras,2020-11-25,1,0,33,1,0,4,1
Glenn,2020-11-25,0,0,47,0,0,0,0
Mariposa,2020-11-25,1,0,19,0,0,0,1
Marin,2020-11-25,7,5,362,4,0,18,12
Santa Cruz,2020-11-25,32,0,382,9,0,1,32
Tuolumne,2020-11-25,11,0,84,3,0,1,11
Nevada,2020-11-25,13,1,138,3,1,4,14
Inyo,2020-11-25,1,0,29,0,0,4,1
Santa Barbara,2020-11-25,32,1,688,8,0,44,33
Plumas,2020-11-25,1,0,35,0,0,0,1
Monterey,2020-11-25,67,3,717,12,2,18,70
Ventura,2020-11-25,84,3,1240,21,1,29,87
Yuba,2020-11-25,30,0,265,6,0,3,30
Mono,2020-11-25,0,0,17,0,0,2,0
Yolo,2020-11-25,14,0,97,5,0,7,14
Colusa,2020-11-25,4,0,48,0,0,0,4
Siskiyou,2020-11-25,12,0,56,2,0,8,12
San Mateo,2020-11-25,46,6,727,7,1,27,52
Amador,2020-11-25,3,0,51,0,0,3,3
San Joaquin,2020-11-25,110,10,1038,32,2,25,120
Napa,2020-11-25,10,0,351,4,0,28,10
Humboldt,2020-11-25,1,3,280,0,0,2,4
Madera,2020-11-25,22,13,329,6,0,12,35
Fresno,2020-11-25,258,17,1717,45,2,20,275
San Francisco,2020-11-25,64,6,1864,20,2,50,70
San Diego,2020-11-25,545,42,6801,154,11,218,587
San Luis Obispo,2020-11-25,9,1,460,2,0,22,10
Orange,2020-11-26,506,36,5930,139,1,164,542
San Diego,2020-11-26,563,41,6811,164,8,220,604
Yuba,2020-11-26,25,0,265,7,0,2,25
San Luis Obispo,2020-11-26,9,1,460,1,0,23,10
Kern,2020-11-26,143,4,1285,32,1,48,147
Ventura,2020-11-26,81,11,1229,18,10,31,92
Humboldt,2020-11-26,2,1,275,0,0,2,3
Tulare,2020-11-26,79,6,679,7,1,27,85
Fresno,2020-11-26,265,15,1669,39,2,14,280
Butte,2020-11-26,32,1,451,8,0,15,33
San Mateo,2020-11-26,47,5,708,8,1,28,52
El Dorado,2020-11-26,11,2,190,4,0,9,13
Sonoma,2020-11-26,30,2,565,6,0,9,32
Imperial,2020-11-26,62,0,265,15,0,7,62
Modoc,2020-11-26,0,0,41,0,0,0,0
San Benito,2020-11-26,3,0,25,2,0,0,3
Shasta,2020-11-26,60,0,561,11,0,3,60
Calaveras,2020-11-26,1,0,33,1,0,4,1
Amador,2020-11-26,4,0,51,0,0,2,4
San Bernardino,2020-11-26,656,48,4074,167,8,69,704
San Joaquin,2020-11-26,107,14,1039,32,5,24,121
Santa Barbara,2020-11-26,31,0,688,8,0,43,31
Lassen,2020-11-26,3,0,25,0,0,0,3
Santa Clara,2020-11-26,230,23,3034,70,2,46,253
Santa Cruz,2020-11-26,32,0,382,7,0,3,32
Riverside,2020-11-26,498,77,3381,115,15,58,575
Sutter,2020-11-26,0,0,14,0,0,0,0
Colusa,2020-11-26,4,0,48,0,0,0,4
Lake,2020-11-26,3,0,77,0,0,3,3
Mendocino,2020-11-26,12,1,177,5,0,0,13
Trinity,2020-11-26,0,0,25,0,0,0,0
Merced,2020-11-26,23,0,271,6,0,11,23
Kings,2020-11-26,50,0,193,6,0,12,50
Los Angeles,2020-11-26,1951,301,20202,484,52,589,2252
Inyo,2020-11-26,1,0,29,0,0,4,1
Tuolumne,2020-11-26,11,0,84,4,0,0,11
Glenn,2020-11-26,0,0,47,0,0,0,0
Siskiyou,2020-11-26,13,0,56,2,0,7,13
San Francisco,2020-11-26,70,4,1836,20,0,56,74
Contra Costa,2020-11-26,90,9,1530,19,4,51,99
Yolo,2020-11-26,13,0,97,5,0,7,13
Plumas,2020-11-26,1,0,35,0,0,0,1
Monterey,2020-11-26,71,2,717,12,1,21,73
Sacramento,2020-11-26,263,22,2547,50,3,73,285
Tehama,2020-11-26,11,0,59,4,0,2,11
Mariposa,2020-11-26,0,0,19,0,0,0,0
Placer,2020-11-26,118,22,799,9,8,23,140
Marin,2020-11-26,6,2,355,3,0,18,8
Del Norte,2020-11-26,0,0,52,0,0,3,0
Stanislaus,2020-11-26,186,14,1296,33,1,17,200
Madera,2020-11-26,23,6,329,6,0,16,29
Nevada,2020-11-26,13,2,125,3,0,5,15
Alameda,2020-11-26,157,54,2524,40,6,88,211
Solano,2020-11-26,67,15,565,19,2,19,82
Mono,2020-11-26,0,0,17,0,0,2,0
Napa,2020-11-26,10,0,351,4,0,26,10
Madera,2020-11-27,25,10,329,7,0,16,35
Stanislaus,2020-11-27,181,20,1294,34,0,19,201
Tehama,2020-11-27,12,0,59,4,0,1,12
Ventura,2020-11-27,84,10,1220,29,4,26,94
San Bernardino,2020-11-27,661,64,4055,162,10,86,725
Mariposa,2020-11-27,0,0,19,0,0,0,0
San Luis Obispo,2020-11-27,10,0,460,1,0,24,10
Riverside,2020-11-27,533,47,3371,112,11,55,580
Monterey,2020-11-27,76,2,717,13,1,23,78
Kings,2020-11-27,52,0,193,7,0,10,52
Tuolumne,2020-11-27,12,0,84,3,0,1,12
Amador,2020-11-27,3,0,51,0,0,4,3
Mendocino,2020-11-27,14,6,177,5,1,2,20
Nevada,2020-11-27,12,0,141,3,0,4,12
Lake,2020-11-27,2,0,77,0,0,3,2
Imperial,2020-11-27,70,0,265,14,0,8,70
Shasta,2020-11-27,57,0,561,10,0,5,57
Santa Clara,2020-11-27,246,22,3012,72,4,63,268
Los Angeles,2020-11-27,2049,299,20087,501,58,612,2348
Tulare,2020-11-27,81,3,679,9,1,27,84
Marin,2020-11-27,7,3,353,3,0,14,10
Trinity,2020-11-27,0,0,25,0,0,0,0
Sutter,2020-11-27,0,0,14,0,0,0,0
San Mateo,2020-11-27,46,6,716,9,1,31,52
Humboldt,2020-11-27,3,2,273,0,0,4,5
Yolo,2020-11-27,18,0,97,5,0,8,18
Sonoma,2020-11-27,31,4,536,4,0,10,35
Inyo,2020-11-27,1,0,29,0,0,4,1
Orange,2020-11-27,534,35,5854,138,3,157,569
Glenn,2020-11-27,0,0,47,0,0,0,0
Santa Cruz,2020-11-27,35,0,382,6,0,2,35
Fresno,2020-11-27,274,20,1656,50,4,17,294
Siskiyou,2020-11-27,13,0,56,2,0,7,13
Modoc,2020-11-27,0,0,41,0,0,0,0
Merced,2020-11-27,22,0,271,8,0,8,22
Plumas,2020-11-27,0,0,35,0,0,0,0
Contra Costa,2020-11-27,86,12,1506,19,2,55,98
San Joaquin,2020-11-27,112,14,1047,27,6,34,126
El Dorado,2020-11-27,11,1,190,4,0,7,12
Colusa,2020-11-27,8,0,48,0,0,0,8
Napa,2020-11-27,11,0,351,4,0,29,11
San Diego,2020-11-27,599,38,6786,167,5,245,637
Alameda,2020-11-27,163,41,2491,42,4,98,204
San Francisco,2020-11-27,72,4,1775,25,1,59,76
Butte,2020-11-27,37,2,451,5,1,13,39
Kern,2020-11-27,165,3,1269,33,0,47,168
Yuba,2020-11-27,28,0,265,8,0,4,28
Santa Barbara,2020-11-27,33,2,688,7,0,58,35
Del Norte,2020-11-27,0,0,52,0,0,1,0
San Benito,2020-11-27,4,0,25,2,0,0,4
Lassen,2020-11-27,3,0,25,0,0,0,3
Placer,2020-11-27,128,13,801,12,3,22,141
Sacramento,2020-11-27,284,18,2541,53,3,72,302
Solano,2020-11-27,62,11,548,18,2,17,73
Calaveras,2020-11-27,1,0,33,1,0,5,1
Mono,2020-11-27,1,0,17,0,0,2,1
Lassen,2020-11-28,5,0,25,0,0,0,5
Contra Costa,2020-11-28,90,18,1535,21,2,46,108
Mono,2020-11-28,0,1,17,0,0,2,1
Modoc,2020-11-28,0,0,41,0,0,0,0
San Bernardino,2020-11-28,728,64,4018,170,8,82,792
Orange,2020-11-28,597,48,5953,148,5,157,645
Ventura,2020-11-28,88,8,1216,35,2,24,96
Madera,2020-11-28,25,7,329,6,0,13,32
Merced,2020-11-28,19,0,271,9,0,7,19
Tulare,2020-11-28,90,4,679,10,1,22,94
Marin,2020-11-28,8,5,357,3,0,16,13
Humboldt,2020-11-28,2,3,266,0,0,0,5
Santa Cruz,2020-11-28,40,0,382,4,0,4,40
Los Angeles,2020-11-28,2185,328,20124,522,46,614,2513
Stanislaus,2020-11-28,186,18,1294,34,0,23,204
Sonoma,2020-11-28,28,4,546,5,0,9,32
Plumas,2020-11-28,0,0,35,0,0,0,0
Calaveras,2020-11-28,1,0,33,1,0,5,1
Trinity,2020-11-28,0,0,25,0,0,0,0
Siskiyou,2020-11-28,14,0,56,2,0,7,14
Lake,2020-11-28,2,0,77,0,0,2,2
Kern,2020-11-28,166,1,1289,37,0,42,167
Placer,2020-11-28,124,15,797,11,2,24,139
Inyo,2020-11-28,1,0,29,0,0,4,1
Amador,2020-11-28,1,0,51,0,0,4,1
San Francisco,2020-11-28,77,3,1762,24,1,65,80
Riverside,2020-11-28,573,63,3404,116,13,53,636
San Diego,2020-11-28,627,46,6796,169,3,260,673
Kings,2020-11-28,56,0,193,8,0,10,56
Alameda,2020-11-28,168,38,2506,48,5,88,206
Tuolumne,2020-11-28,10,0,84,2,0,3,10
Colusa,2020-11-28,9,0,48,0,0,0,9
Sutter,2020-11-28,0,0,14,0,0,0,0
Solano,2020-11-28,64,11,560,17,3,13,75
Tehama,2020-11-28,13,0,59,5,0,1,13
San Joaquin,2020-11-28,125,13,1037,25,5,28,138
Yuba,2020-11-28,32,0,265,9,0,1,32
Nevada,2020-11-28,15,0,114,4,0,2,15
El Dorado,2020-11-28,15,2,190,5,1,2,17
Del Norte,2020-11-28,0,0,52,0,0,0,0
Imperial,2020-11-28,72,0,265,13,0,4,72
San Benito,2020-11-28,5,0,25,2,0,1,5
Sacramento,2020-11-28,303,23,2549,61,4,81,326
Butte,2020-11-28,45,2,451,6,2,10,47
Monterey,2020-11-28,72,1,717,14,1,24,73
Mendocino,2020-11-28,12,0,177,4,0,3,12
Shasta,2020-11-28,55,0,561,9,0,3,55
Santa Clara,2020-11-28,263,18,3034,73,2,63,281
Glenn,2020-11-28,0,0,47,0,0,0,0
Santa Barbara,2020-11-28,39,1,688,7,0,56,40
San Luis Obispo,2020-11-28,6,0,460,1,0,24,6
Napa,2020-11-28,11,0,351,4,0,29,11
Fresno,2020-11-28,278,32,1707,53,4,17,310
San Mateo,2020-11-28,50,6,720,7,2,35,56
Mariposa,2020-11-28,0,0,19,0,0,0,0
Yolo,2020-11-28,20,0,96,7,0,7,20
Santa Cruz,2020-11-29,47,0,382,6,0,6,47
Mariposa,2020-11-29,0,0,19,0,0,0,0
San Mateo,2020-11-29,58,9,727,13,1,38,67
Kern,2020-11-29,161,5,1273,37,0,43,166
Inyo,2020-11-29,1,0,29,0,0,4,1
Tehama,2020-11-29,11,0,59,5,0,0,11
Sacramento,2020-11-29,316,29,2536,69,4,76,345
Lassen,2020-11-29,3,0,25,0,0,0,3
Yuba,2020-11-29,38,0,265,10,0,2,38
San Diego,2020-11-29,658,40,6798,168,4,258,698
Tulare,2020-11-29,96,3,679,12,0,23,99
San Bernardino,2020-11-29,781,58,4041,171,5,88,839
Merced,2020-11-29,28,0,271,11,0,4,28
Siskiyou,2020-11-29,10,0,56,1,0,9,10
Modoc,2020-11-29,0,0,41,0,0,0,0
Stanislaus,2020-11-29,189,11,1293,36,2,22,200
El Dorado,2020-11-29,16,0,190,5,0,5,16
Los Angeles,2020-11-29,2316,335,20078,558,39,603,2651
San Luis Obispo,2020-11-29,5,0,460,1,0,26,5
Monterey,2020-11-29,82,1,717,16,1,24,83
Calaveras,2020-11-29,3,0,33,3,0,3,3
Santa Clara,2020-11-29,289,14,3063,80,2,58,303
Sonoma,2020-11-29,34,1,520,6,0,5,35
Solano,2020-11-29,59,14,547,15,3,15,73
Marin,2020-11-29,10,3,360,3,0,18,13
Fresno,2020-11-29,287,25,1707,56,1,14,312
Glenn,2020-11-29,0,0,47,0,0,0,0
Imperial,2020-11-29,71,1,265,13,0,4,72
Tuolumne,2020-11-29,10,0,84,2,0,4,10
Trinity,2020-11-29,0,0,25,0,0,0,0
Humboldt,2020-11-29,2,2,269,0,1,2,4
Placer,2020-11-29,125,13,791,13,3,23,138
Contra Costa,2020-11-29,106,17,1541,26,1,42,123
Mono,2020-11-29,0,1,17,0,0,2,1
Madera,2020-11-29,24,7,329,7,0,14,31
Santa Barbara,2020-11-29,42,3,688,9,1,58,45
Riverside,2020-11-29,585,81,3417,129,15,47,666
San Joaquin,2020-11-29,134,11,1031,29,5,34,145
Colusa,2020-11-29,9,0,48,0,0,0,9
Shasta,2020-11-29,56,0,561,10,0,3,56
Mendocino,2020-11-29,11,0,177,4,0,5,11
Plumas,2020-11-29,0,0,35,0,0,0,0
Butte,2020-11-29,46,0,451,5,0,19,46
San Benito,2020-11-29,6,0,25,3,0,1,6
Alameda,2020-11-29,171,33,2500,52,7,98,204
Napa,2020-11-29,10,0,351,4,0,27,10
Nevada,2020-11-29,19,1,116,5,1,0,20
Amador,2020-11-29,1,0,51,0,0,4,1
Ventura,2020-11-29,92,13,1219,33,2,17,105
Kings,2020-11-29,58,0,193,8,0,10,58
Sutter,2020-11-29,0,0,14,0,0,0,0
Del Norte,2020-11-29,0,0,51,0,0,1,0
Yolo,2020-11-29,21,0,96,8,0,5,21
San Francisco,2020-11-29,83,1,1727,24,0,71,84
Lake,2020-11-29,2,0,77,0,0,3,2
Orange,2020-11-29,605,59,5921,146,9,162,664
Sutter,2020-11-30,0,0,14,0,0,0,0
Yolo,2020-11-30,18,0,97,7,0,6,18
Monterey,2020-11-30,81,0,717,19,0,22,81
Madera,2020-11-30,21,13,329,6,0,15,34
Orange,2020-11-30,648,57,5861,158,8,149,705
Humboldt,2020-11-30,5,2,270,1,1,1,7
Stanislaus,2020-11-30,200,22,1291,43,3,21,222
Solano,2020-11-30,66,13,550,18,3,12,79
San Joaquin,2020-11-30,138,8,1034,28,3,29,146
Merced,2020-11-30,31,0,271,11,0,4,31
Sonoma,2020-11-30,35,9,544,5,3,5,44
Mendocino,2020-11-30,12,0,177,4,0,1,12
Santa Barbara,2020-11-30,50,2,688,13,1,51,52
Mariposa,2020-11-30,1,0,19,0,0,0,1
Kern,2020-11-30,184,2,1283,41,0,39,186
Sacramento,2020-11-30,344,25,2530,71,9,78,369
San Francisco,2020-11-30,91,0,1771,28,0,73,91
Tuolumne,2020-11-30,13,0,84,3,0,2,13
Calaveras,2020-11-30,4,0,33,2,0,5,4
Marin,2020-11-30,11,4,343,4,1,16,15
Contra Costa,2020-11-30,102,25,1525,25,5,47,127
Imperial,2020-11-30,82,0,265,14,0,2,82
Lake,2020-11-30,2,0,78,0,0,3,2
Kings,2020-11-30,52,0,193,6,0,12,52
San Luis Obispo,2020-11-30,7,2,460,1,0,22,9
Del Norte,2020-11-30,0,0,51,0,0,1,0
San Mateo,2020-11-30,65,9,718,13,2,36,74
Napa,2020-11-30,10,0,351,6,0,22,10
Tehama,2020-11-30,11,0,59,4,0,0,11
San Diego,2020-11-30,696,35,6808,183,4,252,731
Riverside,2020-11-30,600,83,3470,127,8,53,683
Plumas,2020-11-30,0,0,35,0,0,0,0
San Benito,2020-11-30,6,0,25,3,0,1,6
Yuba,2020-11-30,40,0,265,9,0,2,40
Los Angeles,2020-11-30,2439,304,20151,576,36,602,2743
Santa Cruz,2020-11-30,41,0,382,8,0,7,41
Inyo,2020-11-30,1,0,29,1,0,3,1
Nevada,2020-11-30,19,1,140,3,1,3,20
Lassen,2020-11-30,5,0,25,0,0,0,5
Mono,2020-11-30,0,0,17,0,0,2,0
San Bernardino,2020-11-30,856,78,4093,177,8,68,934
Siskiyou,2020-11-30,12,0,56,2,0,10,12
Tulare,2020-11-30,99,10,683,14,1,20,109
Placer,2020-11-30,131,12,773,14,3,25,143
Glenn,2020-11-30,0,0,47,0,0,0,0
Amador,2020-11-30,2,1,51,0,0,3,3
Butte,2020-11-30,45,0,451,7,0,14,45
Trinity,2020-11-30,0,0,25,0,0,0,0
Santa Clara,2020-11-30,291,17,3049,83,2,50,308
Alameda,2020-11-30,188,35,2519,51,4,104,223
El Dorado,2020-11-30,15,0,190,3,0,6,15
Colusa,2020-11-30,9,1,48,0,0,0,10
Fresno,2020-11-30,305,31,1744,54,1,12,336
Ventura,2020-11-30,94,8,1233,34,3,23,102
Shasta,2020-11-30,62,0,561,10,0,3,62
Modoc,2020-11-30,0,0,41,0,0,0,0
San Benito,2020-12-01,8,0,25,3,0,0,8
Mono,2020-12-01,2,0,17,0,0,2,2
Los Angeles,2020-12-01,2572,310,20310,601,41,574,2882
Siskiyou,2020-12-01,12,0,56,3,0,9,12
Tehama,2020-12-01,11,0,59,4,0,1,11
Kern,2020-12-01,189,1,1305,41,0,35,190
Sutter,2020-12-01,0,0,14,0,0,0,0
Glenn,2020-12-01,0,0,47,0,0,0,0
Placer,2020-12-01,130,20,780,17,3,24,150
Stanislaus,2020-12-01,210,18,1293,39,3,25,228
Sacramento,2020-12-01,363,22,2595,77,5,64,385
Imperial,2020-12-01,73,0,265,16,0,0,73
Lassen,2020-12-01,5,0,25,0,0,0,5
Butte,2020-12-01,45,1,451,6,0,16,46
Marin,2020-12-01,15,2,344,4,0,12,17
Amador,2020-12-01,2,1,51,1,0,2,3
Inyo,2020-12-01,1,0,29,1,0,2,1
Sonoma,2020-12-01,38,5,585,5,2,4,43
Modoc,2020-12-01,1,0,41,0,0,0,1
Santa Cruz,2020-12-01,42,0,382,9,0,7,42
El Dorado,2020-12-01,14,1,190,1,1,80,15
Calaveras,2020-12-01,6,0,33,2,0,5,6
Merced,2020-12-01,29,0,271,12,0,1,29
Plumas,2020-12-01,0,0,35,0,0,0,0
Humboldt,2020-12-01,5,5,280,1,2,3,10
San Joaquin,2020-12-01,150,12,1036,39,1,28,162
San Bernardino,2020-12-01,883,82,4105,192,10,54,965
San Diego,2020-12-01,685,48,6825,197,7,210,733
Trinity,2020-12-01,0,0,25,0,0,0,0
Contra Costa,2020-12-01,112,21,1547,27,7,41,133
Ventura,2020-12-01,98,14,1234,40,3,24,112
Santa Barbara,2020-12-01,47,1,688,14,0,47,48
Del Norte,2020-12-01,0,0,51,0,0,2,0
Lake,2020-12-01,2,0,78,0,0,2,2
Tuolumne,2020-12-01,14,0,84,4,0,0,14
Madera,2020-12-01,25,13,329,7,0,15,38
Orange,2020-12-01,689,67,6047,171,8,123,756
Mendocino,2020-12-01,12,0,177,4,0,1,12
Monterey,2020-12-01,85,1,717,17,0,25,86
Napa,2020-12-01,11,0,351,7,0,22,11
Solano,2020-12-01,69,12,551,21,3,12,81
Kings,2020-12-01,56,0,193,6,0,10,56
Shasta,2020-12-01,53,0,561,9,0,2,53
San Luis Obispo,2020-12-01,9,1,460,1,0,20,10
Colusa,2020-12-01,10,0,48,0,0,0,10
Santa Clara,2020-12-01,293,19,3081,87,2,43,312
Yuba,2020-12-01,45,0,265,8,0,1,45
Mariposa,2020-12-01,2,0,19,0,0,0,2
San Mateo,2020-12-01,72,6,744,17,1,40,78
San Francisco,2020-12-01,88,3,1831,27,0,63,91
Alameda,2020-12-01,187,47,2552,57,3,75,234
Tulare,2020-12-01,92,11,683,11,1,21,103
Fresno,2020-12-01,291,27,1732,61,3,9,318
Riverside,2020-12-01,628,76,3485,126,8,44,704
Yolo,2020-12-01,20,0,97,9,0,6,20
Nevada,2020-12-01,16,1,128,4,1,4,17
Contra Costa,2020-12-02,116,15,1564,27,1,55,131
Monterey,2020-12-02,82,1,717,17,0,20,83
Solano,2020-12-02,67,11,559,21,2,12,78
Orange,2020-12-02,735,49,6072,179,6,114,784
Riverside,2020-12-02,649,72,3515,124,5,44,721
Los Angeles,2020-12-02,2668,336,20383,632,25,528,3004
Tuolumne,2020-12-02,11,0,84,2,0,1,11
Mariposa,2020-12-02,1,0,19,0,0,0,1
San Francisco,2020-12-02,93,5,1894,28,0,62,98
Inyo,2020-12-02,2,0,29,0,0,4,2
Glenn,2020-12-02,0,0,47,0,0,0,0
Lassen,2020-12-02,7,0,25,0,0,0,7
Humboldt,2020-12-02,5,6,281,2,1,2,11
Tehama,2020-12-02,11,0,59,3,0,2,11
Lake,2020-12-02,0,0,77,0,0,2,0
Amador,2020-12-02,4,0,51,2,0,3,4
Fresno,2020-12-02,338,29,1736,62,2,10,367
Alameda,2020-12-02,195,43,2563,58,5,85,238
Sutter,2020-12-02,0,0,14,0,0,0,0
Ventura,2020-12-02,98,13,1252,39,4,18,111
Yolo,2020-12-02,20,0,96,11,0,6,20
El Dorado,2020-12-02,13,0,190,1,0,8,13
Placer,2020-12-02,131,14,783,19,2,25,145
San Diego,2020-12-02,705,56,6842,204,4,219,761
Imperial,2020-12-02,82,1,265,18,0,2,83
Shasta,2020-12-02,53,0,561,8,0,4,53
Kern,2020-12-02,179,5,1299,42,0,31,184
Butte,2020-12-02,44,1,451,6,1,12,45
Trinity,2020-12-02,0,0,25,0,0,0,0
Sacramento,2020-12-02,359,29,2600,76,4,71,388
Mendocino,2020-12-02,11,0,177,4,0,1,11
Modoc,2020-12-02,1,0,41,0,0,0,1
San Luis Obispo,2020-12-02,8,1,460,1,0,26,9
Santa Cruz,2020-12-02,47,0,382,9,0,5,47
Colusa,2020-12-02,11,0,48,0,0,0,11
San Bernardino,2020-12-02,904,98,4039,192,12,57,1002
Santa Barbara,2020-12-02,57,3,688,16,0,46,60
Yuba,2020-12-02,37,0,265,10,0,1,37
Del Norte,2020-12-02,0,0,51,0,0,3,0
Tulare,2020-12-02,100,10,679,12,1,22,110
Calaveras,2020-12-02,5,0,33,3,0,5,5
Marin,2020-12-02,16,4,348,6,0,12,20
Nevada,2020-12-02,17,0,128,3,0,6,17
Sonoma,2020-12-02,38,4,609,5,0,4,42
Siskiyou,2020-12-02,15,0,56,3,0,8,15
San Mateo,2020-12-02,70,6,735,21,1,43,76
San Joaquin,2020-12-02,162,7,1042,41,1,27,169
Kings,2020-12-02,58,1,193,11,0,7,59
San Benito,2020-12-02,9,0,25,3,0,0,9
Madera,2020-12-02,28,10,329,8,0,10,38
Santa Clara,2020-12-02,304,23,3073,83,2,56,327
Mono,2020-12-02,2,0,17,0,0,2,2
Plumas,2020-12-02,0,0,35,0,0,0,0
Napa,2020-12-02,12,0,351,6,0,22,12
Merced,2020-12-02,32,0,271,7,0,4,32
Stanislaus,2020-12-02,219,18,1291,41,2,24,237
Tehama,2020-12-03,11,0,59,2,0,1,11
Calaveras,2020-12-03,5,0,33,2,0,5,5
Sacramento,2020-12-03,373,23,2578,71,4,79,396
Amador,2020-12-03,5,0,51,3,0,2,5
Mariposa,2020-12-03,1,0,19,0,0,0,1
Yolo,2020-12-03,18,0,96,11,0,3,18
Del Norte,2020-12-03,0,0,51,0,0,2,0
Tuolumne,2020-12-03,11,0,84,2,0,2,11
Alameda,2020-12-03,206,49,2586,58,3,91,255
Ventura,2020-12-03,104,15,1246,43,6,19,119
San Luis Obispo,2020-12-03,13,0,460,1,0,24,13
Inyo,2020-12-03,2,0,29,0,0,2,2
Nevada,2020-12-03,16,2,123,4,1,4,18
Humboldt,2020-12-03,7,0,282,2,0,4,7
Sonoma,2020-12-03,37,5,613,6,1,7,42
Santa Cruz,2020-12-03,43,0,382,8,0,6,43
Butte,2020-12-03,47,1,451,7,1,21,48
Los Angeles,2020-12-03,2769,328,20371,644,38,486,3097
Marin,2020-12-03,16,3,350,6,0,11,19
San Joaquin,2020-12-03,160,5,1040,46,1,24,165
Colusa,2020-12-03,10,0,48,0,0,0,10
Mono,2020-12-03,3,0,17,0,0,2,3
San Benito,2020-12-03,6,0,25,3,0,0,6
Imperial,2020-12-03,91,1,265,21,0,1,92
Plumas,2020-12-03,1,0,35,0,0,0,1
Lake,2020-12-03,2,0,77,0,0,2,2
Sutter,2020-12-03,0,0,14,0,0,0,0
Fresno,2020-12-03,340,38,1715,66,4,11,378
San Francisco,2020-12-03,93,5,1902,34,1,53,98
Glenn,2020-12-03,0,0,47,0,0,0,0
El Dorado,2020-12-03,15,1,190,4,0,7,16
Santa Barbara,2020-12-03,59,1,688,16,0,40,60
Stanislaus,2020-12-03,218,13,1291,49,2,18,231
San Mateo,2020-12-03,76,7,738,22,0,38,83
Yuba,2020-12-03,39,0,265,10,0,1,39
Mendocino,2020-12-03,10,0,177,3,0,3,10
Tulare,2020-12-03,107,10,682,11,2,18,117
Merced,2020-12-03,38,0,271,7,0,10,38
Contra Costa,2020-12-03,122,14,1573,36,3,35,136
Monterey,2020-12-03,90,1,717,23,0,14,91
Kern,2020-12-03,182,6,1310,39,0,39,188
Orange,2020-12-03,746,64,6088,195,6,133,810
Modoc,2020-12-03,1,2,41,0,0,0,3
Solano,2020-12-03,64,14,575,18,1,12,78
Lassen,2020-12-03,11,0,25,0,0,0,11
Santa Clara,2020-12-03,307,23,3090,79,2,51,330
San Diego,2020-12-03,743,54,6829,207,4,210,797
Placer,2020-12-03,144,19,787,22,0,23,163
Shasta,2020-12-03,51,0,561,11,0,8,51
Kings,2020-12-03,60,0,193,12,0,7,60
Napa,2020-12-03,12,1,351,4,1,24,13
Trinity,2020-12-03,0,0,25,0,0,0,0
Riverside,2020-12-03,658,81,3529,135,5,45,739
Siskiyou,2020-12-03,13,3,56,3,0,8,16
San Bernardino,2020-12-03,880,84,4025,199,9,64,964
Madera,2020-12-03,29,10,275,7,1,3,39
Tuolumne,2020-12-04,11,0,84,1,0,0,11
Colusa,2020-12-04,9,0,48,0,0,0,9
Imperial,2020-12-04,90,0,265,27,0,1,90
Mendocino,2020-12-04,10,0,100,3,0,8,10
Monterey,2020-12-04,90,2,717,24,1,15,92
Los Angeles,2020-12-04,2878,319,20148,666,34,479,3197
San Mateo,2020-12-04,78,11,738,19,1,38,89
Tehama,2020-12-04,9,0,59,1,0,0,9
Del Norte,2020-12-04,0,0,51,0,0,4,0
Yuba,2020-12-04,41,0,265,10,0,5,41
Solano,2020-12-04,69,14,583,19,1,12,83
Sonoma,2020-12-04,41,3,595,7,1,6,44
Orange,2020-12-04,842,45,6194,193,6,121,887
Santa Cruz,2020-12-04,46,1,386,10,0,4,47
Siskiyou,2020-12-04,12,0,56,3,0,6,12
Nevada,2020-12-04,15,1,116,4,0,5,16
Alameda,2020-12-04,213,38,2562,61,3,91,251
Kings,2020-12-04,63,0,121,10,0,0,63
Marin,2020-12-04,15,1,351,6,0,13,16
Merced,2020-12-04,29,0,271,8,0,5,29
Fresno,2020-12-04,354,36,1672,58,0,5,390
San Bernardino,2020-12-04,913,85,4037,209,8,63,998
Humboldt,2020-12-04,7,2,281,1,2,5,9
Lake,2020-12-04,2,0,77,1,0,1,2
Amador,2020-12-04,6,0,51,3,0,1,6
Yolo,2020-12-04,18,0,96,10,0,5,18
Contra Costa,2020-12-04,126,17,1570,35,3,39,143
Santa Barbara,2020-12-04,54,0,688,15,0,60,54
Madera,2020-12-04,28,10,275,7,0,9,38
San Luis Obispo,2020-12-04,15,0,460,1,0,22,15
El Dorado,2020-12-04,19,0,190,5,0,6,19
Sutter,2020-12-04,0,0,14,0,0,0,0
Modoc,2020-12-04,0,0,41,0,0,0,0
Tulare,2020-12-04,104,2,641,11,1,10,106
Kern,2020-12-04,198,5,1121,39,1,33,203
Sacramento,2020-12-04,378,21,2560,71,2,73,399
San Francisco,2020-12-04,96,3,1909,33,2,59,99
Shasta,2020-12-04,49,0,561,11,0,8,49
Inyo,2020-12-04,2,0,29,1,0,3,2
Santa Clara,2020-12-04,332,23,3090,84,2,47,355
Glenn,2020-12-04,1,0,47,0,0,0,1
San Diego,2020-12-04,772,35,6824,200,2,210,807
Butte,2020-12-04,51,1,451,8,0,15,52
Napa,2020-12-04,8,0,200,3,1,13,8
Mono,2020-12-04,1,0,17,0,0,2,1
Calaveras,2020-12-04,4,0,33,2,0,5,4
Riverside,2020-12-04,687,101,3519,145,6,55,788
Lassen,2020-12-04,5,0,25,0,0,0,5
Mariposa,2020-12-04,1,0,19,0,0,0,1
Ventura,2020-12-04,111,15,1175,43,1,16,126
Placer,2020-12-04,148,15,784,20,0,25,163
Plumas,2020-12-04,0,0,35,0,0,0,0
Stanislaus,2020-12-04,225,12,1285,45,2,16,237
San Joaquin,2020-12-04,172,15,944,47,3,9,187
Trinity,2020-12-04,0,0,25,0,0,0,0
San Benito,2020-12-04,5,0,25,2,0,0,5
Marin,2020-12-05,21,0,352,7,0,16,21
San Mateo,2020-12-05,82,8,739,20,0,38,90
Solano,2020-12-05,72,13,585,22,0,12,85
Butte,2020-12-05,57,0,451,6,0,9,57
Napa,2020-12-05,8,0,200,5,0,10,8
Tulare,2020-12-05,115,4,638,12,1,10,119
Placer,2020-12-05,147,23,755,25,3,21,170
San Joaquin,2020-12-05,187,12,1017,54,2,6,199
Ventura,2020-12-05,117,10,1198,46,1,23,127
San Luis Obispo,2020-12-05,11,0,460,1,0,19,11
Plumas,2020-12-05,0,0,35,0,0,0,0
Humboldt,2020-12-05,7,2,278,1,0,5,9
Yolo,2020-12-05,19,0,96,11,0,7,19
Amador,2020-12-05,7,0,51,2,0,1,7
San Bernardino,2020-12-05,958,78,4002,225,5,72,1036
Mariposa,2020-12-05,1,0,19,0,0,0,1
Santa Cruz,2020-12-05,44,1,382,8,0,4,45
Inyo,2020-12-05,2,0,29,1,0,3,2
Trinity,2020-12-05,0,0,25,0,0,0,0
Siskiyou,2020-12-05,12,0,56,3,0,7,12
Lake,2020-12-05,2,1,77,1,0,1,3
Nevada,2020-12-05,16,1,109,5,0,1,17
Sacramento,2020-12-05,371,30,2540,67,6,65,401
Modoc,2020-12-05,1,0,41,0,0,0,1
Del Norte,2020-12-05,0,0,51,0,0,4,0
Colusa,2020-12-05,9,0,48,0,0,0,9
Yuba,2020-12-05,43,0,261,9,0,3,43
San Francisco,2020-12-05,111,6,1882,34,0,57,117
Santa Barbara,2020-12-05,50,1,688,12,0,51,51
Santa Clara,2020-12-05,336,21,3062,84,1,56,357
Calaveras,2020-12-05,2,0,33,2,0,5,2
El Dorado,2020-12-05,22,0,190,5,0,6,22
Glenn,2020-12-05,2,4,47,0,0,0,6
San Diego,2020-12-05,790,45,6980,205,11,198,835
Orange,2020-12-05,848,54,5957,209,5,120,902
Los Angeles,2020-12-05,2988,340,20033,705,56,425,3328
Riverside,2020-12-05,671,116,3506,143,7,50,787
Sutter,2020-12-05,0,0,14,0,0,0,0
Merced,2020-12-05,33,0,271,9,0,4,33
Tehama,2020-12-05,10,0,59,2,0,0,10
Monterey,2020-12-05,87,3,717,24,1,20,90
Contra Costa,2020-12-05,133,17,1584,35,2,45,150
Sonoma,2020-12-05,41,8,563,8,1,8,49
Kern,2020-12-05,199,3,1084,46,0,30,202
Madera,2020-12-05,31,11,275,6,1,8,42
Alameda,2020-12-05,227,32,2556,58,3,98,259
Mono,2020-12-05,1,0,17,0,0,2,1
Mendocino,2020-12-05,8,1,76,3,0,8,9
Lassen,2020-12-05,5,0,25,0,0,0,5
San Benito,2020-12-05,5,0,25,2,0,0,5
Stanislaus,2020-12-05,217,15,1294,48,3,17,232
Tuolumne,2020-12-05,7,0,84,0,0,2,7
Fresno,2020-12-05,396,24,1636,61,3,6,420
Shasta,2020-12-05,49,0,561,11,0,9,49
Kings,2020-12-05,66,0,114,9,0,3,66
Imperial,2020-12-05,96,0,265,29,0,2,96
Contra Costa,2020-12-06,138,20,1566,35,0,66,158
San Diego,2020-12-06,817,54,6935,216,5,223,871
Colusa,2020-12-06,9,0,48,0,0,0,9
Monterey,2020-12-06,97,2,717,19,1,23,99
Riverside,2020-12-06,700,117,3464,146,7,52,817
Siskiyou,2020-12-06,13,0,56,2,0,8,13
San Francisco,2020-12-06,110,5,1834,32,0,71,115
Glenn,2020-12-06,2,4,47,0,0,0,6
Trinity,2020-12-06,0,0,25,0,0,0,0
Nevada,2020-12-06,17,1,109,4,0,5,18
Amador,2020-12-06,7,0,51,3,0,2,7
Sacramento,2020-12-06,374,24,2539,76,5,76,398
Sonoma,2020-12-06,48,9,531,11,4,12,57
Lake,2020-12-06,2,1,77,2,0,1,3
Merced,2020-12-06,35,0,271,8,0,7,35
Imperial,2020-12-06,98,0,265,28,0,0,98
Kings,2020-12-06,69,0,121,9,0,3,69
San Luis Obispo,2020-12-06,13,1,460,5,0,20,14
Shasta,2020-12-06,48,0,561,12,0,10,48
Fresno,2020-12-06,408,28,1648,66,1,7,436
Del Norte,2020-12-06,0,0,51,0,0,5,0
Yolo,2020-12-06,20,0,96,12,0,4,20
Los Angeles,2020-12-06,3113,377,20053,754,57,480,3490
Placer,2020-12-06,154,17,758,27,2,21,171
San Mateo,2020-12-06,82,10,735,22,0,33,92
Tulare,2020-12-06,118,8,634,16,1,8,126
Humboldt,2020-12-06,7,0,271,1,0,3,7
Napa,2020-12-06,11,1,200,4,0,11,12
San Benito,2020-12-06,4,0,25,2,0,0,4
Inyo,2020-12-06,3,0,29,0,0,4,3
Lassen,2020-12-06,5,0,25,0,0,0,5
Santa Cruz,2020-12-06,49,0,382,7,0,6,49
El Dorado,2020-12-06,18,2,190,8,2,6,20
Solano,2020-12-06,69,10,556,21,0,11,79
Orange,2020-12-06,877,44,5882,218,8,117,921
San Joaquin,2020-12-06,199,27,1018,50,4,4,226
Ventura,2020-12-06,122,11,1184,46,2,27,133
Stanislaus,2020-12-06,209,12,1296,47,1,18,221
Butte,2020-12-06,51,0,451,6,0,15,51
Tehama,2020-12-06,10,0,59,2,0,1,10
Mariposa,2020-12-06,2,0,19,0,0,0,2
Kern,2020-12-06,207,2,1092,47,0,31,209
Mendocino,2020-12-06,7,0,71,3,0,7,7
Tuolumne,2020-12-06,9,0,184,1,0,2,9
Alameda,2020-12-06,226,40,2544,60,2,98,266
Yuba,2020-12-06,46,0,261,8,0,9,46
Modoc,2020-12-06,1,0,41,0,0,0,1
Santa Barbara,2020-12-06,59,2,688,11,0,57,61
Marin,2020-12-06,20,0,343,6,0,15,20
Santa Clara,2020-12-06,354,14,3062,87,1,53,368
Calaveras,2020-12-06,2,0,33,2,0,4,2
Plumas,2020-12-06,0,0,35,0,0,0,0
San Bernardino,2020-12-06,984,76,3987,212,6,71,1060
Sutter,2020-12-06,0,0,14,0,0,0,0
Madera,2020-12-06,27,9,275,6,1,5,36
Mono,2020-12-06,0,0,17,0,0,2,0
Merced,2020-12-07,37,0,271,6,0,8,37
San Luis Obispo,2020-12-07,12,3,460,5,0,22,15
Fresno,2020-12-07,420,35,1658,77,5,9,455
Ventura,2020-12-07,128,8,1176,46,3,33,136
Solano,2020-12-07,67,8,550,18,0,13,75
Nevada,2020-12-07,18,0,123,4,0,2,18
Mono,2020-12-07,0,0,17,0,0,2,0
Inyo,2020-12-07,3,0,29,0,0,4,3
San Joaquin,2020-12-07,199,9,1019,49,3,9,208
Tehama,2020-12-07,12,0,59,2,0,2,12
Santa Cruz,2020-12-07,49,0,372,6,0,6,49
Tuolumne,2020-12-07,7,0,84,0,0,3,7
Los Angeles,2020-12-07,3299,354,19993,774,44,497,3653
Lake,2020-12-07,2,0,77,2,0,1,2
Modoc,2020-12-07,0,0,12,0,0,0,0
Amador,2020-12-07,7,0,51,3,0,2,7
Placer,2020-12-07,149,13,764,24,2,23,162
Glenn,2020-12-07,5,0,47,0,0,0,5
Mariposa,2020-12-07,2,0,19,0,0,0,2
Kings,2020-12-07,75,2,111,8,1,0,77
Contra Costa,2020-12-07,140,16,1548,34,2,45,156
San Mateo,2020-12-07,83,12,742,20,1,34,95
Orange,2020-12-07,946,78,5891,238,9,113,1024
Del Norte,2020-12-07,1,0,51,1,0,2,1
Yuba,2020-12-07,42,0,261,10,0,7,42
Santa Clara,2020-12-07,376,22,3053,90,6,63,398
Madera,2020-12-07,24,12,275,8,0,1,36
Alameda,2020-12-07,232,36,2527,57,4,97,268
Butte,2020-12-07,54,1,451,5,0,13,55
Lassen,2020-12-07,6,0,25,0,0,0,6
Siskiyou,2020-12-07,13,0,56,3,0,7,13
Plumas,2020-12-07,0,0,35,0,0,0,0
Sonoma,2020-12-07,47,3,564,13,1,11,50
Sutter,2020-12-07,0,0,14,0,0,0,0
San Benito,2020-12-07,7,0,25,2,0,0,7
Calaveras,2020-12-07,1,0,33,1,0,4,1
Tulare,2020-12-07,126,9,638,16,1,15,135
Yolo,2020-12-07,23,0,96,11,0,2,23
San Bernardino,2020-12-07,996,104,4021,216,9,63,1100
San Francisco,2020-12-07,117,6,1876,31,0,65,123
Colusa,2020-12-07,8,1,48,0,0,0,9
Marin,2020-12-07,17,3,347,7,0,13,20
Santa Barbara,2020-12-07,64,0,688,12,0,57,64
Shasta,2020-12-07,46,0,561,13,0,11,46
Riverside,2020-12-07,733,115,3494,144,7,53,848
Sacramento,2020-12-07,385,27,2544,81,4,78,412
Stanislaus,2020-12-07,231,13,1292,49,2,16,244
El Dorado,2020-12-07,20,1,190,9,1,5,21
Humboldt,2020-12-07,8,1,276,0,0,3,9
Imperial,2020-12-07,121,1,265,28,0,0,122
Kern,2020-12-07,216,8,1121,49,0,20,224
San Diego,2020-12-07,867,41,6928,220,4,211,908
Monterey,2020-12-07,105,1,717,20,0,15,106
Mendocino,2020-12-07,9,0,73,2,0,7,9
Trinity,2020-12-07,0,0,25,0,0,0,0
Napa,2020-12-07,12,1,200,3,0,12,13
San Diego,2020-12-08,874,59,6836,229,6,195,933
Kings,2020-12-08,80,2,127,8,1,0,82
Santa Barbara,2020-12-08,64,3,688,13,0,56,67
Stanislaus,2020-12-08,247,13,1290,52,4,14,260
Imperial,2020-12-08,121,1,265,28,0,3,122
Contra Costa,2020-12-08,143,16,1562,39,3,34,159
Los Angeles,2020-12-08,3433,337,20119,793,54,462,3770
Lassen,2020-12-08,5,0,25,0,0,0,5
Fresno,2020-12-08,454,38,1663,74,3,7,492
Nevada,2020-12-08,14,0,126,5,0,4,14
Madera,2020-12-08,27,10,275,8,0,1,37
Yuba,2020-12-08,45,0,261,11,0,3,45
Santa Clara,2020-12-08,392,21,3074,92,4,38,413
Mendocino,2020-12-08,7,0,78,2,0,4,7
Riverside,2020-12-08,768,127,3535,172,9,49,895
Alameda,2020-12-08,242,38,2541,63,5,87,280
Humboldt,2020-12-08,6,1,269,1,0,6,7
Shasta,2020-12-08,44,2,561,12,0,13,46
San Bernardino,2020-12-08,1053,87,4010,217,6,82,1140
Sutter,2020-12-08,0,0,14,0,0,0,0
San Benito,2020-12-08,7,0,25,2,0,0,7
Monterey,2020-12-08,112,1,717,19,0,16,113
Modoc,2020-12-08,0,0,12,0,0,0,0
Lake,2020-12-08,4,0,77,2,0,1,4
Solano,2020-12-08,74,14,591,18,0,17,88
Napa,2020-12-08,15,1,200,2,0,22,16
Placer,2020-12-08,158,17,768,23,2,20,175
Sonoma,2020-12-08,51,9,580,9,2,10,60
Plumas,2020-12-08,1,0,35,0,0,0,1
Calaveras,2020-12-08,1,0,33,1,0,5,1
Santa Cruz,2020-12-08,48,0,372,10,0,4,48
Mariposa,2020-12-08,3,0,19,0,0,0,3
Siskiyou,2020-12-08,13,0,56,3,0,8,13
Glenn,2020-12-08,5,0,47,0,0,0,5
Mono,2020-12-08,0,0,17,0,0,2,0
Del Norte,2020-12-08,3,0,51,1,0,2,3
Yolo,2020-12-08,26,0,96,11,0,2,26
Tuolumne,2020-12-08,6,0,84,0,0,2,6
San Luis Obispo,2020-12-08,15,0,460,6,0,20,15
San Mateo,2020-12-08,87,10,754,19,1,35,97
Marin,2020-12-08,20,4,336,7,0,13,24
Tehama,2020-12-08,17,0,59,1,0,2,17
Merced,2020-12-08,37,0,271,6,0,9,37
Trinity,2020-12-08,0,0,25,0,0,0,0
Inyo,2020-12-08,3,0,29,1,0,3,3
Sacramento,2020-12-08,398,24,2584,85,1,67,422
Tulare,2020-12-08,128,13,638,14,2,15,141
San Joaquin,2020-12-08,218,9,1019,52,3,5,227
Kern,2020-12-08,225,4,1134,54,0,20,229
Orange,2020-12-08,974,80,6023,239,14,111,1054
Butte,2020-12-08,63,3,451,9,0,7,66
El Dorado,2020-12-08,24,0,190,13,0,4,24
Colusa,2020-12-08,4,0,48,0,0,0,4
San Francisco,2020-12-08,115,5,1877,31,0,53,120
Ventura,2020-12-08,131,4,1206,46,1,31,135
Amador,2020-12-08,7,0,51,3,0,2,7
Colusa,2020-12-09,2,1,48,0,0,0,3
Calaveras,2020-12-09,2,0,33,1,0,5,2
Ventura,2020-12-09,145,7,1218,48,1,31,152
Yolo,2020-12-09,24,0,96,13,0,2,24
Del Norte,2020-12-09,3,0,51,1,0,1,3
Santa Barbara,2020-12-09,72,3,688,15,0,43,75
Humboldt,2020-12-09,3,1,278,1,0,5,4
San Mateo,2020-12-09,96,14,764,24,1,31,110
San Joaquin,2020-12-09,225,13,1016,59,2,3,238
Tuolumne,2020-12-09,7,0,84,0,0,2,7
Contra Costa,2020-12-09,164,5,1563,40,0,33,169
Lake,2020-12-09,4,0,77,2,0,1,4
Solano,2020-12-09,82,16,583,21,2,13,98
Imperial,2020-12-09,127,0,265,32,0,2,127
Mono,2020-12-09,1,0,17,0,0,2,1
Plumas,2020-12-09,1,0,35,0,0,0,1
Merced,2020-12-09,41,0,271,7,0,8,41
Madera,2020-12-09,31,12,275,9,0,7,43
Sutter,2020-12-09,0,0,14,0,0,0,0
San Benito,2020-12-09,6,0,25,1,0,0,6
Inyo,2020-12-09,3,0,29,3,0,1,3
Fresno,2020-12-09,460,31,1583,95,2,8,491
Mendocino,2020-12-09,9,0,79,2,0,7,9
Tulare,2020-12-09,138,12,637,15,1,7,150
San Bernardino,2020-12-09,1094,92,4020,226,5,50,1186
Mariposa,2020-12-09,2,0,19,0,0,0,2
Marin,2020-12-09,29,4,339,7,0,8,33
Orange,2020-12-09,1025,68,6041,257,10,108,1093
San Diego,2020-12-09,905,50,6862,240,5,199,955
Modoc,2020-12-09,0,0,12,0,0,0,0
Alameda,2020-12-09,254,47,2550,69,8,75,301
Monterey,2020-12-09,114,1,908,18,0,18,115
Santa Cruz,2020-12-09,47,0,372,10,0,1,47
Nevada,2020-12-09,13,0,129,5,0,2,13
Lassen,2020-12-09,2,0,25,0,0,0,2
Siskiyou,2020-12-09,11,0,56,2,0,10,11
Los Angeles,2020-12-09,3624,370,20120,819,29,468,3994
Amador,2020-12-09,9,0,51,3,0,2,9
Riverside,2020-12-09,775,132,3239,171,10,72,907
Placer,2020-12-09,166,17,764,20,1,18,183
Butte,2020-12-09,62,3,451,8,0,6,65
Kings,2020-12-09,73,1,123,7,1,1,74
Sacramento,2020-12-09,398,24,2481,79,5,55,422
El Dorado,2020-12-09,25,0,190,11,0,4,25
Glenn,2020-12-09,5,0,47,0,0,0,5
Yuba,2020-12-09,49,0,261,11,0,4,49
Kern,2020-12-09,229,9,1153,52,0,19,238
Stanislaus,2020-12-09,258,12,1290,53,3,17,270
Sonoma,2020-12-09,60,5,605,10,1,10,65
Trinity,2020-12-09,0,0,25,0,0,0,0
Santa Clara,2020-12-09,411,22,3119,98,2,34,433
Tehama,2020-12-09,13,0,59,1,0,3,13
San Francisco,2020-12-09,121,6,1928,33,0,45,127
Shasta,2020-12-09,46,0,561,13,0,13,46
San Luis Obispo,2020-12-09,17,1,460,6,0,22,18
Napa,2020-12-09,14,1,200,3,0,11,15
Orange,2020-12-10,1122,50,6011,265,5,97,1172
San Benito,2020-12-10,10,0,25,2,0,0,10
Merced,2020-12-10,39,0,271,5,0,6,39
Kings,2020-12-10,77,0,127,7,0,5,77
Sacramento,2020-12-10,422,15,2620,82,5,63,437
El Dorado,2020-12-10,25,0,190,14,0,4,25
Stanislaus,2020-12-10,268,8,1288,47,2,21,276
San Francisco,2020-12-10,118,1,1917,33,0,35,119
Yuba,2020-12-10,49,0,261,11,0,5,49
San Mateo,2020-12-10,98,14,761,22,2,29,112
Trinity,2020-12-10,0,0,25,0,0,0,0
Shasta,2020-12-10,49,0,561,10,0,13,49
San Bernardino,2020-12-10,1132,109,4029,234,7,71,1241
Marin,2020-12-10,25,5,335,8,0,9,30
Inyo,2020-12-10,3,1,29,3,0,0,4
Glenn,2020-12-10,5,0,47,0,0,0,5
Colusa,2020-12-10,3,1,48,0,0,5,4
Alameda,2020-12-10,278,34,2550,81,5,70,312
Sutter,2020-12-10,0,0,14,0,0,0,0
Calaveras,2020-12-10,3,0,33,3,0,2,3
Yolo,2020-12-10,24,0,96,12,0,3,24
Placer,2020-12-10,176,18,757,21,0,21,194
Siskiyou,2020-12-10,11,0,56,2,0,10,11
Tuolumne,2020-12-10,8,0,84,0,0,1,8
Lake,2020-12-10,4,0,77,2,0,1,4
Santa Clara,2020-12-10,419,19,3127,97,4,35,438
Imperial,2020-12-10,127,0,265,33,0,1,127
Napa,2020-12-10,14,1,255,7,0,4,15
Riverside,2020-12-10,809,141,3517,170,9,53,950
Humboldt,2020-12-10,4,1,260,3,0,3,5
Los Angeles,2020-12-10,3850,323,20075,856,38,440,4173
Mendocino,2020-12-10,7,0,79,2,0,7,7
Ventura,2020-12-10,146,12,1217,52,2,32,158
Plumas,2020-12-10,2,0,35,0,0,0,2
Tulare,2020-12-10,136,5,636,14,0,10,141
San Diego,2020-12-10,902,61,6963,245,11,194,963
Nevada,2020-12-10,18,2,117,5,0,2,20
Madera,2020-12-10,31,5,275,9,0,5,36
Contra Costa,2020-12-10,156,8,1572,32,1,38,164
Modoc,2020-12-10,0,0,12,0,0,0,0
Sonoma,2020-12-10,68,9,599,9,2,9,77
Mono,2020-12-10,1,0,17,0,0,1,1
Santa Barbara,2020-12-10,73,3,688,17,0,37,76
Butte,2020-12-10,61,3,451,6,0,8,64
Mariposa,2020-12-10,2,0,19,0,0,0,2
Del Norte,2020-12-10,2,0,51,1,0,1,2
Amador,2020-12-10,9,0,51,3,0,0,9
Kern,2020-12-10,236,11,1170,52,0,22,247
Monterey,2020-12-10,119,3,717,18,0,23,122
Lassen,2020-12-10,2,0,25,0,0,0,2
Santa Cruz,2020-12-10,45,0,372,9,0,2,45
Solano,2020-12-10,88,14,592,22,1,15,102
Fresno,2020-12-10,472,41,1570,79,8,11,513
San Joaquin,2020-12-10,233,8,1020,59,2,3,241
Tehama,2020-12-10,13,0,59,1,0,2,13
San Luis Obispo,2020-12-10,19,1,460,4,0,21,20
Madera,2020-12-11,28,4,275,10,0,6,32
Sacramento,2020-12-11,433,20,2623,85,5,57,453
Riverside,2020-12-11,855,149,3498,171,10,46,1004
Fresno,2020-12-11,462,29,1557,89,4,14,491
Merced,2020-12-11,45,0,271,8,0,4,45
Yolo,2020-12-11,24,0,96,12,0,14,24
Butte,2020-12-11,66,3,451,9,0,8,69
San Luis Obispo,2020-12-11,19,0,460,5,0,19,19
Mendocino,2020-12-11,7,0,86,2,0,7,7
Tulare,2020-12-11,174,9,636,15,0,8,183
Amador,2020-12-11,10,0,51,3,0,0,10
San Diego,2020-12-11,928,73,6884,261,13,182,1001
Placer,2020-12-11,176,18,734,17,2,3,194
Shasta,2020-12-11,60,0,561,8,0,12,60
San Joaquin,2020-12-11,247,9,1020,65,0,4,256
San Benito,2020-12-11,8,0,25,2,0,0,8
Tuolumne,2020-12-11,8,0,84,1,0,2,8
Orange,2020-12-11,1150,76,6029,273,10,104,1226
Stanislaus,2020-12-11,287,8,1287,58,1,13,295
Mono,2020-12-11,1,0,17,0,0,2,1
Monterey,2020-12-11,124,3,717,21,0,20,127
Imperial,2020-12-11,124,0,265,30,0,1,124
Colusa,2020-12-11,3,1,48,0,0,5,4
Trinity,2020-12-11,0,0,25,0,0,0,0
San Mateo,2020-12-11,103,9,756,25,1,32,112
Solano,2020-12-11,91,12,585,27,0,9,103
Lassen,2020-12-11,4,0,25,0,0,0,4
Marin,2020-12-11,26,4,343,8,0,8,30
Inyo,2020-12-11,4,1,29,1,0,3,5
Plumas,2020-12-11,1,0,35,0,0,0,1
Tehama,2020-12-11,11,0,59,1,0,2,11
El Dorado,2020-12-11,26,1,190,11,0,3,27
Alameda,2020-12-11,281,36,2553,77,5,63,317
Santa Clara,2020-12-11,431,19,3123,97,5,42,450
Santa Cruz,2020-12-11,48,0,372,9,0,0,48
Sutter,2020-12-11,0,0,14,0,0,0,0
Nevada,2020-12-11,17,2,125,4,0,2,19
Glenn,2020-12-11,5,0,47,0,0,0,5
Humboldt,2020-12-11,4,0,260,2,0,5,4
Santa Barbara,2020-12-11,75,0,688,21,0,38,75
Contra Costa,2020-12-11,155,11,1568,35,0,40,166
Napa,2020-12-11,18,1,259,11,0,9,19
Ventura,2020-12-11,152,11,1213,54,2,36,163
Kern,2020-12-11,248,5,1163,58,0,15,253
Siskiyou,2020-12-11,9,0,56,2,0,10,9
Kings,2020-12-11,73,0,129,7,0,0,73
San Francisco,2020-12-11,127,8,1926,33,0,45,135
San Bernardino,2020-12-11,1154,86,4041,247,7,59,1240
Lake,2020-12-11,5,0,77,2,0,1,5
Los Angeles,2020-12-11,4009,353,20255,845,47,444,4362
Mariposa,2020-12-11,2,0,19,0,0,0,2
Sonoma,2020-12-11,70,5,576,10,2,17,75
Modoc,2020-12-11,0,0,12,0,0,0,0
Yuba,2020-12-11,50,0,261,15,0,1,50
Del Norte,2020-12-11,2,0,51,1,0,1,2
Calaveras,2020-12-11,4,0,33,4,0,3,4
Mendocino,2020-12-12,7,0,86,2,0,7,7
Kings,2020-12-12,77,0,117,5,0,2,77
Alameda,2020-12-12,286,34,2549,79,7,67,320
Marin,2020-12-12,25,5,343,11,1,7,30
Contra Costa,2020-12-12,173,13,1565,41,1,35,186
Mariposa,2020-12-12,2,0,19,0,0,0,2
Inyo,2020-12-12,5,1,29,2,0,2,6
Stanislaus,2020-12-12,299,8,1292,56,3,21,307
Glenn,2020-12-12,5,0,47,0,0,0,5
Nevada,2020-12-12,18,2,121,4,0,2,20
Sutter,2020-12-12,0,0,14,0,0,0,0
Mono,2020-12-12,1,0,17,0,0,2,1
Orange,2020-12-12,1236,71,6047,284,5,98,1307
Los Angeles,2020-12-12,4203,365,20166,883,53,392,4568
Tehama,2020-12-12,12,0,59,2,0,3,12
Ventura,2020-12-12,173,11,1203,60,3,31,184
San Diego,2020-12-12,976,61,6869,265,9,193,1037
Del Norte,2020-12-12,2,0,51,1,0,3,2
Imperial,2020-12-12,135,0,265,32,0,2,135
Lassen,2020-12-12,4,0,25,0,0,0,4
Santa Barbara,2020-12-12,78,1,688,20,0,45,79
Butte,2020-12-12,65,1,451,9,0,11,66
Madera,2020-12-12,32,6,275,7,0,12,38
Calaveras,2020-12-12,5,0,33,4,0,3,5
Solano,2020-12-12,94,10,589,25,2,9,104
Siskiyou,2020-12-12,8,0,56,2,0,10,8
Colusa,2020-12-12,2,0,48,0,0,5,2
San Mateo,2020-12-12,102,9,741,24,0,37,111
San Joaquin,2020-12-12,262,8,940,62,0,5,270
San Francisco,2020-12-12,130,4,1916,35,2,44,134
Modoc,2020-12-12,1,0,12,0,0,0,1
Santa Cruz,2020-12-12,52,0,372,10,0,3,52
Tulare,2020-12-12,176,6,636,15,0,7,182
Monterey,2020-12-12,120,6,717,23,0,18,126
El Dorado,2020-12-12,25,1,190,10,0,7,26
San Bernardino,2020-12-12,1234,88,4033,249,9,62,1322
Humboldt,2020-12-12,4,1,264,2,1,8,5
San Benito,2020-12-12,9,0,25,2,0,0,9
Napa,2020-12-12,18,0,254,6,0,2,18
San Luis Obispo,2020-12-12,25,3,460,7,0,23,28
Kern,2020-12-12,273,9,1122,62,0,18,282
Riverside,2020-12-12,901,95,3480,169,10,39,996
Yolo,2020-12-12,8,0,56,3,0,2,8
Santa Clara,2020-12-12,451,14,3085,104,2,45,465
Tuolumne,2020-12-12,7,0,84,1,0,3,7
Plumas,2020-12-12,1,0,35,0,0,0,1
Shasta,2020-12-12,61,2,561,14,1,8,63
Sacramento,2020-12-12,456,19,2600,87,3,70,475
Trinity,2020-12-12,0,0,25,0,0,0,0
Sonoma,2020-12-12,65,6,584,10,1,20,71
Amador,2020-12-12,11,0,51,2,0,3,11
Fresno,2020-12-12,450,39,1557,89,3,12,489
Lake,2020-12-12,4,0,77,2,0,1,4
Yuba,2020-12-12,62,1,261,15,0,3,63
Merced,2020-12-12,43,0,271,8,0,7,43
Placer,2020-12-12,173,13,746,15,1,3,186
Marin,2020-12-13,26,5,339,11,0,5,31
Sonoma,2020-12-13,70,10,572,11,3,21,80
Tehama,2020-12-13,11,0,59,2,0,1,11
Mendocino,2020-12-13,14,0,88,2,0,6,14
San Joaquin,2020-12-13,277,8,929,66,0,6,285
El Dorado,2020-12-13,27,2,190,8,0,8,29
Lassen,2020-12-13,6,0,25,0,0,0,6
Modoc,2020-12-13,0,0,12,0,0,0,0
Alameda,2020-12-13,302,47,2540,88,6,74,349
San Luis Obispo,2020-12-13,32,1,460,8,0,23,33
Siskiyou,2020-12-13,8,0,56,2,0,10,8
Yuba,2020-12-13,62,2,261,15,0,2,64
Ventura,2020-12-13,181,11,1191,59,4,27,192
San Diego,2020-12-13,994,40,6868,275,1,179,1034
Kings,2020-12-13,75,0,119,6,0,3,75
Placer,2020-12-13,182,10,748,18,3,7,192
Glenn,2020-12-13,5,0,47,0,0,0,5
Santa Barbara,2020-12-13,89,1,688,21,0,48,90
Shasta,2020-12-13,65,1,561,14,1,7,66
San Francisco,2020-12-13,139,4,1867,36,1,54,143
Sutter,2020-12-13,0,0,14,0,0,0,0
Mariposa,2020-12-13,0,0,19,0,0,0,0
Riverside,2020-12-13,930,110,3499,184,7,31,1040
Calaveras,2020-12-13,7,0,33,4,0,3,7
Los Angeles,2020-12-13,4403,372,20090,935,52,404,4775
Solano,2020-12-13,103,10,581,29,1,8,113
Amador,2020-12-13,13,0,51,4,0,0,13
Monterey,2020-12-13,127,6,717,23,0,19,133
Napa,2020-12-13,20,0,265,7,0,6,20
Merced,2020-12-13,41,0,271,8,0,6,41
Colusa,2020-12-13,3,0,48,0,0,5,3
San Bernardino,2020-12-13,1277,87,4037,264,5,55,1364
Humboldt,2020-12-13,4,3,270,2,0,11,7
Kern,2020-12-13,295,6,1125,66,0,10,301
Nevada,2020-12-13,18,2,133,3,0,4,20
Stanislaus,2020-12-13,317,13,1294,57,3,12,330
Inyo,2020-12-13,6,1,29,2,0,2,7
Contra Costa,2020-12-13,177,17,1546,44,2,50,194
Tulare,2020-12-13,178,4,636,13,0,9,182
Del Norte,2020-12-13,3,0,51,1,0,2,3
Orange,2020-12-13,1287,71,5968,288,5,86,1358
Santa Cruz,2020-12-13,53,0,372,11,0,4,53
San Benito,2020-12-13,11,0,25,2,0,0,11
Lake,2020-12-13,4,0,77,2,0,3,4
Madera,2020-12-13,34,0,275,8,0,11,34
San Mateo,2020-12-13,105,10,746,26,1,38,115
Trinity,2020-12-13,0,0,25,0,0,0,0
Fresno,2020-12-13,458,49,1559,90,8,13,507
Imperial,2020-12-13,143,0,265,31,0,0,143
Plumas,2020-12-13,1,0,35,0,0,0,1
Santa Clara,2020-12-13,480,23,3106,108,4,54,503
Sacramento,2020-12-13,463,17,2582,87,4,79,480
Tuolumne,2020-12-13,7,0,84,1,0,3,7
Butte,2020-12-13,77,0,451,14,0,11,77
Yolo,2020-12-13,24,0,96,11,0,3,24
Mono,2020-12-13,1,0,17,0,0,1,1
Los Angeles,2020-12-14,4656,314,20115,988,38,390,4970
Marin,2020-12-14,30,3,335,12,0,4,33
Alameda,2020-12-14,330,44,2532,95,3,73,374
Orange,2020-12-14,1371,89,6002,296,16,101,1460
Kings,2020-12-14,75,0,126,6,0,3,75
Nevada,2020-12-14,18,1,134,2,1,2,19
Del Norte,2020-12-14,1,0,51,0,0,3,1
Merced,2020-12-14,41,0,271,8,0,10,41
San Benito,2020-12-14,11,0,25,2,0,0,11
Napa,2020-12-14,19,1,252,7,1,6,20
San Diego,2020-12-14,1019,63,6867,282,8,193,1082
Tulare,2020-12-14,178,4,636,15,0,8,182
Kern,2020-12-14,284,4,1150,61,0,16,288
Contra Costa,2020-12-14,185,15,1538,44,2,38,200
San Joaquin,2020-12-14,293,8,927,71,1,4,301
El Dorado,2020-12-14,29,1,190,8,1,7,30
Amador,2020-12-14,13,0,51,3,0,2,13
Lake,2020-12-14,5,0,77,2,0,2,5
Butte,2020-12-14,77,0,451,14,0,13,77
San Luis Obispo,2020-12-14,32,0,460,9,0,20,32
San Bernardino,2020-12-14,1319,96,4072,273,8,59,1415
Sonoma,2020-12-14,76,4,545,13,1,20,80
Mendocino,2020-12-14,15,0,88,3,0,7,15
San Mateo,2020-12-14,111,10,749,27,0,36,121
Mariposa,2020-12-14,0,0,19,0,0,0,0
Solano,2020-12-14,107,13,575,32,1,8,120
Ventura,2020-12-14,210,10,1208,58,4,32,220
Trinity,2020-12-14,0,0,25,0,0,0,0
Santa Cruz,2020-12-14,57,0,372,9,0,4,57
Glenn,2020-12-14,5,0,47,0,0,0,5
Santa Barbara,2020-12-14,91,0,688,23,0,46,91
Santa Clara,2020-12-14,511,27,3101,124,2,66,538
Imperial,2020-12-14,151,0,265,31,0,1,151
Plumas,2020-12-14,1,0,35,0,0,0,1
Madera,2020-12-14,35,3,275,7,1,13,38
San Francisco,2020-12-14,150,3,1861,39,1,63,153
Fresno,2020-12-14,491,37,1582,73,3,16,528
Tuolumne,2020-12-14,4,0,84,0,0,3,4
Monterey,2020-12-14,133,7,717,25,1,16,140
Riverside,2020-12-14,972,106,3485,195,6,27,1078
Tehama,2020-12-14,12,0,59,2,0,2,12
Sutter,2020-12-14,0,0,14,0,0,0,0
Siskiyou,2020-12-14,4,1,56,2,0,8,5
Sacramento,2020-12-14,473,21,2572,90,4,86,494
Yolo,2020-12-14,26,0,97,14,0,5,26
Colusa,2020-12-14,3,0,48,0,0,5,3
Mono,2020-12-14,1,0,17,0,0,2,1
Shasta,2020-12-14,60,0,561,13,0,8,60
Calaveras,2020-12-14,6,0,33,4,0,3,6
Inyo,2020-12-14,5,1,29,0,0,4,6
Lassen,2020-12-14,4,0,25,0,0,0,4
Placer,2020-12-14,184,11,752,23,3,0,195
Stanislaus,2020-12-14,334,14,1296,60,5,16,348
Modoc,2020-12-14,0,0,12,0,0,0,0
Yuba,2020-12-14,61,1,261,13,0,4,62
Humboldt,2020-12-14,4,3,266,3,1,11,7
Orange,2020-12-15,1486,81,6070,319,11,95,1567
Siskiyou,2020-12-15,6,1,56,2,0,8,7
San Bernardino,2020-12-15,1413,92,4075,271,8,53,1505
Del Norte,2020-12-15,1,0,51,1,0,1,1
San Luis Obispo,2020-12-15,34,2,460,8,0,21,36
Riverside,2020-12-15,1000,116,3536,212,7,26,1116
Placer,2020-12-15,187,11,736,26,2,2,198
Marin,2020-12-15,34,2,347,12,0,4,36
Los Angeles,2020-12-15,4864,344,20253,991,35,369,5208
Monterey,2020-12-15,148,4,717,24,1,12,152
Merced,2020-12-15,46,0,271,9,0,7,46
Sacramento,2020-12-15,470,22,2627,93,8,83,492
Modoc,2020-12-15,0,0,12,0,0,0,0
Calaveras,2020-12-15,6,0,33,4,0,3,6
Lassen,2020-12-15,6,0,25,0,0,0,6
Amador,2020-12-15,15,0,51,3,0,0,15
Sutter,2020-12-15,0,0,14,0,0,0,0
Tehama,2020-12-15,13,0,59,2,0,1,13
San Diego,2020-12-15,1103,70,6878,298,9,175,1173
Santa Barbara,2020-12-15,90,2,688,24,1,37,92
Mendocino,2020-12-15,16,0,88,3,0,6,16
Madera,2020-12-15,36,11,275,7,0,11,47
Stanislaus,2020-12-15,334,20,1296,59,6,7,354
Santa Clara,2020-12-15,535,18,3100,133,3,39,553
Tulare,2020-12-15,173,7,636,19,2,12,180
Ventura,2020-12-15,226,7,1218,59,3,30,233
Plumas,2020-12-15,2,0,35,0,0,0,2
Solano,2020-12-15,121,11,537,32,1,11,132
Yolo,2020-12-15,27,0,96,16,0,1,27
Alameda,2020-12-15,332,45,2556,93,5,72,377
Kings,2020-12-15,79,0,132,7,0,4,79
San Francisco,2020-12-15,141,3,1903,42,0,48,144
Butte,2020-12-15,84,0,451,13,0,12,84
Sonoma,2020-12-15,66,3,549,11,1,23,69
Colusa,2020-12-15,4,0,48,0,0,5,4
Nevada,2020-12-15,20,0,119,1,0,2,20
Kern,2020-12-15,296,3,1148,64,0,19,299
Imperial,2020-12-15,163,1,265,35,0,3,164
Napa,2020-12-15,18,0,250,6,0,6,18
El Dorado,2020-12-15,32,1,190,9,0,7,33
San Mateo,2020-12-15,110,14,748,27,0,34,124
Contra Costa,2020-12-15,188,9,1541,48,2,31,197
San Benito,2020-12-15,12,0,25,3,0,0,12
Inyo,2020-12-15,7,0,29,0,0,4,7
Glenn,2020-12-15,5,0,47,0,0,0,5
Fresno,2020-12-15,491,40,1576,86,2,11,531
Lake,2020-12-15,7,0,77,2,0,2,7
Shasta,2020-12-15,65,0,561,15,0,7,65
Humboldt,2020-12-15,4,3,278,2,2,14,7
Santa Cruz,2020-12-15,54,0,372,10,0,2,54
Trinity,2020-12-15,0,0,25,0,0,0,0
San Joaquin,2020-12-15,305,4,959,72,0,6,309
Yuba,2020-12-15,59,0,261,14,0,2,59
Tuolumne,2020-12-15,3,0,84,1,0,1,3
Mariposa,2020-12-15,0,0,19,0,0,0,0
Mono,2020-12-15,2,0,17,0,0,2,2
Santa Barbara,2020-12-16,97,5,688,24,2,37,102
Fresno,2020-12-16,527,30,1583,91,5,10,557
Tuolumne,2020-12-16,3,0,84,0,0,4,3
Humboldt,2020-12-16,6,3,274,3,2,14,9
Contra Costa,2020-12-16,196,10,1508,50,1,28,206
Riverside,2020-12-16,1054,85,3530,216,7,29,1139
Sonoma,2020-12-16,65,2,569,11,0,23,67
Glenn,2020-12-16,5,0,47,0,0,0,5
San Joaquin,2020-12-16,315,8,955,75,1,4,323
Yolo,2020-12-16,24,0,96,14,0,1,24
Amador,2020-12-16,13,0,51,3,0,0,13
Tehama,2020-12-16,11,0,59,1,0,1,11
Sacramento,2020-12-16,478,31,2611,102,3,70,509
Merced,2020-12-16,59,0,271,12,0,7,59
Orange,2020-12-16,1519,96,6058,343,15,79,1615
El Dorado,2020-12-16,28,0,190,10,0,4,28
San Luis Obispo,2020-12-16,34,1,460,9,1,19,35
San Bernardino,2020-12-16,1458,127,4063,285,12,41,1585
Lake,2020-12-16,4,0,77,1,0,2,4
Monterey,2020-12-16,145,2,717,24,1,15,147
Trinity,2020-12-16,0,0,25,0,0,0,0
Shasta,2020-12-16,72,0,567,13,0,5,72
Colusa,2020-12-16,5,0,48,0,0,5,5
Solano,2020-12-16,105,16,586,32,1,9,121
Del Norte,2020-12-16,1,0,51,1,0,0,1
Mariposa,2020-12-16,0,0,19,0,0,0,0
Kern,2020-12-16,303,8,1166,62,0,25,311
Alameda,2020-12-16,336,39,2558,89,5,73,375
Placer,2020-12-16,179,9,728,27,2,5,188
San Benito,2020-12-16,12,0,25,3,0,0,12
Napa,2020-12-16,22,1,254,7,0,6,23
Modoc,2020-12-16,0,0,12,0,0,0,0
Mono,2020-12-16,2,0,17,0,0,2,2
Marin,2020-12-16,35,3,349,10,0,5,38
Plumas,2020-12-16,4,0,35,0,0,0,4
Calaveras,2020-12-16,4,0,33,2,0,4,4
Kings,2020-12-16,75,0,127,7,0,0,75
Siskiyou,2020-12-16,9,0,56,2,0,9,9
Santa Cruz,2020-12-16,58,0,372,11,0,2,58
Tulare,2020-12-16,173,9,636,16,2,12,182
San Mateo,2020-12-16,116,13,758,31,1,28,129
Madera,2020-12-16,40,9,275,6,0,9,49
Sutter,2020-12-16,0,0,14,0,0,0,0
Inyo,2020-12-16,7,0,29,2,0,2,7
Ventura,2020-12-16,230,11,1222,63,4,35,241
Mendocino,2020-12-16,14,0,96,3,0,5,14
Butte,2020-12-16,86,1,451,11,0,14,87
San Diego,2020-12-16,1126,60,6798,295,6,168,1186
Imperial,2020-12-16,165,0,265,38,0,0,165
Nevada,2020-12-16,18,0,136,3,0,0,18
Lassen,2020-12-16,7,0,25,0,0,0,7
Los Angeles,2020-12-16,5100,366,20253,1035,36,338,5466
Yuba,2020-12-16,53,1,261,13,0,2,54
Santa Clara,2020-12-16,559,26,3126,127,1,46,585
San Francisco,2020-12-16,140,3,1943,41,0,51,143
Stanislaus,2020-12-16,334,20,1307,56,4,12,354
Inyo,2020-12-17,9,0,29,2,0,2,9
Lassen,2020-12-17,6,0,25,0,0,0,6
Calaveras,2020-12-17,4,0,33,2,0,4,4
Humboldt,2020-12-17,7,4,275,3,2,11,11
San Benito,2020-12-17,13,0,25,3,0,0,13
Placer,2020-12-17,184,11,751,23,3,21,195
Del Norte,2020-12-17,1,0,51,1,0,0,1
Ventura,2020-12-17,240,19,1215,64,3,31,259
Tehama,2020-12-17,8,0,59,1,0,2,8
Sutter,2020-12-17,0,0,14,0,0,0,0
Monterey,2020-12-17,151,2,717,29,0,18,153
El Dorado,2020-12-17,25,0,190,9,0,4,25
Fresno,2020-12-17,553,39,1618,106,0,13,592
San Francisco,2020-12-17,152,9,1951,39,3,43,161
Los Angeles,2020-12-17,5424,339,20282,1115,29,316,5763
Mendocino,2020-12-17,13,0,96,4,0,4,13
Colusa,2020-12-17,5,0,48,0,0,5,5
Nevada,2020-12-17,17,0,125,5,0,0,17
Kings,2020-12-17,77,0,124,8,0,0,77
Solano,2020-12-17,106,19,592,32,1,14,125
Sonoma,2020-12-17,70,3,598,14,1,20,73
Yuba,2020-12-17,54,0,261,12,0,2,54
Trinity,2020-12-17,0,0,25,0,0,0,0
Santa Clara,2020-12-17,561,27,3129,131,1,49,588
Marin,2020-12-17,31,2,342,8,0,8,33
Orange,2020-12-17,1557,78,6054,358,16,90,1635
Santa Cruz,2020-12-17,59,0,372,12,0,2,59
Alameda,2020-12-17,352,50,2557,93,3,65,402
San Bernardino,2020-12-17,1492,100,4094,291,8,40,1592
Glenn,2020-12-17,5,0,47,0,0,0,5
Shasta,2020-12-17,70,4,567,12,0,4,74
Santa Barbara,2020-12-17,98,5,688,23,2,38,103
San Luis Obispo,2020-12-17,35,1,460,9,0,19,36
Napa,2020-12-17,22,2,249,7,2,5,24
Lake,2020-12-17,6,0,77,1,0,2,6
Yolo,2020-12-17,23,0,96,12,0,5,23
Butte,2020-12-17,84,0,451,13,0,9,84
Kern,2020-12-17,315,5,1161,70,0,13,320
San Diego,2020-12-17,1164,55,6833,305,9,172,1219
Riverside,2020-12-17,1092,94,3488,224,7,18,1186
Madera,2020-12-17,42,2,275,6,0,10,44
Mono,2020-12-17,1,0,17,0,0,2,1
Tulare,2020-12-17,177,6,638,18,0,13,183
Stanislaus,2020-12-17,340,14,1306,58,2,11,354
San Joaquin,2020-12-17,313,10,957,75,2,4,323
Mariposa,2020-12-17,0,0,19,0,0,0,0
Tuolumne,2020-12-17,6,0,84,0,0,4,6
Merced,2020-12-17,58,0,271,15,0,4,58
Modoc,2020-12-17,0,0,12,0,0,0,0
Contra Costa,2020-12-17,197,15,1506,58,6,29,212
Amador,2020-12-17,13,0,51,2,0,1,13
Siskiyou,2020-12-17,7,0,56,2,0,7,7
Imperial,2020-12-17,174,0,265,40,0,0,174
Sacramento,2020-12-17,471,22,2626,103,5,72,493
Plumas,2020-12-17,6,0,35,0,0,0,6
San Mateo,2020-12-17,129,9,750,29,1,28,138
San Luis Obispo,2020-12-18,38,1,460,10,0,19,39
Sonoma,2020-12-18,75,2,599,13,0,21,77
Plumas,2020-12-18,5,0,35,0,0,0,5
Santa Clara,2020-12-18,592,25,3134,135,5,43,617
San Joaquin,2020-12-18,323,11,963,77,1,3,334
Placer,2020-12-18,190,14,753,28,1,23,204
Glenn,2020-12-18,5,0,47,0,0,0,5
Amador,2020-12-18,12,0,51,1,0,0,12
Orange,2020-12-18,1601,74,6084,361,13,103,1675
Kern,2020-12-18,312,5,1161,71,0,15,317
Calaveras,2020-12-18,5,0,33,3,0,4,5
Mendocino,2020-12-18,13,0,96,4,0,4,13
Tehama,2020-12-18,8,0,59,1,0,2,8
Merced,2020-12-18,58,0,271,15,0,4,58
Lassen,2020-12-18,6,0,25,0,0,0,6
Inyo,2020-12-18,10,0,29,0,0,4,10
Sacramento,2020-12-18,486,22,2627,108,6,73,508
Madera,2020-12-18,38,2,275,7,0,6,40
Alameda,2020-12-18,353,49,2529,92,9,70,402
Santa Cruz,2020-12-18,58,0,372,12,0,3,58
Shasta,2020-12-18,67,4,567,14,0,4,71
Nevada,2020-12-18,17,1,125,6,0,0,18
Marin,2020-12-18,29,2,335,8,1,7,31
Los Angeles,2020-12-18,5549,323,20349,1156,25,308,5872
Solano,2020-12-18,109,16,595,32,1,12,125
Santa Barbara,2020-12-18,102,5,688,21,1,40,107
Yuba,2020-12-18,54,0,261,12,0,2,54
Trinity,2020-12-18,0,0,25,0,0,0,0
Riverside,2020-12-18,1169,88,3563,226,7,33,1257
Stanislaus,2020-12-18,352,10,1306,62,0,12,362
San Diego,2020-12-18,1204,49,6818,310,6,183,1253
Del Norte,2020-12-18,2,0,52,2,0,2,2
San Benito,2020-12-18,12,0,25,3,0,0,12
San Francisco,2020-12-18,153,9,1922,41,2,43,162
Tulare,2020-12-18,185,8,627,21,0,14,193
Humboldt,2020-12-18,9,1,276,3,0,10,10
San Mateo,2020-12-18,139,14,750,27,3,37,153
Lake,2020-12-18,8,0,77,3,0,2,8
Kings,2020-12-18,77,0,124,8,0,0,77
Modoc,2020-12-18,0,0,12,0,0,0,0
Ventura,2020-12-18,243,13,1208,61,0,34,256
Contra Costa,2020-12-18,223,12,1513,60,2,27,235
Fresno,2020-12-18,565,33,1586,107,4,13,598
Mariposa,2020-12-18,0,0,19,0,0,0,0
San Bernardino,2020-12-18,1508,137,4093,293,10,42,1645
Imperial,2020-12-18,179,0,265,40,0,0,179
Colusa,2020-12-18,5,0,48,0,0,5,5
Sutter,2020-12-18,0,0,14,0,0,0,0
Siskiyou,2020-12-18,6,0,61,2,0,8,6
Tuolumne,2020-12-18,6,0,84,0,0,4,6
Yolo,2020-12-18,23,0,96,11,0,5,23
El Dorado,2020-12-18,22,0,190,8,0,5,22
Napa,2020-12-18,22,1,249,8,0,5,23
Butte,2020-12-18,74,0,451,11,0,13,74
Monterey,2020-12-18,164,2,717,29,0,15,166
Mono,2020-12-18,0,0,17,0,0,2,0
Imperial,2020-12-19,199,0,265,40,0,2,199
Calaveras,2020-12-19,5,0,33,3,0,4,5
San Diego,2020-12-19,1211,53,6825,316,8,209,1264
San Benito,2020-12-19,12,0,25,3,0,0,12
Sutter,2020-12-19,0,0,14,0,0,0,0
San Francisco,2020-12-19,164,6,1924,39,0,61,170
Napa,2020-12-19,19,0,252,6,0,5,19
Lake,2020-12-19,10,0,77,3,0,2,10
Santa Clara,2020-12-19,592,22,3125,134,3,35,614
Nevada,2020-12-19,17,3,134,4,1,1,20
Stanislaus,2020-12-19,343,11,1302,64,1,10,354
Orange,2020-12-19,1682,75,6072,375,11,116,1757
Yolo,2020-12-19,23,1,96,12,0,2,24
Placer,2020-12-19,189,12,748,29,2,22,201
Mariposa,2020-12-19,0,0,19,0,0,0,0
Siskiyou,2020-12-19,8,0,56,2,0,8,8
Sonoma,2020-12-19,71,3,576,17,0,21,74
Mendocino,2020-12-19,8,0,96,3,0,5,8
Santa Cruz,2020-12-19,59,0,373,14,0,2,59
Merced,2020-12-19,61,0,271,17,0,0,61
Riverside,2020-12-19,1178,102,3550,235,8,37,1280
Tulare,2020-12-19,184,2,624,23,0,12,186
Inyo,2020-12-19,10,0,29,0,0,4,10
San Mateo,2020-12-19,136,11,739,26,2,29,147
Yuba,2020-12-19,57,0,261,12,0,5,57
Tehama,2020-12-19,9,0,59,2,0,2,9
Shasta,2020-12-19,60,1,567,8,1,4,61
Contra Costa,2020-12-19,228,11,1518,59,2,38,239
Del Norte,2020-12-19,2,0,53,2,0,3,2
Plumas,2020-12-19,5,0,35,0,0,0,5
Alameda,2020-12-19,359,42,2529,100,10,75,401
Modoc,2020-12-19,0,0,12,0,0,0,0
Solano,2020-12-19,114,19,581,32,1,13,133
San Bernardino,2020-12-19,1508,126,4073,299,5,44,1634
El Dorado,2020-12-19,21,0,190,8,0,4,21
Santa Barbara,2020-12-19,105,3,688,23,1,46,108
Butte,2020-12-19,90,0,451,17,0,5,90
Fresno,2020-12-19,575,30,1566,109,6,8,605
Mono,2020-12-19,0,0,17,0,0,2,0
Marin,2020-12-19,22,4,335,9,1,10,26
Sacramento,2020-12-19,477,25,2635,110,5,63,502
Trinity,2020-12-19,0,0,25,0,0,0,0
Kings,2020-12-19,92,0,120,8,0,0,92
Madera,2020-12-19,40,4,275,9,1,7,44
Lassen,2020-12-19,5,0,25,0,0,0,5
Kern,2020-12-19,331,6,1152,72,0,22,337
Monterey,2020-12-19,171,2,717,30,0,10,173
Colusa,2020-12-19,6,0,48,0,0,5,6
Los Angeles,2020-12-19,5709,309,20319,1175,23,328,6018
San Joaquin,2020-12-19,338,9,956,80,2,0,347
Ventura,2020-12-19,265,14,1218,71,2,38,279
Tuolumne,2020-12-19,10,0,84,0,0,4,10
Humboldt,2020-12-19,7,1,275,3,0,10,8
Glenn,2020-12-19,5,0,47,0,0,0,5
San Luis Obispo,2020-12-19,40,0,460,10,0,20,40
Amador,2020-12-19,11,0,51,1,0,0,11
San Joaquin,2020-12-20,333,6,971,76,2,2,339
Butte,2020-12-20,88,1,451,9,0,8,89
Imperial,2020-12-20,198,0,265,41,0,2,198
San Benito,2020-12-20,15,0,25,3,0,0,15
Fresno,2020-12-20,569,29,1555,104,5,18,598
Tehama,2020-12-20,10,0,59,4,0,1,10
Mono,2020-12-20,0,0,17,0,0,2,0
Sutter,2020-12-20,0,0,14,0,0,0,0
Mendocino,2020-12-20,10,0,95,3,0,5,10
San Luis Obispo,2020-12-20,39,0,460,8,0,25,39
Del Norte,2020-12-20,2,0,51,2,0,3,2
Siskiyou,2020-12-20,8,0,56,2,0,7,8
Tuolumne,2020-12-20,11,0,84,1,0,4,11
Mariposa,2020-12-20,0,0,19,0,0,0,0
Colusa,2020-12-20,6,0,48,0,0,5,6
Marin,2020-12-20,26,4,325,11,1,10,30
Amador,2020-12-20,8,1,51,1,0,2,9
Los Angeles,2020-12-20,5866,358,20231,1202,31,354,6224
Trinity,2020-12-20,0,0,25,0,0,0,0
Contra Costa,2020-12-20,236,14,1505,55,2,37,250
El Dorado,2020-12-20,21,1,190,6,0,6,22
Nevada,2020-12-20,21,2,120,5,0,1,23
Madera,2020-12-20,34,4,275,9,1,9,38
Lake,2020-12-20,8,0,77,2,0,2,8
Shasta,2020-12-20,60,0,567,7,0,9,60
Inyo,2020-12-20,10,0,29,0,0,4,10
San Diego,2020-12-20,1248,46,6687,331,10,214,1294
Riverside,2020-12-20,1239,94,3494,229,6,36,1333
Sacramento,2020-12-20,493,262,2602,97,10,71,755
Yolo,2020-12-20,26,1,96,12,0,6,27
Humboldt,2020-12-20,7,3,270,1,0,12,10
Sonoma,2020-12-20,66,3,547,17,0,25,69
Yuba,2020-12-20,58,0,261,10,0,0,58
Kern,2020-12-20,326,3,1132,73,0,19,329
Napa,2020-12-20,18,0,238,6,0,5,18
Santa Clara,2020-12-20,599,24,3105,134,5,41,623
Tulare,2020-12-20,196,8,627,22,0,15,204
Lassen,2020-12-20,5,0,25,0,0,0,5
Santa Cruz,2020-12-20,60,0,372,15,0,2,60
Glenn,2020-12-20,5,0,47,0,0,0,5
Plumas,2020-12-20,4,0,35,0,0,0,4
San Francisco,2020-12-20,170,5,1831,42,1,67,175
Orange,2020-12-20,1709,72,5965,380,11,103,1781
Alameda,2020-12-20,373,41,2531,97,8,90,414
Ventura,2020-12-20,262,16,1216,70,3,19,278
Calaveras,2020-12-20,6,0,33,3,0,5,6
Monterey,2020-12-20,166,2,717,30,0,11,168
Stanislaus,2020-12-20,346,9,1302,60,0,11,355
Modoc,2020-12-20,0,0,12,0,0,0,0
Placer,2020-12-20,181,9,747,29,0,27,190
Santa Barbara,2020-12-20,103,6,688,22,2,49,109
Solano,2020-12-20,110,12,559,31,1,12,122
San Bernardino,2020-12-20,1545,125,4085,329,8,38,1670
San Mateo,2020-12-20,133,8,744,30,5,31,141
Merced,2020-12-20,67,0,271,15,0,4,67
Kings,2020-12-20,90,0,115,8,0,0,90
San Bernardino,2020-12-21,1618,101,4116,326,5,40,1719
San Mateo,2020-12-21,130,7,738,29,2,33,137
Stanislaus,2020-12-21,365,8,1308,58,1,12,373
Santa Barbara,2020-12-21,113,5,688,22,2,53,118
San Diego,2020-12-21,1314,61,6700,341,6,197,1375
Ventura,2020-12-21,273,8,1235,71,2,26,281
Alameda,2020-12-21,373,38,2532,106,6,82,411
Colusa,2020-12-21,12,0,48,0,0,5,12
Sonoma,2020-12-21,62,3,541,16,0,23,65
Sacramento,2020-12-21,500,262,2604,104,6,68,762
Inyo,2020-12-21,10,0,29,0,0,4,10
Lassen,2020-12-21,5,0,25,0,0,0,5
Santa Clara,2020-12-21,599,25,3105,138,4,50,624
El Dorado,2020-12-21,23,0,190,5,0,11,23
Modoc,2020-12-21,0,0,12,0,0,0,0
Napa,2020-12-21,20,0,247,6,0,5,20
San Luis Obispo,2020-12-21,44,1,460,9,0,22,45
Fresno,2020-12-21,587,28,1569,123,3,14,615
Imperial,2020-12-21,194,1,265,40,0,2,195
Los Angeles,2020-12-21,6155,305,20241,1234,34,373,6460
Calaveras,2020-12-21,6,0,33,3,0,4,6
Humboldt,2020-12-21,6,3,270,2,0,12,9
Mono,2020-12-21,0,0,17,0,0,2,0
Yolo,2020-12-21,24,0,96,12,0,5,24
Amador,2020-12-21,8,0,51,1,0,0,8
Placer,2020-12-21,175,12,751,27,1,21,187
Contra Costa,2020-12-21,238,17,1511,57,1,40,255
Yuba,2020-12-21,62,0,261,9,0,6,62
Plumas,2020-12-21,5,0,35,0,0,0,5
Tulare,2020-12-21,198,8,627,24,2,7,206
Solano,2020-12-21,118,16,573,29,5,13,134
Shasta,2020-12-21,57,0,567,7,0,10,57
Lake,2020-12-21,7,0,77,2,0,2,7
Del Norte,2020-12-21,2,0,51,1,0,2,2
Mendocino,2020-12-21,14,0,96,4,0,6,14
Glenn,2020-12-21,5,0,47,0,0,0,5
Nevada,2020-12-21,17,0,120,4,0,1,17
Santa Cruz,2020-12-21,60,0,372,15,0,3,60
Sutter,2020-12-21,0,0,14,0,0,0,0
Madera,2020-12-21,37,6,304,9,1,8,43
Trinity,2020-12-21,0,0,25,0,0,0,0
Kern,2020-12-21,348,7,1123,73,0,9,355
Tehama,2020-12-21,10,0,59,4,0,1,10
Riverside,2020-12-21,1278,102,3517,250,7,17,1380
San Joaquin,2020-12-21,328,7,969,74,2,1,335
San Francisco,2020-12-21,162,9,1909,45,2,63,171
San Benito,2020-12-21,15,0,25,3,0,0,15
Butte,2020-12-21,95,0,451,10,0,9,95
Orange,2020-12-21,1806,72,6019,390,14,96,1878
Kings,2020-12-21,87,0,129,10,0,0,87
Siskiyou,2020-12-21,9,0,56,3,0,7,9
Tuolumne,2020-12-21,10,0,84,3,0,2,10
Marin,2020-12-21,28,4,334,9,0,12,32
Monterey,2020-12-21,165,2,717,32,0,16,167
Mariposa,2020-12-21,0,0,19,0,0,0,0
Merced,2020-12-21,66,0,271,15,0,4,66
Calaveras,2020-12-22,8,0,33,4,0,4,8
Lake,2020-12-22,6,0,77,2,0,2,6
Riverside,2020-12-22,1322,69,3505,247,9,33,1391
El Dorado,2020-12-22,26,0,190,5,0,8,26
Fresno,2020-12-22,560,30,1582,106,3,7,590
Contra Costa,2020-12-22,237,16,1528,53,2,35,253
Orange,2020-12-22,1854,61,6051,394,11,102,1915
Madera,2020-12-22,43,4,288,11,0,13,47
Mendocino,2020-12-22,16,0,91,4,0,5,16
Ventura,2020-12-22,312,7,1226,72,3,26,319
Sutter,2020-12-22,0,0,14,0,0,0,0
Modoc,2020-12-22,0,0,12,0,0,0,0
Stanislaus,2020-12-22,349,11,1313,62,1,10,360
Los Angeles,2020-12-22,6499,321,20234,1280,46,386,6820
Plumas,2020-12-22,6,0,35,0,0,0,6
Del Norte,2020-12-22,2,0,51,1,0,3,2
Colusa,2020-12-22,12,0,48,0,0,5,12
Alameda,2020-12-22,388,40,2525,118,9,68,428
San Francisco,2020-12-22,157,9,2002,47,0,53,166
San Benito,2020-12-22,14,0,25,3,0,0,14
Mono,2020-12-22,0,0,17,0,0,2,0
Siskiyou,2020-12-22,6,0,56,3,0,8,6
Lassen,2020-12-22,6,0,25,0,0,0,6
Tulare,2020-12-22,202,10,627,26,1,7,212
Shasta,2020-12-22,59,0,567,9,0,6,59
Merced,2020-12-22,67,0,271,15,0,3,67
Trinity,2020-12-22,0,0,25,0,0,0,0
Monterey,2020-12-22,165,1,717,33,0,15,166
Napa,2020-12-22,21,0,261,6,0,11,21
San Mateo,2020-12-22,145,11,746,34,0,29,156
San Diego,2020-12-22,1340,70,6704,346,14,184,1410
Santa Barbara,2020-12-22,123,3,688,21,0,42,126
Marin,2020-12-22,25,2,342,10,0,11,27
Santa Cruz,2020-12-22,65,0,372,17,0,4,65
Sonoma,2020-12-22,77,1,583,18,0,19,78
Yuba,2020-12-22,63,0,261,9,0,4,63
Imperial,2020-12-22,205,0,265,42,0,3,205
Placer,2020-12-22,185,18,755,25,1,20,203
Santa Clara,2020-12-22,618,28,3142,148,3,44,646
San Joaquin,2020-12-22,323,15,954,71,3,3,338
Butte,2020-12-22,88,0,451,12,0,7,88
Sacramento,2020-12-22,518,21,2611,103,10,74,539
Mariposa,2020-12-22,0,0,19,0,0,0,0
Solano,2020-12-22,137,16,589,30,4,18,153
San Bernardino,2020-12-22,1635,119,4092,327,8,37,1754
San Luis Obispo,2020-12-22,49,1,460,9,0,23,50
Glenn,2020-12-22,5,0,47,0,0,0,5
Tehama,2020-12-22,13,0,59,2,0,1,13
Kings,2020-12-22,83,0,127,9,0,0,83
Inyo,2020-12-22,10,0,29,0,0,4,10
Nevada,2020-12-22,15,0,126,5,0,3,15
Kern,2020-12-22,342,3,1130,72,0,11,345
Yolo,2020-12-22,25,18,96,11,0,5,43
Tuolumne,2020-12-22,7,0,84,1,0,2,7
Amador,2020-12-22,9,0,52,2,0,0,9
Humboldt,2020-12-22,6,8,274,2,0,13,14
Santa Barbara,2020-12-23,124,5,668,26,0,22,129
Kings,2020-12-23,83,0,117,10,0,0,83
Tuolumne,2020-12-23,10,0,84,1,0,3,10
Marin,2020-12-23,25,2,345,10,1,12,27
Trinity,2020-12-23,0,0,25,0,0,0,0
Kern,2020-12-23,328,10,1121,66,1,17,338
San Mateo,2020-12-23,157,8,746,41,1,24,165
San Diego,2020-12-23,1404,62,6699,369,11,190,1466
Humboldt,2020-12-23,5,5,270,2,0,14,10
El Dorado,2020-12-23,27,1,190,5,0,7,28
Siskiyou,2020-12-23,4,0,56,2,0,8,4
Nevada,2020-12-23,20,0,141,6,0,1,20
San Benito,2020-12-23,15,0,25,4,0,0,15
Mono,2020-12-23,0,0,17,0,0,2,0
Del Norte,2020-12-23,2,0,51,1,0,2,2
Inyo,2020-12-23,8,0,29,0,0,4,8
Shasta,2020-12-23,52,0,567,10,0,4,52
Santa Cruz,2020-12-23,63,0,372,16,0,5,63
Sutter,2020-12-23,0,0,14,0,0,0,0
Amador,2020-12-23,9,0,52,3,0,0,9
San Joaquin,2020-12-23,333,13,926,77,7,5,346
Plumas,2020-12-23,6,0,35,0,0,0,6
Mendocino,2020-12-23,14,0,92,5,0,3,14
Santa Clara,2020-12-23,635,22,3150,152,2,37,657
Solano,2020-12-23,137,15,595,28,0,12,152
Los Angeles,2020-12-23,6708,292,20196,1329,35,355,7000
Alameda,2020-12-23,403,46,2521,124,8,67,449
Modoc,2020-12-23,0,0,12,0,0,0,0
Placer,2020-12-23,193,17,756,27,1,21,210
Stanislaus,2020-12-23,342,12,1303,62,2,15,354
Merced,2020-12-23,60,0,271,14,0,3,60
San Bernardino,2020-12-23,1642,107,4093,331,5,38,1749
Orange,2020-12-23,1893,73,6082,405,12,101,1966
San Luis Obispo,2020-12-23,48,2,460,9,0,21,50
Colusa,2020-12-23,17,0,48,0,0,5,17
Calaveras,2020-12-23,8,0,33,3,0,4,8
Monterey,2020-12-23,155,3,717,34,0,12,158
Yuba,2020-12-23,58,0,261,7,0,4,58
Fresno,2020-12-23,629,37,1587,126,1,4,666
Madera,2020-12-23,45,9,288,10,1,14,54
Mariposa,2020-12-23,1,0,19,0,0,0,1
Napa,2020-12-23,20,0,250,7,0,8,20
Lake,2020-12-23,6,0,77,3,0,4,6
Sacramento,2020-12-23,512,22,2626,101,4,75,534
Contra Costa,2020-12-23,243,14,1537,54,2,24,257
Imperial,2020-12-23,197,0,265,43,0,2,197
Sonoma,2020-12-23,74,3,572,20,0,19,77
Yolo,2020-12-23,27,1,96,12,0,3,28
Lassen,2020-12-23,5,0,25,0,0,0,5
Butte,2020-12-23,81,0,451,11,0,10,81
Glenn,2020-12-23,14,0,47,0,0,0,14
Riverside,2020-12-23,1327,86,3526,255,6,25,1413
Ventura,2020-12-23,319,14,1232,68,6,34,333
Tehama,2020-12-23,15,0,59,2,0,2,15
San Francisco,2020-12-23,164,11,1995,45,1,52,175
Tulare,2020-12-23,208,4,627,26,0,8,212
Los Angeles,2020-12-24,6770,286,20203,1335,27,364,7056
Modoc,2020-12-24,1,0,12,0,0,0,1
Solano,2020-12-24,129,12,565,34,2,12,141
Santa Barbara,2020-12-24,120,23,668,26,1,22,143
Mendocino,2020-12-24,13,2,88,4,2,4,15
Madera,2020-12-24,45,4,288,10,0,13,49
San Diego,2020-12-24,1405,64,6710,361,7,197,1469
Sacramento,2020-12-24,475,19,2615,98,5,72,494
San Luis Obispo,2020-12-24,47,1,460,8,0,23,48
Butte,2020-12-24,84,0,451,14,0,5,84
Contra Costa,2020-12-24,242,16,1532,49,3,37,258
San Bernardino,2020-12-24,1641,90,4064,325,3,31,1731
Mariposa,2020-12-24,1,0,19,0,0,0,1
Fresno,2020-12-24,621,29,1541,106,4,5,650
Kings,2020-12-24,83,0,125,11,0,0,83
San Benito,2020-12-24,16,0,25,4,0,0,16
Monterey,2020-12-24,176,3,717,33,1,16,179
Amador,2020-12-24,10,0,52,3,0,0,10
San Francisco,2020-12-24,171,11,1972,53,0,58,182
San Joaquin,2020-12-24,323,5,940,77,2,5,328
Placer,2020-12-24,192,19,755,28,1,24,211
Glenn,2020-12-24,14,0,47,0,0,0,14
Nevada,2020-12-24,21,0,119,6,0,0,21
Trinity,2020-12-24,0,0,25,0,0,0,0
Siskiyou,2020-12-24,5,0,56,1,0,9,5
Napa,2020-12-24,21,0,241,5,0,8,21
Stanislaus,2020-12-24,342,7,1294,57,2,17,349
Plumas,2020-12-24,4,0,35,0,0,0,4
Orange,2020-12-24,1955,51,6003,417,8,94,2006
Colusa,2020-12-24,17,0,48,0,0,5,17
San Mateo,2020-12-24,149,8,742,36,1,21,157
Sonoma,2020-12-24,78,3,577,22,0,22,81
Marin,2020-12-24,30,6,346,9,0,9,36
El Dorado,2020-12-24,25,0,190,7,0,6,25
Tuolumne,2020-12-24,6,0,84,0,0,2,6
Inyo,2020-12-24,9,0,29,1,0,4,9
Shasta,2020-12-24,45,3,567,6,0,13,48
Mono,2020-12-24,0,0,17,0,0,3,0
Santa Clara,2020-12-24,629,21,3137,156,0,35,650
Santa Cruz,2020-12-24,67,2,372,17,0,5,69
Humboldt,2020-12-24,6,4,265,2,0,16,10
Yuba,2020-12-24,57,0,261,9,0,3,57
Lassen,2020-12-24,6,0,25,0,0,0,6
Yolo,2020-12-24,29,0,170,12,0,17,29
Lake,2020-12-24,6,0,77,3,0,3,6
Calaveras,2020-12-24,6,0,33,2,0,4,6
Del Norte,2020-12-24,2,0,51,1,0,2,2
Kern,2020-12-24,326,3,1109,69,0,22,329
Tehama,2020-12-24,14,0,59,4,0,2,14
Sutter,2020-12-24,0,0,14,0,0,0,0
Merced,2020-12-24,54,0,271,13,0,4,54
Tulare,2020-12-24,198,7,627,21,1,12,205
Alameda,2020-12-24,385,37,2507,117,4,76,422
Riverside,2020-12-24,1336,85,3502,267,6,49,1421
Ventura,2020-12-24,333,13,1217,67,6,36,346
Imperial,2020-12-24,197,0,265,43,0,0,197
Humboldt,2020-12-25,6,4,274,2,0,15,10
Santa Clara,2020-12-25,633,19,3083,158,2,40,652
Siskiyou,2020-12-25,8,0,56,1,0,9,8
Mendocino,2020-12-25,12,0,81,3,0,2,12
Stanislaus,2020-12-25,349,11,1301,59,1,14,360
Kings,2020-12-25,82,0,112,9,0,0,82
Riverside,2020-12-25,1335,85,3477,266,4,36,1420
San Mateo,2020-12-25,142,6,729,31,2,26,148
Nevada,2020-12-25,22,0,119,6,0,0,22
El Dorado,2020-12-25,26,0,190,8,0,6,26
Ventura,2020-12-25,325,13,1209,67,4,35,338
Alameda,2020-12-25,389,38,2493,113,2,81,427
Los Angeles,2020-12-25,6815,309,20189,1368,41,363,7124
Monterey,2020-12-25,168,2,717,35,0,15,170
Santa Cruz,2020-12-25,68,2,372,18,0,6,70
Kern,2020-12-25,333,5,1084,77,0,16,338
Mono,2020-12-25,0,0,17,0,0,1,0
Contra Costa,2020-12-25,249,16,1518,53,4,33,265
Placer,2020-12-25,192,8,751,24,2,20,200
Tulare,2020-12-25,199,3,627,22,0,10,202
San Bernardino,2020-12-25,1625,95,4031,337,4,49,1720
Sutter,2020-12-25,0,0,14,0,0,0,0
Inyo,2020-12-25,7,0,29,0,0,4,7
Merced,2020-12-25,49,0,271,13,0,5,49
San Luis Obispo,2020-12-25,46,3,460,8,0,27,49
Shasta,2020-12-25,43,4,567,8,0,11,47
Modoc,2020-12-25,1,0,12,0,0,0,1
Yuba,2020-12-25,60,2,261,12,1,4,62
Trinity,2020-12-25,0,0,25,0,0,0,0
Plumas,2020-12-25,3,0,35,0,0,0,3
Del Norte,2020-12-25,3,0,51,0,0,4,3
Imperial,2020-12-25,185,0,265,44,0,0,185
San Diego,2020-12-25,1416,41,6700,365,5,170,1457
Amador,2020-12-25,7,1,52,3,0,0,8
Yolo,2020-12-25,25,47,169,12,0,17,72
Mariposa,2020-12-25,1,0,19,0,0,0,1
Tuolumne,2020-12-25,6,0,84,0,0,4,6
San Benito,2020-12-25,16,0,25,4,0,0,16
Tehama,2020-12-25,16,0,59,2,0,1,16
Glenn,2020-12-25,16,1,47,0,0,0,17
Solano,2020-12-25,133,11,557,32,1,13,144
Calaveras,2020-12-25,5,0,33,2,0,4,5
Orange,2020-12-25,1957,54,5998,432,4,93,2011
Sonoma,2020-12-25,68,1,542,21,0,21,69
Napa,2020-12-25,22,0,234,8,0,8,22
Lassen,2020-12-25,6,0,25,0,0,0,6
Madera,2020-12-25,47,5,288,9,0,13,52
Butte,2020-12-25,91,0,451,15,0,4,91
Fresno,2020-12-25,617,23,1537,136,3,7,640
Marin,2020-12-25,30,6,341,10,0,12,36
Sacramento,2020-12-25,473,20,2596,98,5,83,493
Colusa,2020-12-25,14,0,48,0,0,5,14
San Joaquin,2020-12-25,316,11,906,75,1,11,327
Lake,2020-12-25,5,0,77,3,0,2,5
San Francisco,2020-12-25,164,5,1941,49,1,67,169
Santa Barbara,2020-12-25,117,3,668,25,1,25,120
Santa Barbara,2020-12-26,121,4,668,29,0,27,125
El Dorado,2020-12-26,25,0,190,10,0,2,25
Shasta,2020-12-26,47,1,567,8,0,11,48
Yuba,2020-12-26,65,2,261,13,1,2,67
Tulare,2020-12-26,200,5,627,21,0,15,205
Sonoma,2020-12-26,70,0,534,20,0,23,70
Mariposa,2020-12-26,1,0,19,0,0,0,1
Tehama,2020-12-26,19,0,59,2,0,0,19
San Benito,2020-12-26,16,0,25,4,0,0,16
Stanislaus,2020-12-26,348,17,1301,59,3,20,365
Los Angeles,2020-12-26,6914,303,20201,1404,35,424,7217
Siskiyou,2020-12-26,6,0,56,1,0,9,6
Ventura,2020-12-26,336,20,1214,68,4,33,356
Kings,2020-12-26,88,0,129,9,0,0,88
San Diego,2020-12-26,1440,41,6714,388,9,171,1481
Imperial,2020-12-26,174,2,265,42,0,4,176
Plumas,2020-12-26,3,0,35,0,0,0,3
Madera,2020-12-26,44,1,288,9,0,12,45
Yolo,2020-12-26,29,0,169,4,0,24,29
Placer,2020-12-26,192,11,747,25,0,23,203
Mono,2020-12-26,1,0,17,0,0,1,1
Butte,2020-12-26,100,0,451,16,0,3,100
Inyo,2020-12-26,9,0,29,0,0,4,9
Modoc,2020-12-26,1,0,12,0,0,0,1
Santa Cruz,2020-12-26,64,0,372,18,0,5,64
San Joaquin,2020-12-26,320,12,913,80,1,7,332
Fresno,2020-12-26,620,32,1543,135,4,8,652
Humboldt,2020-12-26,5,2,274,2,0,14,7
Lake,2020-12-26,8,1,77,4,1,1,9
Contra Costa,2020-12-26,242,24,1519,56,5,29,266
Orange,2020-12-26,1990,56,5929,443,7,99,2046
Calaveras,2020-12-26,4,0,33,2,0,4,4
Trinity,2020-12-26,0,0,25,0,0,0,0
Merced,2020-12-26,51,0,271,12,0,7,51
Sacramento,2020-12-26,452,27,2584,99,4,84,479
Lassen,2020-12-26,7,0,25,0,0,0,7
Solano,2020-12-26,141,9,573,36,1,11,150
San Bernardino,2020-12-26,1617,82,4022,329,6,45,1699
Nevada,2020-12-26,21,1,120,4,0,0,22
San Mateo,2020-12-26,146,2,723,33,1,28,148
Colusa,2020-12-26,14,0,48,0,0,5,14
Napa,2020-12-26,23,3,241,10,0,5,26
Tuolumne,2020-12-26,6,0,84,1,0,2,6
Sutter,2020-12-26,0,0,14,0,0,0,0
Kern,2020-12-26,357,9,1074,71,0,33,366
San Luis Obispo,2020-12-26,49,2,460,9,0,25,51
Alameda,2020-12-26,412,37,2506,118,4,80,449
Mendocino,2020-12-26,14,0,80,4,0,2,14
Marin,2020-12-26,26,3,335,10,0,8,29
San Francisco,2020-12-26,172,3,1929,47,0,72,175
Del Norte,2020-12-26,3,0,51,1,0,1,3
Monterey,2020-12-26,180,2,717,38,0,12,182
Riverside,2020-12-26,1382,89,3468,277,1,31,1471
Amador,2020-12-26,9,0,52,2,0,1,9
Santa Clara,2020-12-26,637,18,3081,150,4,48,655
Glenn,2020-12-26,16,1,47,0,0,0,17
Sutter,2020-12-27,0,0,14,0,0,0,0
Santa Cruz,2020-12-27,70,0,373,17,0,3,70
Trinity,2020-12-27,0,0,25,0,0,0,0
San Luis Obispo,2020-12-27,56,1,460,13,0,20,57
Amador,2020-12-27,9,0,52,3,0,0,9
Sacramento,2020-12-27,463,27,2590,94,6,95,490
San Diego,2020-12-27,1481,45,6714,394,4,175,1526
Inyo,2020-12-27,11,0,29,0,0,4,11
Marin,2020-12-27,24,4,335,8,1,10,28
Merced,2020-12-27,54,0,271,12,0,6,54
Placer,2020-12-27,201,14,747,26,2,20,215
Calaveras,2020-12-27,3,0,33,1,0,4,3
Kern,2020-12-27,375,9,1096,73,0,12,384
Humboldt,2020-12-27,6,3,274,1,0,13,9
Butte,2020-12-27,84,0,451,17,0,3,84
San Joaquin,2020-12-27,327,11,930,76,1,9,338
Del Norte,2020-12-27,3,0,51,1,0,2,3
Glenn,2020-12-27,16,1,47,0,0,0,17
Yuba,2020-12-27,68,1,261,14,0,1,69
Orange,2020-12-27,2031,52,6001,453,8,92,2083
Napa,2020-12-27,24,1,241,9,0,5,25
Tuolumne,2020-12-27,7,1,84,1,0,5,8
Modoc,2020-12-27,1,0,12,0,0,0,1
Kings,2020-12-27,90,0,127,9,0,0,90
San Mateo,2020-12-27,152,8,727,34,3,28,160
Mono,2020-12-27,1,0,17,0,0,2,1
Fresno,2020-12-27,625,41,1564,138,5,8,666
Ventura,2020-12-27,341,17,1213,74,5,37,358
Solano,2020-12-27,136,9,572,36,2,11,145
Colusa,2020-12-27,14,0,48,0,0,5,14
Tehama,2020-12-27,22,0,59,2,0,1,22
Nevada,2020-12-27,19,0,131,5,0,0,19
Plumas,2020-12-27,2,0,35,0,0,0,2
Santa Clara,2020-12-27,661,23,3102,155,5,39,684
Los Angeles,2020-12-27,7181,332,20222,1449,65,384,7513
San Benito,2020-12-27,16,0,25,4,0,0,16
Stanislaus,2020-12-27,352,11,1300,62,1,21,363
Lake,2020-12-27,8,0,77,3,0,1,8
Alameda,2020-12-27,418,35,2503,115,4,75,453
Madera,2020-12-27,45,5,288,8,0,13,50
San Francisco,2020-12-27,179,5,1919,46,0,65,184
Yolo,2020-12-27,29,0,169,13,0,15,29
Riverside,2020-12-27,1367,106,3476,282,7,29,1473
Mendocino,2020-12-27,12,1,83,4,1,4,13
Santa Barbara,2020-12-27,127,7,668,33,1,22,134
Monterey,2020-12-27,179,0,717,37,0,9,179
Shasta,2020-12-27,46,1,567,6,0,10,47
Siskiyou,2020-12-27,5,0,56,1,0,9,5
Imperial,2020-12-27,190,2,265,42,0,4,192
El Dorado,2020-12-27,28,0,190,9,0,4,28
San Bernardino,2020-12-27,1655,72,4034,343,5,48,1727
Contra Costa,2020-12-27,257,23,1528,63,4,27,280
Lassen,2020-12-27,5,0,25,0,0,0,5
Tulare,2020-12-27,215,5,627,22,1,12,220
Mariposa,2020-12-27,1,0,19,0,0,0,1
Sonoma,2020-12-27,74,3,570,20,1,23,77
Placer,2020-12-28,206,20,745,28,1,19,226
San Francisco,2020-12-28,186,6,1930,48,3,64,192
Los Angeles,2020-12-28,7415,297,20266,1496,34,356,7712
Modoc,2020-12-28,1,0,12,0,0,0,1
Tulare,2020-12-28,218,12,633,21,1,13,230
San Bernardino,2020-12-28,1738,83,4076,342,5,53,1821
San Mateo,2020-12-28,157,8,724,36,3,27,165
Calaveras,2020-12-28,1,0,33,0,0,5,1
San Luis Obispo,2020-12-28,65,2,460,14,0,23,67
Siskiyou,2020-12-28,5,0,56,1,0,7,5
Riverside,2020-12-28,1448,93,3535,287,5,41,1541
Mono,2020-12-28,0,0,17,0,0,2,0
San Benito,2020-12-28,15,0,25,3,0,0,15
Santa Cruz,2020-12-28,71,0,372,17,0,2,71
Contra Costa,2020-12-28,249,11,1529,62,3,29,260
Nevada,2020-12-28,18,0,134,3,0,2,18
Humboldt,2020-12-28,7,5,274,2,0,14,12
Yuba,2020-12-28,67,0,261,14,0,1,67
Madera,2020-12-28,47,5,288,8,0,13,52
Mendocino,2020-12-28,10,0,88,3,0,7,10
Glenn,2020-12-28,16,1,47,0,0,0,17
Marin,2020-12-28,28,4,342,9,0,12,32
Monterey,2020-12-28,191,0,717,34,0,13,191
Napa,2020-12-28,23,2,250,11,0,47,25
Butte,2020-12-28,77,0,451,12,0,3,77
Fresno,2020-12-28,637,40,1593,117,1,13,677
Mariposa,2020-12-28,1,0,19,0,0,0,1
Lassen,2020-12-28,5,0,25,0,0,0,5
Colusa,2020-12-28,14,0,48,0,0,5,14
Sutter,2020-12-28,0,0,14,0,0,0,0
Shasta,2020-12-28,42,0,567,4,0,7,42
Imperial,2020-12-28,182,3,265,48,0,2,185
Solano,2020-12-28,137,9,568,34,1,11,146
Santa Clara,2020-12-28,690,24,3117,167,4,27,714
Lake,2020-12-28,8,0,77,3,0,1,8
Sacramento,2020-12-28,484,23,2608,93,5,101,507
Sonoma,2020-12-28,76,2,569,23,0,20,78
Inyo,2020-12-28,11,0,29,1,0,3,11
Stanislaus,2020-12-28,352,15,1299,62,1,20,367
Santa Barbara,2020-12-28,129,7,668,35,1,21,136
El Dorado,2020-12-28,26,0,190,9,0,3,26
Alameda,2020-12-28,441,32,2518,117,3,70,473
Orange,2020-12-28,2106,56,6003,473,1,107,2162
Merced,2020-12-28,55,0,271,16,0,3,55
Ventura,2020-12-28,354,11,1218,76,5,36,365
Trinity,2020-12-28,0,0,25,0,0,0,0
Amador,2020-12-28,9,0,52,3,0,1,9
Del Norte,2020-12-28,2,0,51,1,0,2,2
San Joaquin,2020-12-28,331,10,908,81,2,9,341
Tuolumne,2020-12-28,8,1,84,1,0,5,9
Plumas,2020-12-28,2,0,35,0,0,0,2
Kings,2020-12-28,90,1,129,8,0,0,91
Tehama,2020-12-28,23,0,59,2,0,0,23
Kern,2020-12-28,388,11,1123,80,0,10,399
San Diego,2020-12-28,1504,56,6722,396,3,176,1560
Yolo,2020-12-28,24,0,169,7,0,22,24
Lassen,2020-12-29,5,0,25,0,0,0,5
San Joaquin,2020-12-29,329,12,907,83,3,8,341
Amador,2020-12-29,10,0,53,3,0,1,10
Shasta,2020-12-29,45,0,567,5,0,13,45
Butte,2020-12-29,73,0,451,11,0,4,73
San Francisco,2020-12-29,206,6,1984,54,3,60,212
Mendocino,2020-12-29,11,0,91,2,0,6,11
Sonoma,2020-12-29,81,3,607,23,1,20,84
Kings,2020-12-29,94,0,146,10,0,2,94
El Dorado,2020-12-29,29,0,190,10,0,4,29
Stanislaus,2020-12-29,329,16,1299,68,1,18,345
Santa Clara,2020-12-29,701,19,3126,162,1,28,720
Orange,2020-12-29,2145,44,6060,479,2,70,2189
Los Angeles,2020-12-29,7546,279,20330,1528,42,330,7825
Glenn,2020-12-29,15,0,47,0,0,0,15
Alameda,2020-12-29,449,32,2557,123,3,72,481
Santa Barbara,2020-12-29,135,6,668,34,0,23,141
Yuba,2020-12-29,72,0,261,18,0,1,72
Sutter,2020-12-29,0,0,14,0,0,0,0
Placer,2020-12-29,216,15,753,22,2,18,231
Ventura,2020-12-29,357,14,1237,73,4,36,371
Santa Cruz,2020-12-29,74,0,372,15,0,1,74
Calaveras,2020-12-29,3,0,33,1,0,2,3
Inyo,2020-12-29,10,0,29,1,0,3,10
Tulare,2020-12-29,223,7,622,23,0,12,230
Trinity,2020-12-29,0,0,25,0,0,0,0
Yolo,2020-12-29,22,0,169,6,0,21,22
Siskiyou,2020-12-29,2,0,56,1,0,9,2
Solano,2020-12-29,142,13,578,33,2,13,155
San Mateo,2020-12-29,168,5,746,34,0,28,173
Monterey,2020-12-29,202,2,717,36,0,14,204
Madera,2020-12-29,48,8,288,8,0,11,56
Plumas,2020-12-29,2,0,35,0,0,0,2
Kern,2020-12-29,383,7,1171,79,1,14,390
Fresno,2020-12-29,629,23,1582,136,0,7,652
Tuolumne,2020-12-29,10,1,84,2,0,2,11
Lake,2020-12-29,7,0,77,3,0,1,7
Merced,2020-12-29,56,0,271,16,0,0,56
Humboldt,2020-12-29,7,3,267,3,0,11,10
Contra Costa,2020-12-29,247,15,1543,60,2,26,262
San Bernardino,2020-12-29,1770,88,4160,345,7,57,1858
Imperial,2020-12-29,176,2,265,53,0,-1,178
San Benito,2020-12-29,13,0,25,3,0,0,13
Napa,2020-12-29,26,1,262,12,0,1,27
Mariposa,2020-12-29,1,0,19,0,0,0,1
Tehama,2020-12-29,22,0,59,2,0,0,22
San Luis Obispo,2020-12-29,61,0,460,15,0,19,61
Colusa,2020-12-29,6,1,48,0,0,5,7
Nevada,2020-12-29,15,0,125,4,0,2,15
Riverside,2020-12-29,1484,84,3533,297,7,24,1568
Modoc,2020-12-29,1,0,12,0,0,0,1
Marin,2020-12-29,30,4,347,6,0,12,34
Del Norte,2020-12-29,3,0,51,2,0,3,3
Mono,2020-12-29,0,0,17,0,0,1,0
San Diego,2020-12-29,1470,62,6733,393,5,172,1532
Sacramento,2020-12-29,451,49,2608,92,3,86,500
Santa Cruz,2020-12-30,76,0,372,17,0,2,76
Yuba,2020-12-30,73,25,261,18,0,0,98
Santa Barbara,2020-12-30,141,6,668,35,0,18,147
Kings,2020-12-30,90,1,129,7,0,0,91
Siskiyou,2020-12-30,4,0,56,1,0,8,4
Sonoma,2020-12-30,88,2,590,18,0,24,90
Butte,2020-12-30,83,0,451,15,0,4,83
San Luis Obispo,2020-12-30,58,1,460,14,0,20,59
Plumas,2020-12-30,2,0,35,0,0,0,2
Monterey,2020-12-30,198,1,717,34,0,13,199
Stanislaus,2020-12-30,328,15,1296,69,3,16,343
Calaveras,2020-12-30,4,0,33,0,0,4,4
Madera,2020-12-30,51,12,288,7,0,8,63
Sutter,2020-12-30,0,0,14,0,0,0,0
Del Norte,2020-12-30,4,0,51,2,0,3,4
San Francisco,2020-12-30,212,3,1967,56,2,59,215
Fresno,2020-12-30,602,19,1571,118,4,12,621
Humboldt,2020-12-30,5,2,274,2,1,15,7
Contra Costa,2020-12-30,255,16,1565,67,2,25,271
Glenn,2020-12-30,14,0,47,0,0,0,14
Marin,2020-12-30,31,4,346,5,0,12,35
Placer,2020-12-30,200,15,756,23,2,18,215
Amador,2020-12-30,9,1,52,3,0,0,10
El Dorado,2020-12-30,29,0,190,11,0,0,29
San Mateo,2020-12-30,172,6,737,41,0,26,178
Riverside,2020-12-30,1464,82,3572,296,3,31,1546
Mono,2020-12-30,0,0,17,0,0,1,0
Los Angeles,2020-12-30,7628,300,20515,1580,40,320,7928
Nevada,2020-12-30,13,0,137,4,0,1,13
San Bernardino,2020-12-30,1707,78,4135,339,6,41,1785
Merced,2020-12-30,56,0,272,16,0,0,56
Kern,2020-12-30,376,8,1174,78,1,10,384
Alameda,2020-12-30,454,42,2526,115,5,71,496
San Diego,2020-12-30,1499,50,6741,393,6,160,1549
Colusa,2020-12-30,6,0,48,0,0,5,6
Imperial,2020-12-30,176,2,265,50,0,4,178
Solano,2020-12-30,138,12,583,35,0,3,150
Mariposa,2020-12-30,1,0,19,0,0,0,1
Tehama,2020-12-30,22,0,59,1,0,0,22
Sacramento,2020-12-30,491,20,2631,97,3,80,511
Napa,2020-12-30,30,1,260,14,0,1,31
Tuolumne,2020-12-30,10,0,84,2,0,3,10
Yolo,2020-12-30,25,0,169,6,0,22,25
Santa Clara,2020-12-30,695,20,3156,156,1,39,715
Inyo,2020-12-30,9,0,29,1,0,3,9
San Joaquin,2020-12-30,323,10,905,80,2,6,333
Tulare,2020-12-30,218,9,622,24,1,14,227
Lake,2020-12-30,8,0,77,3,0,3,8
Modoc,2020-12-30,1,0,12,0,0,0,1
Lassen,2020-12-30,5,0,25,0,0,0,5
Trinity,2020-12-30,0,0,25,0,0,0,0
San Benito,2020-12-30,14,0,25,3,0,0,14
Mendocino,2020-12-30,11,0,96,2,0,8,11
Orange,2020-12-30,2128,41,6064,495,1,84,2169
Shasta,2020-12-30,39,0,567,6,0,9,39
Ventura,2020-12-30,364,20,1239,73,3,31,384
Merced,2020-12-31,57,1,272,18,0,1,58
San Diego,2020-12-31,1487,56,6743,381,12,175,1543
San Benito,2020-12-31,14,0,25,3,0,0,14
Siskiyou,2020-12-31,5,0,56,2,0,8,5
Nevada,2020-12-31,10,0,125,5,0,0,10
Humboldt,2020-12-31,4,3,274,1,0,14,7
Alameda,2020-12-31,454,43,2529,115,6,67,497
Tulare,2020-12-31,225,13,627,25,1,13,238
Santa Clara,2020-12-31,687,26,3123,165,2,33,713
Sonoma,2020-12-31,90,2,615,19,0,19,92
Santa Cruz,2020-12-31,78,0,372,17,0,1,78
Trinity,2020-12-31,0,0,25,0,0,0,0
Napa,2020-12-31,28,0,247,16,0,2,28
Calaveras,2020-12-31,3,0,33,0,0,4,3
Colusa,2020-12-31,5,0,48,0,0,5,5
Madera,2020-12-31,50,15,288,9,0,8,65
Santa Barbara,2020-12-31,137,11,668,36,0,21,148
Tehama,2020-12-31,21,0,59,1,0,0,21
Monterey,2020-12-31,189,1,717,35,0,21,190
Butte,2020-12-31,74,1,451,11,0,9,75
Lassen,2020-12-31,6,0,25,0,0,0,6
San Joaquin,2020-12-31,309,14,912,83,3,7,323
Los Angeles,2020-12-31,7627,270,20438,1600,36,324,7897
Placer,2020-12-31,188,13,761,25,0,21,201
Solano,2020-12-31,149,11,591,38,1,6,160
Inyo,2020-12-31,7,0,29,1,0,3,7
Mariposa,2020-12-31,0,0,19,0,0,0,0
Tuolumne,2020-12-31,9,0,84,2,0,2,9
Modoc,2020-12-31,1,0,12,0,0,0,1
Yolo,2020-12-31,25,0,169,8,0,21,25
El Dorado,2020-12-31,33,0,190,14,0,1,33
Riverside,2020-12-31,1516,123,3565,308,7,26,1639
Plumas,2020-12-31,2,0,35,0,0,0,2
Contra Costa,2020-12-31,254,15,1566,65,2,60,269
Ventura,2020-12-31,359,15,1220,71,5,31,374
Shasta,2020-12-31,35,0,567,6,0,13,35
San Luis Obispo,2020-12-31,62,1,460,15,0,18,63
Sacramento,2020-12-31,467,27,2605,103,7,68,494
Mono,2020-12-31,0,0,17,0,0,2,0
Amador,2020-12-31,10,0,52,3,0,0,10
Glenn,2020-12-31,11,0,47,0,0,0,11
Yuba,2020-12-31,69,23,261,17,0,1,92
Kings,2020-12-31,79,1,140,9,0,0,80
Fresno,2020-12-31,606,22,1548,148,0,10,628
San Bernardino,2020-12-31,1705,97,4126,345,6,40,1802
Del Norte,2020-12-31,4,0,51,2,0,3,4
San Francisco,2020-12-31,207,8,1939,55,2,64,215
Orange,2020-12-31,2097,50,6085,501,0,96,2147
Sutter,2020-12-31,0,0,14,0,0,0,0
Mendocino,2020-12-31,13,0,96,2,0,6,13
Imperial,2020-12-31,167,1,265,52,0,6,168
Kern,2020-12-31,379,8,1176,78,1,13,387
Marin,2020-12-31,38,4,352,7,0,8,42
San Mateo,2020-12-31,162,5,730,40,0,27,167
Lake,2020-12-31,11,0,77,4,0,1,11
Stanislaus,2020-12-31,315,13,1295,63,2,12,328
Marin,2021-01-01,37,3,339,9,0,9,40
Kings,2021-01-01,81,0,127,11,0,0,81
Sonoma,2021-01-01,94,4,618,20,0,10,98
Calaveras,2021-01-01,2,0,33,0,0,4,2
El Dorado,2021-01-01,33,0,190,9,0,2,33
Butte,2021-01-01,81,2,451,18,1,3,83
Ventura,2021-01-01,359,16,1219,75,2,27,375
Colusa,2021-01-01,5,0,48,0,0,5,5
Yuba,2021-01-01,69,17,261,20,0,1,86
Santa Cruz,2021-01-01,77,0,372,18,0,2,77
Placer,2021-01-01,193,13,754,26,2,21,206
Yolo,2021-01-01,24,0,169,12,0,16,24
San Diego,2021-01-01,1497,63,6740,377,9,177,1560
Stanislaus,2021-01-01,325,9,1297,69,1,15,334
Santa Clara,2021-01-01,682,21,3108,158,4,35,703
Tuolumne,2021-01-01,14,0,84,1,0,1,14
Tehama,2021-01-01,22,0,59,5,0,0,22
Inyo,2021-01-01,6,1,29,2,0,2,7
Del Norte,2021-01-01,3,0,51,1,0,0,3
Monterey,2021-01-01,194,0,717,31,0,37,194
Madera,2021-01-01,49,3,288,8,1,9,52
San Benito,2021-01-01,16,0,25,4,0,0,16
Mariposa,2021-01-01,0,0,19,0,0,0,0
Humboldt,2021-01-01,5,2,269,1,1,20,7
Mendocino,2021-01-01,12,0,121,3,0,4,12
Trinity,2021-01-01,0,0,25,0,0,0,0
Mono,2021-01-01,0,0,17,0,0,1,0
San Joaquin,2021-01-01,300,13,908,79,3,7,313
Kern,2021-01-01,364,10,1140,83,0,12,374
Fresno,2021-01-01,597,20,1543,135,1,10,617
Nevada,2021-01-01,10,4,129,4,0,0,14
Los Angeles,2021-01-01,7544,280,20331,1587,27,325,7824
Alameda,2021-01-01,430,38,2514,114,4,63,468
Sacramento,2021-01-01,469,29,2613,109,3,68,498
Imperial,2021-01-01,176,0,265,59,0,4,176
Santa Barbara,2021-01-01,136,7,668,39,0,25,143
Merced,2021-01-01,53,0,272,18,0,3,53
Napa,2021-01-01,30,0,252,16,0,4,30
Amador,2021-01-01,10,0,52,4,0,0,10
Contra Costa,2021-01-01,251,12,1549,67,0,26,263
San Bernardino,2021-01-01,1676,86,4093,349,1,49,1762
Modoc,2021-01-01,2,0,12,0,0,0,2
Sutter,2021-01-01,0,0,14,0,0,0,0
Orange,2021-01-01,2057,55,6079,506,6,86,2112
San Francisco,2021-01-01,209,5,1949,55,1,58,214
Siskiyou,2021-01-01,5,0,56,2,0,7,5
Lassen,2021-01-01,5,0,25,0,0,0,5
Lake,2021-01-01,9,0,77,5,0,1,9
San Mateo,2021-01-01,171,6,733,40,1,23,177
Plumas,2021-01-01,2,0,35,0,0,0,2
Shasta,2021-01-01,40,1,567,8,0,12,41
San Luis Obispo,2021-01-01,50,2,354,15,0,112,52
Glenn,2021-01-01,11,0,47,0,0,0,11
Riverside,2021-01-01,1486,117,3567,296,4,23,1603
Solano,2021-01-01,146,13,583,41,2,2,159
Tulare,2021-01-01,225,7,626,22,1,14,232
Monterey,2021-01-02,195,0,717,31,0,35,195
El Dorado,2021-01-02,35,2,190,10,1,2,37
Colusa,2021-01-02,5,0,48,0,0,5,5
Los Angeles,2021-01-02,7697,274,20244,1599,39,327,7971
San Francisco,2021-01-02,214,5,1946,57,1,63,219
Butte,2021-01-02,87,1,451,13,0,7,88
Stanislaus,2021-01-02,331,8,1300,74,2,14,339
Mono,2021-01-02,0,0,18,0,0,2,0
Merced,2021-01-02,54,0,271,18,0,3,54
Contra Costa,2021-01-02,251,15,1546,64,1,39,266
Marin,2021-01-02,36,3,335,6,0,11,39
Santa Cruz,2021-01-02,76,0,372,18,0,1,76
Fresno,2021-01-02,601,27,1529,130,1,11,628
Santa Clara,2021-01-02,689,20,3108,148,2,48,709
Inyo,2021-01-02,6,1,29,2,0,2,7
Plumas,2021-01-02,1,0,35,0,0,0,1
Orange,2021-01-02,2136,36,6015,487,5,83,2172
Riverside,2021-01-02,1523,107,3537,299,3,34,1630
Humboldt,2021-01-02,6,3,269,1,0,21,9
Kings,2021-01-02,85,0,139,12,0,0,85
Tuolumne,2021-01-02,11,0,84,0,0,2,11
Yuba,2021-01-02,69,12,261,20,0,1,81
San Mateo,2021-01-02,170,12,746,41,1,23,182
Del Norte,2021-01-02,4,0,51,1,0,0,4
Nevada,2021-01-02,8,3,129,4,0,1,11
Siskiyou,2021-01-02,5,0,56,2,0,9,5
Trinity,2021-01-02,0,0,25,0,0,0,0
San Bernardino,2021-01-02,1715,65,4116,355,13,50,1780
Tehama,2021-01-02,26,0,59,1,0,0,26
Sutter,2021-01-02,0,0,14,0,0,0,0
Santa Barbara,2021-01-02,143,9,668,40,0,21,152
Alameda,2021-01-02,428,48,2513,116,8,59,476
Shasta,2021-01-02,39,2,567,9,0,13,41
Sacramento,2021-01-02,451,29,2623,106,4,82,480
Amador,2021-01-02,11,0,52,4,0,0,11
Modoc,2021-01-02,2,0,12,0,0,0,2
Ventura,2021-01-02,366,18,1230,79,5,23,384
San Joaquin,2021-01-02,307,5,894,81,2,7,312
San Diego,2021-01-02,1486,57,6737,369,6,186,1543
Madera,2021-01-02,50,9,288,8,1,9,59
San Benito,2021-01-02,16,0,25,4,0,0,16
Mariposa,2021-01-02,0,0,19,0,0,0,0
Glenn,2021-01-02,11,0,47,0,0,0,11
Kern,2021-01-02,375,8,1123,79,0,14,383
Calaveras,2021-01-02,3,0,33,0,0,4,3
Sonoma,2021-01-02,93,1,576,17,0,27,94
Tulare,2021-01-02,223,4,626,25,2,14,227
Solano,2021-01-02,157,15,598,38,1,8,172
Lake,2021-01-02,9,0,77,4,0,2,9
Placer,2021-01-02,182,18,750,29,4,20,200
Lassen,2021-01-02,5,0,25,0,0,0,5
Napa,2021-01-02,29,1,241,15,1,1,30
Yolo,2021-01-02,24,0,169,13,0,17,24
Imperial,2021-01-02,182,0,265,61,0,1,182
Mendocino,2021-01-02,13,0,121,4,0,3,13
San Luis Obispo,2021-01-02,49,2,460,15,1,19,51
Yolo,2021-01-03,29,0,170,15,0,26,29
Merced,2021-01-03,57,0,271,18,0,4,57
Modoc,2021-01-03,2,0,12,0,0,0,2
San Benito,2021-01-03,11,0,25,3,0,0,11
San Joaquin,2021-01-03,298,5,886,88,1,23,303
Alameda,2021-01-03,425,41,2473,116,6,62,466
Stanislaus,2021-01-03,344,11,1299,71,1,15,355
Del Norte,2021-01-03,4,0,51,1,0,2,4
San Mateo,2021-01-03,179,9,742,44,2,24,188
Santa Barbara,2021-01-03,157,7,688,48,0,23,164
Siskiyou,2021-01-03,5,0,56,1,0,10,5
Placer,2021-01-03,176,16,746,31,2,23,192
Yuba,2021-01-03,71,7,261,18,0,1,78
Nevada,2021-01-03,8,3,129,4,0,2,11
Lassen,2021-01-03,5,0,25,0,0,0,5
Colusa,2021-01-03,3,1,48,0,0,5,4
Plumas,2021-01-03,1,0,35,0,0,0,1
Mono,2021-01-03,0,0,17,0,0,1,0
San Bernardino,2021-01-03,1733,76,4129,343,7,55,1809
Mariposa,2021-01-03,1,0,19,0,0,0,1
Butte,2021-01-03,86,1,451,9,1,10,87
Mendocino,2021-01-03,12,0,121,3,0,2,12
El Dorado,2021-01-03,35,0,190,10,0,4,35
San Francisco,2021-01-03,206,5,1921,54,1,64,211
Sutter,2021-01-03,0,0,14,0,0,0,0
Santa Cruz,2021-01-03,82,0,372,17,0,3,82
Fresno,2021-01-03,620,43,1582,129,3,6,663
Shasta,2021-01-03,42,0,567,9,0,10,42
Santa Clara,2021-01-03,704,20,3120,147,3,44,724
Kern,2021-01-03,384,11,1139,82,1,14,395
Trinity,2021-01-03,0,0,25,0,0,0,0
Contra Costa,2021-01-03,259,13,1519,65,0,34,272
Marin,2021-01-03,39,2,339,6,0,10,41
Orange,2021-01-03,2178,40,6022,500,6,84,2218
Riverside,2021-01-03,1543,117,3414,330,3,31,1660
Napa,2021-01-03,30,0,249,16,0,1,30
San Diego,2021-01-03,1507,52,6740,373,4,189,1559
Ventura,2021-01-03,377,23,1222,79,4,20,400
Amador,2021-01-03,11,0,52,4,0,0,11
Tehama,2021-01-03,22,0,59,1,0,0,22
Kings,2021-01-03,84,0,134,12,0,0,84
San Luis Obispo,2021-01-03,52,1,460,12,0,22,53
Sonoma,2021-01-03,98,0,568,17,0,21,98
Imperial,2021-01-03,170,0,265,60,0,1,170
Madera,2021-01-03,53,7,288,10,0,6,60
Humboldt,2021-01-03,7,3,267,2,0,14,10
Inyo,2021-01-03,7,0,29,2,0,2,7
Solano,2021-01-03,166,13,600,41,2,8,179
Sacramento,2021-01-03,488,36,2610,105,7,81,524
Los Angeles,2021-01-03,7898,305,20328,1627,31,326,8203
Glenn,2021-01-03,10,0,47,0,0,0,10
Tulare,2021-01-03,224,7,627,26,2,11,231
Calaveras,2021-01-03,3,0,33,0,0,4,3
Tuolumne,2021-01-03,11,0,84,1,0,2,11
Lake,2021-01-03,8,0,77,3,0,2,8
Monterey,2021-01-03,203,0,717,31,0,35,203
Sacramento,2021-01-04,465,33,2629,102,9,87,498
San Francisco,2021-01-04,211,5,1965,54,2,64,216
Glenn,2021-01-04,10,0,47,0,0,0,10
Kings,2021-01-04,96,0,137,14,0,4,96
Trinity,2021-01-04,0,0,25,0,0,0,0
Orange,2021-01-04,2236,42,6031,504,5,88,2278
Modoc,2021-01-04,2,0,12,0,0,0,2
San Joaquin,2021-01-04,324,9,902,87,1,17,333
San Benito,2021-01-04,11,0,25,3,0,0,11
San Mateo,2021-01-04,178,8,748,41,0,8,186
Mono,2021-01-04,0,0,17,0,0,2,0
Tuolumne,2021-01-04,12,0,84,1,0,0,12
Inyo,2021-01-04,8,0,29,2,0,2,8
Mariposa,2021-01-04,1,0,19,0,0,0,1
Lassen,2021-01-04,6,0,25,0,0,0,6
Siskiyou,2021-01-04,4,0,56,1,0,9,4
San Bernardino,2021-01-04,1763,93,4126,346,5,58,1856
Madera,2021-01-04,53,9,288,11,0,2,62
Plumas,2021-01-04,1,0,35,0,0,0,1
Solano,2021-01-04,170,16,595,36,3,11,186
Nevada,2021-01-04,9,1,129,3,1,0,10
Monterey,2021-01-04,198,1,717,32,0,36,199
Amador,2021-01-04,12,0,52,3,0,0,12
Tulare,2021-01-04,231,5,632,27,0,10,236
Tehama,2021-01-04,18,0,59,2,0,0,18
Placer,2021-01-04,178,15,744,29,7,19,193
Yolo,2021-01-04,28,0,170,12,0,14,28
Humboldt,2021-01-04,7,3,268,2,1,14,10
Santa Cruz,2021-01-04,86,0,372,18,0,0,86
Santa Barbara,2021-01-04,172,8,598,55,2,15,180
San Luis Obispo,2021-01-04,58,0,460,14,0,17,58
Imperial,2021-01-04,181,0,265,67,0,0,181
Marin,2021-01-04,34,4,336,6,0,11,38
Colusa,2021-01-04,4,0,48,0,0,5,4
Mendocino,2021-01-04,13,0,121,4,0,6,13
Merced,2021-01-04,60,0,271,17,0,4,60
Sutter,2021-01-04,0,0,14,0,0,0,0
Del Norte,2021-01-04,4,0,51,1,0,1,4
Calaveras,2021-01-04,3,0,33,0,0,5,3
El Dorado,2021-01-04,38,0,190,12,0,5,38
Riverside,2021-01-04,1615,122,3629,342,5,20,1737
Alameda,2021-01-04,424,57,2492,109,6,64,481
Kern,2021-01-04,401,5,1158,90,0,9,406
Santa Clara,2021-01-04,719,19,3105,146,6,40,738
Butte,2021-01-04,84,1,451,9,0,13,85
San Diego,2021-01-04,1537,48,6742,382,5,202,1585
Sonoma,2021-01-04,102,0,566,20,0,21,102
Lake,2021-01-04,9,0,78,4,0,1,9
Shasta,2021-01-04,45,0,567,10,0,10,45
Yuba,2021-01-04,68,2,261,17,1,1,70
Contra Costa,2021-01-04,269,19,1503,69,2,35,288
Los Angeles,2021-01-04,8023,295,20371,1642,27,338,8318
Fresno,2021-01-04,640,46,1610,126,3,11,686
Napa,2021-01-04,27,0,243,14,0,0,27
Stanislaus,2021-01-04,355,7,1298,61,1,18,362
Ventura,2021-01-04,394,15,1222,87,8,22,409
Los Angeles,2021-01-05,8098,324,20495,1628,40,313,8422
Shasta,2021-01-05,51,0,567,10,0,9,51
Marin,2021-01-05,36,4,336,6,0,11,40
Mariposa,2021-01-05,1,0,19,0,0,0,1
Butte,2021-01-05,96,0,451,8,0,12,96
San Benito,2021-01-05,13,0,25,4,0,0,13
Tuolumne,2021-01-05,11,0,84,2,0,0,11
Siskiyou,2021-01-05,5,0,56,1,0,8,5
Nevada,2021-01-05,12,0,118,4,0,4,12
Santa Barbara,2021-01-05,167,6,598,55,1,17,173
Merced,2021-01-05,58,0,271,16,0,3,58
Madera,2021-01-05,55,5,288,10,1,1,60
Glenn,2021-01-05,6,0,47,0,0,0,6
Orange,2021-01-05,2250,42,6076,485,3,85,2292
San Diego,2021-01-05,1585,61,6746,383,8,218,1646
San Mateo,2021-01-05,188,8,760,38,0,8,196
Sonoma,2021-01-05,101,1,595,23,0,18,102
Solano,2021-01-05,168,14,603,34,1,8,182
Kings,2021-01-05,91,0,145,16,0,0,91
Contra Costa,2021-01-05,271,13,1530,62,3,36,284
Sutter,2021-01-05,0,0,14,0,0,0,0
Mono,2021-01-05,2,0,17,0,0,2,2
Plumas,2021-01-05,0,0,35,0,0,0,0
Tehama,2021-01-05,17,0,59,3,0,2,17
Mendocino,2021-01-05,13,0,118,5,0,4,13
Kern,2021-01-05,416,6,1165,86,0,14,422
Humboldt,2021-01-05,6,2,274,2,2,11,8
Monterey,2021-01-05,190,4,717,33,0,32,194
Placer,2021-01-05,180,22,742,27,5,20,202
Stanislaus,2021-01-05,361,8,1296,68,1,11,369
Amador,2021-01-05,9,1,52,4,0,0,10
Colusa,2021-01-05,5,0,48,0,0,5,5
Del Norte,2021-01-05,3,0,51,1,0,1,3
San Francisco,2021-01-05,221,8,1964,60,1,53,229
Lassen,2021-01-05,5,0,25,0,0,0,5
Sacramento,2021-01-05,509,33,2646,118,9,78,542
Santa Clara,2021-01-05,726,15,3142,163,4,37,741
Fresno,2021-01-05,659,36,1619,122,0,6,695
Yuba,2021-01-05,71,5,261,15,0,1,76
Riverside,2021-01-05,1611,120,3657,343,2,23,1731
Imperial,2021-01-05,172,1,265,64,0,4,173
El Dorado,2021-01-05,40,0,190,12,0,6,40
Trinity,2021-01-05,0,0,25,0,0,0,0
Calaveras,2021-01-05,5,0,33,3,0,4,5
Modoc,2021-01-05,2,0,12,0,0,0,2
Napa,2021-01-05,25,0,254,16,0,41,25
San Bernardino,2021-01-05,1785,77,4107,352,3,53,1862
San Joaquin,2021-01-05,340,8,905,87,1,8,348
San Luis Obispo,2021-01-05,64,2,460,16,1,13,66
Santa Cruz,2021-01-05,84,0,372,16,0,5,84
Alameda,2021-01-05,442,51,2512,109,7,71,493
Yolo,2021-01-05,30,2,169,10,0,16,32
Lake,2021-01-05,12,0,77,4,0,1,12
Ventura,2021-01-05,419,13,1220,85,2,22,432
Tulare,2021-01-05,228,6,632,25,0,14,234
Inyo,2021-01-05,8,0,29,2,0,2,8
Nevada,2021-01-06,13,0,121,4,0,3,13
San Benito,2021-01-06,14,0,25,5,0,0,14
Tulare,2021-01-06,219,3,632,26,0,14,222
Trinity,2021-01-06,0,0,25,0,0,0,0
Santa Barbara,2021-01-06,178,4,598,59,0,18,182
Mendocino,2021-01-06,12,0,121,4,0,4,12
Mariposa,2021-01-06,1,0,19,0,0,0,1
Humboldt,2021-01-06,8,3,274,3,2,10,11
Butte,2021-01-06,86,0,451,9,0,11,86
Plumas,2021-01-06,0,0,35,0,0,0,0
Santa Cruz,2021-01-06,76,0,372,14,0,4,76
San Mateo,2021-01-06,180,7,776,39,1,12,187
Kern,2021-01-06,433,13,1164,92,2,13,446
Del Norte,2021-01-06,2,0,51,1,0,1,2
San Francisco,2021-01-06,233,10,2050,60,1,46,243
Modoc,2021-01-06,1,0,12,0,0,0,1
Napa,2021-01-06,26,1,263,22,0,3,27
San Joaquin,2021-01-06,334,9,912,87,0,7,343
El Dorado,2021-01-06,39,0,190,10,0,3,39
Mono,2021-01-06,1,0,17,0,0,2,1
Placer,2021-01-06,181,19,747,27,3,13,200
Alameda,2021-01-06,431,50,2514,112,4,69,481
Calaveras,2021-01-06,6,0,33,3,0,4,6
Inyo,2021-01-06,8,0,29,2,0,2,8
Los Angeles,2021-01-06,8074,311,20435,1665,36,328,8385
Monterey,2021-01-06,207,5,717,32,0,33,212
Tehama,2021-01-06,17,0,59,4,0,1,17
Riverside,2021-01-06,1634,119,3642,364,12,27,1753
Solano,2021-01-06,170,14,583,36,1,8,184
Fresno,2021-01-06,626,29,1594,114,0,8,655
Santa Clara,2021-01-06,723,28,3161,165,6,27,751
Orange,2021-01-06,2253,53,5993,502,4,80,2306
Sacramento,2021-01-06,499,32,2654,115,6,66,531
San Luis Obispo,2021-01-06,70,1,460,17,0,13,71
Imperial,2021-01-06,174,2,265,66,0,4,176
Tuolumne,2021-01-06,10,0,84,1,0,1,10
Sonoma,2021-01-06,105,3,671,19,2,24,108
Marin,2021-01-06,38,3,340,8,0,14,41
Kings,2021-01-06,93,1,146,16,0,4,94
Ventura,2021-01-06,418,8,1164,86,1,21,426
Yuba,2021-01-06,65,5,261,13,0,4,70
Lassen,2021-01-06,4,0,25,0,0,0,4
Merced,2021-01-06,57,0,271,16,0,3,57
Sutter,2021-01-06,0,0,14,0,0,0,0
Madera,2021-01-06,57,4,282,11,0,2,61
San Bernardino,2021-01-06,1762,81,4009,363,5,54,1843
Yolo,2021-01-06,30,0,169,11,0,16,30
Glenn,2021-01-06,6,0,47,0,0,0,6
Shasta,2021-01-06,49,0,567,7,0,8,49
Stanislaus,2021-01-06,349,9,1296,66,2,12,358
San Diego,2021-01-06,1661,71,6755,391,9,169,1732
Amador,2021-01-06,9,0,52,4,0,1,9
Colusa,2021-01-06,7,0,48,0,0,5,7
Contra Costa,2021-01-06,273,17,1536,66,2,27,290
Siskiyou,2021-01-06,5,0,56,1,0,9,5
Lake,2021-01-06,11,0,77,4,0,2,11
El Dorado,2021-01-07,37,0,190,11,0,6,37
Colusa,2021-01-07,7,0,48,0,0,5,7
Del Norte,2021-01-07,2,0,51,1,0,1,2
San Diego,2021-01-07,1685,71,6787,401,9,169,1756
Solano,2021-01-07,179,18,594,41,1,6,197
Glenn,2021-01-07,6,0,47,0,0,0,6
Marin,2021-01-07,38,3,344,7,0,12,41
Santa Clara,2021-01-07,713,36,3164,164,8,30,749
San Bernardino,2021-01-07,1751,82,3954,362,5,48,1833
Merced,2021-01-07,58,0,272,16,0,4,58
San Benito,2021-01-07,11,0,25,4,0,0,11
Los Angeles,2021-01-07,7966,327,20437,1714,27,305,8293
Contra Costa,2021-01-07,288,19,1552,66,4,33,307
Fresno,2021-01-07,640,22,1556,102,0,6,662
Imperial,2021-01-07,170,1,265,65,0,4,171
Yuba,2021-01-07,69,3,261,14,0,3,72
Modoc,2021-01-07,1,1,11,0,0,0,2
Kern,2021-01-07,437,16,1172,103,0,16,453
Yolo,2021-01-07,31,0,169,10,0,17,31
San Francisco,2021-01-07,244,6,2064,61,0,37,250
Monterey,2021-01-07,207,1,717,34,0,37,208
Tuolumne,2021-01-07,11,0,84,2,0,1,11
Orange,2021-01-07,2259,49,6091,514,3,75,2308
Butte,2021-01-07,84,0,451,12,0,7,84
Mariposa,2021-01-07,1,0,19,0,0,0,1
Stanislaus,2021-01-07,349,13,1296,66,1,15,362
San Luis Obispo,2021-01-07,61,3,460,12,0,12,64
Humboldt,2021-01-07,8,2,274,2,0,8,10
San Mateo,2021-01-07,174,14,783,41,0,15,188
Sacramento,2021-01-07,497,40,2626,115,10,63,537
Siskiyou,2021-01-07,4,0,56,1,0,9,4
Sutter,2021-01-07,0,0,14,0,0,0,0
Mono,2021-01-07,0,0,17,0,0,1,0
Mendocino,2021-01-07,12,0,120,4,0,6,12
Nevada,2021-01-07,14,1,121,4,0,3,15
Tehama,2021-01-07,15,0,59,4,0,1,15
Shasta,2021-01-07,48,0,567,5,0,9,48
Napa,2021-01-07,32,0,248,17,0,0,32
Kings,2021-01-07,95,1,136,15,0,2,96
Calaveras,2021-01-07,7,0,33,3,0,4,7
Madera,2021-01-07,53,4,282,13,0,1,57
Plumas,2021-01-07,0,0,35,0,0,0,0
Riverside,2021-01-07,1648,128,3656,370,11,10,1776
Lake,2021-01-07,10,1,77,3,0,3,11
Ventura,2021-01-07,408,8,1160,79,1,22,416
Inyo,2021-01-07,8,0,29,2,0,2,8
Placer,2021-01-07,174,25,745,29,6,12,199
Lassen,2021-01-07,4,0,25,0,0,0,4
Alameda,2021-01-07,432,61,2525,110,4,72,493
Santa Barbara,2021-01-07,183,3,598,60,0,19,186
San Joaquin,2021-01-07,319,12,921,88,0,6,331
Santa Cruz,2021-01-07,77,0,372,13,0,1,77
Trinity,2021-01-07,0,0,25,0,0,0,0
Tulare,2021-01-07,210,5,632,27,1,10,215
Amador,2021-01-07,8,1,52,4,0,1,9
Sonoma,2021-01-07,110,4,651,21,2,18,114
Stanislaus,2021-01-08,343,12,1297,68,2,13,355
Tuolumne,2021-01-08,11,0,84,2,0,1,11
Fresno,2021-01-08,628,22,1560,117,2,9,650
Modoc,2021-01-08,1,0,10,0,0,0,1
Solano,2021-01-08,179,9,598,41,3,11,188
Santa Barbara,2021-01-08,180,6,598,57,1,20,186
Glenn,2021-01-08,6,0,47,0,0,0,6
Napa,2021-01-08,31,0,256,18,0,0,31
Tehama,2021-01-08,14,0,59,3,0,1,14
Tulare,2021-01-08,210,4,677,25,1,8,214
Butte,2021-01-08,80,0,451,9,0,9,80
San Luis Obispo,2021-01-08,56,0,460,11,0,13,56
Placer,2021-01-08,176,17,750,31,4,11,193
Lassen,2021-01-08,3,0,25,0,0,0,3
Shasta,2021-01-08,52,0,567,8,0,10,52
Nevada,2021-01-08,11,0,130,4,0,2,11
Monterey,2021-01-08,204,3,717,30,0,36,207
Del Norte,2021-01-08,2,0,51,0,0,3,2
Mono,2021-01-08,2,0,17,0,0,1,2
Ventura,2021-01-08,410,11,1180,79,3,27,421
Mendocino,2021-01-08,8,0,102,4,0,1,8
San Benito,2021-01-08,15,0,25,6,0,0,15
Inyo,2021-01-08,5,0,29,1,0,3,5
Los Angeles,2021-01-08,7964,289,19600,1731,25,306,8253
San Mateo,2021-01-08,180,10,771,32,1,16,190
Santa Clara,2021-01-08,708,17,3151,173,2,37,725
Sonoma,2021-01-08,101,4,676,17,0,10,105
Plumas,2021-01-08,0,0,35,0,0,0,0
Trinity,2021-01-08,0,0,25,0,0,0,0
Mariposa,2021-01-08,0,0,19,0,0,0,0
Riverside,2021-01-08,1671,119,3633,380,10,23,1790
Alameda,2021-01-08,442,52,2525,112,5,67,494
Merced,2021-01-08,55,0,271,14,0,6,55
Amador,2021-01-08,8,1,52,3,0,0,9
Humboldt,2021-01-08,9,4,274,2,0,15,13
Calaveras,2021-01-08,8,0,33,3,0,4,8
Madera,2021-01-08,45,5,282,14,0,2,50
Colusa,2021-01-08,6,0,48,0,0,5,6
Yuba,2021-01-08,64,0,261,13,0,5,64
Siskiyou,2021-01-08,6,0,56,1,0,9,6
Contra Costa,2021-01-08,280,16,1549,75,1,34,296
Imperial,2021-01-08,156,0,263,64,0,5,156
Santa Cruz,2021-01-08,78,0,372,20,0,3,78
Lake,2021-01-08,12,0,77,3,0,4,12
El Dorado,2021-01-08,36,0,190,10,0,4,36
Sutter,2021-01-08,0,0,14,0,0,0,0
San Joaquin,2021-01-08,314,7,871,86,0,4,321
Yolo,2021-01-08,29,0,169,10,0,17,29
San Diego,2021-01-08,1695,68,6546,410,11,162,1763
Orange,2021-01-08,2221,39,5988,528,3,78,2260
Kern,2021-01-08,422,14,1134,91,0,13,436
San Francisco,2021-01-08,249,5,2082,63,0,50,254
Kings,2021-01-08,94,0,135,12,0,5,94
San Bernardino,2021-01-08,1758,79,3764,360,4,35,1837
Sacramento,2021-01-08,482,31,2636,105,7,63,513
Marin,2021-01-08,34,2,335,8,0,12,36
Tehama,2021-01-09,13,0,59,6,0,1,13
Mono,2021-01-09,2,0,17,0,0,1,2
El Dorado,2021-01-09,42,0,190,10,0,8,42
Lassen,2021-01-09,3,0,25,0,0,0,3
Plumas,2021-01-09,0,0,35,0,0,0,0
Kings,2021-01-09,92,0,135,13,0,3,92
Yuba,2021-01-09,56,0,261,12,0,5,56
Ventura,2021-01-09,421,12,1175,87,2,23,433
Los Angeles,2021-01-09,7910,280,19580,1712,39,319,8190
Calaveras,2021-01-09,10,0,33,3,0,4,10
Trinity,2021-01-09,0,0,25,0,0,0,0
Glenn,2021-01-09,6,0,47,0,0,0,6
Lake,2021-01-09,9,1,77,3,1,4,10
Madera,2021-01-09,44,8,288,12,0,2,52
Alameda,2021-01-09,428,43,2526,115,6,66,471
Del Norte,2021-01-09,2,0,51,0,0,3,2
San Benito,2021-01-09,16,0,25,6,0,0,16
Sonoma,2021-01-09,98,7,646,12,1,10,105
Sacramento,2021-01-09,480,29,2633,110,6,70,509
Shasta,2021-01-09,50,1,567,7,0,4,51
Riverside,2021-01-09,1650,146,3610,375,10,26,1796
Solano,2021-01-09,174,8,610,42,0,10,182
San Luis Obispo,2021-01-09,50,0,460,11,0,16,50
San Joaquin,2021-01-09,316,6,920,90,1,7,322
Imperial,2021-01-09,165,0,264,64,0,0,165
Tuolumne,2021-01-09,11,0,84,3,0,1,11
Placer,2021-01-09,178,26,746,30,5,6,204
Santa Clara,2021-01-09,694,17,3153,172,4,37,711
Santa Barbara,2021-01-09,174,3,598,55,3,20,177
San Mateo,2021-01-09,185,12,765,32,0,16,197
Contra Costa,2021-01-09,296,12,1612,77,1,26,308
Tulare,2021-01-09,211,3,637,27,1,3,214
Mendocino,2021-01-09,15,0,121,2,0,5,15
Sutter,2021-01-09,0,0,14,0,0,0,0
Colusa,2021-01-09,5,0,48,0,0,5,5
San Francisco,2021-01-09,245,7,2121,61,0,54,252
Orange,2021-01-09,2216,34,5984,547,0,95,2250
Nevada,2021-01-09,12,0,115,4,0,1,12
Monterey,2021-01-09,208,4,717,30,0,32,212
Humboldt,2021-01-09,11,0,273,3,0,9,11
Yolo,2021-01-09,33,0,170,13,0,16,33
Napa,2021-01-09,31,0,203,13,0,1,31
Butte,2021-01-09,83,0,451,12,0,7,83
Merced,2021-01-09,56,0,271,16,0,2,56
Siskiyou,2021-01-09,4,0,56,2,0,9,4
San Bernardino,2021-01-09,1716,75,3779,359,7,37,1791
San Diego,2021-01-09,1691,60,6549,399,11,150,1751
Marin,2021-01-09,29,2,339,8,0,12,31
Inyo,2021-01-09,6,0,29,1,0,3,6
Modoc,2021-01-09,1,0,11,0,0,0,1
Fresno,2021-01-09,635,38,1545,114,3,11,673
Amador,2021-01-09,7,0,52,3,0,1,7
Kern,2021-01-09,437,15,1167,102,1,11,452
Santa Cruz,2021-01-09,82,0,372,13,0,0,82
Stanislaus,2021-01-09,338,17,1302,75,0,7,355
Mariposa,2021-01-09,0,0,19,0,0,0,0
San Mateo,2021-01-10,189,12,737,28,1,20,201
Humboldt,2021-01-10,12,0,279,2,0,16,12
Colusa,2021-01-10,5,0,48,0,0,5,5
Contra Costa,2021-01-10,261,13,1587,71,4,36,274
Tehama,2021-01-10,10,0,59,4,0,2,10
Amador,2021-01-10,7,0,52,3,0,0,7
Monterey,2021-01-10,207,14,717,26,0,41,221
San Benito,2021-01-10,19,0,25,6,0,0,19
Madera,2021-01-10,43,9,288,11,0,2,52
Modoc,2021-01-10,1,0,11,0,0,0,1
Lassen,2021-01-10,3,0,25,0,0,0,3
Merced,2021-01-10,58,0,271,15,0,3,58
Sonoma,2021-01-10,97,11,644,13,2,10,108
El Dorado,2021-01-10,46,0,190,8,0,8,46
Trinity,2021-01-10,0,0,25,0,0,0,0
Glenn,2021-01-10,6,0,47,0,0,0,6
Sacramento,2021-01-10,485,27,2615,115,8,82,512
Orange,2021-01-10,2221,56,5936,544,3,84,2277
San Diego,2021-01-10,1697,58,6549,417,13,150,1755
San Joaquin,2021-01-10,320,9,921,91,1,6,329
Solano,2021-01-10,179,11,610,48,1,9,190
Santa Cruz,2021-01-10,69,1,372,13,0,0,70
Los Angeles,2021-01-10,7926,344,19462,1724,35,340,8270
Mono,2021-01-10,1,0,17,0,0,2,1
San Bernardino,2021-01-10,1720,75,3746,356,9,38,1795
Plumas,2021-01-10,0,0,35,0,0,0,0
Del Norte,2021-01-10,2,0,51,0,0,3,2
Butte,2021-01-10,73,1,451,8,0,14,74
Yuba,2021-01-10,56,0,261,14,0,2,56
Tuolumne,2021-01-10,10,0,84,3,0,1,10
Siskiyou,2021-01-10,5,0,56,3,0,9,5
Santa Barbara,2021-01-10,193,4,598,56,2,17,197
San Francisco,2021-01-10,257,10,2112,61,0,70,267
Kern,2021-01-10,449,14,1180,109,2,6,463
Alameda,2021-01-10,424,37,2516,113,4,68,461
Ventura,2021-01-10,410,14,1173,83,3,21,424
Inyo,2021-01-10,5,0,29,1,0,3,5
Yolo,2021-01-10,32,0,171,14,0,16,32
Tulare,2021-01-10,215,5,638,29,1,2,220
Imperial,2021-01-10,151,0,262,64,0,0,151
Kings,2021-01-10,90,0,133,14,0,0,90
Sutter,2021-01-10,0,0,14,0,0,0,0
San Luis Obispo,2021-01-10,48,2,460,8,0,20,50
Stanislaus,2021-01-10,340,13,1305,79,0,14,353
Mendocino,2021-01-10,12,0,109,2,0,6,12
Calaveras,2021-01-10,12,0,33,4,0,3,12
Shasta,2021-01-10,49,1,567,8,0,7,50
Napa,2021-01-10,28,0,207,16,0,1,28
Riverside,2021-01-10,1671,134,3619,357,9,26,1805
Fresno,2021-01-10,626,50,1554,116,1,13,676
Mariposa,2021-01-10,0,0,15,0,0,0,0
Santa Clara,2021-01-10,688,16,3144,163,2,39,704
Marin,2021-01-10,30,4,341,8,0,13,34
Placer,2021-01-10,183,20,753,32,2,4,203
Lake,2021-01-10,10,0,77,3,0,2,10
Nevada,2021-01-10,13,0,115,5,0,8,13
Mariposa,2021-01-11,0,0,15,0,0,0,0
Santa Cruz,2021-01-11,68,1,372,13,0,2,69
Yuba,2021-01-11,54,0,261,14,0,2,54
Madera,2021-01-11,45,2,288,12,0,2,47
San Mateo,2021-01-11,195,10,767,37,1,21,205
Riverside,2021-01-11,1660,131,3550,354,12,16,1791
Kern,2021-01-11,453,11,1178,110,0,11,464
Mendocino,2021-01-11,15,0,116,3,0,5,15
Santa Clara,2021-01-11,687,15,3143,160,5,45,702
Mono,2021-01-11,1,0,17,0,0,2,1
Yolo,2021-01-11,26,0,171,9,0,19,26
Ventura,2021-01-11,437,11,1193,83,2,23,448
Trinity,2021-01-11,0,0,25,0,0,0,0
Sonoma,2021-01-11,97,9,638,17,3,5,106
Monterey,2021-01-11,202,2,717,24,0,26,204
Lassen,2021-01-11,3,0,25,0,0,0,3
San Benito,2021-01-11,18,0,25,6,0,0,18
Tehama,2021-01-11,15,0,59,3,0,0,15
Fresno,2021-01-11,647,37,1569,102,0,13,684
Glenn,2021-01-11,6,0,47,0,0,0,6
Contra Costa,2021-01-11,266,13,1596,70,2,31,279
San Bernardino,2021-01-11,1692,87,3794,341,12,35,1779
Inyo,2021-01-11,4,0,29,0,0,4,4
Los Angeles,2021-01-11,7949,330,19573,1725,37,339,8279
Tulare,2021-01-11,215,6,677,27,3,6,221
Marin,2021-01-11,32,3,339,7,0,13,35
Modoc,2021-01-11,1,0,11,0,0,0,1
Calaveras,2021-01-11,12,0,33,4,0,4,12
Napa,2021-01-11,28,1,204,12,0,2,29
Sacramento,2021-01-11,492,26,2618,120,6,83,518
Shasta,2021-01-11,52,2,567,6,0,4,54
Placer,2021-01-11,184,14,751,30,0,4,198
Del Norte,2021-01-11,1,0,51,0,0,2,1
Plumas,2021-01-11,1,0,35,0,0,0,1
Alameda,2021-01-11,428,50,2487,115,5,70,478
San Francisco,2021-01-11,252,4,2118,59,1,66,256
Solano,2021-01-11,180,16,605,47,5,10,196
Colusa,2021-01-11,6,0,48,0,0,5,6
El Dorado,2021-01-11,46,0,190,9,0,7,46
Tuolumne,2021-01-11,8,0,84,2,0,2,8
Kings,2021-01-11,88,1,132,12,0,1,89
Humboldt,2021-01-11,13,1,274,4,0,12,14
Butte,2021-01-11,72,1,451,12,0,11,73
Santa Barbara,2021-01-11,211,7,598,59,2,15,218
San Joaquin,2021-01-11,327,9,924,91,1,5,336
Merced,2021-01-11,58,0,271,15,0,3,58
Nevada,2021-01-11,12,1,138,4,0,1,13
Stanislaus,2021-01-11,348,9,1305,80,1,10,357
Orange,2021-01-11,2200,47,5981,535,5,87,2247
San Diego,2021-01-11,1725,61,6558,436,5,150,1786
San Luis Obispo,2021-01-11,46,0,460,8,0,21,46
Amador,2021-01-11,8,0,52,3,0,0,8
Imperial,2021-01-11,148,0,262,68,0,24,148
Siskiyou,2021-01-11,4,0,56,3,0,8,4
Sutter,2021-01-11,0,0,14,0,0,0,0
Lake,2021-01-11,9,0,77,3,0,2,9
Kern,2021-01-12,441,10,1164,108,0,18,451
Los Angeles,2021-01-12,7906,295,19619,1699,28,376,8201
Kings,2021-01-12,96,1,137,14,0,0,97
Yuba,2021-01-12,55,0,261,15,0,1,55
Del Norte,2021-01-12,1,0,51,0,0,1,1
Santa Cruz,2021-01-12,72,0,372,13,0,1,72
Santa Barbara,2021-01-12,199,10,598,54,3,16,209
San Benito,2021-01-12,19,0,25,7,0,0,19
Sonoma,2021-01-12,102,8,666,17,3,9,110
Placer,2021-01-12,171,15,748,26,1,9,186
Tulare,2021-01-12,206,9,677,26,2,6,215
Shasta,2021-01-12,53,2,567,6,0,5,55
Humboldt,2021-01-12,15,6,274,4,0,4,21
Nevada,2021-01-12,12,0,125,3,0,4,12
Trinity,2021-01-12,0,0,25,0,0,0,0
Santa Clara,2021-01-12,687,16,3168,157,2,33,703
Mono,2021-01-12,0,0,17,0,0,2,0
Ventura,2021-01-12,448,14,1195,83,3,22,462
Fresno,2021-01-12,645,30,1571,109,2,9,675
Inyo,2021-01-12,4,0,29,0,0,4,4
Lassen,2021-01-12,3,0,25,0,0,0,3
Lake,2021-01-12,7,1,77,3,0,2,8
Calaveras,2021-01-12,12,0,33,4,0,4,12
Butte,2021-01-12,67,1,451,8,0,9,68
Modoc,2021-01-12,0,0,11,0,0,0,0
Tehama,2021-01-12,12,0,59,4,0,0,12
Alameda,2021-01-12,430,38,2505,107,5,61,468
Orange,2021-01-12,2180,42,5964,544,4,85,2222
San Joaquin,2021-01-12,321,14,918,84,1,1,335
San Francisco,2021-01-12,259,14,2142,63,5,52,273
San Diego,2021-01-12,1721,69,6552,434,8,135,1790
Glenn,2021-01-12,6,0,47,0,0,0,6
Amador,2021-01-12,8,0,52,4,0,0,8
Imperial,2021-01-12,142,2,262,61,0,24,144
Colusa,2021-01-12,8,0,48,0,0,5,8
Stanislaus,2021-01-12,359,10,1306,81,1,11,369
Contra Costa,2021-01-12,263,7,1588,68,2,27,270
Mariposa,2021-01-12,0,0,15,0,0,0,0
San Luis Obispo,2021-01-12,55,2,460,7,0,18,57
Siskiyou,2021-01-12,5,2,56,3,0,7,7
Monterey,2021-01-12,207,4,717,25,0,27,211
Yolo,2021-01-12,30,0,169,9,0,18,30
Napa,2021-01-12,30,1,207,14,0,0,31
Tuolumne,2021-01-12,8,0,84,2,0,3,8
Solano,2021-01-12,176,17,618,48,4,3,193
Mendocino,2021-01-12,17,0,113,4,0,2,17
Plumas,2021-01-12,1,0,35,0,0,0,1
El Dorado,2021-01-12,42,0,190,9,0,6,42
Sacramento,2021-01-12,492,23,2652,115,3,71,515
San Bernardino,2021-01-12,1703,91,3813,347,12,41,1794
Madera,2021-01-12,46,4,288,12,0,2,50
Sutter,2021-01-12,0,0,14,0,0,0,0
Merced,2021-01-12,51,0,271,17,0,1,51
Riverside,2021-01-12,1636,125,3569,363,10,15,1761
Marin,2021-01-12,31,2,346,6,0,15,33
San Mateo,2021-01-12,194,11,755,42,1,18,205
Riverside,2021-01-13,1584,117,3509,367,9,11,1701
Los Angeles,2021-01-13,7715,371,19629,1677,40,319,8086
Yolo,2021-01-13,30,0,169,9,0,24,30
Ventura,2021-01-13,448,13,1180,86,3,23,461
Mariposa,2021-01-13,1,0,14,0,0,0,1
Inyo,2021-01-13,5,0,29,0,0,4,5
San Mateo,2021-01-13,193,9,753,42,0,16,202
Butte,2021-01-13,66,0,451,8,0,11,66
Merced,2021-01-13,46,0,271,14,0,3,46
Santa Clara,2021-01-13,669,23,3160,157,5,30,692
Stanislaus,2021-01-13,345,8,1300,78,0,11,353
Siskiyou,2021-01-13,8,0,56,3,0,7,8
Del Norte,2021-01-13,2,0,51,1,0,0,2
Sacramento,2021-01-13,494,16,2638,114,3,58,510
Colusa,2021-01-13,7,0,48,0,0,5,7
Lassen,2021-01-13,5,0,25,0,0,0,5
Nevada,2021-01-13,14,0,136,4,0,5,14
Kings,2021-01-13,95,1,135,12,1,1,96
Monterey,2021-01-13,211,2,717,26,0,21,213
San Luis Obispo,2021-01-13,57,2,460,7,0,16,59
Lake,2021-01-13,8,1,77,3,0,2,9
Marin,2021-01-13,31,2,343,6,0,16,33
Kern,2021-01-13,436,10,1166,98,0,16,446
Calaveras,2021-01-13,9,0,33,3,0,5,9
Alameda,2021-01-13,437,55,2527,116,7,59,492
Modoc,2021-01-13,0,0,11,0,0,0,0
Santa Cruz,2021-01-13,79,0,372,14,0,0,79
San Diego,2021-01-13,1719,56,6557,428,7,138,1775
San Joaquin,2021-01-13,309,12,924,77,2,0,321
Fresno,2021-01-13,623,21,1567,92,2,11,644
Madera,2021-01-13,52,9,279,11,0,3,61
Solano,2021-01-13,173,11,622,49,2,2,184
Sutter,2021-01-13,0,0,14,0,0,0,0
Contra Costa,2021-01-13,250,10,1600,61,1,40,260
Humboldt,2021-01-13,13,4,274,3,0,8,17
Orange,2021-01-13,2169,55,5999,544,5,87,2224
Mono,2021-01-13,0,0,17,0,0,2,0
Trinity,2021-01-13,0,0,25,0,0,0,0
Shasta,2021-01-13,54,2,567,5,0,8,56
Sonoma,2021-01-13,100,0,682,20,0,8,100
El Dorado,2021-01-13,37,0,190,11,0,5,37
Napa,2021-01-13,29,2,206,14,1,0,31
Amador,2021-01-13,7,0,52,4,0,0,7
Tehama,2021-01-13,13,0,59,3,0,0,13
Glenn,2021-01-13,6,2,47,0,0,0,8
Santa Barbara,2021-01-13,197,6,598,53,2,17,203
Placer,2021-01-13,165,12,754,28,2,8,177
San Bernardino,2021-01-13,1678,73,3849,344,9,29,1751
Tuolumne,2021-01-13,7,0,84,3,0,3,7
Plumas,2021-01-13,1,0,35,0,0,0,1
San Francisco,2021-01-13,257,9,2128,61,3,52,266
Tulare,2021-01-13,200,11,677,26,4,8,211
San Benito,2021-01-13,19,0,25,7,0,0,19
Yuba,2021-01-13,53,0,261,15,0,0,53
Mendocino,2021-01-13,16,0,115,4,0,2,16
Imperial,2021-01-13,140,3,263,62,0,0,143
Colusa,2021-01-14,6,0,48,1,0,4,6
Santa Barbara,2021-01-14,192,4,598,52,1,24,196
Marin,2021-01-14,35,3,344,6,1,9,38
Placer,2021-01-14,163,5,751,26,1,7,168
Yolo,2021-01-14,30,0,169,13,0,23,30
Napa,2021-01-14,26,2,211,13,1,2,28
Siskiyou,2021-01-14,5,0,56,0,0,3,5
Riverside,2021-01-14,1563,129,3492,353,8,13,1692
Ventura,2021-01-14,434,12,1183,88,3,23,446
Santa Clara,2021-01-14,647,21,3144,150,4,31,668
Butte,2021-01-14,70,0,451,8,0,12,70
Monterey,2021-01-14,209,7,717,24,0,19,216
El Dorado,2021-01-14,34,0,190,9,0,6,34
San Bernardino,2021-01-14,1660,63,3841,343,9,36,1723
Imperial,2021-01-14,148,2,263,61,0,0,150
Sutter,2021-01-14,0,0,14,0,0,0,0
Calaveras,2021-01-14,11,0,33,5,0,3,11
San Luis Obispo,2021-01-14,57,1,460,9,0,18,58
Amador,2021-01-14,10,0,52,4,0,0,10
Merced,2021-01-14,47,0,271,17,0,2,47
Nevada,2021-01-14,14,0,128,4,0,0,14
Modoc,2021-01-14,0,0,11,0,0,0,0
Yuba,2021-01-14,58,0,261,18,0,1,58
Tulare,2021-01-14,199,8,677,26,0,6,207
Santa Cruz,2021-01-14,80,0,372,12,0,0,80
Mariposa,2021-01-14,1,0,14,0,0,0,1
Tuolumne,2021-01-14,5,0,84,3,0,2,5
Fresno,2021-01-14,614,34,1562,107,2,14,648
Lassen,2021-01-14,4,0,25,0,0,0,4
Shasta,2021-01-14,55,0,567,5,0,17,55
Sacramento,2021-01-14,469,17,2630,124,4,67,486
Sonoma,2021-01-14,94,6,657,18,0,8,100
Plumas,2021-01-14,2,0,35,0,0,0,2
Kern,2021-01-14,435,10,1168,80,0,23,445
Glenn,2021-01-14,6,1,47,0,0,0,7
San Joaquin,2021-01-14,315,8,928,82,1,6,323
Mendocino,2021-01-14,16,0,121,4,0,2,16
Alameda,2021-01-14,437,52,2528,119,7,59,489
Contra Costa,2021-01-14,257,19,1588,62,2,35,276
Kings,2021-01-14,89,1,136,9,1,3,90
Del Norte,2021-01-14,2,0,51,1,0,2,2
Inyo,2021-01-14,4,0,29,0,0,4,4
Solano,2021-01-14,170,16,641,47,4,6,186
San Mateo,2021-01-14,196,8,769,39,0,20,204
San Diego,2021-01-14,1728,57,6553,427,5,141,1785
Trinity,2021-01-14,0,0,25,0,0,0,0
Madera,2021-01-14,49,3,279,11,0,3,52
Mono,2021-01-14,0,0,17,0,0,2,0
Stanislaus,2021-01-14,355,5,1306,77,0,10,360
Lake,2021-01-14,12,0,62,4,0,0,12
Humboldt,2021-01-14,11,1,274,3,0,6,12
San Francisco,2021-01-14,244,9,2120,63,2,50,253
Tehama,2021-01-14,13,0,59,2,0,1,13
Orange,2021-01-14,2102,54,5950,532,7,91,2156
Los Angeles,2021-01-14,7597,300,19626,1675,25,297,7897
San Benito,2021-01-14,19,0,25,7,0,0,19
El Dorado,2021-01-15,36,2,190,9,0,6,38
Mendocino,2021-01-15,13,1,118,2,0,6,14
Amador,2021-01-15,14,0,52,7,0,0,14
Los Angeles,2021-01-15,7498,328,19646,1709,38,286,7826
San Luis Obispo,2021-01-15,54,0,460,9,0,16,54
Monterey,2021-01-15,217,2,717,27,0,4,219
San Diego,2021-01-15,1720,65,6509,425,10,148,1785
Tulare,2021-01-15,203,9,673,27,0,5,212
Fresno,2021-01-15,580,25,1561,85,5,27,605
Calaveras,2021-01-15,7,0,33,4,0,4,7
Trinity,2021-01-15,0,0,25,0,0,0,0
Lassen,2021-01-15,4,0,25,0,0,0,4
Yuba,2021-01-15,53,1,261,18,0,1,54
Riverside,2021-01-15,1567,121,3441,356,11,25,1688
San Bernardino,2021-01-15,1602,64,3870,331,5,52,1666
Marin,2021-01-15,36,2,340,8,0,10,38
Shasta,2021-01-15,52,0,567,5,0,15,52
Santa Barbara,2021-01-15,196,6,598,48,1,28,202
Merced,2021-01-15,54,0,271,15,0,3,54
Butte,2021-01-15,68,0,451,8,0,8,68
Tehama,2021-01-15,14,0,59,2,0,0,14
Mono,2021-01-15,0,0,17,0,0,2,0
San Francisco,2021-01-15,240,4,2123,65,2,53,244
Nevada,2021-01-15,12,0,129,4,0,1,12
Solano,2021-01-15,168,17,614,43,1,2,185
Glenn,2021-01-15,7,1,47,0,0,0,8
Sacramento,2021-01-15,461,12,2624,122,3,67,473
Sonoma,2021-01-15,101,3,680,21,0,4,104
Humboldt,2021-01-15,10,1,274,3,0,6,11
Kings,2021-01-15,88,2,133,10,1,0,90
Orange,2021-01-15,2065,45,5922,542,3,97,2110
Placer,2021-01-15,159,11,751,26,0,11,170
San Joaquin,2021-01-15,296,5,922,79,0,2,301
Lake,2021-01-15,13,0,62,3,0,1,13
Plumas,2021-01-15,2,0,35,0,0,0,2
San Benito,2021-01-15,17,0,25,5,0,0,17
Alameda,2021-01-15,422,48,2521,119,6,59,470
Contra Costa,2021-01-15,274,15,1600,57,2,45,289
Ventura,2021-01-15,440,11,1181,87,2,24,451
Siskiyou,2021-01-15,5,0,56,0,0,6,5
Modoc,2021-01-15,0,0,11,0,0,0,0
Napa,2021-01-15,22,0,211,10,0,2,22
Santa Cruz,2021-01-15,81,0,372,12,0,0,81
Yolo,2021-01-15,28,0,114,11,0,2,28
Inyo,2021-01-15,2,0,29,0,0,2,2
Santa Clara,2021-01-15,654,18,3135,148,4,37,672
Colusa,2021-01-15,15,0,48,0,0,5,15
Imperial,2021-01-15,135,4,264,62,0,0,139
Madera,2021-01-15,49,9,279,16,1,1,58
Del Norte,2021-01-15,1,0,51,0,0,3,1
Tuolumne,2021-01-15,6,0,85,3,0,2,6
Stanislaus,2021-01-15,352,10,1307,80,1,13,362
Kern,2021-01-15,418,9,1186,82,0,18,427
San Mateo,2021-01-15,190,6,759,45,0,19,196
Mariposa,2021-01-15,1,0,14,0,0,0,1
Sutter,2021-01-15,0,0,14,0,0,0,0
Marin,2021-01-16,29,1,333,7,0,5,30
San Diego,2021-01-16,1696,65,6472,416,8,147,1761
Tulare,2021-01-16,204,8,651,28,0,6,212
Yolo,2021-01-16,28,0,114,12,0,2,28
Solano,2021-01-16,166,13,601,45,1,3,179
Tehama,2021-01-16,15,0,59,3,0,0,15
Mendocino,2021-01-16,15,1,121,3,0,6,16
San Benito,2021-01-16,18,0,25,6,0,0,18
Kern,2021-01-16,407,4,1160,89,0,17,411
Butte,2021-01-16,71,0,451,9,0,7,71
San Joaquin,2021-01-16,296,20,927,79,0,7,316
Inyo,2021-01-16,3,0,29,0,0,2,3
Shasta,2021-01-16,58,0,567,6,0,13,58
Placer,2021-01-16,154,7,751,28,1,10,161
Riverside,2021-01-16,1560,107,3386,348,23,17,1667
Fresno,2021-01-16,576,24,1555,88,0,13,600
Imperial,2021-01-16,138,0,264,57,0,0,138
Nevada,2021-01-16,10,0,140,3,0,0,10
Lassen,2021-01-16,4,0,25,0,0,0,4
Kings,2021-01-16,87,1,135,10,0,2,88
Trinity,2021-01-16,0,0,25,0,0,0,0
Santa Barbara,2021-01-16,195,7,598,48,1,20,202
Merced,2021-01-16,64,0,271,17,0,1,64
Madera,2021-01-16,47,8,281,17,0,0,55
Contra Costa,2021-01-16,265,14,1349,58,2,24,279
Del Norte,2021-01-16,2,0,51,0,0,2,2
Stanislaus,2021-01-16,331,8,1302,79,0,13,339
Calaveras,2021-01-16,6,0,33,4,0,4,6
San Luis Obispo,2021-01-16,45,0,460,8,0,17,45
Sutter,2021-01-16,0,0,14,0,0,0,0
Alameda,2021-01-16,446,48,2516,121,7,64,494
Napa,2021-01-16,21,0,206,9,0,4,21
Amador,2021-01-16,14,1,52,6,0,0,15
San Francisco,2021-01-16,239,7,2131,55,2,57,246
Sonoma,2021-01-16,97,6,691,20,0,13,103
San Bernardino,2021-01-16,1523,74,3589,325,7,40,1597
Los Angeles,2021-01-16,7328,296,19425,1720,30,281,7624
Orange,2021-01-16,2026,52,5968,538,2,79,2078
San Mateo,2021-01-16,180,4,720,43,0,17,184
Ventura,2021-01-16,434,5,1165,84,1,27,439
Siskiyou,2021-01-16,5,0,56,0,0,6,5
El Dorado,2021-01-16,32,1,190,11,0,3,33
Lake,2021-01-16,16,0,62,6,0,2,16
Sacramento,2021-01-16,444,18,2636,120,5,68,462
Santa Clara,2021-01-16,635,17,3139,138,5,41,652
Modoc,2021-01-16,0,0,11,0,0,0,0
Humboldt,2021-01-16,10,1,274,3,0,6,11
Plumas,2021-01-16,2,0,35,0,0,0,2
Mono,2021-01-16,0,0,17,0,0,2,0
Monterey,2021-01-16,209,1,717,27,0,14,210
Santa Cruz,2021-01-16,84,0,372,12,0,0,84
Tuolumne,2021-01-16,9,0,85,3,0,0,9
Colusa,2021-01-16,16,0,48,0,0,5,16
Glenn,2021-01-16,7,1,47,0,0,0,8
Mariposa,2021-01-16,2,0,14,0,0,0,2
Yuba,2021-01-16,54,0,261,16,0,3,54
Riverside,2021-01-17,1524,122,3400,339,12,13,1646
San Mateo,2021-01-17,186,4,730,47,0,14,190
Santa Clara,2021-01-17,613,19,3131,148,6,38,632
Yuba,2021-01-17,55,0,261,17,0,2,55
Placer,2021-01-17,152,13,754,23,0,18,165
Inyo,2021-01-17,2,0,29,0,0,2,2
Marin,2021-01-17,28,0,329,8,0,9,28
Plumas,2021-01-17,1,0,35,0,0,0,1
Napa,2021-01-17,27,0,196,11,0,2,27
Tuolumne,2021-01-17,10,0,85,2,0,2,10
Trinity,2021-01-17,0,0,25,0,0,0,0
San Bernardino,2021-01-17,1511,51,3575,322,6,49,1562
San Benito,2021-01-17,18,0,25,6,0,0,18
El Dorado,2021-01-17,33,0,190,10,0,6,33
Del Norte,2021-01-17,1,0,51,0,0,2,1
Sacramento,2021-01-17,441,19,2613,121,5,71,460
Santa Cruz,2021-01-17,83,1,372,12,0,0,84
Mariposa,2021-01-17,2,0,14,0,0,0,2
Butte,2021-01-17,64,0,451,7,0,11,64
Sutter,2021-01-17,0,0,14,0,0,0,0
Tehama,2021-01-17,14,0,59,3,0,1,14
San Luis Obispo,2021-01-17,50,0,460,8,0,19,50
Siskiyou,2021-01-17,2,0,56,1,1,3,2
Santa Barbara,2021-01-17,208,13,598,48,4,13,221
Orange,2021-01-17,1964,51,5913,538,3,86,2015
Merced,2021-01-17,65,0,271,20,0,0,65
San Diego,2021-01-17,1664,69,6467,412,10,150,1733
Stanislaus,2021-01-17,331,10,1305,79,0,14,341
Kings,2021-01-17,92,1,137,13,0,2,93
Lake,2021-01-17,16,0,63,5,0,3,16
Mendocino,2021-01-17,13,0,109,3,0,4,13
San Francisco,2021-01-17,242,5,2127,57,2,67,247
Contra Costa,2021-01-17,266,18,1455,59,1,29,284
Madera,2021-01-17,53,11,281,15,1,0,64
Los Angeles,2021-01-17,7322,302,19322,1728,39,263,7624
Ventura,2021-01-17,430,5,1177,81,4,27,435
Nevada,2021-01-17,10,1,140,3,0,2,11
San Joaquin,2021-01-17,291,10,919,79,0,7,301
Sonoma,2021-01-17,101,6,662,17,1,15,107
Yolo,2021-01-17,28,0,114,12,0,1,28
Glenn,2021-01-17,5,3,47,0,0,0,8
Humboldt,2021-01-17,10,1,274,3,1,4,11
Mono,2021-01-17,0,0,17,0,0,2,0
Imperial,2021-01-17,131,0,234,55,0,2,131
Calaveras,2021-01-17,6,0,33,3,0,5,6
Shasta,2021-01-17,54,0,567,6,0,15,54
Solano,2021-01-17,172,13,616,42,1,6,185
Amador,2021-01-17,14,0,52,7,0,0,14
Fresno,2021-01-17,562,23,1549,91,1,16,585
Tulare,2021-01-17,202,7,651,27,0,14,209
Alameda,2021-01-17,458,44,2503,115,9,70,502
Monterey,2021-01-17,213,3,717,28,0,10,216
Colusa,2021-01-17,14,0,48,0,0,5,14
Lassen,2021-01-17,2,0,25,0,0,0,2
Modoc,2021-01-17,0,0,11,0,0,0,0
Kern,2021-01-17,416,5,1154,88,0,19,421
Tulare,2021-01-18,201,7,653,26,0,14,208
Monterey,2021-01-18,201,4,717,29,0,10,205
San Bernardino,2021-01-18,1487,40,3627,327,13,60,1527
Imperial,2021-01-18,134,0,234,57,0,2,134
Napa,2021-01-18,27,0,204,8,0,2,27
San Benito,2021-01-18,18,0,25,6,0,0,18
San Diego,2021-01-18,1632,73,6483,414,7,168,1705
Mariposa,2021-01-18,2,0,14,0,0,0,2
Fresno,2021-01-18,554,26,1560,99,4,9,580
Lassen,2021-01-18,4,0,25,0,0,0,4
Siskiyou,2021-01-18,2,0,56,0,0,4,2
Inyo,2021-01-18,2,1,29,1,0,2,3
Lake,2021-01-18,16,0,63,4,0,2,16
Glenn,2021-01-18,5,3,47,0,0,0,8
Santa Clara,2021-01-18,611,18,3097,145,1,33,629
Merced,2021-01-18,62,0,271,21,0,0,62
San Joaquin,2021-01-18,303,3,914,81,0,7,306
Mono,2021-01-18,0,0,17,0,0,0,0
Madera,2021-01-18,58,5,281,13,0,0,63
Mendocino,2021-01-18,12,1,98,3,0,5,13
Plumas,2021-01-18,1,0,35,0,0,0,1
Sacramento,2021-01-18,452,20,2632,130,4,67,472
Calaveras,2021-01-18,6,0,33,2,0,5,6
Alameda,2021-01-18,445,40,2480,119,5,72,485
Shasta,2021-01-18,53,0,567,7,0,16,53
Del Norte,2021-01-18,1,0,51,0,0,3,1
Santa Barbara,2021-01-18,205,9,598,49,2,14,214
Colusa,2021-01-18,15,0,48,0,0,5,15
San Luis Obispo,2021-01-18,56,0,460,7,0,19,56
Humboldt,2021-01-18,12,3,274,4,0,6,15
Placer,2021-01-18,148,18,754,24,1,11,166
Amador,2021-01-18,14,0,52,6,0,0,14
Kings,2021-01-18,94,1,137,11,0,4,95
Yuba,2021-01-18,54,0,261,20,0,1,54
Trinity,2021-01-18,0,0,25,0,0,0,0
Tuolumne,2021-01-18,9,0,85,1,0,2,9
Sutter,2021-01-18,0,0,14,0,0,0,0
San Francisco,2021-01-18,241,2,2127,60,0,72,243
Yolo,2021-01-18,30,0,117,10,0,0,30
Stanislaus,2021-01-18,336,13,1300,77,0,17,349
Santa Cruz,2021-01-18,78,1,372,12,0,0,79
Kern,2021-01-18,418,7,1153,88,0,25,425
Contra Costa,2021-01-18,268,13,1453,56,1,24,281
Riverside,2021-01-18,1524,127,3425,344,12,23,1651
Nevada,2021-01-18,8,0,132,3,0,4,8
Sonoma,2021-01-18,94,12,645,18,0,13,106
San Mateo,2021-01-18,187,7,738,43,0,19,194
Modoc,2021-01-18,0,0,12,0,0,0,0
Marin,2021-01-18,29,1,332,9,0,8,30
Solano,2021-01-18,165,9,605,43,0,7,174
Orange,2021-01-18,2007,61,5914,523,5,76,2068
Los Angeles,2021-01-18,7253,347,19317,1693,43,290,7600
Ventura,2021-01-18,426,7,1179,80,2,33,433
El Dorado,2021-01-18,25,0,190,9,0,8,25
Butte,2021-01-18,63,1,451,8,0,12,64
Tehama,2021-01-18,14,0,59,3,0,3,14
Santa Clara,2021-01-19,604,16,3140,145,5,37,620
Stanislaus,2021-01-19,325,17,1305,77,0,17,342
Sonoma,2021-01-19,99,4,648,19,1,18,103
El Dorado,2021-01-19,22,0,190,4,0,5,22
Alameda,2021-01-19,443,47,2491,123,5,70,490
San Joaquin,2021-01-19,305,9,923,78,0,4,314
Yolo,2021-01-19,30,0,121,8,0,0,30
Calaveras,2021-01-19,4,0,33,2,0,5,4
Santa Cruz,2021-01-19,70,1,372,10,0,0,71
Siskiyou,2021-01-19,2,0,56,0,0,5,2
Lassen,2021-01-19,5,0,25,0,0,0,5
Amador,2021-01-19,12,0,52,5,0,0,12
Glenn,2021-01-19,6,2,47,0,0,0,8
Riverside,2021-01-19,1514,126,3429,335,8,34,1640
Nevada,2021-01-19,10,0,119,3,0,2,10
Plumas,2021-01-19,1,0,35,0,0,0,1
Tuolumne,2021-01-19,9,0,84,1,0,2,9
Del Norte,2021-01-19,1,0,51,0,0,2,1
Ventura,2021-01-19,420,14,1172,83,1,21,434
San Diego,2021-01-19,1658,62,6496,438,3,164,1720
Merced,2021-01-19,62,0,271,19,0,2,62
Kern,2021-01-19,403,2,1170,86,0,29,405
Imperial,2021-01-19,122,0,234,52,0,2,122
Humboldt,2021-01-19,11,3,274,4,0,7,14
Butte,2021-01-19,61,0,451,9,0,7,61
Solano,2021-01-19,158,10,587,38,0,6,168
Santa Barbara,2021-01-19,206,9,598,52,2,14,215
Lake,2021-01-19,17,0,62,5,0,1,17
San Benito,2021-01-19,19,0,25,7,0,0,19
San Francisco,2021-01-19,243,4,2106,62,0,69,247
Marin,2021-01-19,31,2,330,10,0,9,33
Shasta,2021-01-19,52,0,567,7,0,16,52
San Mateo,2021-01-19,192,6,746,42,1,16,198
Colusa,2021-01-19,17,0,48,0,0,5,17
San Luis Obispo,2021-01-19,61,0,460,7,0,19,61
Mariposa,2021-01-19,1,0,14,0,0,0,1
Napa,2021-01-19,28,0,202,8,0,1,28
Tehama,2021-01-19,16,0,59,3,0,0,16
Mendocino,2021-01-19,16,1,115,4,0,5,17
Los Angeles,2021-01-19,7263,308,19445,1692,29,296,7571
Madera,2021-01-19,57,7,281,15,0,0,64
Sutter,2021-01-19,0,0,14,0,0,0,0
Yuba,2021-01-19,50,0,261,16,0,3,50
Tulare,2021-01-19,201,13,669,21,1,15,214
Placer,2021-01-19,149,13,757,26,2,8,162
Kings,2021-01-19,93,1,134,10,1,2,94
Monterey,2021-01-19,183,5,717,30,0,12,188
Fresno,2021-01-19,551,22,1579,84,2,9,573
Modoc,2021-01-19,0,2,12,0,0,0,2
San Bernardino,2021-01-19,1477,51,3555,325,2,56,1528
Trinity,2021-01-19,0,0,25,0,0,0,0
Inyo,2021-01-19,1,0,29,0,0,2,1
Sacramento,2021-01-19,447,25,2623,128,4,66,472
Contra Costa,2021-01-19,276,10,1348,62,2,21,286
Orange,2021-01-19,1975,43,5969,527,7,74,2018
Mono,2021-01-19,0,0,17,0,0,1,0
San Joaquin,2021-01-20,296,5,928,78,0,5,301
Alameda,2021-01-20,416,41,2484,121,6,61,457
Imperial,2021-01-20,118,0,234,59,0,1,118
Sacramento,2021-01-20,436,25,2618,126,1,64,461
Butte,2021-01-20,51,0,451,8,0,9,51
San Diego,2021-01-20,1585,62,6511,447,4,154,1647
Colusa,2021-01-20,17,0,48,0,0,5,17
Humboldt,2021-01-20,14,4,276,5,0,8,18
Napa,2021-01-20,26,0,205,7,0,1,26
Tehama,2021-01-20,17,0,59,3,0,0,17
Modoc,2021-01-20,0,0,12,0,0,0,0
Tuolumne,2021-01-20,9,0,84,2,0,2,9
Lassen,2021-01-20,5,0,25,0,0,0,5
San Bernardino,2021-01-20,1434,50,3680,314,3,50,1484
Monterey,2021-01-20,162,1,717,28,0,16,163
Fresno,2021-01-20,560,29,1604,84,2,7,589
Mendocino,2021-01-20,14,1,113,3,0,6,15
Stanislaus,2021-01-20,322,11,1302,73,0,16,333
Sonoma,2021-01-20,98,5,640,20,0,18,103
Calaveras,2021-01-20,4,0,33,2,0,5,4
San Mateo,2021-01-20,192,11,758,38,1,17,203
Tulare,2021-01-20,186,11,673,24,2,9,197
El Dorado,2021-01-20,22,1,190,7,0,8,23
Kings,2021-01-20,87,0,137,9,0,4,87
Santa Clara,2021-01-20,595,28,3150,146,5,25,623
Del Norte,2021-01-20,1,0,51,1,0,1,1
Shasta,2021-01-20,50,0,567,5,0,17,50
Nevada,2021-01-20,9,0,136,2,0,1,9
Ventura,2021-01-20,434,12,1188,86,1,21,446
Santa Barbara,2021-01-20,204,8,603,52,1,14,212
Solano,2021-01-20,161,9,597,41,0,6,170
Siskiyou,2021-01-20,4,0,56,1,0,5,4
Kern,2021-01-20,415,3,1182,87,0,25,418
Madera,2021-01-20,52,4,281,16,0,0,56
Plumas,2021-01-20,0,0,35,0,0,0,0
San Benito,2021-01-20,19,0,25,7,0,0,19
Yuba,2021-01-20,44,0,261,16,0,2,44
Lake,2021-01-20,17,0,62,5,0,0,17
Yolo,2021-01-20,30,0,126,12,0,0,30
Amador,2021-01-20,15,0,52,6,0,0,15
Los Angeles,2021-01-20,7073,340,19392,1687,30,236,7413
Sutter,2021-01-20,0,0,14,0,0,0,0
Mariposa,2021-01-20,0,0,14,0,0,0,0
Contra Costa,2021-01-20,288,11,1357,60,1,22,299
Trinity,2021-01-20,0,0,25,0,0,0,0
Mono,2021-01-20,1,0,17,0,0,2,1
Orange,2021-01-20,1935,45,5975,517,6,70,1980
Inyo,2021-01-20,1,0,29,0,0,2,1
Santa Cruz,2021-01-20,69,3,372,9,0,0,72
San Luis Obispo,2021-01-20,56,0,460,10,0,16,56
Marin,2021-01-20,28,1,320,9,0,10,29
San Francisco,2021-01-20,234,9,2122,58,0,55,243
Placer,2021-01-20,138,13,762,25,1,11,151
Riverside,2021-01-20,1529,126,3433,335,12,22,1655
Glenn,2021-01-20,6,2,47,0,0,0,8
Merced,2021-01-20,58,0,271,19,0,1,58
Madera,2021-01-21,47,2,278,15,1,2,49
Colusa,2021-01-21,15,0,48,0,0,5,15
San Bernardino,2021-01-21,1395,62,3671,313,4,44,1457
Butte,2021-01-21,58,0,451,8,0,7,58
Sacramento,2021-01-21,419,25,2609,122,7,57,444
Solano,2021-01-21,170,11,602,46,0,2,181
Santa Barbara,2021-01-21,187,8,603,50,1,13,195
Shasta,2021-01-21,46,0,567,4,0,14,46
Tuolumne,2021-01-21,7,0,84,2,0,0,7
Glenn,2021-01-21,4,2,47,0,0,0,6
Siskiyou,2021-01-21,3,0,56,1,0,4,3
El Dorado,2021-01-21,24,2,190,8,1,3,26
Trinity,2021-01-21,0,0,25,0,0,0,0
Monterey,2021-01-21,175,1,717,31,0,17,176
Marin,2021-01-21,29,2,322,8,0,9,31
Alameda,2021-01-21,409,42,2513,122,5,66,451
Fresno,2021-01-21,558,26,1591,89,2,8,584
Los Angeles,2021-01-21,6881,345,19411,1654,26,274,7226
Calaveras,2021-01-21,5,0,33,2,0,5,5
Mono,2021-01-21,1,0,17,0,0,2,1
Imperial,2021-01-21,112,3,234,59,0,0,115
Del Norte,2021-01-21,0,0,51,0,0,4,0
Merced,2021-01-21,55,0,271,14,0,2,55
Contra Costa,2021-01-21,267,13,1319,57,2,26,280
Modoc,2021-01-21,0,0,12,0,0,0,0
Riverside,2021-01-21,1455,123,3415,330,12,26,1578
Napa,2021-01-21,26,1,213,6,1,1,27
Humboldt,2021-01-21,13,4,276,5,2,12,17
Yuba,2021-01-21,42,2,261,13,0,2,44
Mariposa,2021-01-21,0,0,14,0,0,0,0
Lassen,2021-01-21,5,0,25,0,0,0,5
San Benito,2021-01-21,14,0,25,6,0,0,14
Sutter,2021-01-21,0,0,14,0,0,0,0
Santa Cruz,2021-01-21,68,0,372,9,0,0,68
San Mateo,2021-01-21,175,7,743,40,1,10,182
Ventura,2021-01-21,428,8,1174,91,0,25,436
Placer,2021-01-21,126,10,765,27,3,8,136
Nevada,2021-01-21,8,0,123,2,0,3,8
Tulare,2021-01-21,173,13,673,24,2,10,186
San Joaquin,2021-01-21,289,11,919,88,0,6,300
San Luis Obispo,2021-01-21,51,2,460,10,1,18,53
Kings,2021-01-21,82,0,137,11,0,2,82
Lake,2021-01-21,11,0,62,3,0,1,11
Inyo,2021-01-21,2,0,29,0,0,2,2
San Francisco,2021-01-21,218,5,2118,56,0,52,223
Yolo,2021-01-21,32,0,132,11,0,1,32
Tehama,2021-01-21,15,0,59,2,0,1,15
San Diego,2021-01-21,1536,69,6508,428,10,165,1605
Santa Clara,2021-01-21,591,20,3152,143,1,26,611
Orange,2021-01-21,1896,29,5945,516,6,96,1925
Sonoma,2021-01-21,95,5,645,21,1,18,100
Amador,2021-01-21,12,0,52,5,0,0,12
Mendocino,2021-01-21,16,1,114,4,1,6,17
Kern,2021-01-21,412,3,1177,100,0,23,415
Stanislaus,2021-01-21,327,13,1298,71,1,17,340
Plumas,2021-01-21,0,0,35,0,0,0,0
El Dorado,2021-01-22,24,0,190,6,0,4,24
Yolo,2021-01-22,32,0,136,11,0,0,32
Colusa,2021-01-22,18,0,48,0,0,5,18
Mono,2021-01-22,0,0,17,0,0,2,0
Napa,2021-01-22,23,0,212,6,0,4,23
Contra Costa,2021-01-22,258,14,1330,54,1,32,272
Alameda,2021-01-22,406,38,2508,115,4,69,444
Tuolumne,2021-01-22,9,0,84,2,0,2,9
Orange,2021-01-22,1818,31,5953,482,2,80,1849
Nevada,2021-01-22,10,0,136,2,0,2,10
San Diego,2021-01-22,1501,63,6503,415,15,147,1564
Kern,2021-01-22,386,5,1179,99,0,23,391
Plumas,2021-01-22,0,0,35,0,0,0,0
San Joaquin,2021-01-22,285,15,919,87,1,5,300
Calaveras,2021-01-22,4,0,33,2,0,6,4
Solano,2021-01-22,166,11,607,49,0,4,177
San Benito,2021-01-22,14,0,25,6,0,0,14
Amador,2021-01-22,12,0,52,5,0,0,12
Marin,2021-01-22,32,4,326,8,0,8,36
San Francisco,2021-01-22,200,14,2122,52,30,52,214
Fresno,2021-01-22,520,23,1567,86,5,7,543
Shasta,2021-01-22,42,0,567,3,0,15,42
Mendocino,2021-01-22,16,2,110,3,1,2,18
Mariposa,2021-01-22,0,0,14,0,0,0,0
Sutter,2021-01-22,0,0,14,0,0,0,0
Monterey,2021-01-22,184,0,717,29,0,14,184
Del Norte,2021-01-22,0,0,51,0,0,3,0
Tulare,2021-01-22,162,13,673,22,1,12,175
Tehama,2021-01-22,18,0,59,1,0,1,18
Los Angeles,2021-01-22,6697,317,19377,1619,25,281,7014
San Bernardino,2021-01-22,1341,74,3661,313,4,57,1415
Glenn,2021-01-22,4,2,47,0,0,0,6
Trinity,2021-01-22,0,0,25,0,0,0,0
Merced,2021-01-22,45,0,271,13,0,4,45
Santa Cruz,2021-01-22,67,2,372,9,0,2,69
Lake,2021-01-22,9,0,62,3,0,2,9
Siskiyou,2021-01-22,3,0,56,1,0,4,3
Imperial,2021-01-22,104,1,234,52,0,0,105
Kings,2021-01-22,84,0,147,11,0,4,84
Sonoma,2021-01-22,100,5,649,22,0,16,105
Sacramento,2021-01-22,401,21,2609,119,5,52,422
San Mateo,2021-01-22,165,7,724,42,1,11,172
Butte,2021-01-22,50,0,451,7,0,14,50
Riverside,2021-01-22,1422,117,3405,349,5,38,1539
San Luis Obispo,2021-01-22,48,1,460,10,0,17,49
Humboldt,2021-01-22,16,7,276,6,1,12,23
Santa Clara,2021-01-22,579,17,3145,147,1,34,596
Modoc,2021-01-22,0,0,12,0,0,0,0
Yuba,2021-01-22,45,0,261,12,0,2,45
Santa Barbara,2021-01-22,191,8,603,51,2,18,199
Placer,2021-01-22,116,10,770,28,0,12,126
Lassen,2021-01-22,5,0,25,0,0,0,5
Stanislaus,2021-01-22,312,12,1299,72,1,18,324
Inyo,2021-01-22,3,0,29,0,0,1,3
Madera,2021-01-22,54,5,278,14,0,1,59
Ventura,2021-01-22,441,12,1182,89,2,25,453
San Mateo,2021-01-23,160,12,726,43,1,16,172
Butte,2021-01-23,50,0,451,10,0,13,50
Kern,2021-01-23,382,11,1164,92,0,17,393
Ventura,2021-01-23,419,12,1214,88,3,31,431
San Bernardino,2021-01-23,1277,61,3683,289,5,59,1338
Santa Cruz,2021-01-23,63,2,372,5,0,1,65
Inyo,2021-01-23,8,0,29,0,0,2,8
Glenn,2021-01-23,4,2,47,0,0,0,6
Shasta,2021-01-23,47,0,567,4,0,12,47
San Benito,2021-01-23,15,0,25,6,0,0,15
Siskiyou,2021-01-23,3,0,56,1,0,2,3
Yuba,2021-01-23,49,0,261,12,0,3,49
San Luis Obispo,2021-01-23,43,1,460,10,0,13,44
Santa Barbara,2021-01-23,185,5,603,46,2,18,190
Santa Clara,2021-01-23,550,16,3145,151,1,33,566
Modoc,2021-01-23,0,0,12,0,0,0,0
Los Angeles,2021-01-23,6486,307,19334,1600,29,299,6793
Mendocino,2021-01-23,15,2,112,2,0,1,17
Orange,2021-01-23,1732,47,5902,467,3,73,1779
Nevada,2021-01-23,1,0,25,0,0,3,1
Fresno,2021-01-23,527,32,1554,90,6,9,559
San Francisco,2021-01-23,195,6,2133,55,0,49,201
Tehama,2021-01-23,15,0,59,1,0,0,15
Napa,2021-01-23,19,0,205,7,0,3,19
Riverside,2021-01-23,1342,106,3371,336,5,28,1448
Imperial,2021-01-23,100,1,234,51,0,0,101
Placer,2021-01-23,118,11,772,28,0,7,129
Mariposa,2021-01-23,0,0,14,0,0,0,0
Del Norte,2021-01-23,0,0,51,0,0,3,0
Contra Costa,2021-01-23,248,15,1347,54,2,29,263
San Diego,2021-01-23,1467,55,6494,421,12,149,1522
Amador,2021-01-23,11,0,52,5,0,0,11
El Dorado,2021-01-23,20,0,190,7,0,3,20
Colusa,2021-01-23,8,0,48,0,0,5,8
Tuolumne,2021-01-23,12,0,84,2,0,1,12
Sacramento,2021-01-23,374,21,2609,115,5,53,395
Stanislaus,2021-01-23,298,16,1299,66,1,18,314
Sutter,2021-01-23,0,0,14,0,0,0,0
Solano,2021-01-23,166,8,625,51,1,1,174
Calaveras,2021-01-23,3,0,33,2,0,6,3
Alameda,2021-01-23,404,40,2531,109,4,73,444
Humboldt,2021-01-23,13,3,276,4,1,14,16
Madera,2021-01-23,53,8,278,17,1,1,61
Tulare,2021-01-23,157,9,677,25,0,3,166
San Joaquin,2021-01-23,285,10,916,89,0,6,295
Kings,2021-01-23,94,0,137,11,0,3,94
Mono,2021-01-23,0,0,17,0,0,2,0
Merced,2021-01-23,44,0,271,13,0,3,44
Lake,2021-01-23,9,0,62,3,0,2,9
Trinity,2021-01-23,0,0,25,0,0,0,0
Lassen,2021-01-23,6,0,25,0,0,0,6
Marin,2021-01-23,34,3,329,6,1,10,37
Yolo,2021-01-23,33,0,136,18,0,0,33
Plumas,2021-01-23,0,0,35,0,0,0,0
Monterey,2021-01-23,170,0,717,24,0,19,170
Sonoma,2021-01-23,96,6,645,23,0,20,102
Trinity,2021-01-24,0,0,25,0,0,0,0
Butte,2021-01-24,55,1,451,9,0,12,56
Solano,2021-01-24,165,11,608,50,2,2,176
San Mateo,2021-01-24,159,9,720,41,1,17,168
Plumas,2021-01-24,0,0,35,0,0,0,0
Napa,2021-01-24,21,0,200,7,0,2,21
Amador,2021-01-24,10,0,52,6,0,0,10
Yolo,2021-01-24,29,2,136,17,0,1,31
Mono,2021-01-24,0,0,17,0,0,2,0
Tuolumne,2021-01-24,13,0,84,1,0,2,13
Marin,2021-01-24,28,2,328,7,1,8,30
San Luis Obispo,2021-01-24,48,0,460,12,0,10,48
Inyo,2021-01-24,6,0,29,0,0,2,6
Mariposa,2021-01-24,0,0,14,0,0,0,0
Contra Costa,2021-01-24,241,18,1334,59,3,25,259
Glenn,2021-01-24,2,2,47,0,0,0,4
Humboldt,2021-01-24,15,3,276,5,0,14,18
Tehama,2021-01-24,13,0,59,1,0,0,13
El Dorado,2021-01-24,23,1,190,9,1,2,24
Mendocino,2021-01-24,16,2,115,1,0,43,18
Santa Cruz,2021-01-24,60,1,372,5,0,2,61
Los Angeles,2021-01-24,6307,299,19292,1565,22,295,6606
San Bernardino,2021-01-24,1274,69,3616,297,6,61,1343
Stanislaus,2021-01-24,291,11,1297,72,1,9,302
Nevada,2021-01-24,12,0,124,3,0,3,12
Imperial,2021-01-24,93,1,234,44,0,4,94
Calaveras,2021-01-24,4,0,33,2,0,5,4
Sonoma,2021-01-24,92,2,623,26,0,17,94
Santa Clara,2021-01-24,554,17,3126,140,3,37,571
Fresno,2021-01-24,536,39,1543,92,3,7,575
San Benito,2021-01-24,14,0,25,6,0,0,14
Yuba,2021-01-24,53,0,261,12,0,3,53
Sutter,2021-01-24,0,0,14,0,0,0,0
Orange,2021-01-24,1703,45,5866,447,3,81,1748
Colusa,2021-01-24,8,0,48,0,0,5,8
Lassen,2021-01-24,7,0,25,0,0,0,7
Monterey,2021-01-24,161,0,717,24,0,16,161
Sacramento,2021-01-24,377,24,2591,107,7,68,401
Kern,2021-01-24,367,12,1143,88,0,20,379
Santa Barbara,2021-01-24,112,84,603,49,1,18,196
Shasta,2021-01-24,42,0,567,3,0,11,42
Modoc,2021-01-24,0,0,12,0,0,0,0
San Diego,2021-01-24,1440,51,6489,412,11,163,1491
Lake,2021-01-24,9,0,62,3,0,2,9
Merced,2021-01-24,51,0,271,14,0,2,51
San Joaquin,2021-01-24,288,12,916,87,0,6,300
Madera,2021-01-24,54,5,278,20,0,1,59
Riverside,2021-01-24,1304,108,3340,334,5,21,1412
San Francisco,2021-01-24,192,5,2103,54,1,57,197
Alameda,2021-01-24,406,39,2514,115,4,70,445
Siskiyou,2021-01-24,2,0,56,0,0,6,2
Kings,2021-01-24,96,0,133,11,0,0,96
Ventura,2021-01-24,417,19,1200,88,4,17,436
Placer,2021-01-24,114,14,771,27,1,6,128
Tulare,2021-01-24,148,7,649,23,0,10,155
Del Norte,2021-01-24,0,0,51,0,0,3,0
San Francisco,2021-01-25,190,9,2109,54,0,54,199
San Luis Obispo,2021-01-25,46,1,460,13,0,12,47
Placer,2021-01-25,109,14,766,25,0,8,123
Inyo,2021-01-25,6,0,29,0,0,2,6
Imperial,2021-01-25,82,2,234,39,0,5,84
Lassen,2021-01-25,7,0,25,0,0,0,7
Orange,2021-01-25,1677,37,5894,437,2,89,1714
Santa Cruz,2021-01-25,55,3,372,5,0,4,58
Tulare,2021-01-25,151,10,672,21,2,12,161
Marin,2021-01-25,29,1,333,6,0,8,30
Madera,2021-01-25,56,8,278,21,0,0,64
Ventura,2021-01-25,405,20,1224,86,3,25,425
Sonoma,2021-01-25,96,4,654,26,1,15,100
Alameda,2021-01-25,396,40,2523,115,4,72,436
Sacramento,2021-01-25,371,21,2607,112,4,68,392
Nevada,2021-01-25,12,0,138,3,0,1,12
Amador,2021-01-25,11,0,52,6,0,0,11
Butte,2021-01-25,49,0,451,9,0,9,49
Merced,2021-01-25,54,0,271,15,0,1,54
Stanislaus,2021-01-25,302,14,1297,72,2,8,316
Humboldt,2021-01-25,12,2,276,5,0,14,14
Santa Clara,2021-01-25,538,11,3102,132,2,42,549
San Mateo,2021-01-25,147,8,715,37,1,16,155
Santa Barbara,2021-01-25,192,8,603,51,2,16,200
Del Norte,2021-01-25,0,0,51,0,0,2,0
Fresno,2021-01-25,553,16,1555,88,0,8,569
Riverside,2021-01-25,1265,124,3380,319,4,26,1389
San Diego,2021-01-25,1429,63,6486,405,11,168,1492
Siskiyou,2021-01-25,2,0,56,0,0,6,2
Monterey,2021-01-25,158,0,720,26,0,19,158
Mendocino,2021-01-25,16,2,112,3,0,7,18
Solano,2021-01-25,159,12,606,48,0,4,171
Tuolumne,2021-01-25,10,0,84,2,0,2,10
Lake,2021-01-25,9,0,62,2,0,2,9
Contra Costa,2021-01-25,224,17,1302,57,4,25,241
Colusa,2021-01-25,4,0,48,0,0,5,4
Shasta,2021-01-25,43,0,567,4,0,14,43
San Benito,2021-01-25,14,0,25,5,0,0,14
Trinity,2021-01-25,0,0,25,0,0,0,0
Yuba,2021-01-25,54,0,256,11,0,2,54
Calaveras,2021-01-25,3,0,33,1,0,6,3
Mariposa,2021-01-25,0,0,14,0,0,0,0
El Dorado,2021-01-25,19,1,190,9,1,5,20
Los Angeles,2021-01-25,6213,287,19309,1551,21,302,6500
San Joaquin,2021-01-25,280,6,910,84,0,7,286
Modoc,2021-01-25,0,0,12,0,0,0,0
Sutter,2021-01-25,0,0,14,0,0,0,0
Kings,2021-01-25,95,0,136,10,0,2,95
Glenn,2021-01-25,1,2,47,0,0,0,3
Yolo,2021-01-25,28,0,134,12,0,1,28
Tehama,2021-01-25,14,0,59,1,0,1,14
Plumas,2021-01-25,0,0,35,0,0,0,0
San Bernardino,2021-01-25,1248,51,3604,283,5,52,1299
Mono,2021-01-25,0,0,17,0,0,1,0
Napa,2021-01-25,24,0,196,8,0,0,24
Kern,2021-01-25,378,9,1150,96,0,18,387
Glenn,2021-01-26,1,2,47,0,0,0,3
Humboldt,2021-01-26,13,11,276,5,0,13,24
Sutter,2021-01-26,0,0,14,0,0,0,0
El Dorado,2021-01-26,21,1,190,5,1,5,22
Butte,2021-01-26,51,1,451,8,0,9,52
Santa Clara,2021-01-26,503,15,3122,127,1,47,518
Santa Barbara,2021-01-26,203,9,603,58,2,13,212
Siskiyou,2021-01-26,2,0,56,0,0,6,2
San Bernardino,2021-01-26,1209,52,3604,279,9,66,1261
San Francisco,2021-01-26,181,6,2113,54,1,48,187
Sacramento,2021-01-26,382,22,2644,112,4,54,404
Stanislaus,2021-01-26,293,10,1297,66,1,14,303
Mono,2021-01-26,0,0,17,0,0,0,0
Del Norte,2021-01-26,0,0,51,0,0,2,0
Amador,2021-01-26,11,0,52,6,0,0,11
Monterey,2021-01-26,161,0,720,22,0,14,161
Los Angeles,2021-01-26,6026,345,19292,1542,30,315,6371
Ventura,2021-01-26,418,12,1224,90,3,25,430
Lassen,2021-01-26,6,0,25,0,0,0,6
Kings,2021-01-26,89,1,137,8,0,5,90
Napa,2021-01-26,21,0,202,7,0,3,21
San Benito,2021-01-26,12,0,25,5,0,2,12
Contra Costa,2021-01-26,222,14,1309,57,3,27,236
Madera,2021-01-26,58,9,278,19,0,0,67
Plumas,2021-01-26,0,0,35,0,0,0,0
Imperial,2021-01-26,77,5,234,37,0,1,82
Sonoma,2021-01-26,97,1,679,26,0,13,98
Yuba,2021-01-26,54,0,261,12,0,4,54
Mariposa,2021-01-26,0,0,14,0,0,0,0
Calaveras,2021-01-26,4,0,33,1,0,5,4
Santa Cruz,2021-01-26,58,3,373,6,0,1,61
Kern,2021-01-26,358,11,1136,89,0,29,369
Solano,2021-01-26,153,9,613,48,0,9,162
Colusa,2021-01-26,4,0,48,0,0,5,4
Trinity,2021-01-26,0,0,25,0,0,0,0
Nevada,2021-01-26,12,0,129,3,0,4,12
San Diego,2021-01-26,1410,62,6490,400,12,157,1472
Tehama,2021-01-26,10,0,59,1,0,1,10
Modoc,2021-01-26,0,0,12,0,0,0,0
Lake,2021-01-26,9,0,49,5,0,2,9
Mendocino,2021-01-26,16,2,116,3,0,5,18
Alameda,2021-01-26,382,36,2504,115,5,71,418
Yolo,2021-01-26,27,0,131,10,0,0,27
Fresno,2021-01-26,543,29,1559,97,2,12,572
San Luis Obispo,2021-01-26,47,2,460,14,0,13,49
Inyo,2021-01-26,7,0,29,0,0,1,7
Tulare,2021-01-26,152,8,676,21,2,15,160
San Mateo,2021-01-26,147,13,726,33,2,12,160
Merced,2021-01-26,54,0,271,16,0,1,54
Tuolumne,2021-01-26,8,0,84,2,0,2,8
Orange,2021-01-26,1639,55,5890,448,6,90,1694
Riverside,2021-01-26,1238,99,3411,315,6,29,1337
Placer,2021-01-26,113,13,775,24,1,6,126
Marin,2021-01-26,29,3,335,8,0,9,32
San Joaquin,2021-01-26,269,10,931,76,0,8,279
Shasta,2021-01-26,39,0,567,4,0,13,39
Inyo,2021-01-27,6,0,29,0,0,2,6
Napa,2021-01-27,20,1,222,8,0,7,21
Plumas,2021-01-27,0,0,35,0,0,0,0
Santa Barbara,2021-01-27,193,5,603,51,2,15,198
Kern,2021-01-27,338,8,1148,83,0,30,346
San Joaquin,2021-01-27,255,16,916,72,0,6,271
Solano,2021-01-27,147,14,618,47,0,6,161
Imperial,2021-01-27,75,1,234,37,0,1,76
Glenn,2021-01-27,3,2,47,0,0,0,5
Tehama,2021-01-27,8,0,59,1,0,3,8
Yolo,2021-01-27,22,0,131,8,0,0,22
Santa Cruz,2021-01-27,51,1,373,6,0,2,52
Stanislaus,2021-01-27,288,13,1297,62,2,15,301
Ventura,2021-01-27,411,8,1233,91,2,22,419
Siskiyou,2021-01-27,2,0,56,0,0,4,2
Lassen,2021-01-27,3,0,25,0,0,0,3
Mariposa,2021-01-27,0,0,14,0,0,0,0
Modoc,2021-01-27,0,0,12,0,0,0,0
Kings,2021-01-27,76,1,136,11,0,1,77
Orange,2021-01-27,1592,32,5985,439,3,97,1624
El Dorado,2021-01-27,18,2,190,6,0,4,20
San Mateo,2021-01-27,149,12,735,37,2,12,161
Trinity,2021-01-27,0,0,25,0,0,0,0
Monterey,2021-01-27,163,1,719,31,0,11,164
Mono,2021-01-27,0,0,17,0,0,2,0
Tulare,2021-01-27,153,4,672,22,0,12,157
Sonoma,2021-01-27,94,6,657,22,0,14,100
Nevada,2021-01-27,9,0,129,2,0,7,9
Alameda,2021-01-27,359,41,2521,104,7,65,400
Tuolumne,2021-01-27,6,0,84,2,0,3,6
San Bernardino,2021-01-27,1164,68,3665,284,8,67,1232
Riverside,2021-01-27,1191,122,3453,317,12,33,1313
San Diego,2021-01-27,1343,61,6491,390,10,156,1404
Yuba,2021-01-27,51,0,261,11,0,4,51
Butte,2021-01-27,46,1,451,7,0,9,47
Contra Costa,2021-01-27,197,11,1324,53,3,36,208
Colusa,2021-01-27,4,0,48,0,0,5,4
Amador,2021-01-27,10,0,52,6,0,0,10
Merced,2021-01-27,53,0,271,16,0,2,53
Los Angeles,2021-01-27,5855,355,19289,1503,25,314,6210
Santa Clara,2021-01-27,509,12,3143,134,1,47,521
Marin,2021-01-27,28,2,340,7,0,9,30
San Benito,2021-01-27,11,0,25,5,0,0,11
Placer,2021-01-27,105,15,774,27,1,7,120
Lake,2021-01-27,9,1,62,5,1,1,10
Calaveras,2021-01-27,4,0,33,1,0,5,4
Sutter,2021-01-27,0,0,14,0,0,0,0
Sacramento,2021-01-27,379,23,2669,108,4,61,402
San Luis Obispo,2021-01-27,46,0,460,18,0,13,46
Mendocino,2021-01-27,15,2,117,3,0,2,17
Humboldt,2021-01-27,12,11,276,2,0,12,23
Fresno,2021-01-27,500,33,1557,81,4,9,533
Del Norte,2021-01-27,0,0,51,0,0,2,0
Madera,2021-01-27,63,6,278,20,0,0,69
Shasta,2021-01-27,37,0,567,2,0,15,37
San Francisco,2021-01-27,178,1,2109,54,0,49,179
Plumas,2021-01-28,0,0,35,0,0,0,0
Trinity,2021-01-28,0,0,25,0,0,0,0
Merced,2021-01-28,52,0,271,21,0,0,52
Santa Clara,2021-01-28,487,9,3145,135,0,47,496
Shasta,2021-01-28,32,0,567,2,0,15,32
Orange,2021-01-28,1521,33,5960,426,4,117,1554
Santa Cruz,2021-01-28,39,1,372,6,0,3,40
El Dorado,2021-01-28,15,3,190,3,0,9,18
San Bernardino,2021-01-28,1128,51,3655,276,4,81,1179
Modoc,2021-01-28,0,0,12,0,0,0,0
Los Angeles,2021-01-28,5669,372,19275,1498,29,272,6041
Mono,2021-01-28,0,0,17,0,0,1,0
Mariposa,2021-01-28,0,0,14,0,0,0,0
Lake,2021-01-28,7,1,62,4,1,1,8
Santa Barbara,2021-01-28,180,7,603,48,2,17,187
Fresno,2021-01-28,472,28,1543,92,0,12,500
Tuolumne,2021-01-28,7,0,84,2,0,3,7
Nevada,2021-01-28,13,0,126,2,0,3,13
Lassen,2021-01-28,3,0,25,0,0,0,3
Solano,2021-01-28,147,11,614,42,0,8,158
Mendocino,2021-01-28,15,2,114,3,0,26,17
Tehama,2021-01-28,11,0,59,2,0,1,11
Napa,2021-01-28,21,0,215,4,0,2,21
Imperial,2021-01-28,75,0,234,36,0,1,75
Riverside,2021-01-28,1128,124,3433,290,14,20,1252
Sonoma,2021-01-28,89,6,642,22,0,13,95
San Francisco,2021-01-28,176,2,2108,55,0,55,178
Butte,2021-01-28,41,1,451,8,0,7,42
Alameda,2021-01-28,353,46,2524,107,8,63,399
Kern,2021-01-28,317,9,1153,92,0,24,326
San Mateo,2021-01-28,146,10,750,35,0,16,156
Marin,2021-01-28,27,2,350,6,0,9,29
Calaveras,2021-01-28,3,0,33,1,0,5,3
San Diego,2021-01-28,1328,55,6487,388,9,159,1383
Colusa,2021-01-28,7,0,48,0,0,5,7
Yolo,2021-01-28,19,0,132,8,0,0,19
Ventura,2021-01-28,386,7,1218,89,3,26,393
Inyo,2021-01-28,4,0,29,0,0,2,4
Kings,2021-01-28,81,0,132,10,0,1,81
San Benito,2021-01-28,12,0,25,5,0,0,12
San Joaquin,2021-01-28,253,16,908,73,0,5,269
Siskiyou,2021-01-28,2,1,56,0,0,4,3
Del Norte,2021-01-28,0,1,51,0,1,1,1
Yuba,2021-01-28,49,0,261,12,0,2,49
San Luis Obispo,2021-01-28,43,0,460,18,0,12,43
Madera,2021-01-28,67,6,272,19,1,0,73
Glenn,2021-01-28,3,2,47,0,0,0,5
Monterey,2021-01-28,149,2,719,30,0,11,151
Stanislaus,2021-01-28,281,10,1303,61,0,18,291
Sacramento,2021-01-28,365,16,2659,111,4,48,381
Placer,2021-01-28,115,17,775,23,3,8,132
Sutter,2021-01-28,0,0,14,0,0,0,0
Amador,2021-01-28,12,0,52,6,0,0,12
Tulare,2021-01-28,153,7,672,22,1,14,160
Contra Costa,2021-01-28,189,14,1313,50,3,33,203
Humboldt,2021-01-28,13,4,276,2,0,7,17
Calaveras,2021-01-29,3,0,33,1,0,5,3
Sonoma,2021-01-29,86,3,637,24,0,16,89
Orange,2021-01-29,1442,36,5922,394,7,108,1478
Santa Barbara,2021-01-29,182,10,603,41,1,18,192
Lake,2021-01-29,8,0,62,3,0,2,8
Santa Clara,2021-01-29,487,8,3152,133,0,40,495
San Diego,2021-01-29,1317,58,6486,379,8,155,1375
Solano,2021-01-29,149,9,594,39,1,7,158
El Dorado,2021-01-29,15,0,190,3,0,12,15
Ventura,2021-01-29,376,14,1213,82,2,23,390
Amador,2021-01-29,12,2,52,5,0,0,14
Trinity,2021-01-29,0,0,25,0,0,0,0
San Joaquin,2021-01-29,223,12,920,71,0,4,235
Tuolumne,2021-01-29,6,0,84,2,0,0,6
Alameda,2021-01-29,347,39,2488,106,5,65,386
San Benito,2021-01-29,12,0,25,5,0,0,12
Sacramento,2021-01-29,352,17,2651,107,3,49,369
Riverside,2021-01-29,1103,122,3406,295,12,29,1225
San Mateo,2021-01-29,136,12,735,28,0,17,148
Kern,2021-01-29,298,10,1158,77,0,28,308
Modoc,2021-01-29,1,0,12,0,0,0,1
Tulare,2021-01-29,154,5,669,22,1,10,159
Siskiyou,2021-01-29,0,0,56,0,0,4,0
Butte,2021-01-29,43,0,451,12,0,4,43
Fresno,2021-01-29,475,27,1539,72,2,8,502
Del Norte,2021-01-29,0,1,51,0,1,1,1
Yolo,2021-01-29,17,0,127,10,0,0,17
Santa Cruz,2021-01-29,45,2,372,11,0,1,47
Yuba,2021-01-29,42,0,261,11,0,4,42
Lassen,2021-01-29,2,0,25,0,0,0,2
Mariposa,2021-01-29,0,0,14,0,0,0,0
San Luis Obispo,2021-01-29,46,2,460,18,0,12,48
Plumas,2021-01-29,0,0,35,0,0,0,0
Los Angeles,2021-01-29,5511,325,19325,1479,35,282,5836
Stanislaus,2021-01-29,270,13,1301,60,0,13,283
Merced,2021-01-29,43,0,271,19,0,1,43
Glenn,2021-01-29,3,2,47,0,0,0,5
Sutter,2021-01-29,0,0,14,0,0,0,0
Colusa,2021-01-29,9,0,48,0,0,5,9
Mendocino,2021-01-29,13,1,115,3,0,26,14
San Francisco,2021-01-29,190,6,2103,47,0,55,196
Monterey,2021-01-29,151,1,718,30,0,13,152
Inyo,2021-01-29,4,0,29,0,0,2,4
Madera,2021-01-29,59,9,267,17,0,0,68
Marin,2021-01-29,27,3,342,7,0,11,30
Tehama,2021-01-29,10,0,59,2,0,1,10
Nevada,2021-01-29,13,0,125,2,0,2,13
Placer,2021-01-29,118,17,786,23,0,12,135
Napa,2021-01-29,18,0,203,5,0,3,18
Humboldt,2021-01-29,8,3,276,0,0,8,11
Kings,2021-01-29,75,0,137,9,0,5,75
Imperial,2021-01-29,80,0,234,34,0,0,80
Shasta,2021-01-29,28,0,567,2,0,15,28
Mono,2021-01-29,0,0,17,0,0,2,0
San Bernardino,2021-01-29,1100,41,3643,277,7,78,1141
Contra Costa,2021-01-29,187,18,1327,49,2,28,205
San Luis Obispo,2021-01-30,46,1,460,15,0,14,47
San Joaquin,2021-01-30,207,18,905,66,1,4,225
Sonoma,2021-01-30,85,6,650,23,0,16,91
Yuba,2021-01-30,43,8,261,13,0,2,51
Napa,2021-01-30,18,0,210,5,0,2,18
Madera,2021-01-30,51,6,267,15,0,0,57
Butte,2021-01-30,43,0,451,8,0,9,43
Orange,2021-01-30,1412,38,5959,392,4,98,1450
Imperial,2021-01-30,76,2,234,30,0,4,78
Modoc,2021-01-30,1,0,12,0,0,0,1
Alameda,2021-01-30,330,38,2515,99,6,70,368
Los Angeles,2021-01-30,5398,320,19244,1461,41,299,5718
Colusa,2021-01-30,5,0,48,0,0,5,5
Amador,2021-01-30,9,0,53,5,0,0,9
El Dorado,2021-01-30,17,1,190,3,0,7,18
Yolo,2021-01-30,16,0,125,9,0,0,16
Monterey,2021-01-30,142,2,719,30,0,17,144
Humboldt,2021-01-30,8,7,276,1,3,4,15
Inyo,2021-01-30,3,0,29,0,0,2,3
Solano,2021-01-30,134,9,604,38,0,6,143
Calaveras,2021-01-30,1,0,33,1,0,5,1
Plumas,2021-01-30,0,0,35,0,0,0,0
Fresno,2021-01-30,460,34,1511,75,2,5,494
Kern,2021-01-30,298,8,1186,79,1,28,306
Riverside,2021-01-30,1028,109,3402,283,9,41,1137
San Diego,2021-01-30,1310,42,6491,373,4,162,1352
Lake,2021-01-30,7,0,62,3,0,2,7
Merced,2021-01-30,41,0,271,8,10,1,41
San Bernardino,2021-01-30,1060,52,3654,265,7,73,1112
Kings,2021-01-30,64,0,135,7,0,5,64
Ventura,2021-01-30,362,14,1226,87,4,23,376
Stanislaus,2021-01-30,262,15,1302,66,2,9,277
Santa Clara,2021-01-30,475,7,3132,128,2,48,482
San Francisco,2021-01-30,177,4,2137,47,0,50,181
Tehama,2021-01-30,9,0,59,2,0,4,9
San Benito,2021-01-30,12,0,25,5,0,0,12
Mono,2021-01-30,0,0,17,0,0,2,0
Mendocino,2021-01-30,12,1,116,2,0,3,13
Shasta,2021-01-30,26,0,567,2,0,17,26
San Mateo,2021-01-30,146,10,737,35,0,13,156
Siskiyou,2021-01-30,0,0,56,0,0,4,0
Santa Cruz,2021-01-30,40,2,372,11,0,1,42
Santa Barbara,2021-01-30,179,7,603,48,2,14,186
Del Norte,2021-01-30,0,0,51,0,0,3,0
Tuolumne,2021-01-30,5,1,84,0,0,2,6
Sacramento,2021-01-30,346,14,2641,104,2,54,360
Sutter,2021-01-30,0,0,14,0,0,0,0
Placer,2021-01-30,121,16,786,20,0,23,137
Lassen,2021-01-30,2,0,25,0,0,0,2
Trinity,2021-01-30,0,0,25,0,0,0,0
Mariposa,2021-01-30,0,0,14,0,0,0,0
Contra Costa,2021-01-30,182,18,1316,49,2,22,200
Marin,2021-01-30,27,4,348,7,0,13,31
Glenn,2021-01-30,3,2,47,0,0,0,5
Tulare,2021-01-30,146,4,649,23,1,7,150
Nevada,2021-01-30,11,0,137,1,0,1,11
Placer,2021-01-31,107,11,787,24,1,13,118
Mendocino,2021-01-31,10,1,118,1,0,5,11
Stanislaus,2021-01-31,246,11,1301,61,1,15,257
Solano,2021-01-31,126,4,608,36,0,10,130
Mariposa,2021-01-31,0,0,14,0,0,0,0
Sonoma,2021-01-31,78,2,634,21,0,17,80
Santa Clara,2021-01-31,454,12,3153,129,3,41,466
Colusa,2021-01-31,5,0,48,0,0,5,5
Contra Costa,2021-01-31,172,16,1302,37,2,38,188
Fresno,2021-01-31,452,29,1519,72,1,9,481
San Joaquin,2021-01-31,212,15,909,69,1,7,227
Butte,2021-01-31,43,0,451,9,0,4,43
Madera,2021-01-31,51,10,267,14,2,0,61
Imperial,2021-01-31,72,0,234,31,0,3,72
Riverside,2021-01-31,979,129,3363,268,11,46,1108
San Francisco,2021-01-31,170,4,2135,49,0,61,174
Monterey,2021-01-31,128,1,719,28,0,20,129
Sutter,2021-01-31,0,0,14,0,0,0,0
Del Norte,2021-01-31,0,0,51,0,0,2,0
Merced,2021-01-31,39,0,271,19,0,4,39
Nevada,2021-01-31,1,11,137,0,2,0,12
San Benito,2021-01-31,10,0,25,4,0,0,10
Kings,2021-01-31,84,0,131,9,0,2,84
Orange,2021-01-31,1362,30,5884,384,3,120,1392
Lassen,2021-01-31,4,0,25,0,0,0,4
Marin,2021-01-31,29,3,344,6,0,13,32
Yuba,2021-01-31,43,7,261,13,0,4,50
Trinity,2021-01-31,0,0,25,0,0,0,0
Lake,2021-01-31,7,0,63,2,0,2,7
Ventura,2021-01-31,351,16,1205,90,4,20,367
Kern,2021-01-31,293,6,1167,75,0,27,299
Los Angeles,2021-01-31,5259,300,19226,1415,36,327,5559
Tehama,2021-01-31,11,0,59,2,0,1,11
San Bernardino,2021-01-31,1036,39,3669,256,4,61,1075
Calaveras,2021-01-31,2,0,33,1,0,5,2
Santa Cruz,2021-01-31,42,2,372,12,0,4,44
Inyo,2021-01-31,4,0,29,1,0,1,4
Alameda,2021-01-31,318,31,2513,97,5,68,349
Napa,2021-01-31,15,0,210,4,0,6,15
Tuolumne,2021-01-31,9,0,84,2,0,1,9
Shasta,2021-01-31,25,0,567,1,0,15,25
Mono,2021-01-31,0,0,17,0,0,1,0
Glenn,2021-01-31,3,2,47,0,0,0,5
Humboldt,2021-01-31,10,2,271,2,1,10,12
Santa Barbara,2021-01-31,170,8,603,47,2,17,178
Amador,2021-01-31,8,0,52,5,0,1,8
Plumas,2021-01-31,0,0,35,0,0,0,0
El Dorado,2021-01-31,12,0,190,3,0,9,12
Modoc,2021-01-31,1,0,12,0,0,0,1
San Luis Obispo,2021-01-31,45,2,460,14,0,16,47
Tulare,2021-01-31,149,5,647,24,1,8,154
Yolo,2021-01-31,12,0,123,8,0,1,12
Siskiyou,2021-01-31,0,0,56,0,0,4,0
Sacramento,2021-01-31,339,14,2631,102,4,67,353
San Mateo,2021-01-31,139,5,724,31,0,18,144
San Diego,2021-01-31,1306,41,6495,379,8,161,1347
Mariposa,2021-02-01,0,0,14,0,0,0,0
San Joaquin,2021-02-01,222,15,909,70,1,7,237
Napa,2021-02-01,16,0,210,3,0,2,16
Madera,2021-02-01,44,2,267,14,0,1,46
Santa Barbara,2021-02-01,161,8,603,48,3,18,169
Amador,2021-02-01,8,0,52,4,0,2,8
Mendocino,2021-02-01,9,1,94,1,0,3,10
Sutter,2021-02-01,0,0,14,0,0,0,0
Yolo,2021-02-01,14,0,126,7,0,2,14
San Bernardino,2021-02-01,1017,46,3585,258,7,46,1063
Marin,2021-02-01,28,4,346,6,0,11,32
Sacramento,2021-02-01,325,19,2624,93,6,68,344
Trinity,2021-02-01,0,0,25,0,0,0,0
Kings,2021-02-01,90,2,135,10,0,3,92
Humboldt,2021-02-01,7,3,276,3,1,5,10
Sonoma,2021-02-01,81,3,647,21,0,14,84
Kern,2021-02-01,287,5,1139,75,0,33,292
San Francisco,2021-02-01,174,1,2127,48,0,72,175
Glenn,2021-02-01,0,0,47,0,0,0,0
Siskiyou,2021-02-01,3,0,56,0,0,5,3
Plumas,2021-02-01,0,0,35,0,0,0,0
Modoc,2021-02-01,1,0,12,0,0,0,1
Shasta,2021-02-01,21,0,567,1,0,14,21
Nevada,2021-02-01,10,0,137,2,0,3,10
Tulare,2021-02-01,142,7,667,22,2,13,149
El Dorado,2021-02-01,11,0,190,3,0,7,11
Lake,2021-02-01,5,0,63,3,0,1,5
Inyo,2021-02-01,3,0,29,0,0,2,3
Alameda,2021-02-01,314,39,2494,100,3,67,353
Lassen,2021-02-01,5,0,25,0,0,0,5
Imperial,2021-02-01,73,0,234,30,0,1,73
Tehama,2021-02-01,10,0,59,2,0,2,10
Merced,2021-02-01,38,0,271,18,0,5,38
Santa Clara,2021-02-01,466,12,3132,130,4,47,478
San Diego,2021-02-01,1258,76,6491,373,13,154,1334
Fresno,2021-02-01,480,28,1537,96,0,13,508
Santa Cruz,2021-02-01,41,1,372,8,0,4,42
Riverside,2021-02-01,954,131,3335,254,9,41,1085
Mono,2021-02-01,0,0,17,0,0,2,0
Monterey,2021-02-01,122,3,720,27,0,18,125
Tuolumne,2021-02-01,8,1,84,0,0,0,9
Orange,2021-02-01,1330,22,5825,370,1,102,1352
San Benito,2021-02-01,9,0,25,3,0,0,9
Solano,2021-02-01,139,7,588,40,0,10,146
Colusa,2021-02-01,4,0,48,0,0,5,4
San Luis Obispo,2021-02-01,47,1,460,11,1,18,48
Butte,2021-02-01,37,0,451,8,0,11,37
Los Angeles,2021-02-01,5165,278,19190,1371,38,340,5443
Calaveras,2021-02-01,2,0,33,2,0,5,2
Ventura,2021-02-01,330,10,1201,88,2,19,340
San Mateo,2021-02-01,132,3,720,32,0,20,135
Placer,2021-02-01,102,14,794,26,3,17,116
Contra Costa,2021-02-01,181,18,1295,45,2,33,199
Del Norte,2021-02-01,0,0,51,0,0,1,0
Stanislaus,2021-02-01,256,12,1302,60,1,15,268
Yuba,2021-02-01,39,6,261,11,0,2,45
Solano,2021-02-02,128,10,568,36,3,10,138
Riverside,2021-02-02,920,127,3346,256,12,49,1047
Tulare,2021-02-02,135,7,670,23,2,5,142
Del Norte,2021-02-02,0,0,51,0,0,2,0
Santa Barbara,2021-02-02,167,7,603,47,2,19,174
Mendocino,2021-02-02,9,1,94,1,0,6,10
Imperial,2021-02-02,66,0,234,27,0,2,66
Colusa,2021-02-02,4,0,48,0,0,5,4
Tuolumne,2021-02-02,3,0,84,0,0,1,3
Sutter,2021-02-02,0,0,14,0,0,0,0
Humboldt,2021-02-02,11,3,276,4,0,8,14
Shasta,2021-02-02,18,0,567,1,0,14,18
Alameda,2021-02-02,316,35,2520,100,3,62,351
San Luis Obispo,2021-02-02,38,0,460,10,0,16,38
Contra Costa,2021-02-02,181,21,1303,45,2,39,202
Santa Clara,2021-02-02,436,12,3144,127,3,47,448
Nevada,2021-02-02,10,1,134,1,0,4,11
Sacramento,2021-02-02,305,14,2616,84,5,60,319
San Benito,2021-02-02,9,0,25,3,0,0,9
San Mateo,2021-02-02,132,7,726,31,0,20,139
Stanislaus,2021-02-02,256,21,1290,63,2,18,277
San Diego,2021-02-02,1233,51,6501,358,6,160,1284
San Bernardino,2021-02-02,969,43,3646,252,8,58,1012
Santa Cruz,2021-02-02,40,0,372,10,0,7,40
Modoc,2021-02-02,1,0,12,0,0,0,1
Orange,2021-02-02,1298,33,5867,363,5,118,1331
Napa,2021-02-02,16,0,213,3,0,3,16
Fresno,2021-02-02,448,39,1567,64,1,14,487
Siskiyou,2021-02-02,3,0,56,0,0,4,3
Kern,2021-02-02,273,8,1145,67,0,24,281
Marin,2021-02-02,25,3,342,5,1,12,28
Inyo,2021-02-02,3,0,29,0,0,1,3
San Francisco,2021-02-02,176,7,2118,44,1,67,183
Mariposa,2021-02-02,0,0,14,0,0,0,0
Amador,2021-02-02,8,0,52,5,0,1,8
San Joaquin,2021-02-02,217,9,923,65,1,7,226
Madera,2021-02-02,39,4,267,14,0,0,43
Placer,2021-02-02,108,14,812,24,2,13,122
Mono,2021-02-02,0,0,17,0,0,2,0
Yuba,2021-02-02,45,4,261,11,0,3,49
Merced,2021-02-02,36,0,271,17,0,3,36
Yolo,2021-02-02,12,0,123,7,0,1,12
Calaveras,2021-02-02,2,0,33,2,0,3,2
Tehama,2021-02-02,10,0,59,3,0,0,10
Kings,2021-02-02,85,0,133,10,0,0,85
Ventura,2021-02-02,333,9,1214,77,3,27,342
Glenn,2021-02-02,0,0,47,0,0,0,0
Butte,2021-02-02,34,0,451,6,0,10,34
Los Angeles,2021-02-02,4990,314,19301,1354,43,319,5304
Monterey,2021-02-02,118,2,720,25,0,16,120
Sonoma,2021-02-02,81,6,655,20,0,11,87
Lassen,2021-02-02,5,0,25,0,0,0,5
Lake,2021-02-02,4,0,63,0,0,3,4
Plumas,2021-02-02,0,0,35,0,0,0,0
Trinity,2021-02-02,0,0,25,0,0,0,0
El Dorado,2021-02-02,10,0,190,2,0,4,10
Sutter,2021-02-03,0,0,14,0,0,0,0
Tuolumne,2021-02-03,5,0,84,1,0,1,5
Santa Cruz,2021-02-03,42,1,373,17,0,4,43
San Joaquin,2021-02-03,209,6,909,71,1,7,215
Solano,2021-02-03,128,7,579,35,0,11,135
San Bernardino,2021-02-03,945,49,3602,242,11,49,994
San Diego,2021-02-03,1202,52,6497,348,9,162,1254
Colusa,2021-02-03,4,0,48,0,0,5,4
Shasta,2021-02-03,19,0,567,2,0,14,19
Yuba,2021-02-03,48,3,261,11,0,0,51
Tehama,2021-02-03,11,0,59,4,0,0,11
Fresno,2021-02-03,435,33,1552,92,2,8,468
Inyo,2021-02-03,5,0,29,0,0,2,5
Mendocino,2021-02-03,5,1,92,2,0,5,6
San Benito,2021-02-03,12,0,25,3,0,0,12
Contra Costa,2021-02-03,165,15,1306,42,4,47,180
Imperial,2021-02-03,61,1,234,27,0,1,62
Santa Clara,2021-02-03,418,9,3144,112,2,48,427
Humboldt,2021-02-03,11,3,273,5,0,7,14
Placer,2021-02-03,108,19,814,25,1,9,127
Orange,2021-02-03,1238,41,5902,365,5,98,1279
Sonoma,2021-02-03,72,9,673,20,0,16,81
Siskiyou,2021-02-03,3,0,56,0,0,4,3
Monterey,2021-02-03,118,2,720,27,0,16,120
San Luis Obispo,2021-02-03,42,1,460,10,0,16,43
Lake,2021-02-03,3,0,62,0,0,2,3
Napa,2021-02-03,17,0,225,2,0,4,17
Mariposa,2021-02-03,0,0,14,0,0,0,0
Nevada,2021-02-03,10,1,136,1,0,3,11
Yolo,2021-02-03,12,0,133,6,0,3,12
Glenn,2021-02-03,0,0,47,0,0,0,0
San Mateo,2021-02-03,125,6,718,32,0,18,131
Riverside,2021-02-03,864,127,3359,243,16,52,991
Los Angeles,2021-02-03,4796,346,19280,1333,53,313,5142
San Francisco,2021-02-03,166,9,2113,47,0,65,175
Mono,2021-02-03,0,0,17,0,0,2,0
Trinity,2021-02-03,0,0,25,0,0,0,0
Kings,2021-02-03,76,1,137,12,0,3,77
Alameda,2021-02-03,301,39,2523,98,3,71,340
Kern,2021-02-03,260,10,1149,66,0,27,270
Santa Barbara,2021-02-03,164,4,603,48,1,20,168
Tulare,2021-02-03,137,13,672,20,2,7,150
Modoc,2021-02-03,2,0,12,0,0,0,2
Ventura,2021-02-03,340,8,1211,80,2,23,348
Butte,2021-02-03,32,0,451,7,0,6,32
Amador,2021-02-03,7,0,52,4,0,1,7
Marin,2021-02-03,23,2,332,4,1,16,25
El Dorado,2021-02-03,9,0,190,2,0,6,9
Lassen,2021-02-03,2,0,25,0,0,0,2
Plumas,2021-02-03,0,0,35,0,0,0,0
Stanislaus,2021-02-03,250,22,1290,60,2,15,272
Del Norte,2021-02-03,0,0,51,0,0,0,0
Calaveras,2021-02-03,3,0,33,2,0,4,3
Madera,2021-02-03,32,7,278,12,0,1,39
Merced,2021-02-03,38,0,271,19,0,4,38
Sacramento,2021-02-03,302,14,2624,78,4,73,316
Stanislaus,2021-02-04,245,21,1301,59,3,8,266
San Mateo,2021-02-04,119,5,721,27,0,21,124
Fresno,2021-02-04,419,24,1535,62,3,2,443
Ventura,2021-02-04,319,9,1232,76,1,27,328
Placer,2021-02-04,114,15,813,23,1,8,129
Inyo,2021-02-04,4,0,29,1,0,1,4
Mariposa,2021-02-04,0,0,14,0,0,0,0
Imperial,2021-02-04,55,1,234,26,0,1,56
Merced,2021-02-04,40,0,271,19,0,0,40
Modoc,2021-02-04,2,0,12,0,0,0,2
San Luis Obispo,2021-02-04,43,0,460,10,0,17,43
Santa Cruz,2021-02-04,45,0,372,16,0,4,45
Shasta,2021-02-04,21,0,567,3,0,16,21
Santa Clara,2021-02-04,381,14,3160,108,3,49,395
Los Angeles,2021-02-04,4607,319,19299,1276,31,332,4926
Tulare,2021-02-04,139,8,672,21,1,9,147
Mono,2021-02-04,0,0,17,0,0,2,0
Glenn,2021-02-04,0,0,47,0,0,0,0
Marin,2021-02-04,25,4,338,5,1,13,29
Yolo,2021-02-04,13,0,131,6,0,3,13
Riverside,2021-02-04,847,117,3319,220,11,56,964
Alameda,2021-02-04,302,42,2520,91,4,67,344
Calaveras,2021-02-04,4,0,33,1,0,5,4
Humboldt,2021-02-04,14,2,273,4,0,10,16
San Joaquin,2021-02-04,196,8,903,62,1,6,204
San Bernardino,2021-02-04,906,50,3613,234,8,47,956
Contra Costa,2021-02-04,174,20,1332,42,3,50,194
Santa Barbara,2021-02-04,161,6,603,44,2,21,167
San Benito,2021-02-04,12,0,25,2,0,0,12
El Dorado,2021-02-04,8,0,190,1,0,8,8
Lake,2021-02-04,2,0,62,0,0,1,2
Madera,2021-02-04,34,5,278,11,0,0,39
Kings,2021-02-04,72,1,135,12,0,3,73
Monterey,2021-02-04,114,0,720,26,0,21,114
Butte,2021-02-04,32,0,451,7,0,7,32
San Francisco,2021-02-04,171,5,2145,47,1,65,176
Tuolumne,2021-02-04,7,1,84,2,0,1,8
Nevada,2021-02-04,14,2,128,2,0,2,16
Sacramento,2021-02-04,292,18,2625,78,5,65,310
Orange,2021-02-04,1233,36,5923,342,4,112,1269
Amador,2021-02-04,6,1,52,2,0,2,7
Sutter,2021-02-04,0,0,14,0,0,0,0
Solano,2021-02-04,118,11,597,32,1,12,129
Napa,2021-02-04,14,0,218,3,0,7,14
Kern,2021-02-04,259,5,1142,60,0,31,264
Trinity,2021-02-04,0,0,25,0,0,0,0
Yuba,2021-02-04,43,3,261,11,0,1,46
Siskiyou,2021-02-04,2,0,56,0,0,4,2
Sonoma,2021-02-04,69,8,643,19,0,16,77
San Diego,2021-02-04,1142,47,6500,333,11,176,1189
Mendocino,2021-02-04,8,1,87,3,0,3,9
Colusa,2021-02-04,5,0,48,0,0,5,5
Lassen,2021-02-04,2,0,25,0,0,0,2
Plumas,2021-02-04,0,0,35,0,0,0,0
Del Norte,2021-02-04,0,0,51,0,0,1,0
Tehama,2021-02-04,9,0,59,3,0,0,9
San Joaquin,2021-02-05,172,6,883,57,0,4,178
Tehama,2021-02-05,11,0,59,2,0,0,11
Merced,2021-02-05,38,0,271,19,0,1,38
Sutter,2021-02-05,0,0,14,0,0,0,0
Stanislaus,2021-02-05,229,24,1296,52,5,15,253
Sonoma,2021-02-05,62,2,640,17,0,16,64
Calaveras,2021-02-05,5,0,33,1,0,5,5
Nevada,2021-02-05,11,4,137,2,0,2,15
Orange,2021-02-05,1164,29,5864,347,2,101,1193
San Mateo,2021-02-05,115,9,708,23,0,20,124
Plumas,2021-02-05,0,0,35,0,0,0,0
Santa Barbara,2021-02-05,154,6,603,43,1,22,160
Kern,2021-02-05,256,2,1141,59,0,28,258
Napa,2021-02-05,14,0,214,4,0,6,14
Lake,2021-02-05,2,0,62,0,0,2,2
Yuba,2021-02-05,43,3,261,9,0,2,46
Madera,2021-02-05,39,8,278,15,0,0,47
Fresno,2021-02-05,405,29,1525,97,1,7,434
Inyo,2021-02-05,6,0,29,1,0,1,6
Mariposa,2021-02-05,0,0,14,0,0,0,0
Marin,2021-02-05,23,2,344,6,1,12,25
San Bernardino,2021-02-05,905,45,3636,216,8,56,950
Modoc,2021-02-05,2,0,12,0,0,0,2
Lassen,2021-02-05,2,0,25,0,0,0,2
Alameda,2021-02-05,294,34,2498,85,2,73,328
Glenn,2021-02-05,0,0,47,0,0,0,0
Amador,2021-02-05,7,1,52,2,0,2,8
Colusa,2021-02-05,4,0,48,0,0,5,4
Monterey,2021-02-05,109,1,720,25,0,18,110
San Francisco,2021-02-05,172,4,2145,49,0,60,176
Contra Costa,2021-02-05,166,21,1340,45,3,35,187
Sacramento,2021-02-05,260,17,2611,64,3,82,277
El Dorado,2021-02-05,6,0,190,1,0,8,6
Imperial,2021-02-05,49,0,234,22,0,4,49
Butte,2021-02-05,31,0,451,8,0,9,31
Humboldt,2021-02-05,15,1,274,4,0,12,16
San Luis Obispo,2021-02-05,36,1,460,10,0,20,37
Riverside,2021-02-05,821,109,3314,214,9,27,930
Del Norte,2021-02-05,0,0,52,0,0,3,0
San Diego,2021-02-05,1100,38,6498,328,11,182,1138
Siskiyou,2021-02-05,2,0,56,0,0,4,2
Santa Cruz,2021-02-05,48,1,372,10,0,11,49
Shasta,2021-02-05,20,0,567,2,0,26,20
Mendocino,2021-02-05,8,0,94,3,0,8,8
Solano,2021-02-05,110,9,592,29,0,13,119
Tulare,2021-02-05,134,9,672,18,2,13,143
San Benito,2021-02-05,12,0,25,4,0,0,12
Los Angeles,2021-02-05,4421,338,19294,1275,36,287,4759
Ventura,2021-02-05,305,11,1207,74,1,25,316
Placer,2021-02-05,109,10,780,22,0,13,119
Kings,2021-02-05,67,0,135,13,0,0,67
Yolo,2021-02-05,12,0,129,5,0,5,12
Mono,2021-02-05,0,0,17,0,0,2,0
Tuolumne,2021-02-05,9,1,84,2,0,1,10
Santa Clara,2021-02-05,360,17,3141,107,3,38,377
Trinity,2021-02-05,0,0,25,0,0,0,0
San Diego,2021-02-06,1074,43,6478,325,11,179,1117
Modoc,2021-02-06,1,0,12,0,0,0,1
San Bernardino,2021-02-06,828,46,3613,203,4,73,874
Mariposa,2021-02-06,0,0,14,0,0,0,0
Marin,2021-02-06,23,1,327,6,0,11,24
Contra Costa,2021-02-06,154,17,1325,44,1,37,171
Tuolumne,2021-02-06,7,1,84,1,0,2,8
Monterey,2021-02-06,105,0,720,22,0,17,105
San Mateo,2021-02-06,107,7,709,24,0,16,114
Orange,2021-02-06,1093,35,5898,335,1,103,1128
Tulare,2021-02-06,126,6,652,15,0,10,132
Napa,2021-02-06,12,0,218,4,0,3,12
Mono,2021-02-06,0,0,17,0,0,2,0
Amador,2021-02-06,6,1,52,1,0,2,7
Kings,2021-02-06,69,2,137,12,0,3,71
Trinity,2021-02-06,0,0,25,0,0,0,0
Sutter,2021-02-06,0,0,14,0,0,0,0
Shasta,2021-02-06,22,0,567,2,0,24,22
Los Angeles,2021-02-06,4186,306,19328,1214,31,277,4492
San Benito,2021-02-06,10,0,25,3,0,0,10
Humboldt,2021-02-06,15,2,274,3,0,9,17
Sacramento,2021-02-06,245,16,2587,66,3,71,261
Merced,2021-02-06,44,0,271,17,0,3,44
Placer,2021-02-06,94,14,780,21,0,13,108
Butte,2021-02-06,25,0,451,8,0,24,25
Yolo,2021-02-06,12,0,131,6,0,2,12
Santa Barbara,2021-02-06,132,5,603,37,0,21,137
Calaveras,2021-02-06,4,0,33,1,0,5,4
Ventura,2021-02-06,298,9,1210,70,2,24,307
Siskiyou,2021-02-06,1,0,56,0,0,3,1
Tehama,2021-02-06,12,0,59,3,0,1,12
Madera,2021-02-06,39,8,278,13,0,0,47
Solano,2021-02-06,98,12,584,32,0,10,110
Alameda,2021-02-06,282,37,2483,93,7,68,319
Yuba,2021-02-06,42,1,261,11,0,2,43
Santa Clara,2021-02-06,341,24,3139,102,1,55,365
Glenn,2021-02-06,0,0,47,0,0,0,0
Inyo,2021-02-06,5,0,29,1,0,1,5
Del Norte,2021-02-06,0,1,52,0,0,1,1
San Joaquin,2021-02-06,175,7,877,61,0,5,182
Plumas,2021-02-06,0,0,35,0,0,0,0
Fresno,2021-02-06,378,25,1499,94,2,6,403
Kern,2021-02-06,244,3,1140,58,0,32,247
Santa Cruz,2021-02-06,46,2,372,11,0,10,48
Imperial,2021-02-06,43,0,246,23,0,2,43
Lake,2021-02-06,2,0,62,0,0,2,2
San Luis Obispo,2021-02-06,32,0,460,8,0,19,32
San Francisco,2021-02-06,159,5,2130,43,0,62,164
Mendocino,2021-02-06,6,0,90,2,0,4,6
Colusa,2021-02-06,7,0,48,0,0,5,7
Sonoma,2021-02-06,69,1,632,16,0,17,70
Stanislaus,2021-02-06,218,31,1296,47,7,12,249
Lassen,2021-02-06,3,0,25,0,0,0,3
El Dorado,2021-02-06,6,0,190,0,0,9,6
Nevada,2021-02-06,9,2,129,1,0,4,11
Riverside,2021-02-06,786,111,3320,201,9,39,897
Fresno,2021-02-07,366,25,1505,98,2,10,391
San Luis Obispo,2021-02-07,33,1,460,8,0,18,34
Contra Costa,2021-02-07,137,18,1300,45,0,39,155
San Diego,2021-02-07,1042,37,6493,318,10,173,1079
Kings,2021-02-07,67,1,135,11,0,2,68
Colusa,2021-02-07,7,0,48,0,0,5,7
Inyo,2021-02-07,5,0,29,1,0,1,5
Santa Cruz,2021-02-07,41,1,372,11,0,10,42
Plumas,2021-02-07,0,0,35,0,0,0,0
Amador,2021-02-07,5,0,52,1,0,3,5
Napa,2021-02-07,12,0,213,2,0,5,12
Tehama,2021-02-07,11,0,59,3,0,2,11
Trinity,2021-02-07,0,0,25,0,0,0,0
San Joaquin,2021-02-07,171,8,893,61,2,2,179
Kern,2021-02-07,270,2,1148,59,0,34,272
Riverside,2021-02-07,768,103,3247,209,5,39,871
Tulare,2021-02-07,124,11,652,18,0,11,135
Mendocino,2021-02-07,8,0,90,2,0,6,8
Solano,2021-02-07,92,8,583,31,0,16,100
Marin,2021-02-07,20,3,336,6,0,10,23
San Bernardino,2021-02-07,822,48,3622,203,3,67,870
Alameda,2021-02-07,279,32,2445,90,4,72,311
Madera,2021-02-07,42,7,276,16,0,0,49
El Dorado,2021-02-07,6,0,190,0,0,10,6
Imperial,2021-02-07,38,2,246,21,0,2,40
Ventura,2021-02-07,282,12,1182,65,4,39,294
Lake,2021-02-07,2,0,62,0,0,1,2
Mariposa,2021-02-07,1,0,14,0,0,0,1
Lassen,2021-02-07,3,0,25,0,0,0,3
Butte,2021-02-07,24,0,451,8,0,24,24
Sonoma,2021-02-07,67,2,634,17,0,19,69
Santa Barbara,2021-02-07,141,6,603,39,0,18,147
Modoc,2021-02-07,1,0,12,0,0,0,1
Yolo,2021-02-07,10,0,131,6,0,3,10
Sacramento,2021-02-07,237,15,2580,68,3,73,252
Calaveras,2021-02-07,4,0,33,1,0,6,4
Monterey,2021-02-07,106,1,720,18,0,19,107
Sutter,2021-02-07,0,0,14,0,0,0,0
Placer,2021-02-07,84,17,777,21,0,8,101
Santa Clara,2021-02-07,327,18,3128,100,2,61,345
Nevada,2021-02-07,9,2,129,1,0,6,11
San Mateo,2021-02-07,101,9,703,27,1,18,110
Los Angeles,2021-02-07,4079,255,19188,1193,27,318,4334
San Benito,2021-02-07,11,0,25,4,0,0,11
Orange,2021-02-07,1046,24,5847,331,4,97,1070
Yuba,2021-02-07,38,2,261,10,0,5,40
Mono,2021-02-07,0,0,17,0,0,2,0
Siskiyou,2021-02-07,2,0,56,2,0,3,2
Stanislaus,2021-02-07,210,22,1299,44,4,16,232
San Francisco,2021-02-07,151,3,2119,45,0,67,154
Glenn,2021-02-07,0,0,47,0,0,0,0
Del Norte,2021-02-07,0,1,52,0,0,4,1
Tuolumne,2021-02-07,7,0,84,1,0,1,7
Merced,2021-02-07,40,0,271,17,0,4,40
Shasta,2021-02-07,22,0,567,5,0,23,22
Humboldt,2021-02-07,14,4,275,3,2,5,18
Napa,2021-02-08,13,0,223,2,0,5,13
Imperial,2021-02-08,38,0,234,24,0,1,38
Placer,2021-02-08,86,11,775,20,0,9,97
San Francisco,2021-02-08,147,2,2126,45,0,71,149
San Diego,2021-02-08,992,47,6483,314,7,184,1039
Kern,2021-02-08,257,3,1144,46,0,32,260
El Dorado,2021-02-08,8,0,190,0,0,7,8
Tehama,2021-02-08,11,0,59,3,0,2,11
Yuba,2021-02-08,36,2,261,11,0,5,38
Mono,2021-02-08,0,0,17,0,0,2,0
Shasta,2021-02-08,22,0,567,5,0,24,22
Plumas,2021-02-08,0,0,35,0,0,0,0
Butte,2021-02-08,23,0,451,9,0,8,23
Alameda,2021-02-08,273,28,2455,86,6,68,301
Los Angeles,2021-02-08,3973,267,19173,1159,45,307,4240
Sonoma,2021-02-08,60,2,625,17,0,21,62
Humboldt,2021-02-08,12,6,274,5,1,7,18
Contra Costa,2021-02-08,131,18,1274,43,2,42,149
Colusa,2021-02-08,7,0,48,0,0,5,7
San Bernardino,2021-02-08,802,67,3610,205,12,71,869
Glenn,2021-02-08,0,0,47,0,0,0,0
Siskiyou,2021-02-08,5,0,56,2,0,4,5
Madera,2021-02-08,41,6,276,16,0,0,47
Marin,2021-02-08,18,3,326,6,0,14,21
San Luis Obispo,2021-02-08,31,2,460,7,1,15,33
Inyo,2021-02-08,4,0,29,1,0,1,4
Del Norte,2021-02-08,1,0,51,1,0,3,1
Riverside,2021-02-08,755,98,3255,193,8,49,853
Tuolumne,2021-02-08,10,0,84,1,0,1,10
Amador,2021-02-08,4,0,52,0,0,3,4
Solano,2021-02-08,99,8,584,30,1,15,107
Kings,2021-02-08,72,0,132,12,0,2,72
Orange,2021-02-08,1058,34,5787,324,4,101,1092
Modoc,2021-02-08,1,0,12,0,0,0,1
Stanislaus,2021-02-08,221,14,1302,46,2,16,235
Mendocino,2021-02-08,12,0,83,2,0,3,12
Trinity,2021-02-08,0,0,25,0,0,0,0
Lake,2021-02-08,3,0,62,0,0,2,3
Mariposa,2021-02-08,1,0,14,0,0,0,1
San Mateo,2021-02-08,96,13,714,27,1,17,109
San Joaquin,2021-02-08,165,5,916,61,0,1,170
Sutter,2021-02-08,0,0,14,0,0,0,0
Lassen,2021-02-08,3,0,25,0,0,0,3
San Benito,2021-02-08,11,0,25,4,0,0,11
Santa Barbara,2021-02-08,149,3,603,41,0,18,152
Fresno,2021-02-08,361,17,1512,95,1,10,378
Yolo,2021-02-08,9,0,131,6,0,3,9
Calaveras,2021-02-08,4,0,33,1,0,6,4
Merced,2021-02-08,40,0,271,17,0,4,40
Tulare,2021-02-08,128,11,672,17,0,14,139
Nevada,2021-02-08,9,2,129,1,0,4,11
Santa Cruz,2021-02-08,40,0,373,10,0,11,40
Ventura,2021-02-08,280,12,1183,63,3,35,292
Santa Clara,2021-02-08,339,13,3120,98,2,64,352
Sacramento,2021-02-08,239,12,2570,71,4,77,251
Monterey,2021-02-08,98,0,720,17,0,20,98
San Diego,2021-02-09,951,50,6481,314,9,179,1001
Merced,2021-02-09,39,0,271,20,0,1,39
San Mateo,2021-02-09,101,17,732,25,3,11,118
Contra Costa,2021-02-09,124,17,1310,37,0,46,141
Los Angeles,2021-02-09,3772,312,19319,1105,41,331,4084
Colusa,2021-02-09,3,0,48,0,0,5,3
Lassen,2021-02-09,3,0,25,0,0,0,3
Marin,2021-02-09,18,3,330,6,0,15,21
Del Norte,2021-02-09,1,0,51,1,0,2,1
Santa Cruz,2021-02-09,38,1,373,10,0,5,39
Nevada,2021-02-09,8,0,131,1,0,4,8
Placer,2021-02-09,82,9,781,16,2,9,91
Plumas,2021-02-09,1,0,35,0,0,0,1
San Bernardino,2021-02-09,738,57,3600,187,13,75,795
Humboldt,2021-02-09,15,2,275,4,0,6,17
Glenn,2021-02-09,0,0,47,0,0,0,0
Santa Barbara,2021-02-09,145,4,603,35,0,25,149
San Francisco,2021-02-09,147,2,2136,44,1,70,149
Sacramento,2021-02-09,250,16,2568,73,4,79,266
Siskiyou,2021-02-09,4,0,56,1,0,4,4
Imperial,2021-02-09,36,1,234,23,0,1,37
Riverside,2021-02-09,726,75,3312,193,6,38,801
Lake,2021-02-09,5,0,62,0,0,0,5
Trinity,2021-02-09,0,0,25,0,0,0,0
Solano,2021-02-09,98,8,591,25,1,14,106
Sonoma,2021-02-09,65,2,649,20,0,22,67
San Luis Obispo,2021-02-09,34,2,460,5,1,16,36
San Benito,2021-02-09,12,0,25,3,0,0,12
Butte,2021-02-09,22,0,451,6,0,16,22
Fresno,2021-02-09,353,16,1536,90,1,15,369
El Dorado,2021-02-09,4,0,190,0,0,5,4
Modoc,2021-02-09,1,0,12,0,0,0,1
Orange,2021-02-09,1009,32,5853,310,1,114,1041
Shasta,2021-02-09,20,0,567,4,0,22,20
Kings,2021-02-09,63,0,137,11,0,3,63
Madera,2021-02-09,45,10,278,11,0,0,55
Tulare,2021-02-09,121,8,672,14,0,12,129
Santa Clara,2021-02-09,342,17,3149,97,2,54,359
Calaveras,2021-02-09,5,0,33,1,0,6,5
Tuolumne,2021-02-09,8,0,84,1,0,0,8
Kern,2021-02-09,268,6,1154,51,0,30,274
Mono,2021-02-09,0,0,17,0,0,2,0
Mendocino,2021-02-09,11,0,82,3,0,3,11
Ventura,2021-02-09,274,17,1189,62,4,33,291
Monterey,2021-02-09,98,0,720,12,0,18,98
Tehama,2021-02-09,12,0,59,3,0,1,12
Mariposa,2021-02-09,1,0,14,0,0,0,1
Amador,2021-02-09,6,0,52,3,0,1,6
Yolo,2021-02-09,11,0,125,6,0,2,11
Stanislaus,2021-02-09,210,13,1304,46,2,12,223
Alameda,2021-02-09,260,40,2471,79,5,72,300
Napa,2021-02-09,12,0,209,2,0,4,12
Inyo,2021-02-09,3,0,29,1,0,1,3
San Joaquin,2021-02-09,160,8,927,61,0,6,168
Sutter,2021-02-09,0,0,14,0,0,0,0
Yuba,2021-02-09,36,0,261,9,0,4,36
Butte,2021-02-10,18,0,451,5,0,17,18
Trinity,2021-02-10,0,0,25,0,0,0,0
San Joaquin,2021-02-10,153,12,914,58,1,9,165
Humboldt,2021-02-10,14,3,275,4,1,4,17
Glenn,2021-02-10,0,0,47,0,0,0,0
Tehama,2021-02-10,13,0,59,2,0,2,13
Sutter,2021-02-10,0,0,14,0,0,0,0
Calaveras,2021-02-10,5,0,33,1,0,6,5
Alameda,2021-02-10,242,41,2503,78,5,75,283
Placer,2021-02-10,79,5,780,18,0,13,84
San Francisco,2021-02-10,132,2,2128,40,1,70,134
Napa,2021-02-10,12,0,219,2,0,2,12
San Mateo,2021-02-10,97,13,730,24,2,16,110
San Luis Obispo,2021-02-10,34,1,460,5,0,15,35
Del Norte,2021-02-10,1,0,51,0,0,2,1
Mendocino,2021-02-10,13,0,84,4,0,3,13
San Bernardino,2021-02-10,706,61,3585,189,9,64,767
San Diego,2021-02-10,916,41,6482,301,10,165,957
Kern,2021-02-10,266,7,1134,46,0,26,273
Yolo,2021-02-10,11,0,128,5,0,0,11
Mono,2021-02-10,1,0,17,0,0,2,1
Contra Costa,2021-02-10,124,14,1316,34,0,44,138
Merced,2021-02-10,38,0,271,19,0,2,38
Los Angeles,2021-02-10,3614,256,19364,1067,27,337,3870
Shasta,2021-02-10,20,0,567,4,0,18,20
Colusa,2021-02-10,3,0,48,0,0,5,3
Imperial,2021-02-10,33,4,234,22,0,1,37
Inyo,2021-02-10,2,0,29,1,0,1,2
Yuba,2021-02-10,34,0,261,10,0,2,34
Siskiyou,2021-02-10,4,0,56,1,0,4,4
Madera,2021-02-10,44,7,278,13,0,1,51
Marin,2021-02-10,20,3,327,7,0,14,23
Santa Barbara,2021-02-10,154,8,603,38,0,19,162
Riverside,2021-02-10,687,71,3318,194,8,32,758
Plumas,2021-02-10,1,0,35,0,0,0,1
Modoc,2021-02-10,1,0,12,0,0,0,1
Amador,2021-02-10,5,0,52,2,0,2,5
Lassen,2021-02-10,1,0,25,0,0,0,1
Fresno,2021-02-10,344,13,1558,87,1,15,357
Lake,2021-02-10,7,0,62,1,0,4,7
El Dorado,2021-02-10,4,0,190,0,0,13,4
Tuolumne,2021-02-10,6,0,84,1,0,0,6
Tulare,2021-02-10,117,7,672,16,0,4,124
Mariposa,2021-02-10,1,0,14,0,0,0,1
Stanislaus,2021-02-10,203,14,1299,41,2,15,217
Sacramento,2021-02-10,245,18,2615,66,4,71,263
San Benito,2021-02-10,12,0,25,3,0,0,12
Orange,2021-02-10,965,35,5867,298,3,120,1000
Santa Clara,2021-02-10,319,11,3067,95,2,57,330
Solano,2021-02-10,96,11,605,25,1,12,107
Monterey,2021-02-10,99,1,720,11,0,18,100
Kings,2021-02-10,60,0,133,10,0,0,60
Sonoma,2021-02-10,53,3,652,17,0,23,56
Santa Cruz,2021-02-10,38,0,373,9,0,0,38
Ventura,2021-02-10,273,18,1182,58,4,38,291
Nevada,2021-02-10,8,0,140,1,0,3,8
Marin,2021-02-11,19,4,317,6,0,15,23
Tulare,2021-02-11,110,13,672,16,0,13,123
Sacramento,2021-02-11,237,18,2591,65,5,74,255
Tehama,2021-02-11,9,0,59,2,0,0,9
Lassen,2021-02-11,1,0,25,0,0,0,1
Del Norte,2021-02-11,1,0,51,1,0,1,1
Los Angeles,2021-02-11,3415,223,19379,1032,22,349,3638
Alameda,2021-02-11,230,40,2517,75,6,67,270
Nevada,2021-02-11,8,0,127,1,0,2,8
Orange,2021-02-11,908,22,5873,290,4,130,930
Sonoma,2021-02-11,48,2,682,16,0,23,50
Glenn,2021-02-11,0,0,47,0,0,0,0
Yolo,2021-02-11,13,0,129,4,0,0,13
Siskiyou,2021-02-11,4,0,56,1,0,4,4
Mono,2021-02-11,2,0,17,0,0,2,2
Modoc,2021-02-11,1,0,12,0,0,0,1
Fresno,2021-02-11,325,21,1566,87,1,10,346
San Francisco,2021-02-11,122,2,2123,33,1,73,124
Imperial,2021-02-11,32,3,234,20,1,2,35
Lake,2021-02-11,7,0,62,0,0,3,7
Colusa,2021-02-11,4,0,48,0,0,5,4
Tuolumne,2021-02-11,6,0,84,1,0,0,6
Plumas,2021-02-11,1,0,35,0,0,0,1
Stanislaus,2021-02-11,197,11,1299,41,3,13,208
Contra Costa,2021-02-11,114,15,1305,34,1,38,129
Humboldt,2021-02-11,11,3,275,4,1,5,14
Sutter,2021-02-11,0,0,14,0,0,0,0
Ventura,2021-02-11,262,10,1185,56,2,32,272
San Joaquin,2021-02-11,170,4,915,60,1,11,174
San Mateo,2021-02-11,93,14,723,24,5,21,107
San Diego,2021-02-11,857,37,6481,282,6,170,894
San Bernardino,2021-02-11,674,43,3606,185,6,76,717
Madera,2021-02-11,42,7,281,12,1,2,49
Merced,2021-02-11,37,0,271,19,0,1,37
San Benito,2021-02-11,15,0,25,4,0,0,15
Butte,2021-02-11,25,0,451,7,0,12,25
Trinity,2021-02-11,0,0,25,0,0,0,0
Santa Clara,2021-02-11,328,23,3080,93,2,48,351
Napa,2021-02-11,12,0,221,1,0,2,12
Santa Barbara,2021-02-11,139,11,603,28,1,29,150
Riverside,2021-02-11,660,64,3307,185,9,34,724
El Dorado,2021-02-11,2,0,190,0,0,12,2
Monterey,2021-02-11,99,0,720,11,0,15,99
Yuba,2021-02-11,32,0,261,11,0,1,32
Solano,2021-02-11,96,15,618,28,2,16,111
Kings,2021-02-11,65,0,131,10,0,1,65
San Luis Obispo,2021-02-11,30,0,460,6,0,16,30
Calaveras,2021-02-11,4,0,33,1,0,6,4
Amador,2021-02-11,3,1,52,3,0,2,4
Shasta,2021-02-11,17,0,567,3,0,19,17
Mariposa,2021-02-11,0,0,14,0,0,0,0
Placer,2021-02-11,76,8,782,18,1,9,84
Mendocino,2021-02-11,13,0,84,5,0,4,13
Kern,2021-02-11,255,8,1164,55,0,30,263
Inyo,2021-02-11,2,0,29,1,0,1,2
Santa Cruz,2021-02-11,39,0,372,12,0,0,39
Lassen,2021-02-12,1,0,25,0,0,0,1
Santa Barbara,2021-02-12,129,5,603,28,0,32,134
Mono,2021-02-12,2,0,17,0,0,2,2
San Bernardino,2021-02-12,626,43,3606,167,5,86,669
Colusa,2021-02-12,5,0,48,0,0,5,5
San Mateo,2021-02-12,88,11,726,20,4,16,99
Sonoma,2021-02-12,50,1,658,18,0,21,51
Trinity,2021-02-12,0,0,25,0,0,0,0
San Diego,2021-02-12,850,40,6461,281,11,178,890
Ventura,2021-02-12,242,9,1193,52,1,31,251
Butte,2021-02-12,18,0,451,4,0,16,18
Madera,2021-02-12,41,4,281,12,0,1,45
Mariposa,2021-02-12,0,0,14,0,0,0,0
Nevada,2021-02-12,9,0,125,1,0,3,9
Tuolumne,2021-02-12,4,0,84,0,0,2,4
Modoc,2021-02-12,1,0,12,0,0,0,1
Santa Clara,2021-02-12,314,20,3069,87,6,53,334
Monterey,2021-02-12,92,0,720,10,0,16,92
Napa,2021-02-12,11,0,220,2,0,3,11
San Benito,2021-02-12,16,0,25,4,0,0,16
Plumas,2021-02-12,1,0,35,0,0,0,1
Merced,2021-02-12,37,0,271,17,0,2,37
Humboldt,2021-02-12,11,3,269,4,0,10,14
Orange,2021-02-12,839,30,5856,270,4,120,869
Del Norte,2021-02-12,2,0,51,1,0,2,2
Santa Cruz,2021-02-12,30,0,372,10,0,0,30
Shasta,2021-02-12,17,0,567,3,0,19,17
Solano,2021-02-12,93,13,612,25,1,11,106
Kings,2021-02-12,64,1,133,7,0,4,65
Siskiyou,2021-02-12,2,0,56,1,0,3,2
Glenn,2021-02-12,0,0,47,0,0,0,0
Amador,2021-02-12,4,0,52,4,0,0,4
Kern,2021-02-12,240,3,1227,57,0,30,243
Yolo,2021-02-12,12,0,131,5,0,2,12
Yuba,2021-02-12,32,2,261,10,0,1,34
Sacramento,2021-02-12,222,19,2595,69,3,79,241
Imperial,2021-02-12,32,1,234,20,1,1,33
Sutter,2021-02-12,0,0,14,0,0,0,0
Riverside,2021-02-12,626,58,3294,184,5,33,684
Fresno,2021-02-12,319,30,1550,84,0,14,349
Contra Costa,2021-02-12,99,12,1325,33,0,50,111
Stanislaus,2021-02-12,196,14,1303,41,2,7,210
Marin,2021-02-12,20,3,321,7,0,15,23
Mendocino,2021-02-12,8,0,84,4,0,4,8
El Dorado,2021-02-12,4,0,190,1,0,6,4
San Luis Obispo,2021-02-12,28,0,460,6,0,22,28
San Joaquin,2021-02-12,158,8,895,52,1,10,166
Tulare,2021-02-12,109,7,668,13,1,15,116
Los Angeles,2021-02-12,3270,196,19282,990,25,333,3466
Alameda,2021-02-12,219,39,2515,72,6,83,258
Calaveras,2021-02-12,4,0,33,1,0,6,4
San Francisco,2021-02-12,118,2,2125,34,0,77,120
Tehama,2021-02-12,9,0,59,2,0,1,9
Lake,2021-02-12,6,0,62,1,0,2,6
Placer,2021-02-12,81,9,779,16,1,9,90
Inyo,2021-02-12,3,1,29,1,0,1,4
Glenn,2021-02-13,0,0,47,0,0,0,0
Los Angeles,2021-02-13,3092,201,19286,930,33,379,3293
San Francisco,2021-02-13,124,5,2125,35,1,71,129
Tuolumne,2021-02-13,3,0,84,0,0,3,3
Stanislaus,2021-02-13,185,16,1305,38,1,13,201
San Benito,2021-02-13,15,0,25,4,0,0,15
Calaveras,2021-02-13,4,0,33,1,0,4,4
Santa Cruz,2021-02-13,28,1,372,8,0,2,29
San Joaquin,2021-02-13,168,11,908,55,1,7,179
Monterey,2021-02-13,83,0,720,10,0,16,83
Kern,2021-02-13,229,3,1180,51,0,31,232
Del Norte,2021-02-13,2,0,51,0,0,1,2
Placer,2021-02-13,77,15,780,17,3,11,92
Riverside,2021-02-13,586,65,3276,186,6,28,651
San Mateo,2021-02-13,86,12,723,22,3,15,98
Sacramento,2021-02-13,227,18,2584,67,3,82,245
Nevada,2021-02-13,7,0,126,0,0,3,7
Tehama,2021-02-13,6,0,59,1,0,0,6
El Dorado,2021-02-13,4,0,190,1,0,5,4
Sutter,2021-02-13,0,0,14,0,0,0,0
Lake,2021-02-13,7,0,62,1,0,0,7
Colusa,2021-02-13,5,0,48,0,0,5,5
Siskiyou,2021-02-13,2,0,56,1,0,2,2
Butte,2021-02-13,15,0,451,0,1,18,15
San Luis Obispo,2021-02-13,28,2,460,6,0,17,30
Inyo,2021-02-13,2,1,29,0,0,2,3
Shasta,2021-02-13,16,0,567,2,0,22,16
Yolo,2021-02-13,11,0,130,6,0,1,11
Sonoma,2021-02-13,47,1,633,17,1,24,48
Contra Costa,2021-02-13,97,18,1339,35,2,42,115
Mono,2021-02-13,1,0,17,0,0,2,1
Fresno,2021-02-13,317,24,1518,87,4,15,341
Mariposa,2021-02-13,0,0,14,0,0,0,0
Humboldt,2021-02-13,12,7,268,4,1,7,19
San Diego,2021-02-13,824,38,6466,288,10,161,862
Orange,2021-02-13,790,26,5878,257,7,112,816
San Bernardino,2021-02-13,572,69,3579,153,5,80,641
Santa Clara,2021-02-13,302,20,3076,81,4,54,322
Madera,2021-02-13,41,6,281,14,0,2,47
Trinity,2021-02-13,0,0,25,0,0,0,0
Mendocino,2021-02-13,12,0,83,6,0,2,12
Plumas,2021-02-13,1,0,35,0,0,0,1
Santa Barbara,2021-02-13,122,7,603,25,2,31,129
Napa,2021-02-13,12,1,212,2,1,2,13
Alameda,2021-02-13,213,38,2522,70,4,73,251
Solano,2021-02-13,91,11,614,24,0,12,102
Tulare,2021-02-13,104,6,647,13,2,17,110
Marin,2021-02-13,18,5,325,6,3,14,23
Lassen,2021-02-13,2,0,25,0,0,0,2
Imperial,2021-02-13,31,2,234,18,1,-3,33
Merced,2021-02-13,40,0,271,15,0,2,40
Ventura,2021-02-13,232,11,1192,52,2,36,243
Yuba,2021-02-13,35,0,261,10,0,1,35
Modoc,2021-02-13,2,0,12,0,0,0,2
Amador,2021-02-13,5,0,52,3,0,0,5
Kings,2021-02-13,61,0,135,10,0,4,61
Inyo,2021-02-14,0,0,29,0,0,2,0
Los Angeles,2021-02-14,2964,200,19158,908,40,360,3164
San Francisco,2021-02-14,118,3,2098,38,0,88,121
Riverside,2021-02-14,576,56,3247,181,6,38,632
Placer,2021-02-14,78,10,770,19,2,12,88
Santa Cruz,2021-02-14,30,0,372,7,0,5,30
Plumas,2021-02-14,2,0,35,0,0,0,2
Del Norte,2021-02-14,2,0,51,0,0,1,2
Calaveras,2021-02-14,2,0,33,1,0,5,2
Mariposa,2021-02-14,0,0,14,0,0,0,0
Imperial,2021-02-14,29,1,234,17,0,0,30
Solano,2021-02-14,92,14,608,22,1,13,106
Humboldt,2021-02-14,13,2,268,4,1,7,15
San Diego,2021-02-14,806,36,6466,277,6,181,842
Stanislaus,2021-02-14,178,17,1303,36,1,8,195
Kern,2021-02-14,221,7,897,52,0,26,228
Orange,2021-02-14,777,32,5829,242,4,127,809
Mono,2021-02-14,1,0,17,0,0,2,1
El Dorado,2021-02-14,6,0,190,2,0,6,6
Merced,2021-02-14,33,0,271,13,0,2,33
Mendocino,2021-02-14,13,0,80,5,0,3,13
Lassen,2021-02-14,2,0,25,0,0,0,2
Modoc,2021-02-14,2,0,12,0,0,0,2
San Mateo,2021-02-14,81,10,733,25,4,15,91
Shasta,2021-02-14,16,0,567,2,0,23,16
Colusa,2021-02-14,5,0,48,0,0,5,5
Monterey,2021-02-14,79,0,720,10,0,19,79
Santa Clara,2021-02-14,293,24,3075,89,4,64,317
Santa Barbara,2021-02-14,119,4,603,25,0,33,123
Sutter,2021-02-14,0,0,14,0,0,0,0
Tulare,2021-02-14,97,5,642,10,2,21,102
Alameda,2021-02-14,201,49,2494,67,5,81,250
San Benito,2021-02-14,13,0,25,4,0,0,13
Amador,2021-02-14,7,0,52,1,0,0,7
Tuolumne,2021-02-14,4,0,84,1,0,2,4
Fresno,2021-02-14,308,16,1509,84,3,17,324
Marin,2021-02-14,17,3,324,7,0,15,20
Nevada,2021-02-14,6,0,126,0,0,6,6
Glenn,2021-02-14,0,0,47,0,0,0,0
Madera,2021-02-14,42,7,277,13,0,0,49
Kings,2021-02-14,60,0,135,10,0,4,60
Contra Costa,2021-02-14,99,17,1325,34,3,40,116
San Joaquin,2021-02-14,159,11,898,56,1,5,170
Butte,2021-02-14,14,2,451,0,1,16,16
Lake,2021-02-14,4,0,62,1,0,1,4
San Bernardino,2021-02-14,576,42,3619,145,6,90,618
Yolo,2021-02-14,10,0,129,5,0,0,10
Yuba,2021-02-14,30,0,261,9,0,3,30
Trinity,2021-02-14,0,0,25,0,0,0,0
San Luis Obispo,2021-02-14,30,0,460,8,0,21,30
Napa,2021-02-14,11,0,205,1,0,4,11
Siskiyou,2021-02-14,3,0,56,1,0,2,3
Sonoma,2021-02-14,48,1,627,20,0,26,49
Sacramento,2021-02-14,223,25,2462,59,4,87,248
Tehama,2021-02-14,6,0,59,1,0,1,6
Ventura,2021-02-14,221,12,1177,50,4,43,233
Stanislaus,2021-02-15,177,11,1293,35,2,16,188
Santa Clara,2021-02-15,271,41,3062,93,6,69,312
Santa Barbara,2021-02-15,106,3,603,21,1,34,109
San Benito,2021-02-15,10,0,25,4,0,0,10
San Joaquin,2021-02-15,146,8,900,56,2,7,154
San Mateo,2021-02-15,80,7,728,24,1,18,87
Lake,2021-02-15,3,0,62,1,0,0,3
Sonoma,2021-02-15,50,1,624,20,0,22,51
Modoc,2021-02-15,2,0,12,0,0,0,2
Mariposa,2021-02-15,0,0,14,0,0,0,0
Plumas,2021-02-15,2,0,35,0,0,0,2
Orange,2021-02-15,748,21,5792,235,9,136,769
Solano,2021-02-15,85,13,585,21,2,14,98
Butte,2021-02-15,11,2,451,1,1,10,13
Sacramento,2021-02-15,227,27,2578,62,5,107,254
Mendocino,2021-02-15,11,0,81,4,0,5,11
Tuolumne,2021-02-15,2,0,84,0,0,2,2
Santa Cruz,2021-02-15,28,0,372,8,0,1,28
Kern,2021-02-15,228,9,1159,53,0,34,237
Alameda,2021-02-15,207,38,2495,64,3,84,245
Calaveras,2021-02-15,1,0,33,1,0,6,1
Humboldt,2021-02-15,15,4,268,4,1,6,19
Yolo,2021-02-15,10,0,146,4,0,2,10
Madera,2021-02-15,46,9,275,13,0,3,55
Contra Costa,2021-02-15,104,28,1321,31,3,43,132
Los Angeles,2021-02-15,2855,189,19163,876,43,382,3044
San Francisco,2021-02-15,114,5,2105,36,0,94,119
Amador,2021-02-15,7,0,52,1,0,2,7
Nevada,2021-02-15,4,0,125,0,0,5,4
Fresno,2021-02-15,309,19,1513,85,2,17,328
Inyo,2021-02-15,0,0,29,0,0,2,0
Napa,2021-02-15,9,0,220,2,0,13,9
Glenn,2021-02-15,0,0,47,0,0,0,0
Kings,2021-02-15,60,0,135,11,0,4,60
Placer,2021-02-15,77,17,768,21,0,9,94
Marin,2021-02-15,17,4,331,5,0,15,21
Del Norte,2021-02-15,2,0,51,0,0,2,2
Lassen,2021-02-15,1,0,25,0,0,0,1
Riverside,2021-02-15,567,51,3210,178,5,39,618
San Luis Obispo,2021-02-15,27,0,460,7,0,22,27
Tehama,2021-02-15,3,0,59,0,0,3,3
Mono,2021-02-15,1,0,17,0,0,2,1
Siskiyou,2021-02-15,3,0,56,1,0,3,3
Shasta,2021-02-15,14,0,567,2,0,24,14
Trinity,2021-02-15,0,0,25,0,0,0,0
Imperial,2021-02-15,28,1,234,16,0,0,29
Monterey,2021-02-15,72,0,720,9,0,16,72
El Dorado,2021-02-15,3,0,190,3,0,8,3
Merced,2021-02-15,34,0,271,12,0,2,34
Tulare,2021-02-15,95,7,642,11,1,16,102
Sutter,2021-02-15,0,0,14,0,0,0,0
Colusa,2021-02-15,5,0,48,0,0,5,5
Ventura,2021-02-15,216,10,1160,48,4,40,226
Yuba,2021-02-15,29,0,261,9,0,1,29
San Diego,2021-02-15,782,37,6454,259,10,192,819
San Bernardino,2021-02-15,575,54,3500,140,16,92,629
Marin,2021-02-16,14,3,325,5,0,15,17
Nevada,2021-02-16,5,0,116,0,0,7,5
Butte,2021-02-16,12,1,451,2,0,10,13
Modoc,2021-02-16,2,1,12,0,0,0,3
Contra Costa,2021-02-16,98,25,1314,32,2,45,123
Kern,2021-02-16,226,9,1164,48,0,29,235
Riverside,2021-02-16,553,60,3228,177,11,40,613
Santa Cruz,2021-02-16,23,1,372,6,0,2,24
Napa,2021-02-16,5,0,212,1,0,5,5
Tulare,2021-02-16,95,9,662,13,1,16,104
Colusa,2021-02-16,3,0,48,0,0,5,3
San Bernardino,2021-02-16,557,55,3542,147,8,74,612
Mono,2021-02-16,1,0,17,0,0,2,1
Yolo,2021-02-16,11,0,125,6,0,1,11
Mendocino,2021-02-16,11,0,85,4,0,3,11
Kings,2021-02-16,56,0,133,11,0,3,56
Sacramento,2021-02-16,212,17,2578,61,4,103,229
Glenn,2021-02-16,0,0,47,0,0,0,0
San Francisco,2021-02-16,118,7,2112,37,1,98,125
Ventura,2021-02-16,202,9,1168,48,1,31,211
Placer,2021-02-16,67,12,769,17,1,14,79
Humboldt,2021-02-16,13,5,268,2,0,4,18
Lake,2021-02-16,1,0,62,0,0,2,1
Merced,2021-02-16,33,0,271,12,0,2,33
Amador,2021-02-16,7,0,52,1,0,1,7
Los Angeles,2021-02-16,2757,223,19197,859,37,391,2980
Sonoma,2021-02-16,45,1,621,18,0,22,46
Shasta,2021-02-16,12,0,567,2,0,23,12
Imperial,2021-02-16,27,1,234,16,0,4,28
Madera,2021-02-16,39,4,277,13,0,0,43
San Mateo,2021-02-16,82,7,726,22,1,24,89
El Dorado,2021-02-16,5,0,190,3,0,8,5
Calaveras,2021-02-16,1,0,33,1,0,5,1
Fresno,2021-02-16,303,21,1528,81,1,17,324
Alameda,2021-02-16,200,37,2498,57,2,87,237
Orange,2021-02-16,719,24,5833,235,5,141,743
Sutter,2021-02-16,0,0,14,0,0,0,0
Inyo,2021-02-16,0,0,29,0,0,2,0
San Joaquin,2021-02-16,144,14,899,58,4,6,158
Stanislaus,2021-02-16,172,12,1304,34,2,22,184
San Diego,2021-02-16,782,39,6472,249,6,217,821
Solano,2021-02-16,82,13,578,22,2,16,95
San Benito,2021-02-16,10,0,25,4,0,0,10
Siskiyou,2021-02-16,1,0,56,1,0,1,1
Plumas,2021-02-16,1,0,35,0,0,0,1
Mariposa,2021-02-16,0,0,14,0,0,0,0
Santa Barbara,2021-02-16,104,3,603,22,1,30,107
Del Norte,2021-02-16,2,0,52,0,0,1,2
San Luis Obispo,2021-02-16,28,0,460,6,0,23,28
Yuba,2021-02-16,29,0,261,9,0,1,29
Santa Clara,2021-02-16,267,27,3038,88,4,66,294
Trinity,2021-02-16,0,0,25,0,0,0,0
Tuolumne,2021-02-16,2,0,84,0,0,2,2
Tehama,2021-02-16,4,0,59,0,0,3,4
Lassen,2021-02-16,0,0,25,0,0,0,0
Monterey,2021-02-16,72,0,720,9,0,19,72
San Benito,2021-02-17,10,0,25,3,0,0,10
Solano,2021-02-17,85,12,590,23,1,19,97
Sutter,2021-02-17,0,0,14,0,0,0,0
Colusa,2021-02-17,3,0,48,0,0,5,3
Santa Cruz,2021-02-17,23,1,372,6,0,1,24
Shasta,2021-02-17,12,0,567,2,0,22,12
Monterey,2021-02-17,65,0,720,9,0,25,65
Modoc,2021-02-17,2,0,12,0,0,0,2
Plumas,2021-02-17,1,0,35,0,0,0,1
Trinity,2021-02-17,0,0,25,0,0,0,0
Siskiyou,2021-02-17,1,0,56,1,0,2,1
Marin,2021-02-17,15,3,317,4,0,17,18
Amador,2021-02-17,6,0,52,1,0,1,6
Mono,2021-02-17,1,0,17,0,0,1,1
San Bernardino,2021-02-17,556,44,3557,143,4,104,600
Madera,2021-02-17,41,9,278,10,0,0,50
Humboldt,2021-02-17,12,3,274,3,2,3,15
Contra Costa,2021-02-17,98,20,1333,33,1,41,118
Riverside,2021-02-17,535,68,3238,172,7,36,603
Orange,2021-02-17,663,26,5847,230,7,128,689
Tuolumne,2021-02-17,3,0,84,1,0,4,3
Tulare,2021-02-17,96,10,662,12,1,15,106
Mariposa,2021-02-17,0,0,14,0,0,0,0
Calaveras,2021-02-17,1,0,33,1,0,6,1
San Diego,2021-02-17,746,55,6476,236,11,210,801
Tehama,2021-02-17,4,0,59,0,0,1,4
Lake,2021-02-17,2,0,62,1,0,1,2
Stanislaus,2021-02-17,173,15,1304,37,1,18,188
Los Angeles,2021-02-17,2640,230,19251,808,26,410,2870
Sacramento,2021-02-17,204,21,2629,60,6,95,225
Sonoma,2021-02-17,43,0,645,15,0,23,43
Placer,2021-02-17,63,13,766,19,2,17,76
San Mateo,2021-02-17,85,9,744,20,1,28,94
Nevada,2021-02-17,4,0,129,0,0,3,4
San Francisco,2021-02-17,108,10,2109,34,2,85,118
Napa,2021-02-17,3,0,214,0,0,4,3
Mendocino,2021-02-17,11,0,83,2,0,4,11
Butte,2021-02-17,16,0,451,2,0,4,16
Yolo,2021-02-17,11,0,129,6,0,1,11
Ventura,2021-02-17,195,8,1143,46,1,30,203
Kern,2021-02-17,219,14,1182,53,0,29,233
Del Norte,2021-02-17,1,0,52,0,0,2,1
Inyo,2021-02-17,1,0,29,0,0,2,1
Kings,2021-02-17,49,0,135,9,0,8,49
San Joaquin,2021-02-17,134,9,907,51,5,3,143
El Dorado,2021-02-17,5,1,190,3,0,9,6
Alameda,2021-02-17,194,33,2499,58,1,76,227
Yuba,2021-02-17,29,1,261,9,0,2,30
Santa Barbara,2021-02-17,95,6,603,20,1,23,101
Fresno,2021-02-17,295,16,1540,75,0,15,311
Merced,2021-02-17,32,0,272,15,0,2,32
Santa Clara,2021-02-17,261,20,3055,87,5,52,281
San Luis Obispo,2021-02-17,24,3,460,5,0,21,27
Imperial,2021-02-17,28,2,234,16,1,2,30
Glenn,2021-02-17,0,0,47,0,0,0,0
Lassen,2021-02-17,0,0,25,0,0,0,0
Madera,2021-02-18,40,12,278,10,0,0,52
Del Norte,2021-02-18,1,2,52,0,0,1,3
San Benito,2021-02-18,9,0,25,3,0,0,9
Sacramento,2021-02-18,201,17,2624,56,2,89,218
Mendocino,2021-02-18,9,0,86,2,0,5,9
Plumas,2021-02-18,1,0,35,0,0,0,1
Santa Barbara,2021-02-18,97,9,603,21,3,23,106
Kern,2021-02-18,185,9,1177,53,0,31,194
San Francisco,2021-02-18,93,7,2110,31,1,82,100
Fresno,2021-02-18,289,18,1540,66,2,17,307
Riverside,2021-02-18,513,63,3228,152,7,43,576
Stanislaus,2021-02-18,173,19,1303,31,1,30,192
Orange,2021-02-18,636,25,5828,215,2,117,661
Amador,2021-02-18,5,1,52,1,0,3,6
San Luis Obispo,2021-02-18,21,2,460,5,0,20,23
Santa Clara,2021-02-18,255,19,3060,82,4,50,274
Lassen,2021-02-18,0,0,25,0,0,0,0
Mono,2021-02-18,0,0,17,0,0,1,0
Solano,2021-02-18,86,12,602,20,0,14,98
Shasta,2021-02-18,12,0,567,2,0,19,12
San Bernardino,2021-02-18,505,34,3565,136,2,96,539
Los Angeles,2021-02-18,2498,247,19277,760,40,419,2745
San Diego,2021-02-18,717,41,6481,224,8,203,758
San Joaquin,2021-02-18,129,16,904,54,4,11,145
Contra Costa,2021-02-18,96,11,1330,37,1,41,107
Nevada,2021-02-18,6,0,129,0,0,2,6
Tuolumne,2021-02-18,0,0,84,0,0,2,0
Lake,2021-02-18,2,0,62,1,0,1,2
Siskiyou,2021-02-18,1,0,56,1,0,4,1
Merced,2021-02-18,33,0,272,15,0,2,33
Modoc,2021-02-18,2,0,12,0,0,0,2
Humboldt,2021-02-18,10,2,274,1,0,8,12
Santa Cruz,2021-02-18,23,2,372,5,0,7,25
Placer,2021-02-18,59,15,768,18,2,17,74
Sonoma,2021-02-18,38,1,651,14,0,21,39
Kings,2021-02-18,42,0,137,10,0,10,42
Butte,2021-02-18,12,0,451,2,0,5,12
Mariposa,2021-02-18,0,0,14,0,0,0,0
Inyo,2021-02-18,2,0,29,0,0,2,2
Yuba,2021-02-18,26,0,261,8,0,2,26
San Mateo,2021-02-18,82,6,733,20,0,28,88
Tulare,2021-02-18,93,6,667,12,0,15,99
Calaveras,2021-02-18,2,0,33,1,0,6,2
Imperial,2021-02-18,29,1,234,14,1,6,30
Trinity,2021-02-18,0,0,25,0,0,0,0
El Dorado,2021-02-18,6,0,190,1,0,12,6
Colusa,2021-02-18,2,0,48,0,0,5,2
Glenn,2021-02-18,0,0,47,0,0,0,0
Ventura,2021-02-18,188,9,1142,46,0,34,197
Alameda,2021-02-18,183,29,2501,58,4,77,212
Monterey,2021-02-18,67,0,720,9,0,24,67
Marin,2021-02-18,18,4,325,4,0,17,22
Sutter,2021-02-18,0,0,14,0,0,0,0
Napa,2021-02-18,2,3,213,0,0,4,5
Yolo,2021-02-18,10,0,126,6,0,5,10
Tehama,2021-02-18,5,0,59,0,0,0,5
Tulare,2021-02-19,83,4,667,12,0,20,87
Napa,2021-02-19,5,1,202,2,0,0,6
Siskiyou,2021-02-19,1,0,56,1,0,4,1
Shasta,2021-02-19,14,0,567,2,0,20,14
Imperial,2021-02-19,27,1,234,14,1,5,28
Los Angeles,2021-02-19,2369,228,19312,712,32,442,2597
Mariposa,2021-02-19,0,0,14,0,0,0,0
Kings,2021-02-19,46,0,135,10,0,8,46
San Diego,2021-02-19,670,35,6476,218,8,195,705
Lassen,2021-02-19,1,0,25,0,0,0,1
Humboldt,2021-02-19,11,2,274,0,2,6,13
Trinity,2021-02-19,0,0,25,0,0,0,0
Inyo,2021-02-19,2,0,29,0,0,2,2
Merced,2021-02-19,32,0,272,11,0,3,32
Santa Barbara,2021-02-19,84,5,603,20,2,23,89
Colusa,2021-02-19,6,0,48,0,0,5,6
Solano,2021-02-19,84,10,604,23,2,5,94
Contra Costa,2021-02-19,84,13,1310,35,2,36,97
Yuba,2021-02-19,26,0,261,5,0,2,26
Kern,2021-02-19,182,5,1184,49,0,30,187
Sutter,2021-02-19,0,0,14,0,0,0,0
Orange,2021-02-19,591,31,5800,196,3,121,622
Del Norte,2021-02-19,1,4,52,0,0,1,5
Yolo,2021-02-19,11,0,127,6,0,3,11
Riverside,2021-02-19,493,40,3232,137,4,42,533
Butte,2021-02-19,12,0,451,2,0,6,12
Santa Cruz,2021-02-19,25,2,372,5,0,6,27
San Francisco,2021-02-19,99,5,2116,32,0,85,104
Modoc,2021-02-19,0,0,12,0,0,0,0
San Bernardino,2021-02-19,469,38,3540,133,6,79,507
Glenn,2021-02-19,0,0,47,0,0,0,0
San Mateo,2021-02-19,80,5,719,19,0,24,85
Tuolumne,2021-02-19,1,0,84,0,0,4,1
Nevada,2021-02-19,3,0,127,1,0,2,3
El Dorado,2021-02-19,7,0,190,1,0,12,7
San Joaquin,2021-02-19,127,24,895,52,4,12,151
Fresno,2021-02-19,265,27,1527,63,2,23,292
Madera,2021-02-19,39,6,278,12,0,6,45
Sonoma,2021-02-19,41,1,670,14,0,23,42
San Benito,2021-02-19,8,0,25,2,0,1,8
Mono,2021-02-19,0,0,17,0,0,1,0
San Luis Obispo,2021-02-19,19,2,460,4,0,20,21
Alameda,2021-02-19,190,29,2519,60,3,79,219
Amador,2021-02-19,7,1,52,1,1,2,8
Tehama,2021-02-19,7,0,59,1,0,0,7
Santa Clara,2021-02-19,243,17,3065,73,2,55,260
Sacramento,2021-02-19,186,19,2621,49,1,82,205
Ventura,2021-02-19,178,6,1173,44,3,35,184
Plumas,2021-02-19,1,0,35,0,0,0,1
Monterey,2021-02-19,72,1,720,8,0,16,73
Lake,2021-02-19,1,0,62,1,0,3,1
Stanislaus,2021-02-19,162,16,1304,30,1,20,178
Marin,2021-02-19,16,3,321,6,0,14,19
Mendocino,2021-02-19,8,0,88,2,0,4,8
Placer,2021-02-19,57,18,777,20,0,16,75
Calaveras,2021-02-19,2,0,33,1,0,7,2
Napa,2021-02-20,7,0,207,2,0,5,7
Inyo,2021-02-20,0,0,29,0,0,1,0
Lake,2021-02-20,1,0,63,0,0,4,1
Sacramento,2021-02-20,177,13,2508,50,2,80,190
Mendocino,2021-02-20,6,1,84,2,0,3,7
Tuolumne,2021-02-20,2,0,84,0,0,2,2
Marin,2021-02-20,14,4,327,6,0,14,18
Trinity,2021-02-20,0,0,25,0,0,0,0
Plumas,2021-02-20,0,0,35,0,0,0,0
Santa Clara,2021-02-20,228,15,3053,71,1,59,243
Stanislaus,2021-02-20,155,15,1305,34,1,23,170
Riverside,2021-02-20,455,56,3196,138,5,36,511
Mono,2021-02-20,0,0,17,0,0,1,0
San Bernardino,2021-02-20,433,37,3510,127,2,102,470
Lassen,2021-02-20,1,0,25,0,0,0,1
Nevada,2021-02-20,2,0,115,1,0,2,2
Santa Barbara,2021-02-20,83,2,603,19,0,32,85
Los Angeles,2021-02-20,2213,212,19279,679,34,438,2425
Calaveras,2021-02-20,2,0,33,1,0,7,2
Ventura,2021-02-20,171,11,1150,43,0,38,182
Alameda,2021-02-20,176,26,2481,58,1,78,202
Imperial,2021-02-20,28,1,234,11,0,3,29
Yuba,2021-02-20,21,1,261,4,0,4,22
Siskiyou,2021-02-20,1,0,56,1,0,5,1
Placer,2021-02-20,64,17,772,21,0,13,81
San Joaquin,2021-02-20,126,25,906,45,5,14,151
Mariposa,2021-02-20,0,0,14,0,0,0,0
Sonoma,2021-02-20,38,1,656,13,0,22,39
Contra Costa,2021-02-20,78,10,1303,30,0,36,88
Orange,2021-02-20,577,32,5839,190,1,122,609
San Benito,2021-02-20,9,0,25,3,0,0,9
Santa Cruz,2021-02-20,25,2,372,5,0,6,27
Tehama,2021-02-20,3,0,59,0,0,1,3
Kern,2021-02-20,167,7,1165,51,0,31,174
Merced,2021-02-20,32,1,272,12,0,4,33
Solano,2021-02-20,70,12,582,17,1,11,82
Monterey,2021-02-20,59,0,720,8,0,18,59
San Francisco,2021-02-20,89,5,2112,28,0,87,94
Modoc,2021-02-20,0,0,12,0,0,0,0
Amador,2021-02-20,6,2,52,1,1,0,8
Humboldt,2021-02-20,10,4,273,0,1,7,14
Glenn,2021-02-20,0,0,47,0,0,0,0
Kings,2021-02-20,45,0,135,9,0,9,45
Tulare,2021-02-20,75,8,647,11,0,26,83
Del Norte,2021-02-20,2,4,52,0,0,2,6
Madera,2021-02-20,35,8,278,10,0,5,43
El Dorado,2021-02-20,6,0,190,2,0,8,6
San Mateo,2021-02-20,64,6,720,19,2,24,70
Butte,2021-02-20,11,0,451,2,0,11,11
Colusa,2021-02-20,7,0,48,0,0,5,7
Shasta,2021-02-20,18,0,567,1,0,21,18
San Luis Obispo,2021-02-20,22,3,460,4,0,22,25
Fresno,2021-02-20,244,32,1512,63,4,19,276
Sutter,2021-02-20,0,0,14,0,0,0,0
Yolo,2021-02-20,10,0,125,6,0,2,10
San Diego,2021-02-20,636,36,6462,205,9,219,672
Tulare,2021-02-21,79,6,647,13,1,21,85
Sonoma,2021-02-21,37,1,632,13,0,24,38
San Bernardino,2021-02-21,437,56,3485,122,6,106,493
San Joaquin,2021-02-21,125,23,896,41,5,16,148
Tehama,2021-02-21,2,0,59,0,0,3,2
Del Norte,2021-02-21,2,4,52,0,0,2,6
San Benito,2021-02-21,7,0,25,3,0,0,7
Ventura,2021-02-21,189,4,1155,38,0,39,193
Lassen,2021-02-21,0,0,25,0,0,0,0
Orange,2021-02-21,556,33,5815,179,1,127,589
Calaveras,2021-02-21,1,0,33,0,0,8,1
Butte,2021-02-21,13,0,451,3,0,8,13
Imperial,2021-02-21,27,1,234,11,0,1,28
Los Angeles,2021-02-21,2146,191,19119,660,31,512,2337
Modoc,2021-02-21,0,0,12,0,0,0,0
Madera,2021-02-21,33,7,278,11,1,7,40
Nevada,2021-02-21,2,1,119,1,0,3,3
Yolo,2021-02-21,9,0,116,6,0,1,9
Santa Cruz,2021-02-21,22,2,372,2,1,3,24
San Francisco,2021-02-21,93,5,2088,27,1,86,98
Alameda,2021-02-21,174,26,2461,55,1,78,200
Santa Clara,2021-02-21,221,21,3040,67,4,69,242
Sacramento,2021-02-21,185,25,2578,53,4,90,210
Shasta,2021-02-21,19,0,567,1,0,21,19
Kern,2021-02-21,167,7,1160,50,0,33,174
El Dorado,2021-02-21,10,0,190,3,0,5,10
Tuolumne,2021-02-21,2,0,84,0,0,4,2
Fresno,2021-02-21,231,13,1493,58,1,28,244
Stanislaus,2021-02-21,143,14,1305,31,2,22,157
Marin,2021-02-21,15,5,317,5,2,14,20
San Luis Obispo,2021-02-21,19,1,460,4,0,25,20
Riverside,2021-02-21,441,51,3161,132,5,43,492
Merced,2021-02-21,32,1,272,10,0,4,33
Mono,2021-02-21,0,0,17,0,0,1,0
Napa,2021-02-21,7,0,209,3,0,3,7
Kings,2021-02-21,41,0,137,6,0,13,41
Solano,2021-02-21,63,16,561,16,1,12,79
Mariposa,2021-02-21,0,0,14,0,0,0,0
Siskiyou,2021-02-21,1,0,56,1,0,5,1
Plumas,2021-02-21,0,0,35,0,0,0,0
San Mateo,2021-02-21,66,8,714,18,1,24,74
Santa Barbara,2021-02-21,82,2,603,17,0,36,84
Glenn,2021-02-21,0,0,47,0,0,0,0
Amador,2021-02-21,6,2,52,1,1,0,8
Trinity,2021-02-21,0,0,25,0,0,0,0
Sutter,2021-02-21,0,0,14,0,0,0,0
Colusa,2021-02-21,8,0,48,0,0,5,8
Monterey,2021-02-21,46,1,720,9,0,19,47
San Diego,2021-02-21,622,36,6454,198,7,223,658
Inyo,2021-02-21,1,0,29,1,0,1,1
Mendocino,2021-02-21,5,1,72,2,0,5,6
Humboldt,2021-02-21,9,7,273,0,1,7,16
Lake,2021-02-21,1,0,63,0,0,4,1
Placer,2021-02-21,64,16,770,23,0,13,80
Yuba,2021-02-21,24,0,261,6,0,3,24
Contra Costa,2021-02-21,84,9,1299,33,0,39,93
San Diego,2021-02-22,601,31,6454,188,7,241,632
Santa Clara,2021-02-22,226,26,3027,71,4,78,252
Tulare,2021-02-22,75,7,667,12,1,21,82
Yuba,2021-02-22,22,0,261,6,0,1,22
Lake,2021-02-22,4,0,63,0,0,4,4
Modoc,2021-02-22,0,0,12,0,0,0,0
Ventura,2021-02-22,167,6,1156,32,2,43,173
San Mateo,2021-02-22,65,8,705,18,1,21,73
Sonoma,2021-02-22,39,2,639,12,0,22,41
Mono,2021-02-22,0,0,17,0,0,2,0
Siskiyou,2021-02-22,2,0,56,3,0,4,2
Merced,2021-02-22,32,1,272,9,0,4,33
San Joaquin,2021-02-22,122,6,901,40,0,14,128
Inyo,2021-02-22,1,0,29,1,0,1,1
Trinity,2021-02-22,0,0,25,0,0,0,0
Tehama,2021-02-22,1,0,59,0,0,5,1
Orange,2021-02-22,539,28,5805,152,0,150,567
Monterey,2021-02-22,40,1,720,8,0,18,41
Stanislaus,2021-02-22,138,15,1304,29,1,17,153
San Benito,2021-02-22,7,0,25,3,0,1,7
San Francisco,2021-02-22,96,5,2076,30,0,91,101
Kings,2021-02-22,40,0,133,6,0,9,40
Imperial,2021-02-22,29,0,234,12,0,4,29
Kern,2021-02-22,170,9,1152,50,0,29,179
Contra Costa,2021-02-22,81,10,1269,34,0,53,91
San Bernardino,2021-02-22,414,44,3522,113,5,96,458
Fresno,2021-02-22,239,19,1515,60,2,22,258
Santa Cruz,2021-02-22,18,3,372,2,1,3,21
Colusa,2021-02-22,8,0,48,0,0,5,8
Plumas,2021-02-22,0,0,35,0,0,0,0
Sacramento,2021-02-22,180,21,2580,50,2,96,201
Alameda,2021-02-22,180,23,2420,54,1,80,203
Mendocino,2021-02-22,4,0,79,2,0,4,4
Mariposa,2021-02-22,0,0,14,0,0,0,0
Glenn,2021-02-22,0,0,47,0,0,0,0
Humboldt,2021-02-22,9,5,274,0,0,7,14
Solano,2021-02-22,56,16,556,16,3,17,72
Los Angeles,2021-02-22,2064,200,19089,619,34,487,2264
Shasta,2021-02-22,15,1,567,2,0,19,16
Placer,2021-02-22,64,6,769,22,0,20,70
Calaveras,2021-02-22,0,0,33,0,0,8,0
San Luis Obispo,2021-02-22,18,0,460,3,0,23,18
Napa,2021-02-22,9,2,205,4,0,5,11
Butte,2021-02-22,13,0,451,4,0,11,13
Marin,2021-02-22,13,5,314,5,1,15,18
Yolo,2021-02-22,10,0,121,6,0,4,10
Riverside,2021-02-22,407,49,3215,112,8,48,456
Amador,2021-02-22,5,1,52,1,1,2,6
Nevada,2021-02-22,5,0,119,1,0,2,5
El Dorado,2021-02-22,9,0,190,2,0,6,9
Madera,2021-02-22,30,6,278,11,0,9,36
Del Norte,2021-02-22,2,1,52,0,1,0,3
Santa Barbara,2021-02-22,76,6,603,17,1,35,82
Sutter,2021-02-22,0,0,14,0,0,0,0
Lassen,2021-02-22,0,0,25,0,0,0,0
Tuolumne,2021-02-22,0,0,84,0,0,4,0
San Francisco,2021-02-23,95,6,2097,28,0,87,101
Santa Barbara,2021-02-23,85,3,603,17,0,22,88
Del Norte,2021-02-23,1,0,52,0,0,1,1
Merced,2021-02-23,33,1,271,8,0,6,34
Tehama,2021-02-23,1,0,59,0,0,5,1
San Benito,2021-02-23,4,0,25,2,0,1,4
Marin,2021-02-23,12,6,319,4,0,16,18
Santa Cruz,2021-02-23,22,2,372,3,0,0,24
Madera,2021-02-23,35,3,278,10,0,7,38
Trinity,2021-02-23,0,0,25,0,0,0,0
Contra Costa,2021-02-23,89,17,1293,30,0,48,106
San Diego,2021-02-23,597,34,6487,178,6,222,631
Plumas,2021-02-23,0,0,35,0,0,0,0
Mendocino,2021-02-23,3,1,85,2,0,3,4
Fresno,2021-02-23,241,14,1532,63,1,18,255
Amador,2021-02-23,4,0,52,1,0,2,4
Yolo,2021-02-23,11,0,127,6,0,2,11
Tuolumne,2021-02-23,1,0,84,0,0,5,1
Calaveras,2021-02-23,1,0,33,0,0,5,1
Yuba,2021-02-23,20,0,261,7,0,1,20
Imperial,2021-02-23,27,0,234,10,0,5,27
Colusa,2021-02-23,3,0,48,0,0,5,3
Shasta,2021-02-23,13,1,567,3,0,18,14
Butte,2021-02-23,16,0,451,1,0,5,16
Modoc,2021-02-23,0,0,12,0,0,0,0
Mariposa,2021-02-23,0,0,14,0,0,0,0
Siskiyou,2021-02-23,2,0,56,3,0,3,2
El Dorado,2021-02-23,6,0,190,1,0,8,6
San Joaquin,2021-02-23,118,15,890,42,0,8,133
Lake,2021-02-23,4,0,63,0,0,5,4
Nevada,2021-02-23,2,1,115,1,0,3,3
Mono,2021-02-23,0,0,17,0,0,2,0
Inyo,2021-02-23,1,0,29,0,0,1,1
Glenn,2021-02-23,0,0,47,0,0,0,0
Riverside,2021-02-23,406,49,3264,116,6,50,455
Sonoma,2021-02-23,37,1,667,12,0,16,38
Solano,2021-02-23,52,13,557,14,2,18,65
Stanislaus,2021-02-23,141,14,1307,30,1,19,155
Kern,2021-02-23,165,7,1117,49,0,26,172
Tulare,2021-02-23,78,9,667,11,1,18,87
Humboldt,2021-02-23,9,2,276,0,0,4,11
Orange,2021-02-23,515,26,5828,151,3,144,541
Monterey,2021-02-23,41,0,720,8,0,22,41
San Luis Obispo,2021-02-23,17,1,460,3,0,18,18
Ventura,2021-02-23,157,8,1188,36,3,41,165
San Mateo,2021-02-23,61,5,703,17,1,16,66
San Bernardino,2021-02-23,396,36,3564,112,6,99,432
Los Angeles,2021-02-23,1988,226,19276,600,28,470,2214
Santa Clara,2021-02-23,215,24,3063,66,1,68,239
Placer,2021-02-23,54,11,775,23,0,19,65
Lassen,2021-02-23,0,0,25,0,0,0,0
Sacramento,2021-02-23,183,18,2573,50,1,85,201
Sutter,2021-02-23,0,0,14,0,0,0,0
Kings,2021-02-23,39,0,129,6,0,5,39
Alameda,2021-02-23,175,25,2438,49,4,78,200
Napa,2021-02-23,9,0,210,5,0,4,9
Ventura,2021-02-24,151,9,1142,33,2,29,160
Lassen,2021-02-24,1,0,25,0,0,0,1
Marin,2021-02-24,14,3,317,4,0,16,17
Tuolumne,2021-02-24,2,0,84,0,0,3,2
Alameda,2021-02-24,172,22,2443,50,1,77,194
Yuba,2021-02-24,22,0,261,4,0,0,22
Madera,2021-02-24,29,5,278,6,0,10,34
Fresno,2021-02-24,227,15,1530,52,1,23,242
San Francisco,2021-02-24,91,7,2106,29,1,81,98
Shasta,2021-02-24,14,1,567,1,1,16,15
Del Norte,2021-02-24,1,0,52,0,0,1,1
Mariposa,2021-02-24,0,0,14,0,0,0,0
San Luis Obispo,2021-02-24,19,2,460,2,0,21,21
Merced,2021-02-24,35,1,271,8,0,2,36
Plumas,2021-02-24,0,0,35,0,0,0,0
San Bernardino,2021-02-24,371,37,3563,102,5,101,408
Sacramento,2021-02-24,182,11,2609,52,1,75,193
Kings,2021-02-24,43,0,133,6,0,9,43
Santa Barbara,2021-02-24,83,4,603,19,0,20,87
San Joaquin,2021-02-24,117,13,894,42,3,9,130
Placer,2021-02-24,53,13,770,21,1,17,66
Nevada,2021-02-24,1,2,132,1,0,1,3
Colusa,2021-02-24,3,0,48,0,0,5,3
Sutter,2021-02-24,0,0,14,0,0,0,0
Amador,2021-02-24,3,0,52,1,0,2,3
San Diego,2021-02-24,560,35,6499,179,6,218,595
Tulare,2021-02-24,74,6,667,10,1,20,80
Calaveras,2021-02-24,1,0,33,0,0,5,1
Mono,2021-02-24,0,0,17,0,0,2,0
Tehama,2021-02-24,2,0,59,0,0,4,2
El Dorado,2021-02-24,4,1,190,1,1,4,5
Trinity,2021-02-24,0,0,25,0,0,0,0
Monterey,2021-02-24,39,0,720,9,0,16,39
Santa Clara,2021-02-24,203,31,3088,62,3,60,234
Modoc,2021-02-24,0,0,12,0,0,0,0
Mendocino,2021-02-24,2,0,88,2,0,2,2
Orange,2021-02-24,515,27,5887,160,2,222,542
Sonoma,2021-02-24,39,0,687,12,0,15,39
Santa Cruz,2021-02-24,19,2,372,2,0,6,21
Kern,2021-02-24,161,7,1158,49,0,19,168
Solano,2021-02-24,52,14,579,15,0,13,66
Imperial,2021-02-24,26,0,234,8,0,3,26
Butte,2021-02-24,16,0,451,1,0,4,16
Inyo,2021-02-24,1,0,29,0,0,1,1
San Mateo,2021-02-24,53,5,704,16,2,21,58
Los Angeles,2021-02-24,1886,215,19281,573,32,466,2101
Napa,2021-02-24,10,0,219,4,0,57,10
Glenn,2021-02-24,0,0,47,0,0,0,0
Contra Costa,2021-02-24,90,18,1296,28,3,45,108
Riverside,2021-02-24,381,57,3288,102,5,55,438
San Benito,2021-02-24,4,0,25,3,0,0,4
Siskiyou,2021-02-24,2,0,56,3,0,2,2
Stanislaus,2021-02-24,137,21,1300,30,3,18,158
Yolo,2021-02-24,12,0,132,6,0,0,12
Lake,2021-02-24,3,0,63,0,0,5,3
Humboldt,2021-02-24,8,2,276,0,1,6,10
Mariposa,2021-02-25,0,0,14,0,0,0,0
El Dorado,2021-02-25,5,0,190,2,0,6,5
Ventura,2021-02-25,144,8,1183,35,1,44,152
Orange,2021-02-25,453,22,5866,137,5,234,475
Marin,2021-02-25,13,2,317,4,1,15,15
Sacramento,2021-02-25,177,16,2597,50,2,73,193
Madera,2021-02-25,33,5,279,8,0,8,38
Trinity,2021-02-25,0,0,25,0,0,0,0
Santa Clara,2021-02-25,192,27,3072,66,2,51,219
Mono,2021-02-25,0,0,17,0,0,2,0
Merced,2021-02-25,35,0,271,6,0,8,35
Fresno,2021-02-25,218,17,1524,48,1,18,235
Sutter,2021-02-25,0,0,14,0,0,0,0
Tuolumne,2021-02-25,2,1,84,0,1,3,3
San Diego,2021-02-25,535,26,6484,173,2,217,561
Yolo,2021-02-25,10,0,132,5,0,2,10
Colusa,2021-02-25,1,0,48,0,0,5,1
Plumas,2021-02-25,0,0,35,0,0,0,0
Stanislaus,2021-02-25,139,14,1309,30,2,20,153
Humboldt,2021-02-25,8,2,276,0,0,6,10
San Benito,2021-02-25,6,0,25,4,0,0,6
Shasta,2021-02-25,18,1,567,4,0,17,19
Kings,2021-02-25,39,0,131,7,0,7,39
Inyo,2021-02-25,0,0,29,0,0,2,0
Yuba,2021-02-25,21,0,261,6,0,2,21
Contra Costa,2021-02-25,74,14,1298,30,0,45,88
Placer,2021-02-25,56,17,771,18,4,16,73
Tulare,2021-02-25,72,6,667,10,2,19,78
Solano,2021-02-25,46,16,581,13,1,7,62
Sonoma,2021-02-25,35,0,663,12,0,18,35
Santa Barbara,2021-02-25,76,5,603,18,1,27,81
Alameda,2021-02-25,168,19,2466,46,1,87,187
Imperial,2021-02-25,25,0,234,8,0,4,25
Monterey,2021-02-25,38,1,720,9,0,17,39
Los Angeles,2021-02-25,1733,229,19286,550,39,474,1962
Siskiyou,2021-02-25,2,0,56,3,0,4,2
San Mateo,2021-02-25,54,2,697,16,0,17,56
Kern,2021-02-25,162,1,1140,54,0,24,163
Lake,2021-02-25,4,1,63,1,0,5,5
Del Norte,2021-02-25,1,0,52,0,0,1,1
Mendocino,2021-02-25,5,0,87,3,0,2,5
Lassen,2021-02-25,1,0,25,0,0,0,1
Amador,2021-02-25,3,1,52,0,1,2,4
Glenn,2021-02-25,0,0,47,0,0,0,0
Santa Cruz,2021-02-25,17,1,372,2,0,10,18
Calaveras,2021-02-25,1,0,33,0,0,5,1
San Francisco,2021-02-25,94,1,2120,27,0,74,95
San Bernardino,2021-02-25,352,26,3559,91,3,110,378
Modoc,2021-02-25,0,0,12,0,0,0,0
San Joaquin,2021-02-25,117,14,877,40,7,6,131
Napa,2021-02-25,8,1,216,3,0,1,9
Butte,2021-02-25,13,0,451,2,0,5,13
Riverside,2021-02-25,361,63,3295,96,9,54,424
San Luis Obispo,2021-02-25,18,1,460,2,0,21,19
Tehama,2021-02-25,3,0,59,0,0,3,3
Nevada,2021-02-25,2,2,122,1,0,2,4
Solano,2021-02-26,45,12,577,14,0,13,57
Napa,2021-02-26,7,3,210,2,0,47,10
Los Angeles,2021-02-26,1661,194,19252,533,32,461,1855
Santa Barbara,2021-02-26,74,6,603,18,1,28,80
Placer,2021-02-26,52,10,773,18,2,15,62
Santa Clara,2021-02-26,194,25,3084,62,0,68,219
Yuba,2021-02-26,18,0,256,5,0,1,18
Sutter,2021-02-26,0,0,14,0,0,0,0
Del Norte,2021-02-26,1,0,52,0,0,0,1
Yolo,2021-02-26,11,0,132,4,0,4,11
Madera,2021-02-26,29,7,279,12,0,6,36
Monterey,2021-02-26,40,1,720,9,0,12,41
El Dorado,2021-02-26,6,0,190,1,0,6,6
Modoc,2021-02-26,0,0,12,0,0,0,0
Shasta,2021-02-26,18,1,567,4,0,17,19
San Francisco,2021-02-26,83,5,2116,24,1,66,88
Merced,2021-02-26,33,0,271,6,0,8,33
Tehama,2021-02-26,3,0,59,0,0,3,3
Sonoma,2021-02-26,35,1,650,12,0,14,36
San Luis Obispo,2021-02-26,18,1,460,2,0,21,19
Fresno,2021-02-26,207,20,1540,48,2,16,227
Riverside,2021-02-26,338,57,3292,87,5,60,395
Humboldt,2021-02-26,6,2,276,0,1,9,8
Kings,2021-02-26,34,0,126,6,0,0,34
Nevada,2021-02-26,2,2,122,1,0,3,4
Plumas,2021-02-26,0,0,35,0,0,0,0
Colusa,2021-02-26,0,0,48,0,0,5,0
Stanislaus,2021-02-26,128,14,1305,31,1,19,142
Alameda,2021-02-26,157,24,2475,42,2,101,181
San Benito,2021-02-26,6,0,25,4,0,0,6
San Diego,2021-02-26,523,39,6493,167,6,222,562
San Joaquin,2021-02-26,109,7,879,39,2,6,116
Mariposa,2021-02-26,0,0,14,0,0,0,0
Tuolumne,2021-02-26,2,0,84,0,0,0,2
Marin,2021-02-26,15,2,316,5,1,16,17
Lake,2021-02-26,3,0,63,1,0,5,3
Contra Costa,2021-02-26,72,11,1299,29,2,47,83
Trinity,2021-02-26,0,0,25,0,0,0,0
San Bernardino,2021-02-26,327,23,3542,85,4,116,350
Calaveras,2021-02-26,1,0,33,1,0,4,1
Lassen,2021-02-26,1,0,25,0,0,0,1
Mendocino,2021-02-26,5,0,87,3,0,4,5
Amador,2021-02-26,3,0,52,0,0,1,3
Santa Cruz,2021-02-26,16,2,372,1,0,7,18
Butte,2021-02-26,15,0,451,2,0,4,15
Kern,2021-02-26,158,4,1140,52,0,24,162
San Mateo,2021-02-26,54,3,682,16,3,12,57
Mono,2021-02-26,1,0,17,0,0,2,1
Orange,2021-02-26,444,15,5852,128,2,249,459
Ventura,2021-02-26,144,9,1191,38,2,44,153
Tulare,2021-02-26,69,8,667,9,0,21,77
Sacramento,2021-02-26,177,17,2626,49,4,71,194
Inyo,2021-02-26,2,0,29,0,0,2,2
Glenn,2021-02-26,0,0,47,0,0,0,0
Imperial,2021-02-26,22,0,234,8,0,5,22
Siskiyou,2021-02-26,3,0,56,0,0,3,3
San Joaquin,2021-02-27,105,9,879,40,2,7,114
Tuolumne,2021-02-27,0,0,84,0,0,2,0
Humboldt,2021-02-27,6,3,276,0,1,9,9
Mendocino,2021-02-27,6,0,90,3,0,3,6
Riverside,2021-02-27,328,50,3262,90,4,60,378
San Francisco,2021-02-27,78,8,2114,24,3,75,86
San Benito,2021-02-27,4,0,25,3,0,0,4
San Mateo,2021-02-27,56,3,675,17,0,17,59
Sutter,2021-02-27,0,0,14,0,0,0,0
Fresno,2021-02-27,201,22,1508,41,1,14,223
Del Norte,2021-02-27,1,0,52,0,0,0,1
Tulare,2021-02-27,62,3,648,7,0,23,65
Glenn,2021-02-27,0,0,47,0,0,0,0
Monterey,2021-02-27,38,3,720,9,0,14,41
Alameda,2021-02-27,163,26,2466,38,4,95,189
Placer,2021-02-27,61,9,770,16,0,21,70
Los Angeles,2021-02-27,1578,183,19266,495,29,465,1761
Yolo,2021-02-27,11,0,132,4,0,4,11
Merced,2021-02-27,33,0,271,6,0,8,33
Trinity,2021-02-27,0,0,25,0,0,0,0
Santa Clara,2021-02-27,187,33,3056,62,3,57,220
Tehama,2021-02-27,3,0,59,0,0,3,3
Mariposa,2021-02-27,0,0,14,0,0,0,0
San Diego,2021-02-27,485,34,6486,156,6,205,519
Mono,2021-02-27,1,0,17,0,0,2,1
Stanislaus,2021-02-27,120,15,1304,31,2,23,135
Contra Costa,2021-02-27,78,16,1327,26,1,47,94
Napa,2021-02-27,8,0,207,2,0,11,8
Colusa,2021-02-27,0,0,48,0,0,5,0
Kings,2021-02-27,37,0,135,7,0,6,37
Ventura,2021-02-27,141,5,1183,36,2,43,146
San Luis Obispo,2021-02-27,16,1,460,1,0,24,17
Amador,2021-02-27,3,0,52,1,0,2,3
Butte,2021-02-27,23,0,451,4,0,10,23
Nevada,2021-02-27,2,2,122,1,0,2,4
Marin,2021-02-27,13,3,317,4,1,18,16
Kern,2021-02-27,159,3,1140,53,0,28,162
Santa Barbara,2021-02-27,70,6,603,18,2,28,76
Lassen,2021-02-27,0,0,25,0,0,0,0
Inyo,2021-02-27,1,0,29,0,0,2,1
Modoc,2021-02-27,0,0,12,0,0,0,0
Sacramento,2021-02-27,165,22,2598,49,6,68,187
El Dorado,2021-02-27,4,1,190,1,1,3,5
Plumas,2021-02-27,0,0,35,0,0,0,0
Sonoma,2021-02-27,30,1,653,13,0,14,31
Siskiyou,2021-02-27,3,0,56,0,0,3,3
San Bernardino,2021-02-27,299,23,3569,78,4,116,322
Yuba,2021-02-27,22,0,261,6,0,2,22
Shasta,2021-02-27,18,1,567,4,0,20,19
Madera,2021-02-27,26,7,281,5,0,2,33
Imperial,2021-02-27,21,2,234,9,0,1,23
Santa Cruz,2021-02-27,15,1,372,1,1,9,16
Orange,2021-02-27,421,22,5869,132,5,245,443
Calaveras,2021-02-27,1,0,33,1,0,5,1
Solano,2021-02-27,39,14,590,12,0,11,53
Lake,2021-02-27,1,0,63,1,0,5,1
Contra Costa,2021-02-28,73,17,1327,25,0,68,90
Yuba,2021-02-28,18,1,261,5,0,3,19
San Bernardino,2021-02-28,285,23,3548,75,5,112,308
Alameda,2021-02-28,152,26,2464,36,4,107,178
San Joaquin,2021-02-28,94,11,885,36,3,7,105
Colusa,2021-02-28,0,0,48,0,0,5,0
Lake,2021-02-28,1,0,63,1,0,26,1
Yolo,2021-02-28,16,0,125,6,0,3,16
Placer,2021-02-28,61,11,770,16,0,19,72
Sacramento,2021-02-28,157,22,2594,47,4,86,179
Imperial,2021-02-28,22,0,234,8,0,3,22
Sonoma,2021-02-28,29,1,632,16,0,14,30
Santa Barbara,2021-02-28,59,5,603,17,0,34,64
Napa,2021-02-28,5,0,202,2,0,3,5
Del Norte,2021-02-28,2,0,53,1,0,1,2
Tehama,2021-02-28,3,0,59,0,0,4,3
Butte,2021-02-28,24,0,451,5,0,13,24
Plumas,2021-02-28,0,0,35,0,0,0,0
Kern,2021-02-28,148,6,1121,46,0,35,154
Trinity,2021-02-28,0,0,25,0,0,0,0
El Dorado,2021-02-28,4,0,190,1,0,5,4
Modoc,2021-02-28,0,0,12,0,0,0,0
Glenn,2021-02-28,0,0,47,0,0,0,0
Amador,2021-02-28,3,0,52,1,0,2,3
Mariposa,2021-02-28,0,0,14,0,0,0,0
Siskiyou,2021-02-28,2,0,56,0,0,4,2
Inyo,2021-02-28,0,0,29,0,0,2,0
Mono,2021-02-28,0,0,17,0,0,2,0
Humboldt,2021-02-28,7,3,276,0,1,7,10
Shasta,2021-02-28,16,0,567,4,0,22,16
Merced,2021-02-28,31,0,271,6,0,7,31
Orange,2021-02-28,419,26,5816,119,4,251,445
Mendocino,2021-02-28,4,0,84,2,0,2,4
Santa Cruz,2021-02-28,15,1,372,1,1,10,16
Madera,2021-02-28,20,8,280,3,0,2,28
Los Angeles,2021-02-28,1502,157,19137,475,28,518,1659
San Diego,2021-02-28,484,20,6491,149,6,227,504
San Luis Obispo,2021-02-28,17,1,460,2,0,28,18
Nevada,2021-02-28,0,1,116,1,0,2,1
Stanislaus,2021-02-28,111,15,1307,31,3,23,126
San Francisco,2021-02-28,79,6,2106,28,3,80,85
Riverside,2021-02-28,307,57,3259,83,11,61,364
Kings,2021-02-28,33,0,129,7,0,2,33
Ventura,2021-02-28,116,4,1138,30,0,39,120
Sutter,2021-02-28,0,0,14,0,0,0,0
Calaveras,2021-02-28,0,0,33,0,0,6,0
Monterey,2021-02-28,38,1,720,8,0,16,39
Fresno,2021-02-28,191,14,1502,38,1,15,205
Lassen,2021-02-28,0,0,25,0,0,0,0
San Benito,2021-02-28,3,0,25,2,0,0,3
San Mateo,2021-02-28,54,3,680,17,0,24,57
Tuolumne,2021-02-28,0,0,84,0,0,2,0
Tulare,2021-02-28,62,8,647,9,0,22,70
Solano,2021-02-28,42,14,590,13,0,12,56
Marin,2021-02-28,14,3,317,3,1,17,17
Santa Clara,2021-02-28,189,32,3059,64,4,63,221
Riverside,2021-03-01,301,45,3208,73,1,66,346
Kings,2021-03-01,34,1,129,6,0,4,35
San Francisco,2021-03-01,74,3,2103,22,0,99,77
San Bernardino,2021-03-01,280,29,3483,69,6,130,309
San Luis Obispo,2021-03-01,12,2,460,1,0,30,14
Humboldt,2021-03-01,3,5,276,0,1,5,8
Glenn,2021-03-01,0,0,47,0,0,0,0
Santa Cruz,2021-03-01,13,1,372,2,0,8,14
Del Norte,2021-03-01,2,0,52,1,0,1,2
Mendocino,2021-03-01,5,0,107,2,0,3,5
Santa Clara,2021-03-01,182,23,3033,58,1,70,205
Napa,2021-03-01,5,0,209,0,0,6,5
Madera,2021-03-01,21,9,282,3,0,8,30
Amador,2021-03-01,2,0,52,1,0,1,2
Marin,2021-03-01,14,5,316,4,0,14,19
Solano,2021-03-01,44,8,569,16,0,13,52
Monterey,2021-03-01,40,1,720,9,0,18,41
Siskiyou,2021-03-01,3,0,56,1,1,4,3
Butte,2021-03-01,22,1,451,5,1,16,23
Nevada,2021-03-01,4,0,132,1,0,6,4
Sonoma,2021-03-01,30,2,642,13,1,14,32
Modoc,2021-03-01,0,0,12,0,0,0,0
El Dorado,2021-03-01,3,0,190,2,0,2,3
Inyo,2021-03-01,1,0,29,0,0,2,1
Trinity,2021-03-01,0,0,25,0,0,0,0
Mariposa,2021-03-01,0,0,14,0,0,0,0
Fresno,2021-03-01,181,17,1523,39,0,16,198
San Benito,2021-03-01,2,0,25,1,0,0,2
Shasta,2021-03-01,16,0,567,4,0,26,16
Lake,2021-03-01,0,0,63,0,0,6,0
Calaveras,2021-03-01,0,0,33,0,0,8,0
Tulare,2021-03-01,62,9,667,9,0,21,71
Ventura,2021-03-01,102,7,1113,33,3,39,109
Yuba,2021-03-01,19,0,261,5,0,2,19
Plumas,2021-03-01,0,0,35,0,0,0,0
Alameda,2021-03-01,136,24,2434,33,2,108,160
Colusa,2021-03-01,1,0,48,0,0,5,1
Tehama,2021-03-01,2,0,59,2,0,2,2
Tuolumne,2021-03-01,0,0,84,0,0,6,0
Imperial,2021-03-01,23,0,234,8,0,5,23
Los Angeles,2021-03-01,1476,155,19111,460,25,563,1631
Orange,2021-03-01,425,21,5863,116,5,255,446
San Diego,2021-03-01,479,35,6486,152,4,237,514
Contra Costa,2021-03-01,75,19,1291,26,0,51,94
Mono,2021-03-01,0,0,17,0,0,1,0
San Mateo,2021-03-01,53,3,692,16,1,23,56
Lassen,2021-03-01,0,0,25,0,0,0,0
Placer,2021-03-01,55,8,768,15,1,21,63
San Joaquin,2021-03-01,98,9,882,36,4,10,107
Santa Barbara,2021-03-01,61,6,603,19,2,30,67
Yolo,2021-03-01,14,1,132,6,0,2,15
Sacramento,2021-03-01,150,18,2554,46,0,88,168
Sutter,2021-03-01,0,0,14,0,0,0,0
Kern,2021-03-01,143,8,1114,42,0,32,151
Merced,2021-03-01,33,0,271,5,0,6,33
Stanislaus,2021-03-01,111,15,1297,28,3,25,126
Butte,2021-03-02,21,0,451,5,0,15,21
Madera,2021-03-02,14,3,279,3,1,9,17
Ventura,2021-03-02,101,14,1149,33,1,42,115
Fresno,2021-03-02,180,28,1536,36,2,25,208
San Benito,2021-03-02,2,0,25,1,0,0,2
Tulare,2021-03-02,62,12,672,10,0,22,74
Trinity,2021-03-02,0,0,25,0,0,0,0
San Joaquin,2021-03-02,97,7,881,36,1,11,104
Tuolumne,2021-03-02,0,0,84,0,0,3,0
San Diego,2021-03-02,443,29,6484,142,7,228,472
San Luis Obispo,2021-03-02,11,3,460,1,0,29,14
Santa Clara,2021-03-02,170,20,2989,57,5,58,190
Lake,2021-03-02,0,0,63,0,0,5,0
Placer,2021-03-02,46,10,774,16,1,19,56
Stanislaus,2021-03-02,112,18,1307,28,4,14,130
Amador,2021-03-02,2,0,52,1,0,1,2
Modoc,2021-03-02,0,0,12,0,0,0,0
Sacramento,2021-03-02,154,16,2590,43,0,84,170
Santa Cruz,2021-03-02,12,0,372,2,0,6,12
Yolo,2021-03-02,11,0,132,5,0,1,11
Contra Costa,2021-03-02,69,22,1288,23,1,54,91
Plumas,2021-03-02,0,0,35,0,0,0,0
El Dorado,2021-03-02,3,0,190,2,0,2,3
Mono,2021-03-02,0,0,17,0,0,2,0
Glenn,2021-03-02,0,0,47,0,0,0,0
Marin,2021-03-02,13,4,321,4,0,17,17
Santa Barbara,2021-03-02,57,2,603,19,1,23,59
Shasta,2021-03-02,17,0,567,5,0,21,17
San Bernardino,2021-03-02,267,17,3507,69,2,118,284
Sutter,2021-03-02,0,0,14,0,0,0,0
San Mateo,2021-03-02,49,5,710,15,1,22,54
Siskiyou,2021-03-02,3,0,56,2,0,2,3
Monterey,2021-03-02,38,1,720,9,0,11,39
Solano,2021-03-02,45,8,581,14,0,17,53
San Francisco,2021-03-02,76,2,2113,22,0,92,78
Humboldt,2021-03-02,1,5,276,0,0,9,6
Mariposa,2021-03-02,0,0,14,0,0,0,0
Kings,2021-03-02,34,1,128,4,0,4,35
Inyo,2021-03-02,2,0,29,0,0,2,2
Colusa,2021-03-02,1,2,48,0,0,5,3
Kern,2021-03-02,127,14,1117,42,0,17,141
Riverside,2021-03-02,303,44,3239,66,3,66,347
Nevada,2021-03-02,4,1,118,2,0,4,5
Alameda,2021-03-02,140,25,2464,31,1,106,165
Napa,2021-03-02,4,0,218,0,0,7,4
Merced,2021-03-02,29,0,271,4,0,8,29
Orange,2021-03-02,403,25,5830,107,7,256,428
Sonoma,2021-03-02,22,2,664,10,1,13,24
Lassen,2021-03-02,0,0,25,0,0,0,0
Del Norte,2021-03-02,1,0,52,1,0,1,1
Tehama,2021-03-02,3,0,59,1,0,4,3
Yuba,2021-03-02,21,0,261,4,0,3,21
Calaveras,2021-03-02,0,0,33,0,0,8,0
Los Angeles,2021-03-02,1401,173,19210,450,29,551,1574
Imperial,2021-03-02,22,0,234,9,0,5,22
Mendocino,2021-03-02,4,0,111,1,0,2,4
Sutter,2021-03-03,0,0,14,0,0,0,0
Madera,2021-03-03,13,6,278,3,0,13,19
San Francisco,2021-03-03,65,9,2116,19,0,94,74
Lassen,2021-03-03,0,0,25,0,0,0,0
Alameda,2021-03-03,145,29,2459,32,1,111,174
Nevada,2021-03-03,3,1,132,2,0,3,4
Tuolumne,2021-03-03,1,0,84,0,0,2,1
Tehama,2021-03-03,3,0,59,1,0,1,3
Humboldt,2021-03-03,1,2,275,0,1,5,3
Siskiyou,2021-03-03,3,0,56,1,0,4,3
Merced,2021-03-03,22,0,271,2,0,8,22
San Benito,2021-03-03,2,0,25,0,0,0,2
Kings,2021-03-03,35,1,130,4,0,5,36
Marin,2021-03-03,16,3,322,4,0,14,19
Del Norte,2021-03-03,1,0,52,1,0,1,1
San Diego,2021-03-03,429,24,6496,139,6,234,453
Ventura,2021-03-03,102,4,1167,32,0,54,106
Riverside,2021-03-03,303,43,3264,68,3,55,346
Butte,2021-03-03,21,0,451,3,0,15,21
Mendocino,2021-03-03,2,0,110,2,0,3,2
El Dorado,2021-03-03,4,0,190,3,0,4,4
Monterey,2021-03-03,40,1,720,8,0,12,41
Amador,2021-03-03,2,0,52,2,0,0,2
Shasta,2021-03-03,15,0,567,5,0,8,15
Mariposa,2021-03-03,0,0,14,0,0,0,0
Inyo,2021-03-03,2,0,29,0,0,2,2
San Luis Obispo,2021-03-03,12,1,460,2,0,27,13
Sonoma,2021-03-03,18,5,660,8,1,15,23
Yolo,2021-03-03,7,0,134,4,0,1,7
Modoc,2021-03-03,0,0,12,0,0,0,0
Trinity,2021-03-03,0,0,25,0,0,0,0
Solano,2021-03-03,44,8,593,11,0,17,52
Yuba,2021-03-03,22,0,261,1,0,1,22
Fresno,2021-03-03,174,24,1525,35,1,24,198
Lake,2021-03-03,0,0,63,0,0,7,0
Kern,2021-03-03,127,9,1127,34,8,30,136
Napa,2021-03-03,4,0,218,1,0,6,4
Tulare,2021-03-03,54,10,672,8,0,23,64
Santa Clara,2021-03-03,176,28,3043,60,5,64,204
Calaveras,2021-03-03,0,0,33,0,0,6,0
Sacramento,2021-03-03,152,9,2593,43,0,74,161
Glenn,2021-03-03,0,0,47,0,0,0,0
Contra Costa,2021-03-03,64,24,1280,21,3,49,88
Santa Barbara,2021-03-03,52,1,603,18,0,23,53
San Mateo,2021-03-03,50,6,730,13,1,19,56
Mono,2021-03-03,0,0,17,0,0,2,0
Placer,2021-03-03,50,4,772,17,0,17,54
Orange,2021-03-03,379,26,5883,97,5,249,405
Imperial,2021-03-03,20,0,234,8,0,6,20
Stanislaus,2021-03-03,114,13,1306,26,3,16,127
Los Angeles,2021-03-03,1341,182,19238,429,19,531,1523
San Joaquin,2021-03-03,93,11,905,35,3,10,104
Colusa,2021-03-03,1,2,48,0,0,5,3
Plumas,2021-03-03,0,0,35,0,0,0,0
Santa Cruz,2021-03-03,11,1,372,2,0,5,12
San Bernardino,2021-03-03,254,31,3544,63,0,120,285
Orange,2021-03-04,339,24,5901,91,5,273,363
Nevada,2021-03-04,5,0,129,2,0,3,5
San Francisco,2021-03-04,53,12,2109,17,1,84,65
Santa Cruz,2021-03-04,11,1,372,2,0,8,12
Shasta,2021-03-04,11,0,567,4,0,19,11
Stanislaus,2021-03-04,121,10,1301,26,3,21,131
Lassen,2021-03-04,0,0,25,0,0,0,0
Kings,2021-03-04,34,0,135,4,0,7,34
Riverside,2021-03-04,279,43,3275,66,0,54,322
Alameda,2021-03-04,140,27,2459,32,1,111,167
Amador,2021-03-04,2,0,52,2,0,0,2
Marin,2021-03-04,15,4,318,4,0,11,19
San Mateo,2021-03-04,46,5,721,15,2,20,51
Sutter,2021-03-04,0,0,14,0,0,0,0
Yolo,2021-03-04,6,0,130,3,0,2,6
Plumas,2021-03-04,0,0,35,0,0,0,0
San Bernardino,2021-03-04,210,30,3531,66,3,128,240
Monterey,2021-03-04,39,1,720,8,0,15,40
Lake,2021-03-04,0,0,63,0,0,1,0
San Joaquin,2021-03-04,89,16,884,30,2,12,105
Trinity,2021-03-04,0,0,25,0,0,0,0
Mono,2021-03-04,0,0,17,0,0,2,0
El Dorado,2021-03-04,4,0,190,3,0,11,4
Merced,2021-03-04,20,0,271,1,0,9,20
Los Angeles,2021-03-04,1264,191,19291,372,16,551,1455
Sonoma,2021-03-04,19,0,694,9,0,14,19
Tulare,2021-03-04,54,9,673,7,0,15,63
Mendocino,2021-03-04,2,0,111,2,0,4,2
Tuolumne,2021-03-04,1,0,84,0,0,2,1
Siskiyou,2021-03-04,3,0,56,1,0,4,3
San Diego,2021-03-04,401,23,6485,127,3,250,424
Del Norte,2021-03-04,1,0,52,1,0,0,1
Fresno,2021-03-04,156,23,1513,34,2,23,179
Imperial,2021-03-04,21,1,234,7,0,6,22
Butte,2021-03-04,23,0,451,2,0,14,23
Mariposa,2021-03-04,0,0,14,0,0,0,0
Sacramento,2021-03-04,143,19,2585,46,1,79,162
Placer,2021-03-04,51,9,777,16,0,21,60
Kern,2021-03-04,127,8,1134,40,0,35,135
Contra Costa,2021-03-04,67,26,1307,20,3,40,93
Humboldt,2021-03-04,1,4,275,0,1,5,5
San Benito,2021-03-04,2,0,25,0,0,0,2
Madera,2021-03-04,9,3,278,3,0,6,12
Glenn,2021-03-04,0,0,47,0,0,0,0
Yuba,2021-03-04,21,0,261,3,0,2,21
Inyo,2021-03-04,2,0,29,0,0,1,2
San Luis Obispo,2021-03-04,12,2,460,2,0,23,14
Santa Clara,2021-03-04,171,23,3003,59,2,47,194
Colusa,2021-03-04,1,3,48,0,0,5,4
Napa,2021-03-04,5,1,215,3,0,5,6
Calaveras,2021-03-04,0,0,33,0,0,6,0
Modoc,2021-03-04,0,0,12,0,0,0,0
Tehama,2021-03-04,3,0,59,1,0,3,3
Santa Barbara,2021-03-04,53,3,603,17,0,29,56
Ventura,2021-03-04,103,8,1159,31,1,52,111
Solano,2021-03-04,39,6,585,11,0,16,45
Lassen,2021-03-05,0,0,25,0,0,0,0
Tuolumne,2021-03-05,0,0,84,0,0,0,0
Tehama,2021-03-05,3,0,59,1,0,5,3
San Mateo,2021-03-05,44,8,734,14,2,21,52
Contra Costa,2021-03-05,60,22,1302,23,2,42,82
Napa,2021-03-05,7,0,213,2,0,2,7
Yuba,2021-03-05,19,0,261,3,0,2,19
Del Norte,2021-03-05,1,0,52,1,0,1,1
Plumas,2021-03-05,0,0,35,0,0,0,0
El Dorado,2021-03-05,3,0,190,3,0,5,3
Santa Barbara,2021-03-05,50,1,603,16,0,25,51
Riverside,2021-03-05,263,47,3256,66,2,67,310
Placer,2021-03-05,45,7,782,14,1,23,52
Sacramento,2021-03-05,144,16,2598,44,4,94,160
Ventura,2021-03-05,110,6,1162,31,0,56,116
Kings,2021-03-05,35,0,131,5,0,5,35
Calaveras,2021-03-05,0,0,33,0,0,6,0
Madera,2021-03-05,7,6,278,3,0,10,13
Inyo,2021-03-05,2,0,29,0,0,1,2
Tulare,2021-03-05,51,9,667,8,1,17,60
Humboldt,2021-03-05,2,5,273,0,1,7,7
Santa Cruz,2021-03-05,8,1,372,1,0,8,9
Modoc,2021-03-05,0,0,12,0,0,0,0
Mendocino,2021-03-05,2,0,111,0,0,2,2
Yolo,2021-03-05,7,0,127,4,0,4,7
San Francisco,2021-03-05,55,12,2106,14,1,79,67
San Joaquin,2021-03-05,89,6,887,31,3,9,95
Orange,2021-03-05,321,15,5887,87,3,247,336
San Bernardino,2021-03-05,248,38,3513,63,6,125,286
Santa Clara,2021-03-05,166,33,3025,52,6,48,199
Amador,2021-03-05,2,0,52,2,0,1,2
Trinity,2021-03-05,0,0,25,0,0,0,0
Shasta,2021-03-05,12,0,567,4,0,16,12
Mono,2021-03-05,0,0,17,0,0,2,0
Lake,2021-03-05,0,0,63,0,0,4,0
Siskiyou,2021-03-05,2,0,56,1,0,4,2
Nevada,2021-03-05,5,0,110,1,0,3,5
Solano,2021-03-05,36,8,566,12,1,9,44
Alameda,2021-03-05,131,28,2456,36,2,104,159
Butte,2021-03-05,19,0,451,3,0,17,19
Monterey,2021-03-05,39,1,720,9,0,16,40
Kern,2021-03-05,126,10,1125,38,1,29,136
Los Angeles,2021-03-05,1176,164,19290,361,22,512,1340
Colusa,2021-03-05,1,3,48,0,0,5,4
Sutter,2021-03-05,0,0,14,0,0,0,0
San Luis Obispo,2021-03-05,13,1,460,2,0,25,14
San Benito,2021-03-05,1,0,25,0,0,0,1
Stanislaus,2021-03-05,115,11,1306,22,2,30,126
Mariposa,2021-03-05,0,0,14,0,0,0,0
Marin,2021-03-05,17,4,326,4,0,8,21
Glenn,2021-03-05,0,0,47,0,0,0,0
Merced,2021-03-05,16,0,271,1,0,11,16
Fresno,2021-03-05,150,24,1497,37,5,24,174
Imperial,2021-03-05,22,0,234,6,0,8,22
Sonoma,2021-03-05,20,0,681,7,0,18,20
San Diego,2021-03-05,359,23,6467,120,4,246,382
Modoc,2021-03-06,0,0,12,0,0,0,0
San Benito,2021-03-06,1,0,25,0,0,0,1
Marin,2021-03-06,17,4,324,3,0,12,21
San Bernardino,2021-03-06,242,20,3489,51,4,118,262
Butte,2021-03-06,18,1,451,3,0,14,19
Fresno,2021-03-06,142,29,1478,35,3,28,171
Inyo,2021-03-06,2,0,29,0,0,1,2
Sonoma,2021-03-06,19,0,651,10,0,15,19
Yuba,2021-03-06,18,0,261,3,0,3,18
San Francisco,2021-03-06,51,5,2125,14,1,75,56
Lassen,2021-03-06,0,0,25,0,0,0,0
Placer,2021-03-06,42,9,774,14,0,19,51
Nevada,2021-03-06,2,0,110,1,0,3,2
Plumas,2021-03-06,0,0,35,0,0,0,0
Tuolumne,2021-03-06,0,0,84,0,0,0,0
San Joaquin,2021-03-06,86,5,873,32,3,11,91
San Diego,2021-03-06,357,27,6468,113,5,279,384
Stanislaus,2021-03-06,105,13,1307,24,2,18,118
Sacramento,2021-03-06,130,19,2545,42,4,85,149
Del Norte,2021-03-06,1,0,52,1,0,3,1
Mendocino,2021-03-06,1,0,107,0,0,5,1
Solano,2021-03-06,34,5,562,9,0,13,39
Shasta,2021-03-06,13,0,567,4,0,19,13
Santa Clara,2021-03-06,159,23,3020,46,3,55,182
Siskiyou,2021-03-06,2,0,56,1,0,2,2
Monterey,2021-03-06,35,0,720,8,0,20,35
Lake,2021-03-06,0,0,63,0,0,2,0
Colusa,2021-03-06,1,2,48,0,0,5,3
Yolo,2021-03-06,7,0,122,4,0,1,7
Humboldt,2021-03-06,2,6,273,0,0,7,8
Madera,2021-03-06,9,11,278,3,1,8,20
Riverside,2021-03-06,257,54,3237,63,4,62,311
Ventura,2021-03-06,106,11,1173,31,0,51,117
Tehama,2021-03-06,3,0,59,1,0,3,3
Sutter,2021-03-06,0,0,14,0,0,0,0
Merced,2021-03-06,14,0,271,1,0,10,14
El Dorado,2021-03-06,2,0,190,2,0,5,2
Amador,2021-03-06,2,0,52,2,0,2,2
Los Angeles,2021-03-06,1132,156,19192,356,17,538,1288
Contra Costa,2021-03-06,61,13,1284,22,2,40,74
Glenn,2021-03-06,0,0,47,0,0,0,0
Calaveras,2021-03-06,1,0,33,0,0,8,1
Kern,2021-03-06,113,8,1113,27,1,35,121
Santa Cruz,2021-03-06,10,0,372,2,0,6,10
Tulare,2021-03-06,47,9,668,6,3,21,56
Trinity,2021-03-06,0,0,25,0,0,0,0
Napa,2021-03-06,6,1,214,2,0,6,7
Santa Barbara,2021-03-06,48,2,603,15,0,30,50
Kings,2021-03-06,33,0,122,3,0,4,33
San Luis Obispo,2021-03-06,11,0,460,3,0,21,11
Orange,2021-03-06,296,15,5860,89,1,254,311
Alameda,2021-03-06,116,29,2464,34,3,99,145
San Mateo,2021-03-06,40,2,701,13,2,20,42
Mariposa,2021-03-06,0,0,14,0,0,0,0
Imperial,2021-03-06,18,0,234,7,0,6,18
Mono,2021-03-06,0,0,17,0,0,1,0
Sutter,2021-03-07,0,0,14,0,0,0,0
Sonoma,2021-03-07,20,1,637,8,1,16,21
Riverside,2021-03-07,251,63,3239,64,10,78,314
San Mateo,2021-03-07,39,2,694,13,1,20,41
Kern,2021-03-07,112,6,1127,33,0,34,118
Solano,2021-03-07,35,4,549,8,0,15,39
San Francisco,2021-03-07,47,9,2103,15,0,90,56
San Diego,2021-03-07,345,21,6450,114,3,255,366
Santa Barbara,2021-03-07,51,3,603,15,0,36,54
Santa Clara,2021-03-07,154,21,2970,49,3,68,175
Ventura,2021-03-07,99,8,1145,25,1,50,107
San Benito,2021-03-07,1,0,25,1,0,1,1
Kings,2021-03-07,28,0,129,3,0,5,28
Madera,2021-03-07,8,6,278,2,0,6,14
Amador,2021-03-07,2,0,52,2,0,3,2
Sacramento,2021-03-07,118,27,2545,39,11,102,145
Contra Costa,2021-03-07,65,10,1272,17,3,43,75
Merced,2021-03-07,16,0,271,3,0,14,16
Mendocino,2021-03-07,2,0,106,0,0,4,2
Shasta,2021-03-07,11,0,567,4,0,20,11
Trinity,2021-03-07,0,0,25,0,0,0,0
Orange,2021-03-07,288,19,5782,84,3,260,307
Nevada,2021-03-07,3,0,99,1,0,2,3
Del Norte,2021-03-07,1,0,52,1,0,2,1
San Bernardino,2021-03-07,249,35,3465,50,7,118,284
San Joaquin,2021-03-07,90,5,880,30,3,9,95
Stanislaus,2021-03-07,116,14,1306,24,3,24,130
El Dorado,2021-03-07,3,0,190,2,0,6,3
Yolo,2021-03-07,6,0,123,3,0,3,6
Santa Cruz,2021-03-07,10,0,372,3,0,7,10
Plumas,2021-03-07,0,0,35,0,0,0,0
Mariposa,2021-03-07,0,0,14,0,0,0,0
Glenn,2021-03-07,0,0,47,0,0,0,0
Mono,2021-03-07,0,0,17,0,0,2,0
Siskiyou,2021-03-07,1,2,56,1,0,2,3
Alameda,2021-03-07,114,27,2434,33,2,112,141
Lake,2021-03-07,0,0,63,0,0,1,0
Inyo,2021-03-07,2,0,29,0,0,1,2
Calaveras,2021-03-07,1,0,33,0,0,8,1
Tehama,2021-03-07,3,0,59,1,0,0,3
Tuolumne,2021-03-07,1,0,84,0,0,1,1
Tulare,2021-03-07,46,8,648,3,2,31,54
Napa,2021-03-07,5,0,207,1,0,4,5
Humboldt,2021-03-07,4,4,268,0,1,7,8
Butte,2021-03-07,18,1,451,2,0,12,19
Imperial,2021-03-07,15,0,234,7,0,5,15
Monterey,2021-03-07,38,0,720,8,0,22,38
Marin,2021-03-07,17,3,320,2,0,8,20
Yuba,2021-03-07,16,0,261,3,0,4,16
Placer,2021-03-07,44,8,774,12,0,27,52
Los Angeles,2021-03-07,1119,128,19119,334,12,573,1247
Fresno,2021-03-07,136,26,1479,41,5,19,162
San Luis Obispo,2021-03-07,15,1,460,4,0,25,16
Lassen,2021-03-07,0,0,25,0,0,0,0
Colusa,2021-03-07,1,0,48,0,0,5,1
Modoc,2021-03-07,0,0,12,0,0,0,0
Lake,2021-03-08,1,0,63,1,0,2,1
Merced,2021-03-08,17,0,271,3,0,13,17
Tehama,2021-03-08,4,0,59,1,0,4,4
Sutter,2021-03-08,0,0,14,0,0,0,0
Madera,2021-03-08,7,6,278,2,1,12,13
Trinity,2021-03-08,0,0,25,0,0,0,0
Stanislaus,2021-03-08,121,16,1306,25,2,21,137
Shasta,2021-03-08,9,0,567,4,0,20,9
Plumas,2021-03-08,0,0,35,0,0,0,0
Imperial,2021-03-08,13,0,234,8,0,3,13
Inyo,2021-03-08,2,0,29,0,0,2,2
Yuba,2021-03-08,18,0,261,3,0,0,18
Kings,2021-03-08,30,1,123,4,0,1,31
Humboldt,2021-03-08,4,5,268,1,1,7,9
Solano,2021-03-08,33,4,495,7,0,18,37
San Bernardino,2021-03-08,253,38,3502,49,11,125,291
El Dorado,2021-03-08,3,0,190,3,0,3,3
Butte,2021-03-08,20,0,451,1,0,13,20
Santa Cruz,2021-03-08,9,0,372,2,0,5,9
Mariposa,2021-03-08,0,0,14,0,0,0,0
San Mateo,2021-03-08,40,4,700,11,1,24,44
Modoc,2021-03-08,0,0,12,0,0,0,0
Los Angeles,2021-03-08,1079,139,19105,320,29,581,1218
San Luis Obispo,2021-03-08,16,1,460,4,0,23,17
Monterey,2021-03-08,38,0,720,8,0,20,38
San Diego,2021-03-08,341,23,6456,110,4,261,364
Santa Clara,2021-03-08,151,23,2972,43,4,72,174
Nevada,2021-03-08,4,0,124,1,0,2,4
Ventura,2021-03-08,89,9,1135,24,1,50,98
Alameda,2021-03-08,118,22,2435,34,1,110,140
Orange,2021-03-08,283,19,5738,77,2,265,302
San Francisco,2021-03-08,49,8,2093,18,0,88,57
Tulare,2021-03-08,42,13,668,4,3,27,55
Yolo,2021-03-08,7,1,125,2,0,1,8
Contra Costa,2021-03-08,68,13,1257,18,5,39,81
San Joaquin,2021-03-08,91,4,886,30,1,12,95
Napa,2021-03-08,5,0,207,1,0,9,5
Tuolumne,2021-03-08,2,0,84,1,0,1,2
San Benito,2021-03-08,0,0,25,0,0,2,0
Santa Barbara,2021-03-08,47,3,603,15,0,40,50
Colusa,2021-03-08,1,3,48,0,0,5,4
Marin,2021-03-08,17,5,325,3,0,7,22
Riverside,2021-03-08,264,50,3245,59,6,66,314
Kern,2021-03-08,115,5,1125,32,0,42,120
Sonoma,2021-03-08,19,3,621,11,0,15,22
Placer,2021-03-08,46,8,779,11,0,21,54
Calaveras,2021-03-08,1,0,33,0,0,6,1
Mono,2021-03-08,0,0,17,0,0,2,0
Amador,2021-03-08,2,0,52,2,0,4,2
Fresno,2021-03-08,142,17,1491,38,2,23,159
Lassen,2021-03-08,0,0,25,0,0,0,0
Mendocino,2021-03-08,2,0,111,0,0,4,2
Glenn,2021-03-08,0,0,47,0,0,0,0
Del Norte,2021-03-08,1,0,52,0,0,4,1
Siskiyou,2021-03-08,4,0,56,2,0,6,4
Sacramento,2021-03-08,116,18,2535,35,5,93,134
Orange,2021-03-09,277,31,5781,73,4,243,308
Tehama,2021-03-09,3,0,59,1,0,3,3
El Dorado,2021-03-09,2,0,190,0,0,1,2
Sacramento,2021-03-09,117,17,2553,36,4,86,134
San Mateo,2021-03-09,36,7,710,13,2,23,43
San Benito,2021-03-09,2,0,25,0,0,2,2
Sutter,2021-03-09,0,0,14,0,0,0,0
San Joaquin,2021-03-09,91,9,888,32,2,14,100
Yuba,2021-03-09,13,0,261,4,0,2,13
Alameda,2021-03-09,110,18,2466,32,1,101,128
Imperial,2021-03-09,14,1,234,8,0,3,15
Placer,2021-03-09,39,6,786,11,1,25,45
Ventura,2021-03-09,90,17,1151,20,2,52,107
San Luis Obispo,2021-03-09,14,0,460,3,0,21,14
San Francisco,2021-03-09,46,14,2118,17,2,92,60
Sonoma,2021-03-09,19,0,611,11,0,13,19
Butte,2021-03-09,21,0,451,1,0,18,21
Inyo,2021-03-09,2,0,29,0,0,2,2
Colusa,2021-03-09,0,3,48,0,0,5,3
Calaveras,2021-03-09,1,0,33,0,0,6,1
Modoc,2021-03-09,0,0,12,0,0,0,0
San Bernardino,2021-03-09,237,29,3520,48,9,131,266
Yolo,2021-03-09,6,0,128,2,0,1,6
Shasta,2021-03-09,8,0,567,3,0,24,8
Trinity,2021-03-09,0,0,25,0,0,0,0
Del Norte,2021-03-09,1,0,52,0,0,3,1
Kings,2021-03-09,29,0,126,4,0,2,29
Mariposa,2021-03-09,0,0,14,0,0,0,0
San Diego,2021-03-09,334,31,6467,100,6,271,365
Mono,2021-03-09,0,0,17,0,0,1,0
Mendocino,2021-03-09,1,0,111,1,0,2,1
Riverside,2021-03-09,254,35,3339,54,2,75,289
Merced,2021-03-09,22,0,271,7,0,3,22
Lassen,2021-03-09,0,0,25,0,0,0,0
Fresno,2021-03-09,142,29,1513,36,3,18,171
Napa,2021-03-09,5,0,200,1,0,6,5
Kern,2021-03-09,104,8,1112,33,0,33,112
Santa Clara,2021-03-09,136,27,2983,41,2,65,163
Los Angeles,2021-03-09,1056,151,19297,309,22,557,1207
Contra Costa,2021-03-09,62,16,1284,19,3,38,78
Marin,2021-03-09,18,2,320,4,0,5,20
Madera,2021-03-09,6,3,278,2,0,12,9
Santa Cruz,2021-03-09,9,1,372,2,0,4,10
Siskiyou,2021-03-09,3,0,56,2,0,6,3
Plumas,2021-03-09,0,0,35,0,0,0,0
Glenn,2021-03-09,0,0,47,0,0,0,0
Stanislaus,2021-03-09,123,19,1307,24,3,21,142
Humboldt,2021-03-09,4,3,273,1,1,8,7
Tulare,2021-03-09,43,11,668,4,3,21,54
Lake,2021-03-09,0,0,64,0,0,1,0
Santa Barbara,2021-03-09,46,2,603,13,0,43,48
Solano,2021-03-09,29,4,518,7,0,19,33
Amador,2021-03-09,2,0,52,2,0,3,2
Monterey,2021-03-09,41,0,720,8,0,21,41
Tuolumne,2021-03-09,1,0,84,0,0,2,1
Nevada,2021-03-09,6,0,121,3,0,0,6
Ventura,2021-03-10,87,12,1138,22,2,48,99
Marin,2021-03-10,14,2,318,6,0,8,16
San Joaquin,2021-03-10,85,10,902,28,2,14,95
Glenn,2021-03-10,0,0,47,0,0,0,0
Plumas,2021-03-10,0,0,35,0,0,0,0
Solano,2021-03-10,26,8,530,8,2,17,34
Yolo,2021-03-10,5,0,127,2,0,1,5
Merced,2021-03-10,21,0,271,7,0,8,21
Colusa,2021-03-10,0,3,48,0,0,5,3
Humboldt,2021-03-10,3,5,273,2,3,3,8
El Dorado,2021-03-10,2,1,190,0,1,4,3
Mono,2021-03-10,0,0,17,0,0,1,0
Stanislaus,2021-03-10,126,15,1306,23,2,26,141
Nevada,2021-03-10,6,0,128,3,0,0,6
Santa Cruz,2021-03-10,6,1,372,2,0,5,7
Orange,2021-03-10,252,24,5838,67,4,243,276
Napa,2021-03-10,3,0,218,1,0,6,3
Santa Barbara,2021-03-10,48,1,603,13,0,38,49
Placer,2021-03-10,32,8,784,9,1,31,40
Modoc,2021-03-10,0,0,12,0,0,0,0
Trinity,2021-03-10,0,0,25,0,0,0,0
Calaveras,2021-03-10,0,0,33,0,0,6,0
Yuba,2021-03-10,12,1,261,4,0,1,13
Alameda,2021-03-10,111,18,2492,31,2,90,129
Shasta,2021-03-10,9,0,567,4,0,19,9
San Diego,2021-03-10,319,30,6481,94,9,271,349
Mendocino,2021-03-10,1,0,111,1,0,5,1
Del Norte,2021-03-10,1,0,52,0,0,4,1
Siskiyou,2021-03-10,3,0,56,2,0,5,3
Inyo,2021-03-10,3,0,29,0,0,2,3
Contra Costa,2021-03-10,54,12,1277,17,1,34,66
Santa Clara,2021-03-10,143,26,3000,43,4,80,169
Amador,2021-03-10,2,0,52,1,0,3,2
Lake,2021-03-10,2,0,63,1,0,1,2
Kern,2021-03-10,98,10,1117,33,0,32,108
Tulare,2021-03-10,42,4,672,7,0,26,46
Imperial,2021-03-10,12,0,234,7,0,6,12
Monterey,2021-03-10,36,0,720,8,0,22,36
Riverside,2021-03-10,234,30,3294,56,2,96,264
Sacramento,2021-03-10,122,23,2576,37,5,84,145
San Bernardino,2021-03-10,219,28,3563,48,2,131,247
Madera,2021-03-10,7,6,278,2,0,10,13
Mariposa,2021-03-10,0,0,14,0,0,0,0
Butte,2021-03-10,23,0,451,1,0,16,23
San Mateo,2021-03-10,34,8,714,15,2,23,42
San Luis Obispo,2021-03-10,11,0,460,2,0,17,11
Kings,2021-03-10,24,0,130,4,0,5,24
Sonoma,2021-03-10,20,0,662,10,0,13,20
Los Angeles,2021-03-10,1015,163,19266,287,23,574,1178
Tuolumne,2021-03-10,1,0,84,0,0,1,1
Lassen,2021-03-10,0,0,25,0,0,0,0
Tehama,2021-03-10,5,0,59,1,0,4,5
Sutter,2021-03-10,0,0,14,0,0,0,0
San Benito,2021-03-10,2,0,25,0,0,1,2
San Francisco,2021-03-10,44,9,2139,18,0,79,53
Fresno,2021-03-10,152,23,1524,34,3,15,175
Calaveras,2021-03-11,0,0,33,0,0,6,0
Nevada,2021-03-11,6,0,121,2,0,2,6
Yolo,2021-03-11,1,4,134,2,0,2,5
San Joaquin,2021-03-11,75,8,895,25,2,10,83
San Benito,2021-03-11,1,0,25,0,0,0,1
Alameda,2021-03-11,107,30,2494,31,1,86,137
San Francisco,2021-03-11,41,10,2129,19,0,87,51
Lassen,2021-03-11,0,0,25,0,0,0,0
Amador,2021-03-11,2,0,52,1,0,3,2
Tehama,2021-03-11,6,0,59,1,0,4,6
Stanislaus,2021-03-11,128,16,1303,26,2,19,144
Siskiyou,2021-03-11,3,0,56,2,0,6,3
Monterey,2021-03-11,35,0,720,8,0,22,35
Sutter,2021-03-11,0,0,14,0,0,0,0
Solano,2021-03-11,21,7,527,6,1,22,28
Del Norte,2021-03-11,0,0,52,0,0,4,0
Madera,2021-03-11,8,10,278,2,0,12,18
Imperial,2021-03-11,15,0,234,7,0,3,15
Glenn,2021-03-11,0,0,47,0,0,0,0
Napa,2021-03-11,5,0,210,2,0,5,5
San Luis Obispo,2021-03-11,9,1,460,1,0,20,10
El Dorado,2021-03-11,2,0,190,0,0,6,2
Santa Barbara,2021-03-11,43,0,603,15,0,32,43
Lake,2021-03-11,1,0,63,1,0,0,1
Mendocino,2021-03-11,2,0,110,1,0,4,2
Colusa,2021-03-11,1,1,48,0,0,5,2
Merced,2021-03-11,23,0,271,7,0,6,23
Los Angeles,2021-03-11,979,167,19316,285,20,578,1146
Butte,2021-03-11,21,0,451,4,0,11,21
Inyo,2021-03-11,3,0,29,1,0,1,3
Tuolumne,2021-03-11,2,0,84,0,0,2,2
Fresno,2021-03-11,147,25,1522,37,1,16,172
Sacramento,2021-03-11,118,19,2603,30,6,76,137
Riverside,2021-03-11,217,25,3278,52,4,85,242
Sonoma,2021-03-11,21,1,677,10,0,14,22
Mariposa,2021-03-11,0,0,14,0,0,0,0
Modoc,2021-03-11,0,0,12,0,0,0,0
Shasta,2021-03-11,9,0,567,3,0,18,9
Contra Costa,2021-03-11,50,11,1290,18,4,37,61
Kings,2021-03-11,20,0,121,3,0,8,20
San Bernardino,2021-03-11,217,34,3573,54,2,146,251
Plumas,2021-03-11,0,0,35,0,0,0,0
Mono,2021-03-11,0,0,17,0,0,1,0
Humboldt,2021-03-11,4,3,273,2,0,2,7
Orange,2021-03-11,245,21,5842,74,5,237,266
Yuba,2021-03-11,12,0,261,3,0,2,12
San Diego,2021-03-11,293,23,6469,90,4,249,316
Ventura,2021-03-11,88,6,1150,22,0,49,94
Tulare,2021-03-11,36,7,667,7,0,30,43
San Mateo,2021-03-11,38,8,720,15,3,21,46
Placer,2021-03-11,30,12,778,9,3,26,42
Santa Cruz,2021-03-11,6,1,372,2,0,5,7
Kern,2021-03-11,98,8,1124,34,0,33,106
Marin,2021-03-11,15,3,318,7,0,8,18
Trinity,2021-03-11,0,0,25,0,0,0,0
Santa Clara,2021-03-11,131,16,3005,45,6,68,147
Yolo,2021-03-12,4,0,131,3,0,2,4
Modoc,2021-03-12,0,0,12,0,0,0,0
Orange,2021-03-12,237,30,5835,71,2,236,267
Riverside,2021-03-12,204,23,3230,51,4,93,227
Glenn,2021-03-12,0,0,47,0,0,0,0
San Francisco,2021-03-12,41,3,2143,18,0,82,44
Kings,2021-03-12,17,0,111,4,0,2,17
Humboldt,2021-03-12,4,3,273,2,0,4,7
Napa,2021-03-12,3,0,207,2,0,2,3
Placer,2021-03-12,31,9,783,9,0,24,40
Santa Clara,2021-03-12,132,17,3019,48,6,59,149
Tulare,2021-03-12,37,6,672,8,1,32,43
Amador,2021-03-12,1,0,52,1,0,4,1
Merced,2021-03-12,20,0,271,7,0,2,20
Fresno,2021-03-12,143,20,1528,37,1,17,163
Alameda,2021-03-12,118,27,2499,30,0,100,145
Mariposa,2021-03-12,0,0,14,0,0,0,0
Ventura,2021-03-12,85,4,1163,21,0,48,89
Tehama,2021-03-12,6,0,59,1,0,4,6
Lake,2021-03-12,1,0,63,1,0,1,1
San Luis Obispo,2021-03-12,9,2,460,0,0,15,11
Sonoma,2021-03-12,22,0,652,11,0,16,22
San Diego,2021-03-12,290,30,6468,95,4,277,320
Shasta,2021-03-12,9,0,567,2,0,21,9
Plumas,2021-03-12,0,0,35,0,0,0,0
Del Norte,2021-03-12,0,0,52,0,0,2,0
Trinity,2021-03-12,0,0,25,0,0,0,0
San Mateo,2021-03-12,35,6,727,14,2,25,41
Solano,2021-03-12,25,9,529,4,1,21,34
Los Angeles,2021-03-12,951,155,19274,281,21,572,1106
Contra Costa,2021-03-12,49,11,1290,16,1,32,60
Kern,2021-03-12,95,4,1122,32,0,29,99
Mendocino,2021-03-12,3,0,105,0,0,6,3
Colusa,2021-03-12,1,2,48,0,0,5,3
Yuba,2021-03-12,10,1,261,2,0,4,11
San Bernardino,2021-03-12,200,21,3552,50,4,126,221
Nevada,2021-03-12,5,0,129,2,0,0,5
Inyo,2021-03-12,2,0,29,0,0,2,2
Santa Barbara,2021-03-12,39,0,603,15,0,30,39
Sacramento,2021-03-12,116,17,2620,29,3,77,133
Monterey,2021-03-12,39,0,720,6,0,25,39
Tuolumne,2021-03-12,2,0,84,0,0,2,2
Marin,2021-03-12,17,3,327,7,0,8,20
Stanislaus,2021-03-12,126,15,1306,27,3,26,141
Calaveras,2021-03-12,0,0,33,0,0,7,0
Siskiyou,2021-03-12,2,0,56,1,0,6,2
Madera,2021-03-12,6,6,278,2,0,13,12
El Dorado,2021-03-12,3,1,190,0,1,4,4
San Benito,2021-03-12,1,0,25,0,0,0,1
Mono,2021-03-12,0,0,17,0,0,1,0
Santa Cruz,2021-03-12,5,1,372,2,0,5,6
Lassen,2021-03-12,0,0,25,0,0,0,0
Imperial,2021-03-12,14,0,234,8,0,3,14
San Joaquin,2021-03-12,73,13,892,20,3,4,86
Sutter,2021-03-12,0,0,14,0,0,0,0
Butte,2021-03-12,17,0,451,2,0,16,17
Amador,2021-03-13,1,0,52,1,0,4,1
San Luis Obispo,2021-03-13,9,2,460,0,0,23,11
Napa,2021-03-13,5,0,210,1,0,4,5
Stanislaus,2021-03-13,118,14,1307,30,1,25,132
Kings,2021-03-13,15,0,109,5,0,4,15
Tehama,2021-03-13,5,0,59,1,0,4,5
Kern,2021-03-13,92,5,1098,32,0,34,97
Lake,2021-03-13,2,0,63,1,0,3,2
Yolo,2021-03-13,4,0,132,3,0,3,4
Trinity,2021-03-13,0,0,25,0,0,0,0
Siskiyou,2021-03-13,1,0,56,1,0,6,1
Placer,2021-03-13,39,6,784,11,0,24,45
San Bernardino,2021-03-13,194,20,3546,48,2,143,214
Modoc,2021-03-13,0,0,12,0,0,0,0
Sonoma,2021-03-13,23,1,649,10,0,17,24
Mendocino,2021-03-13,3,0,110,0,0,6,3
Mono,2021-03-13,0,0,17,0,0,2,0
Orange,2021-03-13,241,26,5863,76,3,260,267
San Diego,2021-03-13,279,24,6470,92,5,297,303
San Joaquin,2021-03-13,69,11,880,18,3,11,80
Humboldt,2021-03-13,4,6,268,2,1,6,10
Santa Cruz,2021-03-13,9,0,372,3,0,7,9
Nevada,2021-03-13,6,0,132,2,0,0,6
Colusa,2021-03-13,1,1,48,0,0,5,2
Ventura,2021-03-13,77,6,1161,21,0,43,83
Glenn,2021-03-13,0,0,47,0,0,0,0
El Dorado,2021-03-13,1,0,190,0,0,7,1
Plumas,2021-03-13,0,0,35,0,0,0,0
Calaveras,2021-03-13,1,0,33,0,0,7,1
Madera,2021-03-13,9,14,278,3,2,5,23
Lassen,2021-03-13,0,0,25,0,0,0,0
Los Angeles,2021-03-13,893,156,19192,251,22,590,1049
Santa Clara,2021-03-13,131,12,3019,45,4,70,143
Butte,2021-03-13,13,1,451,2,0,11,14
Monterey,2021-03-13,37,0,720,6,0,24,37
Marin,2021-03-13,18,5,321,7,1,8,23
Del Norte,2021-03-13,0,0,52,0,0,2,0
Solano,2021-03-13,25,7,567,4,1,21,32
San Benito,2021-03-13,1,0,25,0,0,2,1
Shasta,2021-03-13,10,0,567,2,0,22,10
San Mateo,2021-03-13,35,7,715,16,2,19,42
Inyo,2021-03-13,3,0,29,0,0,1,3
Imperial,2021-03-13,13,0,234,6,0,3,13
Riverside,2021-03-13,182,23,3219,43,3,88,205
Tulare,2021-03-13,34,4,653,8,1,26,38
Sacramento,2021-03-13,119,14,2601,24,3,80,133
Fresno,2021-03-13,128,20,1498,36,2,17,148
Mariposa,2021-03-13,0,0,14,0,0,0,0
Santa Barbara,2021-03-13,37,1,603,12,0,38,38
Merced,2021-03-13,20,0,271,7,0,3,20
Alameda,2021-03-13,117,34,2517,34,4,99,151
Yuba,2021-03-13,9,1,261,1,0,6,10
Tuolumne,2021-03-13,3,0,84,0,0,2,3
Contra Costa,2021-03-13,48,16,1297,13,3,35,64
Sutter,2021-03-13,0,0,14,0,0,0,0
San Francisco,2021-03-13,46,8,2142,18,0,70,54
Tuolumne,2021-03-14,1,0,84,0,0,0,1
Siskiyou,2021-03-14,1,0,56,1,0,6,1
Solano,2021-03-14,29,7,566,4,1,24,36
Kings,2021-03-14,14,0,109,4,0,4,14
Fresno,2021-03-14,131,22,1492,37,2,23,153
Placer,2021-03-14,37,6,784,11,0,22,43
San Bernardino,2021-03-14,191,29,3514,43,5,150,220
Sonoma,2021-03-14,23,1,639,9,0,17,24
San Francisco,2021-03-14,45,9,2138,16,1,84,54
Orange,2021-03-14,233,24,5757,72,4,249,257
Tulare,2021-03-14,35,3,652,5,1,25,38
Yolo,2021-03-14,4,0,115,2,0,2,4
El Dorado,2021-03-14,2,0,190,0,0,6,2
Kern,2021-03-14,95,5,1103,26,0,45,100
Contra Costa,2021-03-14,51,15,1297,16,4,37,66
Lake,2021-03-14,2,0,64,1,0,2,2
Merced,2021-03-14,21,0,271,8,0,8,21
Napa,2021-03-14,3,0,206,1,0,3,3
Monterey,2021-03-14,39,0,720,6,0,19,39
Amador,2021-03-14,1,0,52,1,0,0,1
Madera,2021-03-14,12,7,278,3,0,12,19
Santa Barbara,2021-03-14,39,3,603,13,1,39,42
Alameda,2021-03-14,114,32,2517,33,3,108,146
Los Angeles,2021-03-14,865,145,19097,241,24,641,1010
Colusa,2021-03-14,1,1,48,0,0,5,2
Mariposa,2021-03-14,0,0,14,0,0,0,0
Butte,2021-03-14,12,1,451,1,0,15,13
Lassen,2021-03-14,0,0,25,0,0,0,0
Tehama,2021-03-14,5,0,59,1,0,3,5
Sutter,2021-03-14,0,0,14,0,0,0,0
Del Norte,2021-03-14,0,0,52,0,0,0,0
San Mateo,2021-03-14,34,8,717,13,1,24,42
Humboldt,2021-03-14,4,6,267,2,2,8,10
Shasta,2021-03-14,9,0,567,2,0,15,9
Santa Clara,2021-03-14,138,16,3009,44,5,61,154
San Diego,2021-03-14,284,23,6451,91,8,283,307
Plumas,2021-03-14,0,0,35,0,0,0,0
Marin,2021-03-14,16,5,321,7,1,7,21
Yuba,2021-03-14,10,1,261,2,0,5,11
Nevada,2021-03-14,5,0,125,1,0,2,5
Riverside,2021-03-14,195,21,3173,45,6,103,216
Trinity,2021-03-14,0,0,25,0,0,0,0
Stanislaus,2021-03-14,122,15,1307,31,2,28,137
Sacramento,2021-03-14,121,16,2593,24,3,101,137
Mono,2021-03-14,0,0,17,0,0,2,0
Inyo,2021-03-14,3,0,29,0,0,1,3
San Joaquin,2021-03-14,61,11,879,18,3,12,72
Ventura,2021-03-14,76,6,1128,19,0,44,82
Imperial,2021-03-14,14,0,234,6,0,3,14
Santa Cruz,2021-03-14,9,0,372,2,0,9,9
San Luis Obispo,2021-03-14,8,0,460,0,0,26,8
Mendocino,2021-03-14,2,0,105,0,0,3,2
Glenn,2021-03-14,0,0,47,0,0,0,0
Calaveras,2021-03-14,1,0,33,0,0,7,1
San Benito,2021-03-14,1,0,25,0,0,2,1
Modoc,2021-03-14,0,0,12,0,0,0,0
Sutter,2021-03-15,0,0,14,0,0,0,0
Nevada,2021-03-15,5,0,133,1,0,2,5
Placer,2021-03-15,40,6,784,9,0,27,46
Alameda,2021-03-15,108,27,2501,31,3,105,135
Mendocino,2021-03-15,2,0,106,1,0,2,2
Fresno,2021-03-15,125,19,1477,31,1,15,144
San Benito,2021-03-15,0,0,25,0,0,0,0
Shasta,2021-03-15,8,1,567,2,0,16,9
Monterey,2021-03-15,36,0,720,7,0,25,36
Mono,2021-03-15,0,0,17,0,0,2,0
Tuolumne,2021-03-15,1,0,84,0,0,4,1
Inyo,2021-03-15,2,0,29,0,0,2,2
Trinity,2021-03-15,0,0,25,0,0,0,0
Contra Costa,2021-03-15,44,17,1267,16,4,42,61
Sonoma,2021-03-15,26,1,669,8,0,17,27
San Joaquin,2021-03-15,64,10,889,19,4,9,74
Napa,2021-03-15,2,0,219,1,0,4,2
Yuba,2021-03-15,9,0,261,1,0,6,9
San Diego,2021-03-15,286,20,6461,88,9,286,306
Los Angeles,2021-03-15,857,137,19133,236,28,622,994
Kern,2021-03-15,98,10,1116,27,0,52,108
Colusa,2021-03-15,1,1,48,0,0,5,2
Stanislaus,2021-03-15,125,13,1309,29,1,20,138
Yolo,2021-03-15,2,0,135,1,0,4,2
Plumas,2021-03-15,0,0,35,0,0,0,0
Solano,2021-03-15,29,7,562,4,1,18,36
San Luis Obispo,2021-03-15,7,0,460,0,0,26,7
Lassen,2021-03-15,0,0,25,0,0,0,0
San Bernardino,2021-03-15,185,17,3530,46,1,156,202
El Dorado,2021-03-15,1,0,190,0,0,4,1
Glenn,2021-03-15,0,0,47,0,0,0,0
Tulare,2021-03-15,37,7,647,7,0,26,44
Santa Cruz,2021-03-15,7,1,373,2,0,9,8
San Mateo,2021-03-15,26,6,686,11,1,21,32
Amador,2021-03-15,1,0,52,1,0,0,1
Sacramento,2021-03-15,119,14,2576,19,4,105,133
Tehama,2021-03-15,5,0,59,0,0,1,5
Del Norte,2021-03-15,0,0,52,0,0,2,0
Kings,2021-03-15,15,0,125,2,0,0,15
Merced,2021-03-15,19,0,271,6,0,11,19
Calaveras,2021-03-15,1,0,33,0,0,5,1
Santa Barbara,2021-03-15,40,1,603,15,0,38,41
Modoc,2021-03-15,0,0,12,0,0,0,0
Mariposa,2021-03-15,0,0,14,0,0,0,0
Imperial,2021-03-15,14,0,234,7,0,4,14
Lake,2021-03-15,2,0,63,0,0,0,2
Ventura,2021-03-15,73,9,1139,22,1,44,82
Butte,2021-03-15,12,1,451,1,0,10,13
Siskiyou,2021-03-15,2,0,56,1,0,3,2
Madera,2021-03-15,9,4,278,3,0,13,13
Humboldt,2021-03-15,5,2,272,1,1,9,7
Marin,2021-03-15,15,3,319,7,0,9,18
Orange,2021-03-15,216,24,5709,62,5,262,240
Santa Clara,2021-03-15,144,14,2965,44,1,66,158
Riverside,2021-03-15,188,23,3136,42,5,98,211
San Francisco,2021-03-15,45,3,2115,16,0,93,48
